Time,Clonskeagh Totem,Clonskeagh Totem IN,Clonskeagh Totem OUT,Dun Laoghaire @ Peoples Park Cyclist,Dun Laoghaire @ Peoples Park Cyclists IN,Dun Laoghaire @ Peoples Park Cyclists OUT,Dun Laoghaire @ Seapoint Beach Cyclist,Dun Laoghaire @ Seapoint Beach Cyclists IN,Dun Laoghaire @ Seapoint Beach Cyclists OUT,Dun Laoghaire @ York Road Cyclist,Dun Laoghaire @ York Road Cyclists IN,Dun Laoghaire @ York Road Cyclists OUT,Glenageary Cyclist,Glenageary Bikes IN,Glenageary Bikes OUT,Grange Road Totem,N11 Before UCD,N11 Before UCD Cyclist IN,N11 Before UCD Cyclist OUT,N11 Outbound (Montrose),N11 Outbound (Montrose) OUT-Away From City Centre,N11 Outbound (Montrose) IN- Towards City Centre,N11 Totem Inbound,Rock Road Bus Lane,Rock Road Park,Rock Road Park IN,Rock Road Park OUT,Rock Road Totem Inbound,Wyattville Rd - Bicycles From N11,Wyattville Rd - Bicycles Towards N11,Wyattville Rd At Park Gates Cyclist,Wyattville Rd At Park Gates Bikes IN,Wyattville Rd At Park Gates Bikes OUT,Wyattville Road At Steps Cyclist,Wyattville Road At Steps Bikes IN,Wyattville Road At Steps Bikes OUT
"Jan 1, 2022 12:00 AM",7,4,3,0,0,0,1,1,0,2,0,2,1,0,1,3,1,1,0,0,0,0,1,0,9,9,0,1,0,0,,,,,,
"Jan 1, 2022 1:00 AM",4,4,0,1,0,1,4,0,4,2,0,2,0,0,0,4,3,2,1,0,0,0,2,1,5,2,3,0,0,0,,,,,,
"Jan 1, 2022 2:00 AM",9,6,3,1,1,0,4,1,3,4,2,2,0,0,0,0,0,0,0,0,0,0,0,2,0,0,0,6,0,2,,,,,,
"Jan 1, 2022 3:00 AM",0,0,0,0,0,0,3,0,3,2,0,2,0,0,0,0,1,1,0,0,0,0,1,1,0,0,0,2,0,0,,,,,,
"Jan 1, 2022 4:00 AM",3,1,2,1,1,0,2,0,2,0,0,0,3,0,3,0,0,0,0,0,0,0,0,0,0,0,0,0,0,0,,,,,,
"Jan 1, 2022 5:00 AM",3,2,1,0,0,0,1,0,1,1,0,1,0,0,0,1,0,0,0,0,0,0,1,1,0,0,0,1,1,0,,,,,,
"Jan 1, 2022 6:00 AM",5,2,3,4,3,1,4,4,0,3,3,0,1,0,1,1,1,1,0,0,0,0,1,1,1,1,0,0,0,0,,,,,,
"Jan 1, 2022 7:00 AM",6,2,4,3,1,2,5,2,3,5,3,2,1,0,1,0,2,2,0,0,0,0,2,4,2,1,1,6,1,1,,,,,,
"Jan 1, 2022 8:00 AM",4,1,3,8,7,1,12,9,3,6,5,1,3,2,1,2,2,2,0,0,0,0,2,6,4,3,1,4,1,1,,,,,,
"Jan 1, 2022 9:00 AM",16,6,10,47,37,10,41,30,11,40,32,8,0,0,0,3,6,6,0,0,0,0,6,4,17,12,5,7,0,2,,,,,,
"Jan 1, 2022 10:00 AM",11,5,6,62,35,27,86,59,27,63,39,24,9,4,5,6,8,8,0,0,0,0,8,17,28,21,7,10,1,3,,,,,,
"Jan 1, 2022 11:00 AM",31,16,15,100,57,43,140,95,45,79,52,27,17,12,5,16,15,15,0,0,0,0,12,24,54,40,14,16,2,4,,,,,,
"Jan 1, 2022 12:00 PM",41,25,16,141,73,68,166,88,78,117,71,46,27,9,18,13,13,12,1,0,0,0,14,22,61,42,19,22,10,2,,,,,,
"Jan 1, 2022 1:00 PM",42,17,25,156,67,89,143,69,74,125,55,70,32,23,9,18,11,10,1,0,0,0,10,19,40,22,18,22,3,8,,,,,,
"Jan 1, 2022 2:00 PM",36,20,16,135,66,69,151,58,93,132,69,63,20,8,12,19,16,16,0,0,0,0,12,26,54,24,30,30,5,2,,,,,,
"Jan 1, 2022 3:00 PM",38,19,19,112,49,63,122,59,63,94,48,46,27,4,23,25,22,22,0,0,0,0,17,19,79,42,37,28,2,2,,,,,,
"Jan 1, 2022 4:00 PM",25,9,16,84,36,48,75,21,54,65,26,39,32,20,12,15,13,13,0,0,0,0,16,11,49,22,27,26,2,1,,,,,,
"Jan 1, 2022 5:00 PM",18,7,11,24,9,15,34,12,22,27,13,14,8,1,7,0,12,11,1,0,0,0,11,8,16,5,11,11,1,0,,,,,,
"Jan 1, 2022 6:00 PM",23,8,15,14,10,4,12,8,4,8,4,4,1,0,1,4,6,6,0,0,0,0,6,6,4,4,0,5,0,1,,,,,,
"Jan 1, 2022 7:00 PM",18,8,10,10,3,7,8,2,6,10,6,4,3,3,0,1,4,4,0,0,0,0,4,5,0,0,0,7,2,2,,,,,,
"Jan 1, 2022 8:00 PM",12,6,6,7,4,3,12,7,5,13,8,5,2,0,2,4,5,5,0,0,0,0,4,3,4,3,1,7,0,2,,,,,,
"Jan 1, 2022 9:00 PM",10,4,6,2,1,1,5,2,3,8,5,3,1,1,0,1,7,6,1,0,0,0,6,3,1,1,0,2,1,0,,,,,,
"Jan 1, 2022 10:00 PM",11,4,7,3,3,0,1,1,0,2,2,0,1,0,1,1,3,2,1,0,0,0,2,1,2,1,1,2,1,0,,,,,,
"Jan 1, 2022 11:00 PM",2,1,1,0,0,0,2,1,1,2,1,1,0,0,0,2,2,2,0,0,0,0,1,2,1,0,1,0,0,0,,,,,,
"Jan 2, 2022 12:00 AM",1,0,1,0,0,0,0,0,0,2,1,1,1,0,1,0,0,0,0,0,0,0,0,2,0,0,0,1,1,0,,,,,,
"Jan 2, 2022 1:00 AM",1,0,1,0,0,0,0,0,0,0,0,0,0,0,0,2,1,1,0,0,0,0,1,0,0,0,0,0,0,0,,,,,,
"Jan 2, 2022 2:00 AM",4,2,2,0,0,0,0,0,0,0,0,0,0,0,0,0,0,0,0,0,0,0,0,0,0,0,0,0,0,0,,,,,,
"Jan 2, 2022 3:00 AM",0,0,0,0,0,0,0,0,0,0,0,0,0,0,0,0,0,0,0,0,0,0,0,1,0,0,0,0,0,0,,,,,,
"Jan 2, 2022 4:00 AM",1,1,0,0,0,0,1,1,0,0,0,0,0,0,0,0,0,0,0,0,0,0,0,2,0,0,0,0,0,0,,,,,,
"Jan 2, 2022 5:00 AM",1,1,0,0,0,0,2,2,0,0,0,0,0,0,0,0,1,1,0,0,0,0,1,0,0,0,0,4,0,0,,,,,,
"Jan 2, 2022 6:00 AM",4,1,3,1,1,0,2,1,1,2,2,0,0,0,0,3,2,2,0,0,0,0,2,2,0,0,0,0,0,1,,,,,,
"Jan 2, 2022 7:00 AM",8,4,4,7,6,1,13,9,4,14,10,4,3,3,0,2,6,6,0,0,0,0,6,9,2,2,0,11,0,0,,,,,,
"Jan 2, 2022 8:00 AM",9,2,7,19,12,7,24,15,9,23,13,10,4,3,1,2,6,6,0,0,0,0,6,15,9,8,1,16,0,1,,,,,,
"Jan 2, 2022 9:00 AM",23,11,12,79,57,22,86,56,30,62,44,18,6,4,2,2,6,6,0,0,0,0,5,25,19,14,5,23,1,15,,,,,,
"Jan 2, 2022 10:00 AM",24,14,10,103,63,40,134,88,46,90,57,33,15,5,10,8,19,16,3,0,0,0,16,14,34,22,12,18,1,9,,,,,,
"Jan 2, 2022 11:00 AM",32,14,18,120,58,62,138,64,74,90,48,42,15,9,6,9,19,17,2,0,0,0,18,33,49,28,21,31,6,4,,,,,,
"Jan 2, 2022 12:00 PM",49,33,16,141,43,98,169,78,91,121,54,67,17,10,7,5,15,15,0,0,0,0,13,28,53,27,26,29,13,3,,,,,,
"Jan 2, 2022 1:00 PM",35,20,15,129,73,56,135,79,56,119,71,48,39,23,16,13,21,19,2,0,0,0,20,34,44,28,16,45,12,3,,,,,,
"Jan 2, 2022 2:00 PM",51,28,23,121,63,58,108,49,59,90,47,43,36,24,12,11,20,17,3,0,0,0,16,19,44,28,16,28,4,2,,,,,,
"Jan 2, 2022 3:00 PM",47,22,25,92,36,56,90,39,51,78,35,43,40,17,23,15,11,10,1,0,0,0,5,12,23,9,14,29,1,1,,,,,,
"Jan 2, 2022 4:00 PM",31,13,18,86,42,44,70,26,44,71,30,41,46,18,28,12,7,7,0,0,0,0,7,15,39,20,19,15,0,0,,,,,,
"Jan 2, 2022 5:00 PM",15,4,11,25,10,15,29,16,13,32,13,19,7,1,6,7,9,8,1,0,0,0,8,13,20,12,8,13,2,3,,,,,,
"Jan 2, 2022 6:00 PM",23,11,12,12,3,9,18,8,10,19,4,15,10,4,6,5,5,4,1,0,0,0,4,4,3,3,0,6,0,0,,,,,,
"Jan 2, 2022 7:00 PM",15,7,8,3,2,1,17,4,13,13,4,9,6,3,3,3,3,3,0,0,0,0,3,5,6,5,1,8,1,2,,,,,,
"Jan 2, 2022 8:00 PM",18,7,11,6,3,3,7,1,6,5,1,4,3,1,2,2,5,5,0,0,0,0,5,5,1,0,1,12,0,0,,,,,,
"Jan 2, 2022 9:00 PM",18,6,12,3,1,2,3,0,3,5,2,3,1,0,1,3,5,4,1,0,0,0,5,4,1,0,1,3,1,1,,,,,,
"Jan 2, 2022 10:00 PM",7,1,6,4,2,2,3,2,1,2,1,1,0,0,0,3,2,2,0,0,0,0,2,1,3,0,3,4,0,1,,,,,,
"Jan 2, 2022 11:00 PM",2,1,1,0,0,0,2,0,2,3,1,2,1,0,1,0,1,1,0,0,0,0,2,4,0,0,0,2,0,1,,,,,,
"Jan 3, 2022 12:00 AM",1,0,1,0,0,0,1,0,1,1,0,1,0,0,0,0,0,0,0,0,0,0,0,1,0,0,0,2,0,0,,,,,,
"Jan 3, 2022 1:00 AM",1,0,1,0,0,0,2,0,2,0,0,0,0,0,0,0,0,0,0,0,0,0,0,0,0,0,0,2,0,0,,,,,,
"Jan 3, 2022 2:00 AM",3,3,0,0,0,0,0,0,0,0,0,0,0,0,0,0,0,0,0,0,0,0,0,0,0,0,0,0,0,1,,,,,,
"Jan 3, 2022 3:00 AM",1,0,1,0,0,0,0,0,0,0,0,0,0,0,0,0,0,0,0,0,0,0,1,0,0,0,0,1,0,0,,,,,,
"Jan 3, 2022 4:00 AM",0,0,0,0,0,0,0,0,0,0,0,0,0,0,0,0,0,0,0,0,0,0,0,0,0,0,0,0,0,0,,,,,,
"Jan 3, 2022 5:00 AM",2,0,2,0,0,0,0,0,0,0,0,0,0,0,0,0,1,1,0,0,0,0,1,1,0,0,0,4,0,0,,,,,,
"Jan 3, 2022 6:00 AM",6,4,2,2,0,2,6,1,5,4,0,4,0,0,0,3,3,3,0,0,0,0,3,2,2,1,1,7,1,0,,,,,,
"Jan 3, 2022 7:00 AM",6,3,3,9,5,4,8,6,2,8,6,2,2,0,2,2,6,5,1,0,0,0,5,6,2,2,0,8,0,2,,,,,,
"Jan 3, 2022 8:00 AM",10,2,8,18,10,8,18,8,10,17,11,6,9,3,6,1,5,5,0,0,0,0,6,11,4,3,1,13,1,4,,,,,,
"Jan 3, 2022 9:00 AM",31,11,20,79,54,25,84,59,25,71,46,25,9,2,7,3,11,11,0,0,0,0,11,22,28,22,6,16,1,4,,,,,,
"Jan 3, 2022 10:00 AM",28,16,12,100,65,35,121,76,45,101,65,36,7,5,2,11,8,7,1,0,0,0,9,28,34,30,4,21,3,4,,,,,,
"Jan 3, 2022 11:00 AM",31,19,12,107,58,49,132,68,64,94,48,46,16,12,4,15,14,13,1,0,0,0,14,27,63,49,14,25,7,8,,,,,,
"Jan 3, 2022 12:00 PM",42,20,22,124,54,70,138,71,67,127,67,60,19,13,6,19,22,22,0,0,0,0,18,27,72,31,41,29,10,6,,,,,,
"Jan 3, 2022 1:00 PM",43,18,25,150,74,76,137,80,57,127,72,55,21,11,10,21,28,28,0,0,0,0,24,23,39,19,20,35,3,7,,,,,,
"Jan 3, 2022 2:00 PM",66,30,36,119,60,59,130,46,84,131,51,80,30,18,12,15,15,14,1,0,0,0,19,24,41,27,14,31,7,2,,,,,,
"Jan 3, 2022 3:00 PM",63,32,31,107,39,68,110,53,57,97,48,49,18,7,11,18,14,13,1,0,0,0,10,23,57,18,39,43,10,1,,,,,,
"Jan 3, 2022 4:00 PM",40,19,21,61,23,38,73,27,46,77,28,49,20,6,14,14,16,15,1,0,0,0,15,13,27,14,13,22,6,3,,,,,,
"Jan 3, 2022 5:00 PM",30,10,20,23,12,11,43,14,29,32,16,16,6,3,3,12,12,12,0,0,0,0,11,15,18,10,8,26,2,1,,,,,,
"Jan 3, 2022 6:00 PM",30,12,18,18,9,9,19,6,13,14,8,6,9,7,2,8,7,7,0,0,0,0,6,9,6,3,3,8,2,1,,,,,,
"Jan 3, 2022 7:00 PM",22,9,13,10,5,5,8,1,7,10,4,6,1,0,1,2,6,6,0,0,0,0,6,6,3,3,0,15,0,1,,,,,,
"Jan 3, 2022 8:00 PM",14,7,7,3,2,1,5,2,3,5,3,2,0,0,0,6,7,5,2,0,0,0,5,4,2,2,0,6,0,2,,,,,,
"Jan 3, 2022 9:00 PM",8,2,6,1,1,0,3,2,1,2,1,1,0,0,0,6,2,2,0,0,0,0,2,1,1,1,0,3,1,0,,,,,,
"Jan 3, 2022 10:00 PM",5,4,1,0,0,0,1,0,1,2,0,2,0,0,0,4,0,0,0,0,0,0,0,2,3,0,3,4,0,0,,,,,,
"Jan 3, 2022 11:00 PM",0,0,0,1,1,0,2,0,2,2,1,1,1,0,1,2,2,1,1,0,0,0,1,1,0,0,0,1,0,0,,,,,,
"Jan 4, 2022 12:00 AM",2,1,1,0,0,0,0,0,0,1,1,0,2,0,2,0,1,1,0,0,0,0,1,1,0,0,0,0,0,0,,,,,,
"Jan 4, 2022 1:00 AM",1,1,0,1,0,1,0,0,0,0,0,0,0,0,0,0,1,1,0,0,0,0,1,0,0,0,0,0,0,0,,,,,,
"Jan 4, 2022 2:00 AM",2,2,0,0,0,0,0,0,0,0,0,0,0,0,0,0,0,0,0,0,0,0,0,0,0,0,0,0,0,0,,,,,,
"Jan 4, 2022 3:00 AM",0,0,0,0,0,0,0,0,0,1,0,1,0,0,0,0,0,0,0,0,0,0,0,0,0,0,0,0,0,0,,,,,,
"Jan 4, 2022 4:00 AM",2,2,0,0,0,0,1,0,1,1,0,1,0,0,0,0,1,1,0,0,0,0,1,0,0,0,0,1,0,0,,,,,,
"Jan 4, 2022 5:00 AM",6,3,3,0,0,0,1,0,1,1,0,1,0,0,0,3,3,3,0,0,0,0,3,1,0,0,0,8,0,0,,,,,,
"Jan 4, 2022 6:00 AM",17,10,7,7,3,4,11,4,7,10,5,5,1,1,0,7,14,14,0,0,0,0,14,6,3,3,0,19,1,3,,,,,,
"Jan 4, 2022 7:00 AM",47,32,15,27,7,20,34,10,24,29,12,17,10,8,2,7,33,33,0,0,0,0,36,19,10,2,8,46,0,3,,,,,,
"Jan 4, 2022 8:00 AM",69,47,22,33,10,23,54,24,30,44,19,25,10,7,3,2,48,47,1,0,0,0,47,24,25,6,19,59,5,2,,,,,,
"Jan 4, 2022 9:00 AM",44,31,13,30,14,16,43,21,22,32,15,17,6,4,2,7,25,24,1,0,0,0,23,8,17,11,6,25,1,0,,,,,,
"Jan 4, 2022 10:00 AM",27,21,6,56,34,22,61,37,24,65,48,17,10,7,3,20,21,21,0,0,0,0,23,21,19,13,6,24,3,2,,,,,,
"Jan 4, 2022 11:00 AM",42,24,18,46,19,27,70,28,42,61,25,36,11,5,6,9,15,13,2,0,0,0,11,18,25,20,5,24,4,3,,,,,,
"Jan 4, 2022 12:00 PM",44,24,20,54,36,18,93,56,37,49,33,16,19,13,6,15,19,17,2,0,0,0,13,20,25,19,6,22,4,3,,,,,,
"Jan 4, 2022 1:00 PM",51,26,25,75,37,38,71,31,40,66,40,26,20,7,13,10,23,22,1,0,0,0,19,13,37,24,13,26,3,2,,,,,,
"Jan 4, 2022 2:00 PM",67,42,25,73,39,34,71,42,29,74,41,33,14,11,3,63,18,15,3,0,0,0,16,14,31,25,6,24,4,7,,,,,,
"Jan 4, 2022 3:00 PM",47,19,28,49,26,23,54,27,27,41,21,20,13,5,8,19,22,19,3,0,0,0,18,23,30,16,14,20,3,2,,,,,,
"Jan 4, 2022 4:00 PM",87,28,59,48,24,24,62,30,32,41,21,20,5,3,2,20,13,13,0,0,0,0,14,25,35,27,8,24,5,3,,,,,,
"Jan 4, 2022 5:00 PM",67,15,52,37,26,11,62,40,22,50,27,23,14,7,7,5,13,13,0,0,0,0,15,48,34,21,13,40,0,1,,,,,,
"Jan 4, 2022 6:00 PM",57,15,42,21,18,3,32,20,12,27,18,9,8,4,4,11,11,11,0,0,0,0,12,30,14,12,2,19,1,1,,,,,,
"Jan 4, 2022 7:00 PM",29,11,18,13,11,2,25,13,12,22,12,10,5,3,2,5,11,11,0,0,0,0,12,17,5,3,2,11,4,0,,,,,,
"Jan 4, 2022 8:00 PM",25,9,16,8,5,3,13,7,6,8,4,4,4,1,3,3,4,4,0,0,0,0,6,17,9,4,5,11,3,3,,,,,,
"Jan 4, 2022 9:00 PM",13,3,10,1,1,0,4,1,3,3,1,2,5,0,5,4,7,6,1,0,0,0,6,2,2,2,0,8,0,1,,,,,,
"Jan 4, 2022 10:00 PM",5,3,2,2,1,1,4,3,1,2,1,1,1,0,1,1,1,1,0,0,0,0,1,5,1,0,1,4,2,0,,,,,,
"Jan 4, 2022 11:00 PM",2,1,1,0,0,0,0,0,0,2,1,1,0,0,0,1,1,1,0,0,0,0,1,1,0,0,0,1,0,0,,,,,,
"Jan 5, 2022 12:00 AM",0,0,0,0,0,0,0,0,0,1,0,1,0,0,0,0,0,0,0,0,0,0,0,1,0,0,0,0,0,0,,,,,,
"Jan 5, 2022 1:00 AM",1,1,0,0,0,0,0,0,0,0,0,0,0,0,0,0,0,0,0,0,0,0,0,0,1,0,1,1,0,0,,,,,,
"Jan 5, 2022 2:00 AM",2,2,0,0,0,0,0,0,0,0,0,0,0,0,0,0,0,0,0,0,0,0,0,0,0,0,0,0,0,0,,,,,,
"Jan 5, 2022 3:00 AM",0,0,0,0,0,0,0,0,0,0,0,0,0,0,0,0,0,0,0,0,0,0,0,0,0,0,0,0,0,0,,,,,,
"Jan 5, 2022 4:00 AM",1,1,0,0,0,0,1,1,0,0,0,0,0,0,0,0,0,0,0,0,0,0,0,2,0,0,0,0,0,0,,,,,,
"Jan 5, 2022 5:00 AM",6,4,2,0,0,0,1,0,1,1,0,1,0,0,0,2,2,2,0,0,0,0,3,2,2,1,1,10,1,0,,,,,,
"Jan 5, 2022 6:00 AM",23,14,9,6,2,4,8,1,7,5,1,4,1,1,0,2,10,10,0,0,0,0,10,6,0,0,0,26,0,1,,,,,,
"Jan 5, 2022 7:00 AM",47,34,13,27,6,21,29,12,17,31,12,19,5,4,1,5,31,31,0,0,0,0,34,13,10,6,4,46,2,2,,,,,,
"Jan 5, 2022 8:00 AM",75,52,23,37,11,26,58,23,35,37,19,18,4,3,1,6,40,40,0,0,0,0,42,21,17,7,10,64,4,4,,,,,,
"Jan 5, 2022 9:00 AM",43,31,12,28,8,20,36,20,16,31,18,13,6,5,1,3,19,19,0,0,0,0,19,14,26,16,10,35,2,3,,,,,,
"Jan 5, 2022 10:00 AM",34,23,11,33,19,14,39,21,18,33,25,8,14,9,5,9,16,16,0,0,0,0,15,9,19,12,7,11,2,3,,,,,,
"Jan 5, 2022 11:00 AM",40,19,21,47,27,20,61,29,32,38,18,20,14,4,10,1,18,17,1,0,0,0,13,17,20,7,13,25,3,2,,,,,,
"Jan 5, 2022 12:00 PM",40,31,9,70,42,28,75,53,22,52,32,20,19,12,7,7,17,13,4,0,0,0,15,21,18,15,3,30,4,2,,,,,,
"Jan 5, 2022 1:00 PM",59,31,28,74,33,41,73,29,44,61,28,33,18,10,8,9,21,17,4,0,0,0,22,21,24,15,9,25,1,3,,,,,,
"Jan 5, 2022 2:00 PM",61,32,29,71,33,38,63,35,28,50,37,13,15,15,0,13,18,16,2,0,0,0,16,24,28,19,9,25,4,1,,,,,,
"Jan 5, 2022 3:00 PM",57,30,27,58,30,28,65,27,38,55,24,31,12,5,7,15,25,25,0,0,0,0,19,14,30,15,15,23,7,7,,,,,,
"Jan 5, 2022 4:00 PM",71,29,42,55,33,22,69,38,31,52,29,23,13,6,7,13,19,18,1,0,0,0,22,37,38,24,14,24,3,1,,,,,,
"Jan 5, 2022 5:00 PM",102,27,75,34,26,8,50,28,22,51,26,25,13,4,9,12,16,14,2,0,0,0,19,45,34,15,19,24,4,0,,,,,,
"Jan 5, 2022 6:00 PM",82,33,49,31,23,8,51,36,15,45,28,17,5,1,4,9,10,10,0,0,0,0,10,36,19,14,5,20,2,4,,,,,,
"Jan 5, 2022 7:00 PM",50,16,34,16,13,3,27,19,8,22,13,9,6,1,5,8,13,12,1,0,0,0,13,31,9,8,1,13,2,3,,,,,,
"Jan 5, 2022 8:00 PM",29,10,19,6,3,3,9,5,4,8,4,4,1,0,1,4,9,7,2,0,0,0,10,17,3,2,1,10,2,3,,,,,,
"Jan 5, 2022 9:00 PM",14,7,7,5,4,1,7,6,1,5,4,1,1,1,0,2,8,7,1,0,0,0,7,2,6,4,2,9,4,2,,,,,,
"Jan 5, 2022 10:00 PM",9,4,5,2,1,1,5,1,4,5,2,3,0,0,0,1,3,2,1,0,0,0,2,3,4,2,2,6,0,0,,,,,,
"Jan 5, 2022 11:00 PM",1,1,0,0,0,0,1,1,0,0,0,0,0,0,0,0,0,0,0,0,0,0,0,3,0,0,0,1,0,0,,,,,,
"Jan 6, 2022 12:00 AM",0,0,0,0,0,0,0,0,0,0,0,0,1,0,1,0,1,1,0,0,0,0,0,1,0,0,0,1,0,0,,,,,,
"Jan 6, 2022 1:00 AM",3,2,1,0,0,0,0,0,0,1,1,0,0,0,0,0,1,1,0,0,0,0,1,0,0,0,0,2,0,0,,,,,,
"Jan 6, 2022 2:00 AM",1,1,0,0,0,0,0,0,0,0,0,0,0,0,0,0,0,0,0,0,0,0,0,0,0,0,0,0,0,0,,,,,,
"Jan 6, 2022 3:00 AM",1,0,1,0,0,0,0,0,0,0,0,0,0,0,0,0,0,0,0,0,0,0,0,0,0,0,0,0,0,0,,,,,,
"Jan 6, 2022 4:00 AM",3,3,0,0,0,0,0,0,0,0,0,0,0,0,0,0,1,1,0,0,0,0,1,0,0,0,0,1,1,0,,,,,,
"Jan 6, 2022 5:00 AM",6,4,2,0,0,0,2,0,2,2,1,1,0,0,0,1,5,5,0,0,0,0,5,3,0,0,0,5,0,0,,,,,,
"Jan 6, 2022 6:00 AM",17,9,8,4,1,3,8,3,5,5,1,4,3,3,0,5,9,9,0,0,0,0,9,7,2,2,0,18,0,1,,,,,,
"Jan 6, 2022 7:00 AM",48,35,13,12,3,9,24,7,17,16,5,11,4,2,2,5,28,28,0,0,0,0,30,15,6,2,4,26,1,2,,,,,,
"Jan 6, 2022 8:00 AM",65,40,25,22,8,14,35,8,27,27,11,16,12,7,5,7,33,31,2,0,0,0,32,19,11,4,7,64,2,1,,,,,,
"Jan 6, 2022 9:00 AM",53,36,17,7,2,5,21,11,10,17,11,6,0,0,0,5,15,14,1,0,0,0,16,9,13,8,5,20,0,0,,,,,,
"Jan 6, 2022 10:00 AM",30,20,10,10,3,7,17,14,3,11,7,4,5,4,1,3,14,13,1,0,0,0,13,8,7,2,5,9,1,1,,,,,,
"Jan 6, 2022 11:00 AM",15,9,6,9,5,4,17,9,8,11,7,4,5,4,1,2,4,3,1,0,0,0,2,6,3,1,2,10,3,0,,,,,,
"Jan 6, 2022 12:00 PM",32,19,13,17,10,7,24,14,10,22,14,8,8,5,3,8,9,8,1,0,0,0,8,14,12,8,4,10,2,2,,,,,,
"Jan 6, 2022 1:00 PM",46,22,24,27,12,15,37,18,19,28,14,14,12,8,4,7,10,8,2,0,0,0,9,11,11,4,7,10,1,2,,,,,,
"Jan 6, 2022 2:00 PM",33,15,18,15,7,8,27,14,13,18,9,9,7,4,3,7,15,15,0,0,0,0,14,16,10,8,2,9,1,1,,,,,,
"Jan 6, 2022 3:00 PM",40,19,21,15,8,7,36,21,15,23,14,9,7,1,6,18,14,14,0,0,0,0,12,16,12,4,8,15,0,0,,,,,,
"Jan 6, 2022 4:00 PM",63,34,29,28,18,10,29,17,12,29,16,13,15,5,10,12,10,9,1,0,0,0,10,20,12,9,3,19,3,1,,,,,,
"Jan 6, 2022 5:00 PM",67,25,42,28,19,9,45,23,22,37,19,18,12,4,8,11,14,12,2,0,0,0,11,33,16,12,4,31,0,2,,,,,,
"Jan 6, 2022 6:00 PM",45,11,34,24,20,4,43,27,16,31,20,11,6,1,5,8,17,16,1,0,0,0,16,26,10,7,3,22,2,1,,,,,,
"Jan 6, 2022 7:00 PM",38,14,24,8,5,3,11,6,5,11,6,5,4,1,3,5,10,9,1,0,0,0,10,14,7,4,3,12,0,1,,,,,,
"Jan 6, 2022 8:00 PM",22,5,17,5,4,1,10,6,4,6,5,1,2,1,1,3,6,6,0,0,0,0,5,12,3,1,2,12,1,1,,,,,,
"Jan 6, 2022 9:00 PM",16,5,11,2,1,1,4,1,3,5,2,3,1,0,1,4,8,8,0,0,0,0,8,6,2,2,0,9,0,2,,,,,,
"Jan 6, 2022 10:00 PM",8,3,5,1,1,0,3,2,1,3,2,1,1,1,0,2,0,0,0,0,0,0,0,1,2,1,1,0,0,1,,,,,,
"Jan 6, 2022 11:00 PM",0,0,0,0,0,0,1,0,1,2,0,2,0,0,0,2,1,1,0,0,0,0,1,0,0,0,0,3,0,0,,,,,,
"Jan 7, 2022 12:00 AM",0,0,0,0,0,0,0,0,0,0,0,0,0,0,0,0,0,0,0,0,0,0,0,1,2,2,0,0,0,0,,,,,,
"Jan 7, 2022 1:00 AM",1,0,1,0,0,0,1,0,1,1,0,1,0,0,0,0,0,0,0,0,0,0,0,0,0,0,0,0,0,0,,,,,,
"Jan 7, 2022 2:00 AM",3,0,3,0,0,0,0,0,0,0,0,0,0,0,0,0,0,0,0,0,0,0,0,0,0,0,0,0,0,0,,,,,,
"Jan 7, 2022 3:00 AM",0,0,0,0,0,0,1,0,1,1,0,1,0,0,0,0,0,0,0,0,0,0,0,0,0,0,0,0,0,0,,,,,,
"Jan 7, 2022 4:00 AM",1,1,0,0,0,0,0,0,0,0,0,0,0,0,0,0,0,0,0,0,0,0,0,0,0,0,0,0,0,0,,,,,,
"Jan 7, 2022 5:00 AM",6,2,4,0,0,0,1,0,1,1,0,1,0,0,0,2,5,5,0,0,0,0,5,3,1,0,1,6,1,0,,,,,,
"Jan 7, 2022 6:00 AM",17,11,6,9,3,6,11,6,5,9,5,4,0,0,0,4,7,7,0,0,0,0,6,8,3,3,0,13,0,1,,,,,,
"Jan 7, 2022 7:00 AM",54,30,24,30,8,22,41,12,29,34,13,21,3,3,0,3,21,21,0,0,0,0,23,21,12,3,9,39,2,3,,,,,,
"Jan 7, 2022 8:00 AM",86,58,28,50,16,34,57,20,37,59,21,38,23,16,7,13,45,43,2,0,0,0,44,18,23,7,16,60,2,2,,,,,,
"Jan 7, 2022 9:00 AM",52,37,15,32,11,21,41,15,26,34,19,15,5,3,2,3,21,21,0,0,0,0,22,11,15,7,8,32,0,4,,,,,,
"Jan 7, 2022 10:00 AM",30,19,11,24,15,9,18,11,7,23,12,11,7,4,3,0,11,10,1,0,0,0,9,7,6,3,3,11,2,0,,,,,,
"Jan 7, 2022 11:00 AM",23,13,10,13,10,3,27,14,13,12,8,4,10,2,8,2,9,9,0,0,0,0,7,4,13,9,4,17,2,1,,,,,,
"Jan 7, 2022 12:00 PM",27,15,12,8,5,3,11,6,5,5,2,3,7,6,1,5,7,6,1,0,0,0,8,6,3,3,0,10,1,1,,,,,,
"Jan 7, 2022 1:00 PM",49,20,29,23,12,11,30,16,14,23,13,10,8,6,2,6,18,17,1,0,0,0,15,13,13,10,3,16,3,0,,,,,,
"Jan 7, 2022 2:00 PM",38,21,17,32,18,14,42,28,14,33,21,12,15,7,8,5,11,10,1,0,0,0,9,15,9,6,3,11,3,3,,,,,,
"Jan 7, 2022 3:00 PM",54,27,27,28,15,13,61,36,25,33,21,12,9,2,7,11,16,15,1,0,0,0,13,22,27,20,7,26,0,1,,,,,,
"Jan 7, 2022 4:00 PM",42,17,25,48,37,11,67,40,27,47,35,12,8,2,6,13,15,14,1,0,0,0,12,26,21,13,8,32,2,2,,,,,,
"Jan 7, 2022 5:00 PM",71,28,43,23,13,10,53,34,19,30,15,15,5,1,4,10,13,12,1,0,0,0,10,36,14,11,3,18,4,3,,,,,,
"Jan 7, 2022 6:00 PM",57,14,43,18,16,2,26,17,9,23,17,6,9,2,7,18,15,12,3,0,0,0,12,31,8,8,0,17,2,0,,,,,,
"Jan 7, 2022 7:00 PM",39,17,22,11,6,5,20,12,8,15,8,7,5,3,2,5,16,15,1,0,0,0,14,15,5,2,3,12,2,0,,,,,,
"Jan 7, 2022 8:00 PM",26,6,20,9,7,2,6,4,2,5,4,1,5,1,4,6,7,6,1,0,0,0,7,11,4,4,0,12,1,1,,,,,,
"Jan 7, 2022 9:00 PM",12,5,7,5,4,1,10,5,5,7,3,4,1,1,0,10,3,3,0,0,0,0,4,6,1,1,0,6,0,0,,,,,,
"Jan 7, 2022 10:00 PM",9,3,6,0,0,0,4,1,3,3,2,1,2,1,1,1,2,2,0,0,0,0,1,5,1,0,1,10,0,2,,,,,,
"Jan 7, 2022 11:00 PM",2,1,1,2,1,1,3,1,2,3,1,2,0,0,0,2,0,0,0,0,0,0,0,0,0,0,0,1,0,0,,,,,,
"Jan 8, 2022 12:00 AM",3,2,1,0,0,0,0,0,0,0,0,0,0,0,0,0,2,2,0,0,0,0,2,0,0,0,0,2,1,1,,,,,,
"Jan 8, 2022 1:00 AM",2,1,1,5,3,2,1,1,0,4,1,3,0,0,0,0,0,0,0,0,0,0,0,0,1,1,0,0,0,0,,,,,,
"Jan 8, 2022 2:00 AM",0,0,0,0,0,0,0,0,0,0,0,0,0,0,0,0,1,1,0,0,0,0,1,1,0,0,0,0,0,0,,,,,,
"Jan 8, 2022 3:00 AM",0,0,0,0,0,0,0,0,0,0,0,0,0,0,0,0,0,0,0,0,0,0,0,0,0,0,0,1,0,0,,,,,,
"Jan 8, 2022 4:00 AM",1,0,1,0,0,0,2,1,1,0,0,0,0,0,0,0,0,0,0,0,0,0,0,1,0,0,0,0,0,0,,,,,,
"Jan 8, 2022 5:00 AM",1,0,1,1,1,0,1,0,1,0,0,0,0,0,0,0,0,0,0,0,0,0,0,3,0,0,0,3,1,0,,,,,,
"Jan 8, 2022 6:00 AM",2,0,2,0,0,0,3,1,2,1,0,1,0,0,0,2,4,4,0,0,0,0,3,3,0,0,0,11,1,0,,,,,,
"Jan 8, 2022 7:00 AM",12,5,7,7,4,3,6,4,2,5,4,1,2,0,2,4,7,7,0,0,0,0,6,5,4,4,0,4,0,2,,,,,,
"Jan 8, 2022 8:00 AM",11,6,5,6,4,2,8,6,2,5,3,2,1,1,0,2,3,3,0,0,0,0,5,3,0,0,0,4,3,2,,,,,,
"Jan 8, 2022 9:00 AM",22,16,6,39,21,18,30,19,11,30,17,13,5,5,0,1,5,5,0,0,0,0,5,10,14,7,7,15,1,1,,,,,,
"Jan 8, 2022 10:00 AM",29,13,16,68,32,36,57,30,27,52,26,26,7,6,1,14,9,7,2,0,0,0,6,14,12,4,8,17,3,1,,,,,,
"Jan 8, 2022 11:00 AM",37,19,18,56,24,32,65,38,27,56,35,21,13,10,3,13,9,9,0,0,0,0,10,13,26,19,7,18,10,3,,,,,,
"Jan 8, 2022 12:00 PM",32,17,15,74,40,34,95,51,44,70,38,32,12,5,7,14,15,14,1,0,0,0,12,16,34,20,14,20,3,2,,,,,,
"Jan 8, 2022 1:00 PM",54,29,25,102,54,48,88,50,38,89,46,43,47,28,19,13,18,14,4,0,0,0,14,18,37,23,14,31,3,5,,,,,,
"Jan 8, 2022 2:00 PM",41,19,22,115,56,59,134,85,49,119,69,50,23,11,12,16,19,18,1,0,0,0,13,32,39,21,18,28,4,6,,,,,,
"Jan 8, 2022 3:00 PM",45,18,27,112,50,62,125,48,77,101,53,48,29,11,18,21,19,19,0,0,0,0,18,18,38,20,18,38,12,0,,,,,,
"Jan 8, 2022 4:00 PM",35,20,15,80,36,44,74,30,44,69,23,46,24,11,13,28,17,15,2,0,0,0,17,8,31,16,15,21,4,1,,,,,,
"Jan 8, 2022 5:00 PM",32,16,16,23,8,15,47,14,33,27,12,15,8,3,5,17,9,8,1,0,0,0,8,14,9,2,7,22,4,0,,,,,,
"Jan 8, 2022 6:00 PM",36,14,22,4,2,2,17,5,12,13,4,9,1,1,0,6,2,2,0,0,0,0,2,12,8,2,6,8,1,0,,,,,,
"Jan 8, 2022 7:00 PM",23,11,12,9,5,4,12,5,7,8,4,4,1,0,1,4,6,6,0,0,0,0,5,12,3,2,1,9,1,1,,,,,,
"Jan 8, 2022 8:00 PM",19,8,11,11,10,1,10,6,4,10,7,3,3,0,3,4,13,12,1,0,0,0,11,8,3,2,1,7,0,2,,,,,,
"Jan 8, 2022 9:00 PM",18,8,10,9,5,4,7,3,4,4,2,2,2,0,2,4,7,5,2,0,0,0,5,5,2,1,1,3,0,2,,,,,,
"Jan 8, 2022 10:00 PM",7,4,3,2,1,1,1,1,0,3,0,3,1,1,0,2,1,1,0,0,0,0,1,3,2,1,1,8,1,1,,,,,,
"Jan 8, 2022 11:00 PM",7,3,4,0,0,0,3,1,2,3,1,2,1,0,1,4,1,1,0,0,0,0,1,1,0,0,0,2,0,0,,,,,,
"Jan 9, 2022 12:00 AM",3,1,2,0,0,0,1,1,0,0,0,0,1,1,0,0,1,1,0,0,0,0,1,0,2,2,0,1,0,0,,,,,,
"Jan 9, 2022 1:00 AM",1,1,0,2,2,0,0,0,0,0,0,0,2,0,2,0,0,0,0,0,0,0,0,0,0,0,0,1,0,0,,,,,,
"Jan 9, 2022 2:00 AM",2,1,1,0,0,0,2,1,1,0,0,0,0,0,0,0,0,0,0,0,0,0,0,0,0,0,0,1,0,1,,,,,,
"Jan 9, 2022 3:00 AM",1,1,0,0,0,0,0,0,0,1,1,0,0,0,0,0,0,0,0,0,0,0,0,1,0,0,0,0,0,0,,,,,,
"Jan 9, 2022 4:00 AM",1,0,1,0,0,0,2,2,0,1,0,1,0,0,0,0,0,0,0,0,0,0,0,4,0,0,0,0,0,0,,,,,,
"Jan 9, 2022 5:00 AM",0,0,0,0,0,0,1,0,1,1,0,1,0,0,0,0,0,0,0,0,0,0,0,1,0,0,0,2,0,0,0,0,0,,,
"Jan 9, 2022 6:00 AM",2,1,1,0,0,0,1,0,1,0,0,0,0,0,0,0,4,4,0,0,0,0,3,3,0,0,0,4,0,0,0,0,0,,,
"Jan 9, 2022 7:00 AM",9,8,1,5,3,2,6,4,2,6,5,1,0,0,0,3,2,2,0,0,0,0,2,2,1,1,0,9,0,3,0,0,0,,,
"Jan 9, 2022 8:00 AM",18,6,12,29,23,6,29,24,5,35,26,9,1,1,0,2,9,9,0,0,0,0,11,14,8,8,0,14,0,6,0,0,0,,,
"Jan 9, 2022 9:00 AM",22,8,14,108,79,29,82,61,21,90,69,21,3,3,0,6,9,9,0,0,0,0,11,20,32,22,10,30,4,8,0,0,0,,,
"Jan 9, 2022 10:00 AM",28,9,19,150,88,62,136,86,50,135,90,45,9,7,2,11,14,14,0,0,0,0,14,40,55,37,18,38,1,9,0,0,0,,,
"Jan 9, 2022 11:00 AM",59,31,28,157,76,81,143,73,70,155,81,74,15,10,5,12,18,15,3,0,0,0,15,46,62,36,26,42,8,3,0,0,0,,,
"Jan 9, 2022 12:00 PM",45,14,31,177,86,91,142,68,74,135,63,72,32,27,5,31,18,17,1,0,0,0,16,27,53,24,29,48,11,7,0,0,0,,,
"Jan 9, 2022 1:00 PM",54,24,30,146,72,74,157,95,62,130,68,62,26,17,9,19,20,19,1,0,0,0,22,45,44,25,19,52,9,8,0,0,0,,,
"Jan 9, 2022 2:00 PM",48,29,19,112,41,71,142,61,81,115,48,67,24,14,10,24,17,17,0,0,0,0,12,17,34,20,14,42,4,2,13,8,5,,,
"Jan 9, 2022 3:00 PM",58,33,25,90,52,38,119,61,58,83,42,41,25,13,12,13,15,14,1,0,0,0,16,14,44,25,19,31,3,3,17,12,5,,,
"Jan 9, 2022 4:00 PM",50,16,34,68,37,31,79,35,44,57,29,28,20,8,12,18,14,14,0,0,0,0,14,12,29,9,20,25,6,1,7,7,0,,,
"Jan 9, 2022 5:00 PM",28,10,18,30,12,18,44,18,26,32,16,16,2,0,2,14,9,9,0,0,0,0,9,7,13,6,7,20,4,0,6,4,2,,,
"Jan 9, 2022 6:00 PM",28,16,12,9,4,5,19,10,9,10,6,4,3,3,0,8,1,1,0,0,0,0,3,9,2,0,2,11,1,1,4,1,3,,,
"Jan 9, 2022 7:00 PM",24,10,14,15,9,6,9,0,9,9,1,8,4,1,3,7,3,3,0,0,0,0,3,5,5,1,4,9,0,0,0,0,0,,,
"Jan 9, 2022 8:00 PM",22,12,10,7,5,2,10,5,5,7,3,4,0,0,0,7,4,3,1,0,0,0,3,11,5,4,1,4,0,2,4,3,1,,,
"Jan 9, 2022 9:00 PM",14,7,7,2,1,1,2,0,2,2,0,2,0,0,0,4,6,5,1,0,0,0,5,2,2,1,1,7,0,1,2,2,0,,,
"Jan 9, 2022 10:00 PM",4,2,2,0,0,0,2,1,1,2,0,2,0,0,0,0,1,1,0,0,0,0,1,4,2,0,2,3,0,1,0,0,0,,,
"Jan 9, 2022 11:00 PM",2,1,1,0,0,0,2,1,1,2,1,1,1,1,0,2,0,0,0,0,0,0,0,0,0,0,0,1,0,0,1,1,0,,,
"Jan 10, 2022 12:00 AM",2,1,1,0,0,0,0,0,0,0,0,0,2,0,2,0,1,1,0,0,0,0,1,0,0,0,0,1,0,0,0,0,0,,,
"Jan 10, 2022 1:00 AM",1,1,0,0,0,0,0,0,0,0,0,0,0,0,0,0,0,0,0,0,0,0,0,0,0,0,0,0,0,0,0,0,0,,,
"Jan 10, 2022 2:00 AM",0,0,0,0,0,0,0,0,0,0,0,0,0,0,0,0,0,0,0,0,0,0,0,0,0,0,0,0,0,0,0,0,0,,,
"Jan 10, 2022 3:00 AM",0,0,0,1,1,0,0,0,0,0,0,0,0,0,0,0,0,0,0,0,0,0,0,0,0,0,0,0,0,0,0,0,0,,,
"Jan 10, 2022 4:00 AM",0,0,0,2,0,2,0,0,0,0,0,0,0,0,0,0,2,2,0,0,0,0,2,0,0,0,0,0,0,0,1,1,0,,,
"Jan 10, 2022 5:00 AM",7,6,1,0,0,0,2,1,1,2,1,1,0,0,0,1,3,3,0,0,0,0,2,3,1,1,0,9,0,0,0,0,0,,,
"Jan 10, 2022 6:00 AM",26,17,9,11,3,8,16,7,9,14,7,7,1,1,0,4,16,14,2,0,0,0,15,9,6,3,3,30,0,1,3,3,0,,,
"Jan 10, 2022 7:00 AM",78,52,26,36,13,23,59,18,41,46,17,29,3,3,0,10,44,44,0,0,0,0,43,22,26,9,17,63,1,3,1,1,0,,,
"Jan 10, 2022 8:00 AM",140,93,47,82,27,55,108,33,75,89,34,55,38,22,16,26,77,72,5,0,0,0,73,29,60,15,45,111,3,2,16,13,3,,,
"Jan 10, 2022 9:00 AM",69,56,13,40,15,25,64,34,30,56,29,27,15,12,3,5,28,28,0,0,0,0,27,17,25,19,6,40,1,3,2,2,0,,,
"Jan 10, 2022 10:00 AM",36,27,9,42,20,22,38,25,13,34,21,13,4,1,3,7,21,19,2,0,0,0,17,14,22,8,14,22,2,4,0,0,0,,,
"Jan 10, 2022 11:00 AM",35,17,18,47,19,28,47,21,26,35,15,20,9,2,7,5,14,14,0,0,0,0,12,11,18,12,6,15,1,3,3,2,1,,,
"Jan 10, 2022 12:00 PM",54,30,24,50,29,21,55,29,26,41,18,23,16,10,6,10,13,13,0,0,0,0,11,14,25,17,8,19,4,2,3,3,0,,,
"Jan 10, 2022 1:00 PM",57,24,33,64,37,27,63,35,28,49,28,21,30,11,19,14,23,18,5,0,0,0,14,22,30,10,20,25,3,2,5,4,1,,,
"Jan 10, 2022 2:00 PM",36,17,19,77,47,30,75,49,26,63,39,24,14,9,5,27,15,14,1,0,0,0,15,22,30,18,12,17,1,2,8,2,6,,,
"Jan 10, 2022 3:00 PM",65,24,41,48,24,24,99,45,54,55,22,33,20,6,14,21,19,19,0,0,0,0,16,18,34,21,13,27,2,3,5,3,2,,,
"Jan 10, 2022 4:00 PM",87,32,55,59,38,21,78,42,36,66,42,24,14,8,6,19,23,22,1,0,0,0,21,46,27,19,8,45,7,3,11,5,6,,,
"Jan 10, 2022 5:00 PM",127,32,95,48,31,17,74,50,24,56,37,19,21,2,19,22,28,25,3,0,0,0,26,69,34,26,8,52,4,3,6,3,3,,,
"Jan 10, 2022 6:00 PM",106,35,71,36,30,6,68,51,17,55,39,16,11,4,7,17,19,17,2,0,0,0,17,53,38,28,10,20,4,2,8,6,2,,,
"Jan 10, 2022 7:00 PM",60,22,38,20,16,4,31,18,13,25,16,9,1,0,1,12,20,15,5,0,0,0,15,23,13,8,5,12,2,1,5,3,2,,,
"Jan 10, 2022 8:00 PM",40,15,25,12,8,4,12,8,4,14,7,7,1,0,1,10,14,11,3,0,0,0,11,14,11,8,3,7,0,3,3,2,1,,,
"Jan 10, 2022 9:00 PM",28,12,16,3,2,1,12,6,6,13,5,8,1,0,1,8,5,5,0,0,0,0,5,3,7,7,0,9,0,0,2,1,1,,,
"Jan 10, 2022 10:00 PM",14,5,9,2,1,1,3,1,2,4,3,1,0,0,0,6,3,3,0,0,0,0,3,7,1,1,0,4,0,1,1,1,0,,,
"Jan 10, 2022 11:00 PM",3,1,2,1,0,1,1,0,1,3,1,2,0,0,0,1,2,2,0,0,0,0,2,2,0,0,0,3,0,0,0,0,0,,,
"Jan 11, 2022 12:00 AM",0,0,0,1,1,0,1,1,0,2,2,0,0,0,0,0,1,1,0,0,0,0,0,3,0,0,0,0,0,0,0,0,0,,,
"Jan 11, 2022 1:00 AM",1,0,1,0,0,0,2,2,0,0,0,0,0,0,0,0,0,0,0,0,0,0,0,0,0,0,0,0,0,0,0,0,0,,,
"Jan 11, 2022 2:00 AM",1,1,0,1,1,0,1,1,0,1,1,0,0,0,0,0,0,0,0,0,0,0,0,0,0,0,0,0,1,0,0,0,0,,,
"Jan 11, 2022 3:00 AM",2,1,1,2,0,2,0,0,0,0,0,0,0,0,0,0,0,0,0,0,0,0,0,0,0,0,0,0,0,0,0,0,0,,,
"Jan 11, 2022 4:00 AM",1,1,0,0,0,0,1,1,0,0,0,0,0,0,0,1,1,1,0,0,0,0,0,1,0,0,0,0,0,0,0,0,0,,,
"Jan 11, 2022 5:00 AM",6,4,2,1,0,1,3,0,3,2,0,2,0,0,0,2,4,4,0,0,0,0,4,3,1,1,0,10,0,0,0,0,0,,,
"Jan 11, 2022 6:00 AM",34,27,7,21,9,12,25,13,12,22,14,8,1,1,0,5,15,15,0,0,0,0,15,12,6,4,2,22,0,2,3,3,0,,,
"Jan 11, 2022 7:00 AM",84,56,28,32,12,20,66,26,40,43,19,24,7,7,0,12,47,47,0,0,0,0,49,29,31,14,17,70,4,5,1,1,0,,,
"Jan 11, 2022 8:00 AM",152,95,57,99,33,66,138,48,90,114,46,68,44,31,13,22,93,90,3,0,0,0,88,34,60,19,41,108,3,5,15,13,2,,,
"Jan 11, 2022 9:00 AM",91,74,17,53,25,28,67,38,29,66,39,27,13,9,4,3,41,41,0,0,0,0,36,25,28,16,12,39,4,10,3,1,2,,,
"Jan 11, 2022 10:00 AM",55,34,21,51,23,28,61,41,20,45,31,14,7,6,1,6,24,24,0,0,0,0,25,17,18,12,6,23,2,7,4,4,0,,,
"Jan 11, 2022 11:00 AM",48,26,22,62,27,35,54,25,29,52,25,27,16,9,7,4,17,17,0,0,0,0,17,11,27,21,6,28,4,3,3,1,2,,,
"Jan 11, 2022 12:00 PM",44,27,17,78,42,36,62,31,31,63,36,27,19,9,10,13,21,20,1,0,0,0,19,24,20,9,11,18,3,4,4,2,2,,,
"Jan 11, 2022 1:00 PM",59,26,33,91,40,51,91,47,44,71,37,34,10,3,7,21,29,24,5,0,0,0,23,19,31,21,10,35,6,7,2,2,0,,,
"Jan 11, 2022 2:00 PM",62,30,32,74,44,30,95,54,41,75,51,24,20,10,10,15,14,12,2,0,0,0,12,18,25,12,13,32,4,1,9,6,3,,,
"Jan 11, 2022 3:00 PM",74,29,45,84,44,40,79,45,34,55,27,28,20,9,11,12,24,24,0,0,0,0,20,37,27,20,7,33,6,1,8,5,3,,,
"Jan 11, 2022 4:00 PM",103,40,63,62,41,21,84,52,32,80,43,37,17,6,11,22,27,26,1,0,0,0,25,34,36,28,8,46,6,2,7,4,3,,,
"Jan 11, 2022 5:00 PM",136,34,102,53,30,23,89,49,40,70,43,27,12,3,9,17,21,20,1,0,0,0,23,70,35,25,10,54,4,3,6,3,3,,,
"Jan 11, 2022 6:00 PM",116,36,80,56,41,15,82,55,27,61,40,21,11,1,10,16,21,18,3,0,0,0,20,62,36,29,7,37,4,3,5,5,0,,,
"Jan 11, 2022 7:00 PM",73,20,53,30,22,8,44,28,16,41,23,18,5,1,4,9,14,11,3,0,0,0,9,32,14,10,4,23,4,0,9,6,3,,,
"Jan 11, 2022 8:00 PM",59,19,40,13,6,7,28,13,15,20,10,10,2,2,0,10,12,10,2,0,0,0,10,23,13,6,7,18,3,3,0,0,0,,,
"Jan 11, 2022 9:00 PM",35,14,21,7,5,2,14,9,5,11,7,4,1,0,1,8,10,9,1,0,0,0,10,9,1,1,0,14,0,3,4,1,3,,,
"Jan 11, 2022 10:00 PM",18,6,12,10,5,5,8,2,6,8,3,5,0,0,0,4,2,2,0,0,0,0,2,5,4,1,3,6,1,0,0,0,0,,,
"Jan 11, 2022 11:00 PM",0,0,0,0,0,0,2,1,1,1,0,1,0,0,0,0,1,1,0,0,0,0,1,0,2,1,1,2,0,0,0,0,0,,,
"Jan 12, 2022 12:00 AM",0,0,0,1,1,0,1,1,0,1,1,0,2,0,2,1,0,0,0,0,0,0,0,2,2,2,0,0,0,1,0,0,0,,,
"Jan 12, 2022 1:00 AM",0,0,0,0,0,0,1,1,0,0,0,0,0,0,0,0,0,0,0,0,0,0,0,1,0,0,0,1,0,0,0,0,0,,,
"Jan 12, 2022 2:00 AM",1,1,0,0,0,0,0,0,0,1,1,0,0,0,0,0,1,1,0,0,0,0,1,0,0,0,0,3,0,0,0,0,0,,,
"Jan 12, 2022 3:00 AM",0,0,0,0,0,0,2,0,2,0,0,0,0,0,0,0,0,0,0,0,0,0,0,0,0,0,0,0,0,0,0,0,0,,,
"Jan 12, 2022 4:00 AM",1,1,0,0,0,0,1,1,0,0,0,0,0,0,0,0,0,0,0,0,0,0,0,1,0,0,0,0,0,0,0,0,0,,,
"Jan 12, 2022 5:00 AM",5,2,3,1,1,0,4,2,2,3,2,1,0,0,0,2,5,5,0,0,0,0,5,4,1,0,1,12,0,0,0,0,0,,,
"Jan 12, 2022 6:00 AM",22,17,5,11,4,7,15,6,9,15,7,8,0,0,0,2,16,15,1,0,0,0,17,7,5,3,2,23,0,1,2,2,0,,,
"Jan 12, 2022 7:00 AM",80,55,25,49,20,29,68,20,48,49,16,33,9,9,0,7,53,52,1,0,0,0,56,31,31,9,22,73,3,7,2,1,1,,,
"Jan 12, 2022 8:00 AM",143,96,47,110,31,79,140,46,94,105,34,71,30,23,7,31,76,73,3,0,0,0,74,41,51,13,38,126,3,6,11,9,2,,,
"Jan 12, 2022 9:00 AM",88,69,19,57,24,33,78,39,39,63,37,26,6,4,2,8,40,40,0,0,0,0,37,19,38,20,18,41,3,3,3,2,1,,,
"Jan 12, 2022 10:00 AM",43,21,22,51,28,23,53,31,22,41,27,14,11,9,2,3,30,28,2,0,0,0,26,19,20,12,8,25,2,3,8,6,2,,,
"Jan 12, 2022 11:00 AM",39,22,17,61,33,28,83,44,39,59,33,26,16,4,12,11,13,12,1,0,0,0,13,20,38,31,7,29,9,6,6,3,3,,,
"Jan 12, 2022 12:00 PM",52,27,25,94,48,46,97,44,53,78,38,40,19,13,6,6,21,20,1,0,0,0,18,20,37,21,16,23,7,5,4,4,0,,,
"Jan 12, 2022 1:00 PM",71,32,39,108,65,43,102,63,39,91,60,31,21,8,13,16,24,23,1,0,0,0,20,35,42,28,14,29,5,4,3,1,2,,,
"Jan 12, 2022 2:00 PM",72,28,44,82,40,42,92,43,49,70,43,27,17,6,11,19,11,11,0,0,0,0,10,24,39,20,19,22,4,1,8,6,2,,,
"Jan 12, 2022 3:00 PM",70,37,33,95,52,43,86,48,38,75,40,35,15,3,12,18,14,14,0,0,0,0,13,35,33,22,11,19,3,4,11,8,3,,,
"Jan 12, 2022 4:00 PM",100,38,62,60,34,26,74,39,35,62,29,33,16,9,7,22,21,19,2,0,0,0,17,48,32,20,12,54,5,2,7,6,1,,,
"Jan 12, 2022 5:00 PM",117,38,79,49,27,22,89,45,44,74,37,37,15,4,11,24,17,16,1,0,0,0,20,61,40,30,10,54,5,0,6,3,3,,,
"Jan 12, 2022 6:00 PM",115,43,72,40,31,9,62,47,15,43,31,12,10,2,8,18,27,21,6,0,0,0,21,48,30,27,3,36,3,1,4,1,3,,,
"Jan 12, 2022 7:00 PM",51,18,33,26,18,8,45,31,14,37,19,18,4,3,1,11,15,14,1,0,0,0,13,26,16,13,3,19,2,1,1,1,0,,,
"Jan 12, 2022 8:00 PM",40,6,34,24,16,8,28,16,12,32,19,13,3,2,1,4,8,8,0,0,0,0,9,26,12,10,2,18,3,1,3,2,1,,,
"Jan 12, 2022 9:00 PM",32,14,18,9,5,4,14,8,6,8,4,4,6,3,3,4,8,8,0,0,0,0,7,8,7,7,0,13,2,1,3,2,1,,,
"Jan 12, 2022 10:00 PM",15,5,10,5,1,4,9,5,4,5,3,2,1,0,1,6,11,10,1,0,0,0,10,7,3,0,3,8,0,0,1,0,1,,,
"Jan 12, 2022 11:00 PM",5,3,2,4,2,2,6,2,4,5,2,3,1,0,1,2,2,2,0,0,0,0,2,1,0,0,0,2,0,0,0,0,0,,,
"Jan 13, 2022 12:00 AM",1,0,1,0,0,0,1,0,1,1,0,1,0,0,0,0,0,0,0,0,0,0,0,0,1,0,1,2,0,0,1,0,1,,,
"Jan 13, 2022 1:00 AM",0,0,0,3,1,2,4,0,4,4,0,4,0,0,0,0,1,0,1,0,0,0,0,0,2,0,2,0,0,0,0,0,0,,,
"Jan 13, 2022 2:00 AM",1,1,0,0,0,0,0,0,0,1,0,1,0,0,0,0,1,1,0,0,0,0,1,0,0,0,0,1,0,0,0,0,0,,,
"Jan 13, 2022 3:00 AM",0,0,0,0,0,0,0,0,0,0,0,0,0,0,0,0,0,0,0,0,0,0,0,0,0,0,0,1,0,0,0,0,0,,,
"Jan 13, 2022 4:00 AM",1,1,0,0,0,0,0,0,0,0,0,0,0,0,0,0,0,0,0,0,0,0,0,0,0,0,0,1,0,0,0,0,0,,,
"Jan 13, 2022 5:00 AM",5,2,3,1,0,1,3,1,2,3,1,2,0,0,0,2,8,8,0,0,0,0,8,4,0,0,0,9,0,0,0,0,0,,,
"Jan 13, 2022 6:00 AM",24,14,10,20,8,12,16,7,9,18,12,6,1,1,0,5,14,13,1,0,0,0,15,11,6,3,3,22,0,0,0,0,0,,,
"Jan 13, 2022 7:00 AM",78,55,23,32,13,19,70,25,45,46,16,30,9,8,1,9,40,39,1,0,0,0,41,31,26,10,16,69,3,3,0,0,0,,,
"Jan 13, 2022 8:00 AM",139,86,53,89,28,61,142,54,88,97,40,57,29,18,11,21,79,75,4,0,0,0,80,39,69,21,48,122,3,3,13,10,3,,,
"Jan 13, 2022 9:00 AM",76,59,17,57,26,31,79,37,42,68,39,29,15,10,5,12,40,40,0,0,0,0,38,17,38,22,16,45,2,4,6,6,0,,,
"Jan 13, 2022 10:00 AM",43,31,12,53,26,27,76,45,31,47,30,17,16,9,7,13,26,26,0,0,0,0,25,18,27,20,7,25,5,2,3,2,1,,,
"Jan 13, 2022 11:00 AM",45,24,21,51,27,24,69,35,34,46,26,20,8,6,2,11,18,18,0,0,0,0,12,8,16,13,3,26,5,2,5,4,1,,,
"Jan 13, 2022 12:00 PM",48,25,23,55,37,18,66,35,31,64,37,27,24,10,14,20,15,13,2,0,0,0,16,17,28,19,9,21,1,4,6,4,2,,,
"Jan 13, 2022 1:00 PM",53,23,30,75,35,40,74,30,44,62,28,34,15,10,5,25,17,15,2,0,0,0,15,20,23,15,8,23,5,0,4,2,2,,,
"Jan 13, 2022 2:00 PM",58,24,34,55,36,19,61,35,26,56,34,22,16,11,5,16,12,11,1,0,0,0,13,11,23,12,11,28,1,3,5,4,1,,,
"Jan 13, 2022 3:00 PM",61,32,29,52,31,21,65,36,29,60,34,26,11,4,7,10,21,21,0,0,0,0,19,30,25,14,11,15,4,1,3,1,2,,,
"Jan 13, 2022 4:00 PM",104,35,69,55,33,22,68,40,28,50,30,20,7,2,5,22,18,18,0,0,0,0,19,40,27,21,6,43,8,2,8,4,4,,,
"Jan 13, 2022 5:00 PM",128,44,84,36,22,14,60,33,27,51,22,29,14,4,10,10,23,20,3,0,0,0,19,58,34,26,8,45,5,1,4,3,1,,,
"Jan 13, 2022 6:00 PM",100,25,75,43,33,10,68,51,17,58,41,17,7,1,6,15,23,21,2,0,0,0,24,41,35,29,6,39,2,1,6,3,3,,,
"Jan 13, 2022 7:00 PM",79,24,55,21,14,7,36,24,12,20,13,7,2,1,1,7,17,17,0,0,0,0,17,34,18,15,3,19,4,4,4,2,2,,,
"Jan 13, 2022 8:00 PM",56,19,37,25,17,8,24,15,9,22,14,8,10,0,10,6,22,20,2,0,0,0,21,31,7,7,0,16,2,2,3,2,1,,,
"Jan 13, 2022 9:00 PM",39,12,27,8,4,4,7,4,3,6,1,5,0,0,0,4,2,2,0,0,0,0,3,6,6,4,2,11,2,2,0,0,0,,,
"Jan 13, 2022 10:00 PM",19,11,8,5,2,3,9,3,6,5,2,3,1,0,1,3,5,5,0,0,0,0,5,9,5,3,2,9,1,1,0,0,0,,,
"Jan 13, 2022 11:00 PM",6,3,3,14,7,7,3,1,2,0,0,0,1,1,0,1,3,3,0,0,0,0,3,2,2,0,2,2,1,0,0,0,0,,,
"Jan 14, 2022 12:00 AM",1,0,1,0,0,0,1,1,0,1,1,0,0,0,0,0,1,1,0,0,0,0,1,1,0,0,0,0,0,0,0,0,0,,,
"Jan 14, 2022 1:00 AM",0,0,0,0,0,0,0,0,0,1,0,1,0,0,0,0,2,0,2,0,0,0,0,0,0,0,0,1,0,0,0,0,0,,,
"Jan 14, 2022 2:00 AM",3,2,1,0,0,0,0,0,0,0,0,0,0,0,0,1,0,0,0,0,0,0,0,1,0,0,0,1,0,0,0,0,0,,,
"Jan 14, 2022 3:00 AM",0,0,0,0,0,0,0,0,0,0,0,0,0,0,0,0,0,0,0,0,0,0,0,0,0,0,0,0,0,0,0,0,0,,,
"Jan 14, 2022 4:00 AM",2,1,1,0,0,0,0,0,0,0,0,0,0,0,0,0,0,0,0,0,0,0,0,1,0,0,0,0,0,0,0,0,0,,,
"Jan 14, 2022 5:00 AM",4,2,2,1,1,0,3,1,2,2,1,1,0,0,0,3,4,4,0,0,0,0,5,2,2,1,1,7,1,0,0,0,0,,,
"Jan 14, 2022 6:00 AM",27,17,10,13,2,11,14,8,6,12,6,6,4,3,1,3,16,15,1,0,0,0,16,10,9,8,1,26,1,1,0,0,0,,,
"Jan 14, 2022 7:00 AM",76,54,22,61,27,34,70,27,43,48,23,25,9,7,2,7,34,34,0,0,0,0,41,30,17,5,12,63,0,3,3,2,1,,,
"Jan 14, 2022 8:00 AM",133,86,47,86,23,63,128,49,79,98,39,59,25,18,7,14,66,64,2,0,0,0,60,37,53,17,36,97,10,2,12,8,4,,,
"Jan 14, 2022 9:00 AM",78,57,21,56,29,27,90,53,37,67,46,21,8,3,5,12,29,29,0,0,0,0,26,17,38,20,18,44,1,1,4,3,1,,,
"Jan 14, 2022 10:00 AM",45,30,15,63,34,29,54,27,27,63,36,27,13,6,7,4,25,24,1,0,0,0,24,18,19,8,11,20,2,5,2,2,0,,,
"Jan 14, 2022 11:00 AM",42,23,19,51,13,38,56,21,35,35,10,25,6,6,0,12,15,12,3,0,0,0,15,4,20,11,9,21,3,7,2,1,1,,,
"Jan 14, 2022 12:00 PM",68,36,32,46,28,18,79,41,38,50,30,20,18,11,7,8,16,16,0,0,0,0,13,16,32,21,11,19,4,2,4,3,1,,,
"Jan 14, 2022 1:00 PM",84,37,47,78,39,39,86,41,45,74,37,37,18,6,12,11,28,26,2,0,0,0,26,23,39,20,19,29,8,0,8,3,5,,,
"Jan 14, 2022 2:00 PM",59,31,28,66,37,29,71,40,31,64,37,27,14,10,4,16,23,22,1,0,0,0,22,26,23,16,7,25,4,2,4,4,0,,,
"Jan 14, 2022 3:00 PM",88,45,43,46,19,27,63,29,34,48,23,25,20,13,7,25,24,23,1,0,0,0,23,30,32,18,14,37,5,7,5,3,2,,,
"Jan 14, 2022 4:00 PM",95,33,62,58,35,23,67,43,24,57,37,20,16,5,11,18,24,23,1,0,0,0,21,44,23,16,7,38,4,4,7,3,4,,,
"Jan 14, 2022 5:00 PM",117,36,81,48,24,24,78,36,42,53,26,27,15,3,12,15,17,14,3,0,0,0,15,49,40,29,11,46,2,2,5,2,3,,,
"Jan 14, 2022 6:00 PM",105,33,72,33,23,10,42,32,10,31,21,10,7,5,2,13,18,16,2,0,0,0,19,35,20,16,4,27,2,4,12,7,5,,,
"Jan 14, 2022 7:00 PM",80,27,53,18,14,4,32,23,9,19,12,7,5,2,3,6,15,14,1,0,0,0,14,23,11,8,3,10,0,1,3,0,3,,,
"Jan 14, 2022 8:00 PM",48,23,25,13,10,3,14,7,7,9,6,3,3,0,3,9,16,13,3,0,0,0,16,15,10,6,4,8,5,0,6,5,1,,,
"Jan 14, 2022 9:00 PM",35,16,19,14,3,11,6,4,2,8,2,6,2,1,1,6,5,5,0,0,0,0,5,7,5,4,1,8,0,1,0,0,0,,,
"Jan 14, 2022 10:00 PM",18,9,9,9,8,1,6,3,3,6,4,2,1,0,1,5,5,5,0,0,0,0,6,4,5,5,0,7,0,1,0,0,0,,,
"Jan 14, 2022 11:00 PM",5,2,3,1,0,1,2,0,2,6,4,2,0,0,0,6,2,2,0,0,0,0,2,2,1,0,1,3,0,1,0,0,0,,,
"Jan 15, 2022 12:00 AM",9,3,6,0,0,0,0,0,0,1,1,0,1,0,1,2,2,2,0,0,0,0,2,1,0,0,0,1,0,0,0,0,0,,,
"Jan 15, 2022 1:00 AM",2,0,2,3,0,3,2,1,1,1,0,1,0,0,0,1,0,0,0,0,0,0,0,1,4,4,0,1,0,0,0,0,0,,,
"Jan 15, 2022 2:00 AM",4,3,1,0,0,0,0,0,0,0,0,0,0,0,0,2,0,0,0,0,0,0,0,0,0,0,0,0,0,0,0,0,0,,,
"Jan 15, 2022 3:00 AM",2,0,2,0,0,0,1,0,1,0,0,0,0,0,0,0,0,0,0,0,0,0,1,1,0,0,0,2,0,0,1,1,0,,,
"Jan 15, 2022 4:00 AM",3,1,2,0,0,0,1,1,0,0,0,0,0,0,0,0,0,0,0,0,0,0,0,1,0,0,0,1,0,0,0,0,0,,,
"Jan 15, 2022 5:00 AM",1,1,0,3,1,2,3,1,2,5,1,4,0,0,0,1,2,2,0,0,0,0,2,3,0,0,0,3,0,0,0,0,0,,,
"Jan 15, 2022 6:00 AM",10,5,5,2,1,1,4,2,2,2,2,0,0,0,0,0,0,0,0,0,0,0,0,3,0,0,0,5,1,0,0,0,0,,,
"Jan 15, 2022 7:00 AM",18,9,9,14,6,8,13,9,4,10,8,2,1,0,1,4,6,6,0,0,0,0,7,7,4,4,0,20,1,1,1,0,1,,,
"Jan 15, 2022 8:00 AM",32,16,16,42,30,12,39,27,12,42,35,7,4,3,1,7,16,14,2,0,0,0,14,24,12,11,1,18,0,1,1,0,1,,,
"Jan 15, 2022 9:00 AM",58,31,27,69,37,32,79,48,31,74,46,28,7,5,2,10,15,15,0,0,0,0,16,24,23,13,10,29,0,8,3,3,0,,,
"Jan 15, 2022 10:00 AM",63,34,29,94,52,42,121,67,54,79,46,33,14,4,10,13,33,32,1,0,0,0,28,40,44,25,19,33,1,4,1,0,1,,,
"Jan 15, 2022 11:00 AM",54,24,30,110,51,59,145,70,75,94,48,46,14,10,4,10,25,23,2,0,0,0,24,23,48,29,19,36,7,2,4,3,1,,,
"Jan 15, 2022 12:00 PM",54,24,30,110,43,67,134,64,70,103,50,53,11,5,6,21,19,19,0,0,0,0,19,34,48,27,21,44,4,3,6,4,2,,,
"Jan 15, 2022 1:00 PM",72,39,33,93,60,33,99,55,44,94,63,31,7,3,4,14,18,12,6,0,0,0,14,20,59,39,20,45,3,4,1,1,0,,,
"Jan 15, 2022 2:00 PM",53,28,25,101,55,46,99,57,42,86,53,33,17,11,6,31,24,23,1,0,0,0,22,32,51,26,25,36,9,2,2,1,1,,,
"Jan 15, 2022 3:00 PM",51,24,27,101,44,57,107,47,60,96,46,50,20,13,7,18,17,17,0,0,0,0,15,21,59,31,28,33,2,3,7,5,2,,,
"Jan 15, 2022 4:00 PM",31,13,18,83,34,49,76,29,47,72,25,47,23,10,13,11,18,18,0,0,0,0,18,17,49,26,23,33,7,2,11,8,3,,,
"Jan 15, 2022 5:00 PM",44,16,28,42,20,22,42,14,28,44,17,27,9,0,9,7,20,17,3,0,0,0,17,15,18,2,16,28,4,1,5,4,1,,,
"Jan 15, 2022 6:00 PM",38,16,22,20,15,5,24,15,9,21,11,10,12,2,10,6,5,5,0,0,0,0,5,13,10,7,3,3,3,2,5,4,1,,,
"Jan 15, 2022 7:00 PM",37,18,19,8,2,6,10,2,8,8,2,6,4,1,3,13,8,8,0,0,0,0,8,5,6,4,2,13,0,1,1,1,0,,,
"Jan 15, 2022 8:00 PM",22,10,12,12,9,3,14,7,7,12,1,11,5,2,3,4,17,16,1,0,0,0,16,12,3,3,0,12,1,1,2,1,1,,,
"Jan 15, 2022 9:00 PM",25,6,19,10,3,7,10,3,7,9,3,6,4,2,2,5,5,5,0,0,0,0,5,6,0,0,0,8,0,1,2,1,1,,,
"Jan 15, 2022 10:00 PM",10,5,5,21,11,10,7,3,4,5,2,3,0,0,0,2,5,5,0,0,0,0,5,4,3,2,1,5,2,2,1,0,1,,,
"Jan 15, 2022 11:00 PM",12,6,6,1,1,0,4,2,2,2,1,1,0,0,0,2,3,3,0,0,0,0,3,3,3,1,2,3,0,0,0,0,0,,,
"Jan 16, 2022 12:00 AM",6,3,3,0,0,0,0,0,0,2,0,2,0,0,0,1,3,3,0,0,0,0,2,2,1,1,0,4,0,0,0,0,0,,,
"Jan 16, 2022 1:00 AM",2,1,1,1,1,0,0,0,0,0,0,0,0,0,0,1,0,0,0,0,0,0,0,1,0,0,0,1,0,0,0,0,0,,,
"Jan 16, 2022 2:00 AM",3,1,2,2,2,0,2,2,0,2,1,1,0,0,0,0,0,0,0,0,0,0,0,3,0,0,0,2,1,0,2,1,1,,,
"Jan 16, 2022 3:00 AM",1,0,1,0,0,0,1,1,0,0,0,0,2,0,2,0,0,0,0,0,0,0,0,0,0,0,0,0,0,0,0,0,0,,,
"Jan 16, 2022 4:00 AM",1,0,1,0,0,0,0,0,0,0,0,0,0,0,0,0,0,0,0,0,0,0,0,0,0,0,0,0,0,0,0,0,0,,,
"Jan 16, 2022 5:00 AM",1,0,1,0,0,0,0,0,0,0,0,0,0,0,0,0,0,0,0,0,0,0,0,2,0,0,0,4,0,0,0,0,0,,,
"Jan 16, 2022 6:00 AM",2,2,0,2,1,1,6,3,3,4,3,1,1,1,0,1,0,0,0,0,0,0,0,3,0,0,0,7,0,0,2,2,0,,,
"Jan 16, 2022 7:00 AM",13,8,5,9,4,5,7,7,0,8,7,1,0,0,0,1,4,4,0,0,0,0,3,6,2,2,0,9,1,1,3,2,1,,,
"Jan 16, 2022 8:00 AM",27,14,13,51,40,11,53,38,15,47,36,11,1,1,0,6,11,10,1,0,0,0,10,24,17,11,6,15,1,3,0,0,0,,,
"Jan 16, 2022 9:00 AM",37,24,13,126,76,50,131,80,51,107,70,37,4,1,3,11,20,20,0,0,0,0,18,37,34,25,9,50,3,19,1,1,0,,,
"Jan 16, 2022 10:00 AM",60,36,24,184,119,65,176,114,62,147,89,58,16,5,11,14,26,25,1,0,0,0,24,38,70,42,28,32,6,14,5,3,2,,,
"Jan 16, 2022 11:00 AM",55,31,24,165,71,94,161,76,85,152,76,76,23,13,10,20,21,21,0,0,0,0,27,43,45,27,18,59,11,15,21,12,9,,,
"Jan 16, 2022 12:00 PM",74,31,43,185,87,98,205,109,96,155,81,74,32,22,10,35,23,22,1,0,0,0,23,49,89,52,37,43,19,5,8,5,3,,,
"Jan 16, 2022 1:00 PM",67,31,36,169,82,87,176,94,82,150,85,65,22,9,13,29,38,37,1,0,0,0,28,47,69,49,20,56,13,4,10,7,3,,,
"Jan 16, 2022 2:00 PM",64,41,23,165,81,84,143,70,73,139,70,69,16,8,8,22,12,10,2,0,0,0,13,35,81,53,28,55,4,2,11,8,3,,,
"Jan 16, 2022 3:00 PM",63,28,35,133,67,66,143,66,77,117,63,54,22,15,7,15,28,25,3,0,0,0,19,47,62,24,38,48,5,5,15,8,7,,,
"Jan 16, 2022 4:00 PM",59,23,36,133,64,69,106,42,64,88,36,52,18,8,10,24,22,21,1,0,0,0,18,24,51,23,28,38,1,4,6,2,4,,,
"Jan 16, 2022 5:00 PM",46,18,28,47,24,23,52,16,36,48,10,38,13,2,11,10,18,18,0,0,0,0,18,16,22,8,14,29,1,1,5,3,2,,,
"Jan 16, 2022 6:00 PM",42,23,19,18,5,13,20,9,11,14,8,6,7,6,1,5,11,10,1,0,0,0,10,13,8,4,4,12,3,1,3,1,2,,,
"Jan 16, 2022 7:00 PM",29,11,18,1,1,0,12,5,7,9,1,8,3,2,1,13,7,7,0,0,0,0,5,8,2,2,0,13,0,0,2,1,1,,,
"Jan 16, 2022 8:00 PM",27,11,16,6,4,2,10,4,6,6,2,4,2,0,2,4,8,7,1,0,0,0,4,4,3,1,2,16,0,0,1,0,1,,,
"Jan 16, 2022 9:00 PM",16,7,9,7,3,4,9,3,6,4,2,2,1,0,1,3,7,7,0,0,0,0,6,6,4,3,1,8,0,0,1,1,0,,,
"Jan 16, 2022 10:00 PM",12,6,6,1,0,1,3,1,2,2,0,2,2,0,2,2,3,0,3,0,0,0,0,2,3,0,3,2,1,1,4,2,2,,,
"Jan 16, 2022 11:00 PM",2,1,1,0,0,0,2,0,2,2,0,2,0,0,0,2,0,0,0,0,0,0,0,4,0,0,0,5,0,0,0,0,0,,,
"Jan 17, 2022 12:00 AM",2,0,2,0,0,0,0,0,0,0,0,0,0,0,0,0,0,0,0,0,0,0,0,0,0,0,0,0,0,0,0,0,0,,,
"Jan 17, 2022 1:00 AM",1,0,1,0,0,0,1,1,0,0,0,0,0,0,0,0,0,0,0,0,0,0,0,0,0,0,0,0,0,0,0,0,0,,,
"Jan 17, 2022 2:00 AM",3,2,1,0,0,0,0,0,0,0,0,0,0,0,0,0,0,0,0,0,0,0,0,0,0,0,0,0,0,0,0,0,0,,,
"Jan 17, 2022 3:00 AM",0,0,0,0,0,0,0,0,0,0,0,0,0,0,0,0,0,0,0,0,0,0,0,0,0,0,0,1,0,0,1,1,0,,,
"Jan 17, 2022 4:00 AM",1,1,0,0,0,0,0,0,0,0,0,0,0,0,0,0,1,0,1,0,0,0,0,0,0,0,0,0,0,0,0,0,0,,,
"Jan 17, 2022 5:00 AM",5,3,2,1,0,1,3,0,3,3,1,2,0,0,0,1,6,6,0,0,0,0,6,2,2,2,0,11,0,0,0,0,0,,,
"Jan 17, 2022 6:00 AM",38,24,14,11,4,7,21,8,13,18,10,8,2,2,0,4,18,18,0,0,0,0,17,9,10,6,4,25,0,2,0,0,0,,,
"Jan 17, 2022 7:00 AM",70,44,26,35,14,21,58,20,38,43,17,26,4,4,0,12,52,52,0,0,0,0,52,30,16,6,10,61,2,3,5,3,2,,,
"Jan 17, 2022 8:00 AM",178,132,46,88,23,65,103,37,66,84,35,49,39,24,15,23,112,110,2,0,0,0,101,41,56,17,39,127,6,2,9,8,1,,,
"Jan 17, 2022 9:00 AM",135,110,25,46,17,29,65,37,28,45,23,22,10,6,4,8,73,73,0,0,0,0,60,15,24,13,11,52,1,1,2,2,0,,,
"Jan 17, 2022 10:00 AM",80,59,21,27,16,11,59,32,27,43,23,20,11,11,0,12,35,35,0,0,0,0,34,10,23,17,6,24,2,6,3,3,0,,,
"Jan 17, 2022 11:00 AM",62,35,27,45,24,21,65,39,26,38,29,9,5,2,3,6,28,26,2,0,0,0,21,15,16,11,5,13,1,2,1,1,0,,,
"Jan 17, 2022 12:00 PM",73,40,33,49,28,21,79,41,38,58,31,27,23,11,12,8,30,27,3,0,0,0,25,22,26,16,10,31,6,3,2,2,0,,,
"Jan 17, 2022 1:00 PM",86,44,42,56,26,30,91,47,44,54,22,32,12,6,6,10,28,24,4,0,0,0,20,23,18,9,9,28,5,3,4,4,0,,,
"Jan 17, 2022 2:00 PM",68,26,42,57,33,24,76,41,35,47,28,19,11,7,4,20,29,25,4,0,0,0,20,27,25,19,6,24,5,2,5,4,1,,,
"Jan 17, 2022 3:00 PM",105,39,66,77,44,33,65,37,28,61,32,29,17,8,9,19,32,26,6,0,0,0,23,38,36,28,8,25,4,3,9,4,5,,,
"Jan 17, 2022 4:00 PM",121,31,90,55,27,28,60,34,26,47,22,25,8,3,5,27,30,26,4,0,0,0,25,42,37,29,8,36,9,5,9,6,3,,,
"Jan 17, 2022 5:00 PM",193,57,136,54,36,18,88,49,39,71,43,28,15,5,10,24,29,27,2,0,0,0,22,64,41,32,9,54,2,5,7,2,5,,,
"Jan 17, 2022 6:00 PM",121,33,88,55,42,13,71,49,22,49,34,15,7,2,5,19,22,14,8,0,0,0,15,47,26,21,5,35,5,2,7,6,1,,,
"Jan 17, 2022 7:00 PM",63,22,41,18,13,5,37,21,16,24,14,10,5,1,4,12,16,12,4,0,0,0,11,28,16,11,5,20,3,4,6,3,3,,,
"Jan 17, 2022 8:00 PM",63,13,50,20,11,9,22,8,14,26,8,18,4,1,3,9,17,16,1,0,0,0,18,13,9,6,3,13,3,3,4,2,2,,,
"Jan 17, 2022 9:00 PM",23,3,20,4,2,2,16,6,10,8,3,5,3,3,0,11,11,10,1,0,0,0,10,11,5,3,2,8,4,0,5,2,3,,,
"Jan 17, 2022 10:00 PM",28,11,17,3,2,1,6,5,1,6,5,1,2,0,2,3,5,5,0,0,0,0,5,7,0,0,0,2,1,0,4,3,1,,,
"Jan 17, 2022 11:00 PM",3,2,1,1,0,1,4,3,1,2,1,1,1,1,0,1,5,3,2,0,0,0,3,6,0,0,0,2,0,0,0,0,0,,,
"Jan 18, 2022 12:00 AM",1,0,1,0,0,0,0,0,0,1,1,0,0,0,0,0,0,0,0,0,0,0,0,1,0,0,0,0,0,0,0,0,0,,,
"Jan 18, 2022 1:00 AM",3,2,1,0,0,0,0,0,0,0,0,0,0,0,0,0,1,0,1,0,0,0,0,0,0,0,0,1,0,0,0,0,0,,,
"Jan 18, 2022 2:00 AM",4,2,2,0,0,0,0,0,0,0,0,0,0,0,0,0,0,0,0,0,0,0,0,0,0,0,0,0,0,0,0,0,0,,,
"Jan 18, 2022 3:00 AM",0,0,0,0,0,0,0,0,0,0,0,0,0,0,0,0,0,0,0,0,0,0,0,0,0,0,0,0,0,0,0,0,0,,,
"Jan 18, 2022 4:00 AM",1,0,1,0,0,0,0,0,0,0,0,0,0,0,0,1,1,1,0,0,0,0,1,0,0,0,0,1,0,0,0,0,0,,,
"Jan 18, 2022 5:00 AM",4,3,1,1,0,1,4,2,2,3,1,2,0,0,0,2,5,5,0,0,0,0,6,0,1,1,0,8,0,0,0,0,0,,,
"Jan 18, 2022 6:00 AM",29,21,8,11,4,7,21,6,15,17,9,8,1,1,0,3,14,14,0,0,0,0,16,13,4,4,0,26,2,1,3,3,0,,,
"Jan 18, 2022 7:00 AM",84,50,34,26,5,21,57,18,39,32,10,22,7,7,0,8,54,54,0,0,0,0,54,27,24,5,19,73,1,5,5,4,1,,,
"Jan 18, 2022 8:00 AM",193,145,48,98,32,66,126,56,70,106,49,57,32,19,13,28,128,124,4,0,0,0,113,39,46,17,29,110,6,5,12,11,1,,,
"Jan 18, 2022 9:00 AM",103,87,16,54,20,34,66,27,39,62,33,29,18,8,10,8,59,56,3,0,0,0,49,25,34,14,20,53,4,1,5,3,2,,,
"Jan 18, 2022 10:00 AM",82,61,21,40,22,18,51,31,20,40,27,13,5,3,2,9,38,37,1,0,0,0,25,21,23,16,7,25,2,3,2,1,1,,,
"Jan 18, 2022 11:00 AM",59,35,24,45,15,30,60,34,26,50,23,27,16,7,9,5,26,24,2,0,0,0,17,12,24,14,10,21,5,4,6,5,1,,,
"Jan 18, 2022 12:00 PM",65,37,28,59,36,23,79,40,39,50,29,21,14,8,6,12,36,31,5,0,0,0,28,20,26,18,8,39,1,3,2,1,1,,,
"Jan 18, 2022 1:00 PM",89,38,51,60,28,32,88,39,49,45,22,23,16,9,7,20,29,28,1,0,0,0,24,27,44,25,19,38,6,5,4,4,0,,,
"Jan 18, 2022 2:00 PM",79,33,46,43,23,20,70,42,28,51,28,23,13,6,7,25,33,29,4,0,0,0,23,30,27,14,13,24,4,2,2,1,1,,,
"Jan 18, 2022 3:00 PM",92,29,63,47,30,17,73,35,38,56,28,28,18,7,11,12,37,31,6,0,0,0,28,27,34,19,15,30,3,5,6,4,2,,,
"Jan 18, 2022 4:00 PM",126,56,70,59,35,24,71,45,26,72,39,33,13,4,9,18,26,20,6,0,0,0,22,41,39,26,13,44,5,2,6,4,2,,,
"Jan 18, 2022 5:00 PM",174,44,130,39,31,8,81,41,40,65,32,33,15,8,7,19,34,27,7,0,0,0,26,57,41,31,10,59,2,1,5,3,2,,,
"Jan 18, 2022 6:00 PM",137,44,93,46,37,9,84,59,25,73,47,26,6,1,5,12,34,31,3,0,0,0,32,57,33,29,4,51,2,1,4,4,0,,,
"Jan 18, 2022 7:00 PM",107,34,73,37,22,15,40,28,12,42,26,16,7,0,7,10,18,13,5,0,0,0,20,30,15,11,4,14,2,1,1,0,1,,,
"Jan 18, 2022 8:00 PM",86,21,65,13,7,6,26,18,8,16,10,6,3,1,2,10,19,13,6,0,0,0,16,25,8,6,2,18,2,4,2,2,0,,,
"Jan 18, 2022 9:00 PM",43,12,31,12,10,2,19,13,6,13,9,4,3,1,2,5,10,9,1,0,0,0,10,12,6,5,1,10,2,2,3,1,2,,,
"Jan 18, 2022 10:00 PM",25,6,19,8,2,6,11,4,7,9,2,7,0,0,0,7,5,5,0,0,0,0,5,8,3,2,1,7,1,0,1,1,0,,,
"Jan 18, 2022 11:00 PM",5,0,5,1,0,1,11,7,4,4,3,1,0,0,0,1,4,4,0,0,0,0,4,4,2,1,1,2,3,0,1,1,0,,,
"Jan 19, 2022 12:00 AM",4,0,4,0,0,0,0,0,0,0,0,0,2,0,2,0,2,1,1,0,0,0,1,1,0,0,0,1,1,0,0,0,0,,,
"Jan 19, 2022 1:00 AM",1,1,0,0,0,0,0,0,0,0,0,0,0,0,0,0,0,0,0,0,0,0,0,0,0,0,0,0,0,0,0,0,0,,,
"Jan 19, 2022 2:00 AM",3,3,0,0,0,0,0,0,0,0,0,0,0,0,0,0,0,0,0,0,0,0,0,0,0,0,0,0,0,0,0,0,0,,,
"Jan 19, 2022 3:00 AM",1,1,0,0,0,0,0,0,0,0,0,0,0,0,0,0,0,0,0,0,0,0,0,0,0,0,0,0,0,0,0,0,0,,,
"Jan 19, 2022 4:00 AM",0,0,0,1,0,1,1,0,1,1,0,1,0,0,0,1,0,0,0,0,0,0,0,0,0,0,0,0,0,0,0,0,0,,,
"Jan 19, 2022 5:00 AM",5,5,0,2,1,1,3,2,1,3,2,1,0,0,0,1,3,3,0,0,0,0,3,0,1,0,1,8,0,0,0,0,0,,,
"Jan 19, 2022 6:00 AM",25,18,7,4,2,2,14,6,8,6,4,2,0,0,0,3,19,19,0,0,0,0,18,12,4,4,0,27,0,2,1,1,0,,,
"Jan 19, 2022 7:00 AM",83,56,27,43,13,30,65,22,43,45,16,29,5,5,0,8,59,59,0,0,0,0,58,30,20,7,13,62,1,3,4,4,0,,,
"Jan 19, 2022 8:00 AM",199,151,48,96,31,65,115,39,76,109,44,65,21,15,6,28,132,129,3,0,0,0,119,42,50,15,35,142,8,3,17,14,3,,,
"Jan 19, 2022 9:00 AM",107,88,19,65,23,42,72,32,40,67,30,37,14,9,5,6,64,62,2,0,0,0,57,12,34,20,14,41,2,3,3,2,1,,,
"Jan 19, 2022 10:00 AM",83,57,26,36,17,19,54,30,24,47,26,21,7,7,0,9,47,43,4,0,0,0,28,17,21,9,12,26,3,4,6,6,0,,,
"Jan 19, 2022 11:00 AM",78,46,32,46,24,22,65,31,34,40,25,15,14,7,7,7,32,28,4,0,0,0,28,14,32,22,10,34,1,0,1,1,0,,,
"Jan 19, 2022 12:00 PM",90,43,47,68,31,37,75,36,39,65,26,39,15,10,5,7,35,31,4,0,0,0,25,28,26,15,11,36,3,1,5,5,0,,,
"Jan 19, 2022 1:00 PM",100,43,57,73,41,32,88,52,36,62,34,28,17,9,8,20,40,35,5,0,0,0,31,32,55,38,17,39,3,5,2,1,1,,,
"Jan 19, 2022 2:00 PM",65,25,40,70,40,30,68,34,34,54,32,22,15,10,5,18,29,23,6,0,0,0,23,33,20,12,8,28,6,3,10,9,1,,,
"Jan 19, 2022 3:00 PM",94,28,66,58,34,24,69,48,21,53,31,22,14,1,13,11,26,20,6,0,0,0,18,27,30,24,6,27,11,3,17,8,9,,,
"Jan 19, 2022 4:00 PM",136,44,92,55,36,19,58,34,24,49,28,21,15,1,14,20,19,14,5,0,0,0,15,46,33,22,11,38,7,0,6,5,1,,,
"Jan 19, 2022 5:00 PM",164,40,124,53,36,17,90,50,40,73,43,30,11,5,6,25,29,21,8,0,0,0,23,67,44,31,13,49,3,1,6,3,3,,,
"Jan 19, 2022 6:00 PM",153,42,111,48,35,13,77,58,19,56,35,21,8,2,6,20,33,26,7,0,0,0,26,44,46,39,7,34,3,4,7,4,3,,,
"Jan 19, 2022 7:00 PM",78,31,47,36,26,10,43,35,8,38,26,12,1,0,1,11,19,16,3,0,0,0,16,42,8,6,2,21,4,2,3,3,0,,,
"Jan 19, 2022 8:00 PM",65,17,48,17,12,5,32,19,13,21,11,10,4,0,4,9,16,14,2,0,0,0,12,21,9,7,2,20,5,8,5,3,2,,,
"Jan 19, 2022 9:00 PM",35,6,29,4,3,1,11,4,7,4,3,1,0,0,0,3,4,3,1,0,0,0,6,9,18,11,7,8,3,1,4,2,2,,,
"Jan 19, 2022 10:00 PM",25,8,17,2,1,1,6,2,4,7,4,3,0,0,0,4,5,5,0,0,0,0,5,9,3,2,1,9,4,0,5,4,1,,,
"Jan 19, 2022 11:00 PM",8,2,6,0,0,0,3,1,2,1,1,0,0,0,0,1,2,2,0,0,0,0,2,2,0,0,0,3,0,0,0,0,0,,,
"Jan 20, 2022 12:00 AM",2,1,1,0,0,0,0,0,0,1,1,0,0,0,0,1,0,0,0,0,0,0,0,2,0,0,0,4,0,0,1,1,0,,,
"Jan 20, 2022 1:00 AM",0,0,0,0,0,0,1,1,0,1,1,0,0,0,0,0,0,0,0,0,0,0,0,0,0,0,0,0,0,0,0,0,0,,,
"Jan 20, 2022 2:00 AM",4,3,1,0,0,0,0,0,0,0,0,0,0,0,0,0,0,0,0,0,0,0,0,0,0,0,0,0,0,0,0,0,0,,,
"Jan 20, 2022 3:00 AM",0,0,0,0,0,0,0,0,0,0,0,0,0,0,0,0,0,0,0,0,0,0,0,0,0,0,0,0,0,0,0,0,0,,,
"Jan 20, 2022 4:00 AM",2,2,0,0,0,0,0,0,0,0,0,0,0,0,0,1,0,0,0,0,0,0,0,0,0,0,0,1,0,0,0,0,0,,,
"Jan 20, 2022 5:00 AM",3,1,2,2,0,2,3,2,1,4,2,2,1,1,0,1,8,8,0,0,0,0,8,1,1,1,0,8,0,0,0,0,0,,,
"Jan 20, 2022 6:00 AM",30,23,7,10,3,7,20,6,14,17,10,7,2,1,1,5,14,13,1,0,0,0,14,12,6,3,3,30,0,6,2,2,0,,,
"Jan 20, 2022 7:00 AM",100,74,26,34,11,23,61,21,40,46,18,28,6,5,1,11,61,61,0,0,0,0,56,28,26,10,16,61,3,4,3,3,0,,,
"Jan 20, 2022 8:00 AM",200,142,58,68,17,51,128,43,85,101,32,69,18,11,7,23,117,115,2,0,0,0,108,48,70,25,45,117,9,5,16,12,4,,,
"Jan 20, 2022 9:00 AM",105,85,20,45,12,33,75,37,38,50,28,22,16,11,5,13,68,67,1,0,0,0,54,21,54,29,25,50,2,2,2,1,1,,,
"Jan 20, 2022 10:00 AM",87,65,22,44,18,26,60,30,30,41,17,24,15,10,5,9,44,43,1,0,0,0,36,13,14,5,9,26,3,2,1,1,0,,,
"Jan 20, 2022 11:00 AM",59,31,28,41,19,22,58,30,28,39,23,16,10,6,4,8,26,21,5,0,0,0,16,12,11,3,8,23,1,2,3,2,1,,,
"Jan 20, 2022 12:00 PM",61,39,22,57,29,28,52,31,21,45,23,22,16,8,8,12,27,21,6,0,0,0,17,20,23,13,10,23,4,2,7,7,0,,,
"Jan 20, 2022 1:00 PM",76,29,47,58,31,27,80,40,40,56,32,24,17,10,7,9,29,24,5,0,0,0,18,33,29,15,14,23,9,2,2,2,0,,,
"Jan 20, 2022 2:00 PM",81,31,50,56,31,25,64,34,30,48,28,20,17,10,7,21,24,23,1,0,0,0,20,22,32,23,9,35,3,5,3,1,2,,,
"Jan 20, 2022 3:00 PM",95,43,52,42,23,19,52,29,23,42,21,21,20,11,9,18,28,24,4,0,0,0,19,34,26,15,11,17,5,1,4,3,1,,,
"Jan 20, 2022 4:00 PM",132,45,87,71,41,30,92,49,43,74,39,35,11,5,6,17,29,26,3,0,0,0,24,38,60,37,23,39,6,4,7,5,2,,,
"Jan 20, 2022 5:00 PM",164,46,118,45,28,17,88,54,34,69,42,27,14,3,11,14,34,28,6,0,0,0,27,72,32,26,6,61,6,3,4,3,1,,,
"Jan 20, 2022 6:00 PM",143,43,100,50,42,8,77,59,18,61,45,16,6,2,4,17,38,33,5,0,0,0,36,59,35,30,5,37,5,1,9,7,2,,,
"Jan 20, 2022 7:00 PM",83,27,56,20,13,7,38,25,13,30,19,11,13,9,4,7,20,18,2,0,0,0,18,27,12,6,6,23,5,0,1,1,0,,,
"Jan 20, 2022 8:00 PM",71,29,42,25,22,3,27,17,10,27,20,7,6,1,5,7,23,20,3,0,0,0,18,28,11,9,2,16,1,1,6,2,4,,,
"Jan 20, 2022 9:00 PM",37,15,22,17,6,11,20,7,13,17,7,10,5,4,1,10,8,6,2,0,0,0,6,6,9,5,4,16,2,2,0,0,0,,,
"Jan 20, 2022 10:00 PM",29,11,18,6,3,3,4,2,2,6,2,4,0,0,0,2,3,3,0,0,0,0,3,6,4,3,1,5,0,1,0,0,0,,,
"Jan 20, 2022 11:00 PM",3,0,3,1,1,0,0,0,0,0,0,0,0,0,0,3,6,6,0,0,0,0,5,4,0,0,0,1,1,0,0,0,0,,,
"Jan 21, 2022 12:00 AM",5,0,5,0,0,0,1,0,1,2,1,1,0,0,0,1,2,2,0,0,0,0,2,1,0,0,0,0,1,0,0,0,0,,,
"Jan 21, 2022 1:00 AM",4,1,3,0,0,0,0,0,0,0,0,0,1,0,1,1,1,0,1,0,0,0,0,0,0,0,0,0,0,0,0,0,0,,,
"Jan 21, 2022 2:00 AM",3,2,1,0,0,0,0,0,0,0,0,0,0,0,0,0,0,0,0,0,0,0,0,0,0,0,0,1,0,0,1,1,0,,,
"Jan 21, 2022 3:00 AM",0,0,0,0,0,0,0,0,0,0,0,0,0,0,0,0,0,0,0,0,0,0,0,0,0,0,0,0,0,0,0,0,0,,,
"Jan 21, 2022 4:00 AM",2,1,1,1,0,1,0,0,0,0,0,0,0,0,0,0,1,1,0,0,0,0,1,1,0,0,0,1,0,0,1,1,0,,,
"Jan 21, 2022 5:00 AM",8,5,3,1,1,0,4,3,1,4,2,2,0,0,0,1,3,3,0,0,0,0,3,1,1,1,0,9,0,0,1,1,0,,,
"Jan 21, 2022 6:00 AM",32,22,10,17,6,11,16,6,10,15,6,9,5,4,1,5,14,14,0,0,0,0,15,15,3,2,1,24,0,2,1,1,0,,,
"Jan 21, 2022 7:00 AM",77,52,25,55,24,31,57,22,35,43,16,27,7,7,0,7,41,41,0,0,0,0,45,27,22,9,13,54,2,6,3,3,0,,,
"Jan 21, 2022 8:00 AM",183,140,43,76,29,47,101,40,61,83,33,50,26,13,13,17,103,100,3,0,0,0,92,38,46,13,33,104,6,0,13,11,2,,,
"Jan 21, 2022 9:00 AM",89,61,28,63,25,38,57,25,32,58,31,27,17,12,5,8,49,47,2,0,0,0,42,20,31,15,16,50,2,3,7,4,3,,,
"Jan 21, 2022 10:00 AM",63,42,21,55,30,25,51,34,17,50,30,20,6,4,2,11,33,33,0,0,0,0,32,17,20,14,6,26,4,3,8,3,5,,,
"Jan 21, 2022 11:00 AM",50,24,26,63,26,37,53,21,32,53,21,32,2,2,0,12,27,21,6,0,0,0,23,14,25,14,11,27,11,4,7,6,1,,,
"Jan 21, 2022 12:00 PM",77,39,38,57,28,29,57,31,26,40,22,18,12,7,5,9,27,25,2,0,0,0,20,21,23,14,9,21,4,2,3,1,2,,,
"Jan 21, 2022 1:00 PM",106,48,58,46,25,21,99,47,52,60,35,25,11,4,7,18,28,23,5,0,0,0,21,32,31,17,14,25,3,1,4,2,2,,,
"Jan 21, 2022 2:00 PM",70,23,47,48,23,25,62,36,26,50,25,25,12,7,5,12,24,22,2,0,0,0,19,22,31,17,14,23,6,3,5,3,2,,,
"Jan 21, 2022 3:00 PM",78,30,48,59,29,30,48,22,26,46,24,22,20,8,12,18,23,19,4,0,0,0,14,27,31,15,16,35,6,2,6,4,2,,,
"Jan 21, 2022 4:00 PM",105,36,69,64,41,23,71,43,28,74,43,31,12,5,7,21,25,20,5,0,0,0,22,40,45,37,8,46,6,2,2,2,0,,,
"Jan 21, 2022 5:00 PM",153,44,109,49,30,19,63,38,25,58,31,27,12,6,6,20,34,29,5,0,0,0,29,57,32,20,12,35,2,0,8,4,4,,,
"Jan 21, 2022 6:00 PM",125,41,84,37,28,9,54,42,12,40,27,13,9,4,5,15,28,24,4,0,0,0,25,38,23,18,5,20,1,1,5,1,4,,,
"Jan 21, 2022 7:00 PM",76,30,46,20,15,5,41,31,10,27,18,9,2,1,1,10,17,16,1,0,0,0,18,31,12,8,4,21,3,1,1,1,0,,,
"Jan 21, 2022 8:00 PM",55,19,36,15,9,6,33,17,16,27,13,14,4,1,3,9,16,15,1,0,0,0,17,16,8,5,3,21,3,1,1,1,0,,,
"Jan 21, 2022 9:00 PM",41,12,29,12,7,5,25,11,14,16,6,10,6,2,4,5,9,9,0,0,0,0,10,5,12,7,5,19,1,1,1,1,0,,,
"Jan 21, 2022 10:00 PM",23,6,17,5,0,5,5,0,5,7,2,5,0,0,0,6,8,6,2,0,0,0,6,3,1,1,0,9,0,2,0,0,0,,,
"Jan 21, 2022 11:00 PM",12,4,8,3,1,2,6,3,3,7,0,7,2,1,1,2,3,3,0,0,0,0,3,2,1,0,1,3,0,0,2,1,1,,,
"Jan 22, 2022 12:00 AM",6,3,3,0,0,0,0,0,0,0,0,0,0,0,0,2,1,1,0,0,0,0,1,3,0,0,0,3,0,0,1,1,0,,,
"Jan 22, 2022 1:00 AM",3,1,2,0,0,0,0,0,0,0,0,0,1,0,1,0,1,0,1,0,0,0,1,1,0,0,0,0,0,0,0,0,0,,,
"Jan 22, 2022 2:00 AM",4,2,2,0,0,0,1,1,0,1,1,0,0,0,0,0,3,3,0,0,0,0,3,1,0,0,0,2,0,0,0,0,0,,,
"Jan 22, 2022 3:00 AM",2,1,1,0,0,0,1,1,0,0,0,0,0,0,0,0,3,3,0,0,0,0,2,2,0,0,0,0,0,0,0,0,0,,,
"Jan 22, 2022 4:00 AM",2,1,1,0,0,0,1,0,1,0,0,0,0,0,0,2,1,1,0,0,0,0,1,0,1,0,1,0,0,0,0,0,0,,,
"Jan 22, 2022 5:00 AM",0,0,0,1,0,1,0,0,0,2,0,2,0,0,0,0,1,1,0,0,0,0,0,0,1,1,0,4,0,0,0,0,0,,,
"Jan 22, 2022 6:00 AM",7,5,2,2,0,2,2,1,1,4,2,2,1,1,0,0,6,6,0,0,0,0,6,2,2,2,0,5,0,0,0,0,0,,,
"Jan 22, 2022 7:00 AM",17,7,10,10,7,3,12,8,4,13,12,1,4,0,4,5,9,9,0,0,0,0,9,8,2,2,0,17,0,1,1,0,1,,,
"Jan 22, 2022 8:00 AM",32,21,11,29,21,8,35,21,14,29,17,12,9,3,6,9,12,12,0,0,0,0,12,13,12,6,6,19,2,7,2,1,1,,,
"Jan 22, 2022 9:00 AM",61,36,25,73,52,21,75,52,23,68,55,13,11,10,1,11,25,25,0,0,0,0,25,28,26,19,7,26,5,3,7,4,3,,,
"Jan 22, 2022 10:00 AM",46,25,21,116,64,52,125,72,53,116,69,47,9,7,2,19,22,21,1,0,0,0,21,42,42,23,19,36,5,8,7,4,3,,,
"Jan 22, 2022 11:00 AM",54,22,32,153,81,72,169,91,78,139,72,67,14,7,7,9,15,15,0,0,0,0,15,39,72,39,33,47,7,2,2,2,0,,,
"Jan 22, 2022 12:00 PM",72,32,40,128,62,66,163,77,86,122,53,69,18,7,11,24,28,26,2,0,0,0,27,46,61,34,27,42,10,8,11,8,3,,,
"Jan 22, 2022 1:00 PM",67,37,30,132,52,80,142,60,82,109,43,66,32,19,13,11,28,26,2,0,0,0,18,26,45,29,16,50,9,8,4,2,2,,,
"Jan 22, 2022 2:00 PM",66,39,27,99,45,54,133,55,78,97,45,52,19,10,9,16,22,20,2,0,0,0,14,33,57,28,29,52,11,1,9,7,2,,,
"Jan 22, 2022 3:00 PM",66,32,34,99,43,56,123,55,68,91,45,46,27,11,16,31,12,10,2,0,0,0,9,12,44,22,22,43,7,1,3,2,1,,,
"Jan 22, 2022 4:00 PM",51,23,28,79,35,44,88,33,55,78,36,42,20,10,10,20,20,19,1,0,0,0,18,12,40,24,16,19,2,1,3,3,0,,,
"Jan 22, 2022 5:00 PM",55,27,28,40,19,21,55,25,30,53,21,32,10,7,3,15,18,13,5,0,0,0,12,19,18,10,8,17,3,0,3,2,1,,,
"Jan 22, 2022 6:00 PM",63,25,38,15,10,5,14,5,9,10,5,5,12,4,8,12,12,11,1,0,0,0,11,11,5,2,3,23,3,3,1,1,0,,,
"Jan 22, 2022 7:00 PM",35,14,21,13,6,7,18,11,7,13,6,7,3,0,3,5,7,7,0,0,0,0,7,6,7,7,0,10,3,0,5,3,2,,,
"Jan 22, 2022 8:00 PM",29,14,15,12,8,4,11,8,3,9,5,4,2,1,1,1,12,11,1,0,0,0,10,9,3,3,0,8,0,1,1,0,1,,,
"Jan 22, 2022 9:00 PM",25,10,15,5,3,2,7,5,2,7,3,4,1,0,1,7,6,6,0,0,0,0,10,4,5,2,3,8,2,1,1,0,1,,,
"Jan 22, 2022 10:00 PM",14,5,9,4,3,1,10,3,7,4,2,2,1,1,0,2,2,1,1,0,0,0,2,5,2,1,1,5,0,1,2,1,1,,,
"Jan 22, 2022 11:00 PM",5,2,3,2,1,1,1,1,0,3,2,1,1,0,1,4,1,1,0,0,0,0,1,3,2,1,1,2,0,0,0,0,0,,,
"Jan 23, 2022 12:00 AM",9,4,5,0,0,0,1,1,0,1,1,0,1,0,1,1,4,4,0,0,0,0,3,4,1,1,0,3,0,2,0,0,0,,,
"Jan 23, 2022 1:00 AM",8,5,3,3,0,3,1,0,1,3,0,3,1,0,1,1,1,1,0,0,0,0,1,6,2,2,0,0,0,0,0,0,0,,,
"Jan 23, 2022 2:00 AM",3,2,1,3,3,0,2,2,0,3,3,0,2,0,2,1,1,1,0,0,0,0,1,2,1,1,0,1,0,1,1,1,0,,,
"Jan 23, 2022 3:00 AM",4,0,4,1,1,0,1,1,0,1,1,0,4,4,0,2,0,0,0,0,0,0,0,0,0,0,0,1,0,0,0,0,0,,,
"Jan 23, 2022 4:00 AM",2,0,2,1,1,0,0,0,0,1,1,0,0,0,0,0,0,0,0,0,0,0,0,0,0,0,0,1,0,0,0,0,0,,,
"Jan 23, 2022 5:00 AM",1,0,1,0,0,0,0,0,0,0,0,0,0,0,0,0,1,1,0,0,0,0,1,2,0,0,0,1,0,1,0,0,0,,,
"Jan 23, 2022 6:00 AM",7,2,5,6,3,3,8,4,4,7,4,3,0,0,0,1,6,6,0,0,0,0,6,4,0,0,0,6,0,0,1,1,0,,,
"Jan 23, 2022 7:00 AM",9,4,5,9,4,5,12,10,2,10,8,2,4,4,0,0,7,7,0,0,0,0,7,4,6,6,0,9,1,2,2,1,1,,,
"Jan 23, 2022 8:00 AM",33,23,10,77,50,27,67,40,27,72,46,26,1,1,0,8,13,13,0,0,0,0,11,21,23,12,11,14,0,3,0,0,0,,,
"Jan 23, 2022 9:00 AM",41,26,15,119,76,43,101,66,35,100,70,30,9,3,6,11,36,36,0,0,0,0,41,50,42,20,22,44,3,13,1,1,0,,,
"Jan 23, 2022 10:00 AM",58,36,22,196,116,80,162,97,65,157,96,61,9,5,4,19,30,29,1,0,0,0,27,36,41,23,18,42,10,5,4,1,3,,,
"Jan 23, 2022 11:00 AM",59,22,37,178,90,88,172,81,91,156,77,79,15,11,4,31,13,12,1,0,0,0,12,50,63,38,25,30,10,6,9,6,3,,,
"Jan 23, 2022 12:00 PM",74,38,36,176,82,94,185,100,85,145,66,79,38,20,18,23,26,26,0,0,0,0,27,41,62,37,25,44,8,7,13,9,4,,,
"Jan 23, 2022 1:00 PM",66,28,38,138,81,57,150,68,82,127,79,48,32,12,20,24,25,25,0,0,0,0,25,36,60,43,17,66,18,6,4,3,1,,,
"Jan 23, 2022 2:00 PM",57,25,32,124,71,53,122,70,52,117,68,49,20,6,14,15,21,20,1,0,0,0,17,32,62,34,28,39,6,4,6,4,2,,,
"Jan 23, 2022 3:00 PM",66,40,26,159,68,91,168,83,85,143,67,76,24,10,14,28,24,22,2,0,0,0,21,28,50,27,23,48,4,3,10,4,6,,,
"Jan 23, 2022 4:00 PM",39,18,21,86,43,43,122,44,78,86,32,54,35,25,10,13,21,19,2,0,0,0,16,22,44,19,25,40,1,1,2,1,1,,,
"Jan 23, 2022 5:00 PM",40,12,28,69,35,34,82,27,55,59,21,38,20,9,11,9,16,16,0,0,0,0,16,13,17,7,10,38,0,0,1,1,0,,,
"Jan 23, 2022 6:00 PM",36,14,22,20,12,8,18,6,12,11,5,6,3,2,1,7,11,11,0,0,0,0,10,8,7,1,6,11,1,2,1,0,1,,,
"Jan 23, 2022 7:00 PM",34,17,17,12,10,2,9,7,2,9,3,6,5,0,5,11,6,6,0,0,0,0,8,11,5,3,2,12,0,0,3,2,1,,,
"Jan 23, 2022 8:00 PM",20,8,12,5,3,2,11,5,6,6,4,2,3,2,1,10,11,9,2,0,0,0,9,4,1,0,1,9,1,0,2,1,1,,,
"Jan 23, 2022 9:00 PM",29,15,14,5,2,3,7,4,3,8,3,5,1,0,1,8,3,3,0,0,0,0,4,8,1,1,0,11,0,0,1,1,0,,,
"Jan 23, 2022 10:00 PM",13,4,9,4,1,3,3,1,2,3,1,2,0,0,0,4,0,0,0,0,0,0,0,6,3,1,2,3,0,0,0,0,0,,,
"Jan 23, 2022 11:00 PM",9,3,6,0,0,0,4,2,2,2,0,2,0,0,0,0,3,3,0,0,0,0,3,6,2,2,0,4,0,0,0,0,0,,,
"Jan 24, 2022 12:00 AM",3,0,3,0,0,0,0,0,0,0,0,0,0,0,0,0,0,0,0,0,0,0,0,1,0,0,0,2,0,0,,,,,,
"Jan 24, 2022 1:00 AM",2,1,1,0,0,0,1,0,1,1,1,0,0,0,0,0,0,0,0,0,0,0,0,0,1,0,1,1,0,0,,,,,,
"Jan 24, 2022 2:00 AM",2,2,0,0,0,0,0,0,0,0,0,0,0,0,0,1,0,0,0,0,0,0,0,1,0,0,0,0,0,0,,,,,,
"Jan 24, 2022 3:00 AM",1,0,1,0,0,0,0,0,0,0,0,0,0,0,0,0,0,0,0,0,0,0,0,0,0,0,0,1,0,0,,,,,,
"Jan 24, 2022 4:00 AM",1,0,1,1,0,1,2,1,1,1,0,1,0,0,0,0,1,1,0,0,0,0,0,1,0,0,0,1,0,0,,,,,,
"Jan 24, 2022 5:00 AM",6,3,3,1,1,0,2,1,1,3,2,1,0,0,0,3,4,4,0,0,0,0,4,0,0,0,0,12,0,0,,,,,,
"Jan 24, 2022 6:00 AM",37,29,8,12,5,7,17,6,11,13,8,5,4,2,2,3,19,19,0,0,0,0,19,14,7,4,3,27,0,3,,,,,,
"Jan 24, 2022 7:00 AM",94,64,30,45,17,28,66,26,40,49,27,22,4,4,0,11,54,54,0,0,0,0,55,33,27,11,16,80,3,4,,,,,,
"Jan 24, 2022 8:00 AM",187,139,48,81,19,62,118,29,89,94,30,64,29,23,6,22,133,129,4,0,0,0,118,42,65,14,51,132,7,3,,,,,,
"Jan 24, 2022 9:00 AM",154,130,24,47,18,29,79,38,41,64,31,33,15,4,11,6,74,73,1,0,0,0,61,31,40,20,20,61,3,3,,,,,,
"Jan 24, 2022 10:00 AM",70,55,15,63,32,31,59,37,22,47,29,18,12,7,5,10,43,42,1,0,0,0,38,20,20,13,7,29,0,2,,,,,,
"Jan 24, 2022 11:00 AM",68,39,29,64,27,37,74,33,41,67,36,31,14,10,4,11,31,30,1,0,0,0,25,22,37,26,11,23,5,3,,,,,,
"Jan 24, 2022 12:00 PM",67,37,30,67,27,40,92,52,40,58,30,28,22,13,9,15,41,39,2,0,0,0,33,18,28,19,9,22,6,4,,,,,,
"Jan 24, 2022 1:00 PM",83,41,42,67,38,29,102,54,48,73,38,35,15,3,12,11,28,24,4,0,0,0,20,39,100,42,58,27,4,2,,,,,,
"Jan 24, 2022 2:00 PM",75,31,44,63,38,25,88,38,50,54,29,25,17,11,6,14,26,22,4,0,0,0,20,20,30,22,8,37,5,4,,,,,,
"Jan 24, 2022 3:00 PM",103,29,74,68,36,32,77,49,28,55,37,18,21,12,9,18,37,30,7,0,0,0,24,31,30,19,11,28,4,1,,,,,,
"Jan 24, 2022 4:00 PM",123,41,82,54,31,23,80,45,35,64,37,27,11,5,6,21,23,17,6,0,0,0,16,41,34,22,12,48,5,1,,,,,,
"Jan 24, 2022 5:00 PM",179,32,147,55,37,18,88,52,36,67,37,30,18,5,13,24,39,25,14,0,0,0,23,77,43,34,9,60,2,3,,,,,,
"Jan 24, 2022 6:00 PM",150,37,113,37,31,6,76,58,18,61,41,20,6,2,4,16,31,25,6,0,0,0,31,45,34,33,1,40,4,3,,,,,,
"Jan 24, 2022 7:00 PM",79,31,48,35,22,13,44,31,13,37,25,12,4,1,3,12,15,11,4,0,0,0,11,32,24,18,6,25,4,3,,,,,,
"Jan 24, 2022 8:00 PM",71,21,50,14,10,4,28,18,10,21,12,9,3,1,2,9,21,19,2,0,0,0,20,21,5,4,1,19,1,0,,,,,,
"Jan 24, 2022 9:00 PM",47,14,33,7,2,5,10,5,5,9,2,7,0,0,0,8,14,13,1,0,0,0,11,10,2,1,1,8,2,1,,,,,,
"Jan 24, 2022 10:00 PM",20,8,12,1,0,1,5,1,4,4,1,3,2,1,1,9,6,4,2,0,0,0,3,7,0,0,0,7,2,0,,,,,,
"Jan 24, 2022 11:00 PM",7,2,5,0,0,0,3,1,2,0,0,0,0,0,0,1,2,2,0,0,0,0,2,3,1,0,1,3,0,1,,,,,,
"Jan 25, 2022 12:00 AM",5,0,5,0,0,0,2,1,1,2,1,1,0,0,0,1,0,0,0,0,0,0,0,3,1,0,1,0,0,0,,,,,,
"Jan 25, 2022 1:00 AM",4,3,1,0,0,0,2,1,1,1,0,1,1,0,1,0,1,1,0,0,0,0,0,3,1,1,0,0,0,0,,,,,,
"Jan 25, 2022 2:00 AM",4,3,1,0,0,0,0,0,0,0,0,0,0,0,0,0,0,0,0,0,0,0,0,1,0,0,0,0,0,0,,,,,,
"Jan 25, 2022 3:00 AM",0,0,0,0,0,0,0,0,0,0,0,0,0,0,0,0,0,0,0,0,0,0,0,0,0,0,0,0,0,0,,,,,,
"Jan 25, 2022 4:00 AM",2,1,1,0,0,0,0,0,0,0,0,0,0,0,0,1,1,1,0,0,0,0,1,0,0,0,0,1,0,0,,,,,,
"Jan 25, 2022 5:00 AM",4,2,2,3,2,1,5,4,1,9,4,5,0,0,0,2,7,7,0,0,0,0,6,2,1,1,0,12,0,0,,,,,,
"Jan 25, 2022 6:00 AM",38,29,9,13,3,10,19,6,13,18,7,11,1,1,0,5,17,17,0,0,0,0,18,10,4,3,1,30,0,3,,,,,,
"Jan 25, 2022 7:00 AM",90,65,25,39,15,24,65,22,43,54,23,31,6,6,0,16,70,70,0,0,0,0,70,45,22,11,11,87,1,3,,,,,,
"Jan 25, 2022 8:00 AM",197,140,57,97,29,68,132,43,89,112,36,76,24,16,8,21,133,133,0,0,0,0,122,48,60,19,41,147,5,3,,,,,,
"Jan 25, 2022 9:00 AM",110,87,23,50,15,35,77,42,35,71,39,32,13,8,5,11,67,66,1,0,0,0,57,21,34,15,19,58,2,4,,,,,,
"Jan 25, 2022 10:00 AM",88,70,18,46,25,21,40,27,13,37,24,13,11,6,5,8,54,52,2,0,0,0,39,18,14,11,3,37,1,1,,,,,,
"Jan 25, 2022 11:00 AM",60,34,26,46,22,24,51,29,22,33,15,18,16,6,10,9,31,29,2,0,0,0,26,14,13,9,4,29,6,4,,,,,,
"Jan 25, 2022 12:00 PM",75,47,28,68,38,30,51,27,24,40,20,20,9,1,8,10,31,30,1,0,0,0,27,16,19,7,12,31,3,6,,,,,,
"Jan 25, 2022 1:00 PM",109,49,60,42,28,14,68,37,31,37,20,17,13,3,10,18,43,35,8,0,0,0,32,28,21,16,5,28,4,2,,,,,,
"Jan 25, 2022 2:00 PM",65,24,41,49,20,29,57,30,27,46,26,20,12,4,8,27,27,20,7,0,0,0,18,26,25,16,9,29,6,4,,,,,,
"Jan 25, 2022 3:00 PM",109,40,69,48,26,22,72,47,25,50,30,20,12,5,7,16,30,25,5,0,0,0,20,28,33,23,10,20,4,1,,,,,,
"Jan 25, 2022 4:00 PM",135,41,94,54,33,21,94,58,36,62,33,29,20,12,8,13,35,27,8,0,0,0,23,59,40,28,12,41,6,1,,,,,,
"Jan 25, 2022 5:00 PM",195,48,147,46,36,10,100,66,34,78,50,28,16,6,10,16,31,27,4,0,0,0,28,88,46,32,14,60,11,3,,,,,,
"Jan 25, 2022 6:00 PM",148,42,106,56,39,17,96,66,30,73,47,26,10,2,8,15,40,34,6,0,0,0,34,73,43,35,8,49,0,1,,,,,,
"Jan 25, 2022 7:00 PM",104,31,73,34,24,10,47,29,18,38,20,18,8,1,7,24,26,21,5,0,0,0,22,47,17,14,3,41,5,1,,,,,,
"Jan 25, 2022 8:00 PM",87,30,57,21,14,7,40,25,15,27,20,7,2,1,1,11,15,15,0,0,0,0,16,20,15,11,4,20,5,6,,,,,,
"Jan 25, 2022 9:00 PM",57,19,38,7,7,0,9,4,5,13,9,4,3,1,2,3,10,8,2,0,0,0,8,10,6,5,1,13,0,1,,,,,,
"Jan 25, 2022 10:00 PM",39,17,22,4,3,1,8,6,2,3,2,1,3,1,2,6,6,5,1,0,0,0,6,11,2,2,0,2,1,0,,,,,,
"Jan 25, 2022 11:00 PM",11,2,9,0,0,0,6,1,5,6,2,4,0,0,0,2,2,2,0,0,0,0,2,3,1,0,1,6,0,0,,,,,,
"Jan 26, 2022 12:00 AM",9,1,8,0,0,0,0,0,0,0,0,0,0,0,0,0,1,0,1,0,0,0,0,2,1,1,0,1,0,0,,,,,,
"Jan 26, 2022 1:00 AM",7,3,4,0,0,0,1,1,0,1,1,0,0,0,0,1,2,0,2,0,0,0,0,2,2,2,0,1,1,0,,,,,,
"Jan 26, 2022 2:00 AM",4,2,2,0,0,0,0,0,0,0,0,0,0,0,0,0,0,0,0,0,0,0,0,1,0,0,0,0,0,0,,,,,,
"Jan 26, 2022 3:00 AM",1,0,1,0,0,0,0,0,0,0,0,0,2,0,2,0,0,0,0,0,0,0,0,1,0,0,0,0,0,0,,,,,,
"Jan 26, 2022 4:00 AM",2,1,1,0,0,0,0,0,0,0,0,0,0,0,0,1,0,0,0,0,0,0,0,0,0,0,0,0,0,0,,,,,,
"Jan 26, 2022 5:00 AM",4,1,3,2,0,2,2,0,2,3,0,3,0,0,0,1,8,8,0,0,0,0,7,1,0,0,0,9,0,0,,,,,,
"Jan 26, 2022 6:00 AM",38,27,11,19,6,13,25,8,17,18,6,12,0,0,0,4,21,21,0,0,0,0,21,11,6,3,3,25,0,2,,,,,,
"Jan 26, 2022 7:00 AM",104,76,28,38,11,27,52,13,39,44,14,30,8,8,0,16,68,68,0,0,0,0,64,28,19,5,14,80,1,4,,,,,,
"Jan 26, 2022 8:00 AM",199,145,54,96,34,62,146,58,88,114,42,72,42,27,15,28,145,142,3,0,0,0,138,51,59,16,43,150,11,4,,,,,,
"Jan 26, 2022 9:00 AM",118,87,31,68,25,43,94,47,47,77,45,32,10,7,3,12,77,76,1,0,0,0,70,25,35,22,13,59,1,4,,,,,,
"Jan 26, 2022 10:00 AM",88,72,16,65,32,33,68,40,28,58,39,19,10,5,5,14,42,42,0,0,0,0,27,18,29,21,8,26,4,2,,,,,,
"Jan 26, 2022 11:00 AM",57,40,17,76,42,34,58,30,28,62,33,29,10,2,8,9,37,35,2,0,0,0,28,18,28,24,4,33,1,3,,,,,,
"Jan 26, 2022 12:00 PM",88,49,39,100,41,59,81,30,51,83,32,51,16,9,7,10,40,36,4,0,0,0,29,18,24,9,15,29,2,2,,,,,,
"Jan 26, 2022 1:00 PM",117,49,68,71,44,27,93,52,41,81,45,36,21,12,9,21,31,29,2,0,0,0,29,35,38,25,13,31,7,7,,,,,,
"Jan 26, 2022 2:00 PM",85,39,46,58,31,27,74,50,24,54,37,17,26,14,12,28,39,32,7,0,0,0,31,27,29,22,7,32,0,3,,,,,,
"Jan 26, 2022 3:00 PM",103,41,62,47,28,19,59,35,24,45,27,18,23,14,9,25,30,24,6,0,0,0,19,41,34,25,9,28,4,1,,,,,,
"Jan 26, 2022 4:00 PM",133,40,93,54,27,27,69,37,32,44,19,25,25,8,17,23,35,28,7,0,0,0,23,41,31,17,14,42,7,2,,,,,,
"Jan 26, 2022 5:00 PM",205,40,165,65,46,19,84,57,27,73,43,30,20,8,12,23,31,22,9,0,0,0,21,83,41,34,7,53,4,4,,,,,,
"Jan 26, 2022 6:00 PM",160,36,124,37,29,8,77,54,23,48,29,19,11,4,7,16,41,31,10,0,0,0,36,57,43,37,6,47,5,5,,,,,,
"Jan 26, 2022 7:00 PM",96,24,72,32,25,7,55,38,17,50,36,14,10,4,6,12,15,10,5,0,0,0,13,39,19,13,6,25,6,2,,,,,,
"Jan 26, 2022 8:00 PM",70,22,48,16,8,8,23,13,10,22,12,10,1,0,1,6,13,11,2,0,0,0,9,19,8,7,1,17,3,3,,,,,,
"Jan 26, 2022 9:00 PM",41,13,28,7,4,3,14,7,7,8,4,4,2,0,2,9,12,9,3,0,0,0,8,8,9,6,3,13,4,0,,,,,,
"Jan 26, 2022 10:00 PM",22,7,15,3,2,1,9,3,6,6,2,4,5,3,2,5,2,2,0,0,0,0,3,11,2,1,1,4,2,0,,,,,,
"Jan 26, 2022 11:00 PM",10,2,8,1,1,0,2,2,0,2,1,1,1,1,0,3,2,2,0,0,0,0,2,2,1,1,0,6,0,0,,,,,,
"Jan 27, 2022 12:00 AM",7,2,5,1,1,0,1,1,0,1,1,0,1,0,1,1,1,0,1,0,0,0,0,,0,0,0,3,0,2,,,,,,
"Jan 27, 2022 1:00 AM",2,0,2,0,0,0,2,2,0,0,0,0,0,0,0,0,0,0,0,0,0,0,0,,1,1,0,1,0,0,,,,,,
"Jan 27, 2022 2:00 AM",6,1,5,0,0,0,1,1,0,1,1,0,0,0,0,0,0,0,0,0,0,0,0,,0,0,0,0,0,0,,,,,,
"Jan 27, 2022 3:00 AM",0,0,0,0,0,0,0,0,0,0,0,0,0,0,0,0,0,0,0,0,0,0,0,,0,0,0,1,0,0,,,,,,
"Jan 27, 2022 4:00 AM",1,1,0,0,0,0,0,0,0,0,0,0,0,0,0,2,0,0,0,0,0,0,0,,0,0,0,1,0,0,,,,,,
"Jan 27, 2022 5:00 AM",3,2,1,1,0,1,2,0,2,1,0,1,0,0,0,1,11,11,0,0,0,0,11,,1,1,0,8,1,0,,,,,,
"Jan 27, 2022 6:00 AM",41,32,9,11,2,9,17,6,11,12,6,6,3,1,2,6,19,18,1,0,0,0,18,,5,2,3,21,0,5,,,,,,
"Jan 27, 2022 7:00 AM",91,67,24,42,17,25,59,22,37,49,18,31,6,5,1,13,59,59,0,0,0,0,59,,23,13,10,80,1,2,,,,,,
"Jan 27, 2022 8:00 AM",209,147,62,91,30,61,140,46,94,111,44,67,27,18,9,17,125,123,2,0,0,0,108,,86,20,66,139,7,2,,,,,,
"Jan 27, 2022 9:00 AM",112,90,22,44,10,34,73,36,37,58,28,30,16,9,7,8,71,68,3,0,0,0,65,,29,21,8,59,2,2,,,,,,
"Jan 27, 2022 10:00 AM",74,54,20,53,26,27,71,33,38,52,30,22,5,1,4,14,42,42,0,0,0,0,23,,28,14,14,32,1,1,,,,,,
"Jan 27, 2022 11:00 AM",69,42,27,49,31,18,45,25,20,38,24,14,11,5,6,11,35,33,2,0,0,0,30,,12,7,5,21,1,4,,,,,,
"Jan 27, 2022 12:00 PM",71,37,34,52,32,20,69,34,35,51,26,25,13,7,6,13,36,33,3,0,0,0,29,,23,13,10,28,7,0,,,,,,
"Jan 27, 2022 1:00 PM",95,45,50,75,40,35,73,35,38,54,29,25,10,6,4,10,30,26,4,0,0,0,25,,25,20,5,24,3,2,,,,,,
"Jan 27, 2022 2:00 PM",88,31,57,59,28,31,66,41,25,51,29,22,9,5,4,15,32,27,5,0,0,0,24,,28,19,9,19,2,7,,,,,,
"Jan 27, 2022 3:00 PM",112,45,67,43,24,19,57,38,19,47,31,16,13,10,3,20,27,21,6,0,0,0,13,,30,19,11,25,6,4,,,,,,
"Jan 27, 2022 4:00 PM",158,52,106,62,42,20,90,55,35,71,43,28,18,7,11,30,32,26,6,0,0,0,27,,33,26,7,50,9,6,,,,,,
"Jan 27, 2022 5:00 PM",177,45,132,61,40,21,94,54,40,74,37,37,25,7,18,15,27,23,4,0,0,0,23,,49,38,11,61,5,2,,,,,,
"Jan 27, 2022 6:00 PM",124,29,95,42,34,8,76,55,21,63,47,16,16,3,13,16,38,31,7,0,0,0,32,,42,30,12,46,3,2,,,,,,
"Jan 27, 2022 7:00 PM",106,30,76,42,20,22,49,35,14,41,23,18,7,4,3,7,20,17,3,0,0,0,18,,24,16,8,30,3,1,,,,,,
"Jan 27, 2022 8:00 PM",87,28,59,23,12,11,31,16,15,25,12,13,4,1,3,6,15,13,2,0,0,0,14,,7,3,4,14,3,0,,,,,,
"Jan 27, 2022 9:00 PM",34,12,22,21,13,8,23,12,11,20,10,10,5,3,2,7,10,9,1,0,0,0,7,,10,6,4,9,4,2,,,,,,
"Jan 27, 2022 10:00 PM",32,12,20,13,7,6,18,5,13,14,4,10,3,0,3,6,6,5,1,0,0,0,5,,6,4,2,13,2,2,,,,,,
"Jan 27, 2022 11:00 PM",16,5,11,3,2,1,3,2,1,4,2,2,1,0,1,3,2,1,1,0,0,0,1,,0,0,0,1,0,0,,,,,,
"Jan 28, 2022 12:00 AM",8,1,7,1,0,1,0,0,0,2,0,2,0,0,0,0,3,1,2,0,0,0,1,,2,1,1,1,1,0,,,,,,
"Jan 28, 2022 1:00 AM",3,1,2,0,0,0,2,0,2,1,0,1,0,0,0,1,0,0,0,0,0,0,0,,1,1,0,0,0,1,,,,,,
"Jan 28, 2022 2:00 AM",4,1,3,1,1,0,2,2,0,0,0,0,0,0,0,0,2,2,0,0,0,0,2,0,1,1,0,1,0,1,,,,,,
"Jan 28, 2022 3:00 AM",3,2,1,0,0,0,1,0,1,2,1,1,0,0,0,0,0,0,0,0,0,0,0,2,0,0,0,2,0,0,,,,,,
"Jan 28, 2022 4:00 AM",3,1,2,0,0,0,1,1,0,0,0,0,0,0,0,0,0,0,0,0,0,0,0,1,0,0,0,2,0,1,,,,,,
"Jan 28, 2022 5:00 AM",9,8,1,1,0,1,2,1,1,5,2,3,0,0,0,4,5,5,0,0,0,0,5,2,3,3,0,8,2,0,,,,,,
"Jan 28, 2022 6:00 AM",31,17,14,15,5,10,22,9,13,16,8,8,2,2,0,3,18,18,0,0,0,0,19,8,6,4,2,27,0,2,,,,,,
"Jan 28, 2022 7:00 AM",76,46,30,59,23,36,59,24,35,58,21,37,7,7,0,9,39,39,0,0,0,0,40,30,16,10,6,62,1,4,,,,,,
"Jan 28, 2022 8:00 AM",183,129,54,78,21,57,120,48,72,100,42,58,22,15,7,13,108,106,2,0,0,0,101,45,60,14,46,111,7,1,,,,,,
"Jan 28, 2022 9:00 AM",115,80,35,61,28,33,103,56,47,73,45,28,15,12,3,6,54,53,1,0,0,0,43,23,36,23,13,59,0,5,,,,,,
"Jan 28, 2022 10:00 AM",65,41,24,67,28,39,91,43,48,42,19,23,10,4,6,8,45,44,1,0,0,0,39,23,29,12,17,36,0,2,,,,,,
"Jan 28, 2022 11:00 AM",58,31,27,51,26,25,56,30,26,48,30,18,14,6,8,10,27,23,4,0,0,0,17,11,25,13,12,18,8,4,,,,,,
"Jan 28, 2022 12:00 PM",71,36,35,75,40,35,64,29,35,62,29,33,16,10,6,8,31,30,1,0,0,0,21,15,16,10,6,33,1,2,,,,,,
"Jan 28, 2022 1:00 PM",98,35,63,59,31,28,77,37,40,60,31,29,22,6,16,14,30,23,7,0,0,0,19,27,28,16,12,38,11,2,,,,,,
"Jan 28, 2022 2:00 PM",71,35,36,61,35,26,72,47,25,57,36,21,22,16,6,12,31,23,8,0,0,0,18,30,27,17,10,24,1,8,,,,,,
"Jan 28, 2022 3:00 PM",94,37,57,55,24,31,63,35,28,56,29,27,30,12,18,17,21,18,3,0,0,0,14,33,35,20,15,34,3,4,,,,,,
"Jan 28, 2022 4:00 PM",94,35,59,56,35,21,78,43,35,67,34,33,13,6,7,20,30,27,3,0,0,0,25,48,38,24,14,37,2,2,,,,,,
"Jan 28, 2022 5:00 PM",147,51,96,44,27,17,64,41,23,59,36,23,14,4,10,18,26,25,1,0,0,0,24,57,35,24,11,44,2,1,,,,,,
"Jan 28, 2022 6:00 PM",107,26,81,26,21,5,63,53,10,41,28,13,9,1,8,15,31,26,5,0,0,0,29,52,33,30,3,29,3,3,,,,,,
"Jan 28, 2022 7:00 PM",67,23,44,23,19,4,39,30,9,30,18,12,4,2,2,5,14,14,0,0,0,0,13,31,15,13,2,22,5,0,,,,,,
"Jan 28, 2022 8:00 PM",49,15,34,6,6,0,21,14,7,22,17,5,4,1,3,9,17,14,3,0,0,0,13,11,5,4,1,12,1,0,,,,,,
"Jan 28, 2022 9:00 PM",29,10,19,8,7,1,13,6,7,10,4,6,5,3,2,7,6,6,0,0,0,0,7,8,4,3,1,9,2,2,,,,,,
"Jan 28, 2022 10:00 PM",28,9,19,10,5,5,16,5,11,17,6,11,2,0,2,2,6,4,2,0,0,0,4,4,5,5,0,10,0,0,,,,,,
"Jan 28, 2022 11:00 PM",10,4,6,8,5,3,12,5,7,11,5,6,3,2,1,0,5,4,1,0,0,0,3,4,3,2,1,7,0,2,,,,,,
"Jan 29, 2022 12:00 AM",6,1,5,0,0,0,0,0,0,3,1,2,2,1,1,3,0,0,0,0,0,0,0,7,4,1,3,2,0,0,,,,,,
"Jan 29, 2022 1:00 AM",14,7,7,1,1,0,2,2,0,3,3,0,2,1,1,1,1,0,1,0,0,0,0,5,1,1,0,2,1,0,,,,,,
"Jan 29, 2022 2:00 AM",9,3,6,0,0,0,2,2,0,2,2,0,0,0,0,1,0,0,0,0,0,0,0,1,1,1,0,0,0,0,,,,,,
"Jan 29, 2022 3:00 AM",2,0,2,1,0,1,1,0,1,1,0,1,0,0,0,0,0,0,0,0,0,0,0,2,0,0,0,0,0,0,,,,,,
"Jan 29, 2022 4:00 AM",5,0,5,0,0,0,0,0,0,0,0,0,0,0,0,2,0,0,0,0,0,0,0,2,1,0,1,1,0,0,,,,,,
"Jan 29, 2022 5:00 AM",1,0,1,0,0,0,0,0,0,0,0,0,0,0,0,1,1,1,0,0,0,0,1,3,0,0,0,2,1,0,,,,,,
"Jan 29, 2022 6:00 AM",10,5,5,3,1,2,5,1,4,4,1,3,0,0,0,0,1,1,0,0,0,0,1,1,1,1,0,11,0,0,,,,,,
"Jan 29, 2022 7:00 AM",12,9,3,9,5,4,10,7,3,9,6,3,2,1,1,4,7,7,0,0,0,0,7,4,4,4,0,12,1,2,,,,,,
"Jan 29, 2022 8:00 AM",29,13,16,35,26,9,48,39,9,36,30,6,6,2,4,2,11,10,1,0,0,0,8,12,7,6,1,18,1,4,,,,,,
"Jan 29, 2022 9:00 AM",33,19,14,39,22,17,34,15,19,34,21,13,10,8,2,3,11,11,0,0,0,0,12,9,10,6,4,30,1,10,,,,,,
"Jan 29, 2022 10:00 AM",54,23,31,44,23,21,48,26,22,41,27,14,12,6,6,4,14,14,0,0,0,0,12,26,13,10,3,26,0,4,,,,,,
"Jan 29, 2022 11:00 AM",45,25,20,86,48,38,99,60,39,95,56,39,17,10,7,8,21,18,3,0,0,0,15,28,44,35,9,26,8,6,,,,,,
"Jan 29, 2022 12:00 PM",67,31,36,82,48,34,118,61,57,77,40,37,18,11,7,18,17,16,1,0,0,0,15,27,30,19,11,30,11,3,,,,,,
"Jan 29, 2022 1:00 PM",57,29,28,97,56,41,95,52,43,81,51,30,22,8,14,19,26,21,5,0,0,0,19,35,35,26,9,35,14,3,,,,,,
"Jan 29, 2022 2:00 PM",66,44,22,77,33,44,101,48,53,101,52,49,21,11,10,12,20,18,2,0,0,0,16,30,33,22,11,29,5,4,,,,,,
"Jan 29, 2022 3:00 PM",55,28,27,77,42,35,99,42,57,73,38,35,19,10,9,14,18,16,2,0,0,0,18,17,37,18,19,26,5,5,,,,,,
"Jan 29, 2022 4:00 PM",45,21,24,72,37,35,67,32,35,62,27,35,20,13,7,20,26,23,3,0,0,0,23,23,33,20,13,22,5,4,,,,,,
"Jan 29, 2022 5:00 PM",39,15,24,34,14,20,30,9,21,26,8,18,19,9,10,20,13,13,0,0,0,0,13,14,19,9,10,16,1,1,,,,,,
"Jan 29, 2022 6:00 PM",41,18,23,11,8,3,23,15,8,14,7,7,10,3,7,13,7,6,1,0,0,0,7,11,12,4,8,22,3,0,,,,,,
"Jan 29, 2022 7:00 PM",36,18,18,13,8,5,11,4,7,10,7,3,10,4,6,9,6,6,0,0,0,0,7,18,0,0,0,16,3,0,,,,,,
"Jan 29, 2022 8:00 PM",27,13,14,9,4,5,15,9,6,12,5,7,3,1,2,2,7,6,1,0,0,0,5,12,2,2,0,6,0,2,,,,,,
"Jan 29, 2022 9:00 PM",21,10,11,6,4,2,15,8,7,8,3,5,0,0,0,1,2,2,0,0,0,0,3,6,2,1,1,11,2,2,,,,,,
"Jan 29, 2022 10:00 PM",10,3,7,7,5,2,6,2,4,13,5,8,1,1,0,3,4,4,0,0,0,0,4,7,3,1,2,8,0,1,,,,,,
"Jan 29, 2022 11:00 PM",9,4,5,6,1,5,3,1,2,5,1,4,3,1,2,0,2,2,0,0,0,0,2,5,0,0,0,3,0,2,,,,,,
"Jan 30, 2022 12:00 AM",5,2,3,0,0,0,4,0,4,5,1,4,0,0,0,0,1,1,0,0,0,0,1,3,4,1,3,5,0,2,,,,,,
"Jan 30, 2022 1:00 AM",5,1,4,1,1,0,4,2,2,2,1,1,2,2,0,0,1,0,1,0,0,0,0,4,2,0,2,0,0,0,,,,,,
"Jan 30, 2022 2:00 AM",4,3,1,0,0,0,3,1,2,2,1,1,0,0,0,0,2,1,1,0,0,0,1,2,1,1,0,0,0,0,,,,,,
"Jan 30, 2022 3:00 AM",1,0,1,0,0,0,0,0,0,1,1,0,0,0,0,0,0,0,0,0,0,0,0,2,2,1,1,2,0,2,,,,,,
"Jan 30, 2022 4:00 AM",2,0,2,1,1,0,1,1,0,1,1,0,1,0,1,0,1,0,1,0,0,0,0,2,0,0,0,0,0,0,,,,,,
"Jan 30, 2022 5:00 AM",1,0,1,1,0,1,1,0,1,1,0,1,0,0,0,0,0,0,0,0,0,0,0,0,1,1,0,2,0,0,,,,,,
"Jan 30, 2022 6:00 AM",9,5,4,2,1,1,5,3,2,3,2,1,0,0,0,2,0,0,0,0,0,0,0,4,0,0,0,3,0,0,,,,,,
"Jan 30, 2022 7:00 AM",8,7,1,10,5,5,8,6,2,9,6,3,2,0,2,3,7,7,0,0,0,0,4,8,1,1,0,8,0,0,,,,,,
"Jan 30, 2022 8:00 AM",45,23,22,40,27,13,56,40,16,37,30,7,1,1,0,9,14,13,1,0,0,0,14,27,23,17,6,16,2,7,,,,,,
"Jan 30, 2022 9:00 AM",45,13,32,127,82,45,140,101,39,113,73,40,8,4,4,15,22,22,0,0,0,0,21,36,50,26,24,35,5,19,,,,,,
"Jan 30, 2022 10:00 AM",29,14,15,148,89,59,189,106,83,133,83,50,13,9,4,13,22,21,1,0,0,0,20,34,70,44,26,53,7,12,,,,,,
"Jan 30, 2022 11:00 AM",68,42,26,179,63,116,207,103,104,192,91,101,32,25,7,19,21,19,2,0,0,0,21,46,55,31,24,68,12,8,,,,,,
"Jan 30, 2022 12:00 PM",67,40,27,160,66,94,190,82,108,144,62,82,29,21,8,25,22,21,1,0,0,0,18,35,60,29,31,49,5,6,,,,,,
"Jan 30, 2022 1:00 PM",69,33,36,145,71,74,144,70,74,128,66,62,22,10,12,25,31,30,1,0,0,0,28,31,76,39,37,42,4,6,,,,,,
"Jan 30, 2022 2:00 PM",58,32,26,124,59,65,115,54,61,112,52,60,13,3,10,25,29,29,0,0,0,0,23,30,48,25,23,41,11,4,,,,,,
"Jan 30, 2022 3:00 PM",54,26,28,128,54,74,122,52,70,106,54,52,30,13,17,9,19,16,3,0,0,0,17,18,54,18,36,26,6,2,,,,,,
"Jan 30, 2022 4:00 PM",58,33,25,55,30,25,64,25,39,57,21,36,15,8,7,6,9,7,2,0,0,0,7,18,26,8,18,21,0,4,,,,,,
"Jan 30, 2022 5:00 PM",32,13,19,15,7,8,24,13,11,18,8,10,8,4,4,4,5,5,0,0,0,0,5,16,7,6,1,15,0,3,,,,,,
"Jan 30, 2022 6:00 PM",25,8,17,12,7,5,20,5,15,14,3,11,14,8,6,4,7,7,0,0,0,0,5,13,5,2,3,9,1,1,,,,,,
"Jan 30, 2022 7:00 PM",31,14,17,5,3,2,10,4,6,12,4,8,5,1,4,9,8,7,1,0,0,0,7,4,3,3,0,8,2,1,,,,,,
"Jan 30, 2022 8:00 PM",21,8,13,4,3,1,6,3,3,3,1,2,2,0,2,2,5,3,2,0,0,0,3,8,0,0,0,10,0,0,,,,,,
"Jan 30, 2022 9:00 PM",12,5,7,1,0,1,5,2,3,3,2,1,0,0,0,2,4,3,1,0,0,0,3,1,1,1,0,3,0,0,,,,,,
"Jan 30, 2022 10:00 PM",6,2,4,1,0,1,3,3,0,1,0,1,1,0,1,0,1,1,0,0,0,0,2,6,0,0,0,5,1,1,,,,,,
"Jan 30, 2022 11:00 PM",7,2,5,0,0,0,2,0,2,3,0,3,3,0,3,2,1,1,0,0,0,0,1,4,0,0,0,1,0,0,,,,,,
"Jan 31, 2022 12:00 AM",6,0,6,0,0,0,0,0,0,1,1,0,0,0,0,1,0,0,0,0,0,0,0,1,1,0,1,0,0,0,,,,,,
"Jan 31, 2022 1:00 AM",5,1,4,0,0,0,1,1,0,0,0,0,0,0,0,0,0,0,0,0,0,0,0,0,1,1,0,2,0,0,,,,,,
"Jan 31, 2022 2:00 AM",1,0,1,0,0,0,0,0,0,0,0,0,0,0,0,0,0,0,0,0,0,0,0,0,0,0,0,1,0,0,,,,,,
"Jan 31, 2022 3:00 AM",0,0,0,1,0,1,0,0,0,0,0,0,0,0,0,0,0,0,0,0,0,0,0,0,0,0,0,0,0,0,,,,,,
"Jan 31, 2022 4:00 AM",1,0,1,0,0,0,0,0,0,0,0,0,0,0,0,1,2,2,0,0,0,0,2,2,0,0,0,2,0,0,,,,,,
"Jan 31, 2022 5:00 AM",5,3,2,1,0,1,4,2,2,5,3,2,2,0,2,1,2,2,0,0,0,0,3,0,1,1,0,10,0,0,,,,,,
"Jan 31, 2022 6:00 AM",34,24,10,8,3,5,12,3,9,9,5,4,2,1,1,6,23,23,0,0,0,0,23,11,7,3,4,33,0,4,,,,,,
"Jan 31, 2022 7:00 AM",98,74,24,42,14,28,60,21,39,45,21,24,6,6,0,10,60,60,0,0,0,0,59,28,14,8,6,69,2,3,,,,,,
"Jan 31, 2022 8:00 AM",184,137,47,72,14,58,123,32,91,88,28,60,32,20,12,24,122,120,2,0,0,0,119,42,62,21,41,167,9,3,,,,,,
"Jan 31, 2022 9:00 AM",131,114,17,54,23,31,70,32,38,50,26,24,8,7,1,9,68,68,0,0,0,0,62,29,31,16,15,47,2,2,,,,,,
"Jan 31, 2022 10:00 AM",63,39,24,43,21,22,70,37,33,44,28,16,13,8,5,11,41,40,1,0,0,0,30,9,24,16,8,29,1,4,,,,,,
"Jan 31, 2022 11:00 AM",54,35,19,39,18,21,63,36,27,44,21,23,10,8,2,8,34,29,5,0,0,0,24,14,36,18,18,25,3,2,,,,,,
"Jan 31, 2022 12:00 PM",58,34,24,48,26,22,59,28,31,53,32,21,26,11,15,17,32,30,2,0,0,0,24,20,24,11,13,17,4,2,,,,,,
"Jan 31, 2022 1:00 PM",82,42,40,41,25,16,77,40,37,49,22,27,5,1,4,9,31,23,8,0,0,0,24,20,21,13,8,31,4,4,,,,,,
"Jan 31, 2022 2:00 PM",47,23,24,43,21,22,51,23,28,50,29,21,13,8,5,17,27,22,5,0,0,0,20,22,17,6,11,20,4,1,,,,,,
"Jan 31, 2022 3:00 PM",82,33,49,54,35,19,57,30,27,46,25,21,19,13,6,8,25,16,9,0,0,0,13,36,28,14,14,28,4,2,,,,,,
"Jan 31, 2022 4:00 PM",114,41,73,50,33,17,61,37,24,52,31,21,19,5,14,11,29,27,2,0,0,0,24,45,35,26,9,42,1,3,,,,,,
"Jan 31, 2022 5:00 PM",162,38,124,50,32,18,77,53,24,64,39,25,22,4,18,12,26,22,4,0,0,0,22,82,45,35,10,54,8,4,,,,,,
"Jan 31, 2022 6:00 PM",153,41,112,36,32,4,78,55,23,49,35,14,9,1,8,12,28,22,6,0,0,0,25,61,37,29,8,31,0,3,,,,,,
"Jan 31, 2022 7:00 PM",80,27,53,21,17,4,39,31,8,22,19,3,2,1,1,11,23,17,6,0,0,0,16,27,13,10,3,12,3,3,,,,,,
"Jan 31, 2022 8:00 PM",52,12,40,19,12,7,23,14,9,18,10,8,1,1,0,8,18,15,3,0,0,0,14,19,12,10,2,20,4,0,,,,,,
"Jan 31, 2022 9:00 PM",44,11,33,8,6,2,22,7,15,18,6,12,1,1,0,2,14,13,1,0,0,0,14,9,5,4,1,15,3,1,,,,,,
"Jan 31, 2022 10:00 PM",25,7,18,4,4,0,9,5,4,6,3,3,3,1,2,4,3,1,2,0,0,0,1,6,3,2,1,6,1,0,,,,,,
"Jan 31, 2022 11:00 PM",6,1,5,1,0,1,5,4,1,2,1,1,1,1,0,0,3,2,1,0,0,0,3,5,1,0,1,4,0,0,,,,,,
"Feb 1, 2022 12:00 AM",5,1,4,0,0,0,0,0,0,0,0,0,0,0,0,1,1,0,1,0,0,0,1,3,0,0,0,0,0,0,,,,,,
"Feb 1, 2022 1:00 AM",5,3,2,0,0,0,0,0,0,0,0,0,0,0,0,0,1,0,1,0,0,0,1,1,0,0,0,0,0,0,,,,,,
"Feb 1, 2022 2:00 AM",4,3,1,0,0,0,0,0,0,0,0,0,0,0,0,0,0,0,0,0,0,0,0,2,0,0,0,0,0,0,,,,,,
"Feb 1, 2022 3:00 AM",1,0,1,1,0,1,1,0,1,1,0,1,0,0,0,0,0,0,0,0,0,0,0,0,0,0,0,1,0,0,,,,,,
"Feb 1, 2022 4:00 AM",1,0,1,0,0,0,0,0,0,0,0,0,0,0,0,1,2,2,0,0,0,0,2,0,0,0,0,1,0,1,,,,,,
"Feb 1, 2022 5:00 AM",3,1,2,0,0,0,2,1,1,2,1,1,0,0,0,3,7,7,0,0,0,0,7,2,2,2,0,8,0,0,,,,,,
"Feb 1, 2022 6:00 AM",33,19,14,12,4,8,15,6,9,13,7,6,4,3,1,8,14,14,0,0,0,0,15,14,4,3,1,30,0,1,,,,,,
"Feb 1, 2022 7:00 AM",95,65,30,44,15,29,57,17,40,48,19,29,9,9,0,6,64,64,0,0,0,0,67,23,21,10,11,70,2,3,,,,,,
"Feb 1, 2022 8:00 AM",184,139,45,72,16,56,135,43,92,95,33,62,20,15,5,28,139,137,2,0,0,0,135,39,60,15,45,159,6,6,,,,,,
"Feb 1, 2022 9:00 AM",116,100,16,39,11,28,62,26,36,46,22,24,8,6,2,4,60,58,2,0,0,0,51,22,39,18,21,56,3,4,,,,,,
"Feb 1, 2022 10:00 AM",59,47,12,27,13,14,33,19,14,30,16,14,5,3,2,4,38,36,2,0,0,0,22,16,9,5,4,17,0,1,,,,,,
"Feb 1, 2022 11:00 AM",36,22,14,26,13,13,24,16,8,23,13,10,8,6,2,4,23,20,3,0,0,0,12,9,12,10,2,21,1,2,,,,,,
"Feb 1, 2022 12:00 PM",53,29,24,24,14,10,36,20,16,20,12,8,8,5,3,5,20,19,1,0,0,0,17,17,14,8,6,19,5,2,,,,,,
"Feb 1, 2022 1:00 PM",80,45,35,34,20,14,42,23,19,32,17,15,11,2,9,8,31,28,3,0,0,0,23,21,20,12,8,25,4,1,,,,,,
"Feb 1, 2022 2:00 PM",53,19,34,18,10,8,33,21,12,31,20,11,8,5,3,14,25,23,2,0,0,0,18,24,15,9,6,19,5,0,,,,,,
"Feb 1, 2022 3:00 PM",85,32,53,17,9,8,40,18,22,27,10,17,14,6,8,14,30,25,5,0,0,0,24,18,20,13,7,21,1,2,,,,,,
"Feb 1, 2022 4:00 PM",114,33,81,33,26,7,50,36,14,41,30,11,10,4,6,14,28,25,3,0,0,0,25,40,26,24,2,34,2,3,,,,,,
"Feb 1, 2022 5:00 PM",188,39,149,49,33,16,82,46,36,54,29,25,11,2,9,11,41,35,6,0,0,0,33,76,30,20,10,50,7,2,,,,,,
"Feb 1, 2022 6:00 PM",150,35,115,56,39,17,80,63,17,66,42,24,17,3,14,24,39,29,10,0,0,0,29,74,41,36,5,37,6,2,,,,,,
"Feb 1, 2022 7:00 PM",92,23,69,31,27,4,52,37,15,39,29,10,11,4,7,10,20,18,2,0,0,0,18,36,16,11,5,15,1,2,,,,,,
"Feb 1, 2022 8:00 PM",69,23,46,12,10,2,25,16,9,19,12,7,2,2,0,10,16,15,1,0,0,0,14,14,8,7,1,14,3,2,,,,,,
"Feb 1, 2022 9:00 PM",39,12,27,4,3,1,15,7,8,10,5,5,0,0,0,4,13,13,0,0,0,0,13,9,6,4,2,10,0,1,,,,,,
"Feb 1, 2022 10:00 PM",25,9,16,1,1,0,7,0,7,4,1,3,1,0,1,3,4,2,2,0,0,0,2,9,4,3,1,5,2,2,,,,,,
"Feb 1, 2022 11:00 PM",11,4,7,2,2,0,3,3,0,4,2,2,0,0,0,0,3,3,0,0,0,0,3,4,1,1,0,2,0,0,,,,,,
"Feb 2, 2022 12:00 AM",4,0,4,0,0,0,1,1,0,0,0,0,0,0,0,2,1,1,0,0,0,0,1,1,1,1,0,0,0,0,,,,,,
"Feb 2, 2022 1:00 AM",2,1,1,1,1,0,1,1,0,2,2,0,0,0,0,0,1,0,1,0,0,0,0,1,1,1,0,0,1,0,,,,,,
"Feb 2, 2022 2:00 AM",5,4,1,0,0,0,0,0,0,0,0,0,0,0,0,0,0,0,0,0,0,0,0,0,1,1,0,0,0,0,,,,,,
"Feb 2, 2022 3:00 AM",1,0,1,0,0,0,1,1,0,1,1,0,1,0,1,0,0,0,0,0,0,0,0,3,0,0,0,4,0,0,,,,,,
"Feb 2, 2022 4:00 AM",1,0,1,1,0,1,1,0,1,1,0,1,0,0,0,1,0,0,0,0,0,0,0,1,0,0,0,0,0,0,,,,,,
"Feb 2, 2022 5:00 AM",6,5,1,1,1,0,3,2,1,3,2,1,0,0,0,1,9,9,0,0,0,0,9,2,0,0,0,10,0,0,,,,,,
"Feb 2, 2022 6:00 AM",33,21,12,9,3,6,17,4,13,8,1,7,3,3,0,4,20,19,1,0,0,0,23,15,3,2,1,37,0,4,,,,,,
"Feb 2, 2022 7:00 AM",93,68,25,61,20,41,74,22,52,52,18,34,11,11,0,15,70,68,2,0,0,0,72,33,24,9,15,76,2,5,,,,,,
"Feb 2, 2022 8:00 AM",218,164,54,100,28,72,135,45,90,126,47,79,34,16,18,12,137,134,3,0,0,0,129,50,68,21,47,165,9,7,,,,,,
"Feb 2, 2022 9:00 AM",130,99,31,64,31,33,74,39,35,70,34,36,8,4,4,9,62,62,0,0,0,0,54,26,39,20,19,64,1,2,,,,,,
"Feb 2, 2022 10:00 AM",67,49,18,41,16,25,54,30,24,48,26,22,11,10,1,10,45,45,0,0,0,0,30,19,17,11,6,36,3,0,,,,,,
"Feb 2, 2022 11:00 AM",43,22,21,51,23,28,69,38,31,46,25,21,9,5,4,17,32,29,3,0,0,0,22,16,25,14,11,26,2,6,,,,,,
"Feb 2, 2022 12:00 PM",62,32,30,67,37,30,66,29,37,56,35,21,14,4,10,7,39,38,1,0,0,0,32,20,27,14,13,26,10,4,,,,,,
"Feb 2, 2022 1:00 PM",84,40,44,73,46,27,115,73,42,77,47,30,28,11,17,16,40,32,8,0,0,0,25,43,37,23,14,27,3,4,,,,,,
"Feb 2, 2022 2:00 PM",78,25,53,45,33,12,74,52,22,58,43,15,15,10,5,16,24,21,3,0,0,0,18,29,25,17,8,28,0,3,,,,,,
"Feb 2, 2022 3:00 PM",91,32,59,46,26,20,60,36,24,44,18,26,12,5,7,15,30,25,5,0,0,0,18,31,33,24,9,37,4,1,,,,,,
"Feb 2, 2022 4:00 PM",141,37,104,49,24,25,63,31,32,54,28,26,22,5,17,20,35,29,6,0,0,0,29,41,31,18,13,41,4,4,,,,,,
"Feb 2, 2022 5:00 PM",207,60,147,38,26,12,87,50,37,59,35,24,18,9,9,17,39,27,12,0,0,0,30,72,44,32,12,61,5,2,,,,,,
"Feb 2, 2022 6:00 PM",148,39,109,51,36,15,78,62,16,57,40,17,10,4,6,13,40,34,6,0,0,0,31,70,39,37,2,33,5,1,,,,,,
"Feb 2, 2022 7:00 PM",83,23,60,38,26,12,41,32,9,39,30,9,6,3,3,14,17,12,5,0,0,0,13,40,17,15,2,27,4,2,,,,,,
"Feb 2, 2022 8:00 PM",68,24,44,16,11,5,30,16,14,22,11,11,3,1,2,12,16,13,3,0,0,0,13,22,13,9,4,23,3,3,,,,,,
"Feb 2, 2022 9:00 PM",53,14,39,5,3,2,13,9,4,10,7,3,3,2,1,5,14,9,5,0,0,0,10,12,8,7,1,11,4,0,,,,,,
"Feb 2, 2022 10:00 PM",32,8,24,9,9,0,9,6,3,10,6,4,3,0,3,5,5,2,3,0,0,0,1,10,3,3,0,4,1,0,,,,,,
"Feb 2, 2022 11:00 PM",11,2,9,3,1,2,2,0,2,2,1,1,2,0,2,2,1,1,0,0,0,0,1,5,0,0,0,5,0,1,,,,,,
"Feb 3, 2022 12:00 AM",0,0,0,0,0,0,0,0,0,0,0,0,0,0,0,2,2,1,1,0,0,0,1,4,1,1,0,1,0,0,,,,,,
"Feb 3, 2022 1:00 AM",4,1,3,0,0,0,2,1,1,0,0,0,0,0,0,0,0,0,0,0,0,0,1,0,1,1,0,1,0,0,,,,,,
"Feb 3, 2022 2:00 AM",3,3,0,0,0,0,0,0,0,1,0,1,0,0,0,0,0,0,0,0,0,0,0,0,0,0,0,0,0,0,,,,,,
"Feb 3, 2022 3:00 AM",3,0,3,0,0,0,2,1,1,1,1,0,0,0,0,0,0,0,0,0,0,0,0,3,0,0,0,2,0,0,,,,,,
"Feb 3, 2022 4:00 AM",1,0,1,0,0,0,0,0,0,0,0,0,1,0,1,1,0,0,0,0,0,0,0,0,0,0,0,0,0,0,,,,,,
"Feb 3, 2022 5:00 AM",5,4,1,1,0,1,6,1,5,5,1,4,0,0,0,0,7,7,0,0,0,0,8,2,0,0,0,12,0,0,,,,,,
"Feb 3, 2022 6:00 AM",32,25,7,20,6,14,21,9,12,23,11,12,3,3,0,4,21,19,2,0,0,0,20,11,7,4,3,35,0,4,,,,,,
"Feb 3, 2022 7:00 AM",85,65,20,36,14,22,72,25,47,48,19,29,5,5,0,15,59,58,1,0,0,0,62,34,27,10,17,73,3,8,,,,,,
"Feb 3, 2022 8:00 AM",198,142,56,91,26,65,118,37,81,108,43,65,42,25,17,30,127,125,2,0,0,0,123,40,59,13,46,155,5,8,,,,,,
"Feb 3, 2022 9:00 AM",116,93,23,45,15,30,85,46,39,71,37,34,11,7,4,14,71,71,0,0,0,0,67,21,36,24,12,40,5,4,,,,,,
"Feb 3, 2022 10:00 AM",76,57,19,55,22,33,65,34,31,48,25,23,17,12,5,10,46,45,1,0,0,0,34,18,27,15,12,35,0,3,,,,,,
"Feb 3, 2022 11:00 AM",66,46,20,45,22,23,47,24,23,37,20,17,14,10,4,11,39,34,5,0,0,0,27,17,17,8,9,31,2,1,,,,,,
"Feb 3, 2022 12:00 PM",82,43,39,61,32,29,60,32,28,53,25,28,8,5,3,10,25,23,2,0,0,0,24,26,30,17,13,23,2,2,,,,,,
"Feb 3, 2022 1:00 PM",91,38,53,60,40,20,55,28,27,45,31,14,22,12,10,17,30,26,4,0,0,0,23,26,25,21,4,25,4,1,,,,,,
"Feb 3, 2022 2:00 PM",85,35,50,41,26,15,55,32,23,47,26,21,11,5,6,24,32,23,9,0,0,0,17,26,18,12,6,29,4,6,,,,,,
"Feb 3, 2022 3:00 PM",94,35,59,35,17,18,53,36,17,34,25,9,14,8,6,12,25,20,5,0,0,0,18,29,17,11,6,33,3,1,,,,,,
"Feb 3, 2022 4:00 PM",126,36,90,49,34,15,75,49,26,53,31,22,19,5,14,19,34,26,8,0,0,0,28,44,36,29,7,41,2,4,,,,,,
"Feb 3, 2022 5:00 PM",170,46,124,52,35,17,81,48,33,76,42,34,21,3,18,22,37,32,5,0,0,0,30,82,44,28,16,41,3,1,,,,,,
"Feb 3, 2022 6:00 PM",142,36,106,53,36,17,90,62,28,65,43,22,3,1,2,12,32,26,6,0,0,0,28,83,38,32,6,37,6,1,,,,,,
"Feb 3, 2022 7:00 PM",94,30,64,28,21,7,48,33,15,45,30,15,9,3,6,9,22,21,1,0,0,0,20,36,18,14,4,25,2,0,,,,,,
"Feb 3, 2022 8:00 PM",62,21,41,11,5,6,26,15,11,18,8,10,3,2,1,13,12,9,3,0,0,0,7,24,8,5,3,17,2,3,,,,,,
"Feb 3, 2022 9:00 PM",30,5,25,3,3,0,11,8,3,6,6,0,1,1,0,2,5,3,2,0,0,0,3,8,4,3,1,12,0,0,,,,,,
"Feb 3, 2022 10:00 PM",24,9,15,1,1,0,13,3,10,3,1,2,0,0,0,4,3,1,2,0,0,0,1,7,1,1,0,9,2,2,,,,,,
"Feb 3, 2022 11:00 PM",13,7,6,4,0,4,3,2,1,6,0,6,1,1,0,1,2,1,1,0,0,0,0,5,5,3,2,3,0,0,,,,,,
"Feb 4, 2022 12:00 AM",6,2,4,0,0,0,0,0,0,1,1,0,0,0,0,0,2,1,1,0,0,0,1,5,1,1,0,0,1,0,,,,,,
"Feb 4, 2022 1:00 AM",3,2,1,0,0,0,0,0,0,0,0,0,0,0,0,0,0,0,0,0,0,0,0,0,0,0,0,0,0,0,,,,,,
"Feb 4, 2022 2:00 AM",4,3,1,0,0,0,0,0,0,0,0,0,0,0,0,0,2,1,1,0,0,0,1,1,0,0,0,2,0,0,,,,,,
"Feb 4, 2022 3:00 AM",0,0,0,0,0,0,0,0,0,0,0,0,0,0,0,0,0,0,0,0,0,0,0,1,1,1,0,2,0,0,,,,,,
"Feb 4, 2022 4:00 AM",4,1,3,0,0,0,3,3,0,1,1,0,1,0,1,1,1,1,0,0,0,0,1,2,0,0,0,0,0,2,,,,,,
"Feb 4, 2022 5:00 AM",9,4,5,1,1,0,2,1,1,1,1,0,0,0,0,1,7,7,0,0,0,0,7,0,1,1,0,9,1,1,,,,,,
"Feb 4, 2022 6:00 AM",31,19,12,12,1,11,11,3,8,8,1,7,2,1,1,4,21,21,0,0,0,0,21,12,2,1,1,28,0,4,,,,,,
"Feb 4, 2022 7:00 AM",71,50,21,44,21,23,55,18,37,44,17,27,9,9,0,6,49,49,0,0,0,0,47,26,23,10,13,62,4,3,,,,,,
"Feb 4, 2022 8:00 AM",167,133,34,76,19,57,99,34,65,92,43,49,24,13,11,25,93,90,3,0,0,0,91,32,48,19,29,113,10,6,,,,,,
"Feb 4, 2022 9:00 AM",93,75,18,52,26,26,67,37,30,52,32,20,8,7,1,5,48,46,2,0,0,0,41,26,29,16,13,52,0,3,,,,,,
"Feb 4, 2022 10:00 AM",83,49,34,48,26,22,46,31,15,37,21,16,3,2,1,5,32,32,0,0,0,0,30,16,16,12,4,26,3,2,,,,,,
"Feb 4, 2022 11:00 AM",45,31,14,40,16,24,47,23,24,36,18,18,7,4,3,8,25,24,1,0,0,0,16,13,17,11,6,20,6,0,,,,,,
"Feb 4, 2022 12:00 PM",69,30,39,52,30,22,54,29,25,49,30,19,9,4,5,10,31,26,5,0,0,0,22,19,20,13,7,28,3,3,,,,,,
"Feb 4, 2022 1:00 PM",98,36,62,47,25,22,80,41,39,39,18,21,12,7,5,12,26,22,4,0,0,0,18,28,31,19,12,25,4,2,,,,,,
"Feb 4, 2022 2:00 PM",71,28,43,38,18,20,60,29,31,39,20,19,13,8,5,12,30,26,4,0,0,0,24,19,19,14,5,28,3,3,,,,,,
"Feb 4, 2022 3:00 PM",75,31,44,27,16,11,41,24,17,31,18,13,15,9,6,18,23,21,2,0,0,0,21,29,28,18,10,20,7,1,,,,,,
"Feb 4, 2022 4:00 PM",91,22,69,51,39,12,65,41,24,58,40,18,16,6,10,17,30,26,4,0,0,0,23,39,36,27,9,31,3,2,,,,,,
"Feb 4, 2022 5:00 PM",118,24,94,47,27,20,72,47,25,57,35,22,12,4,8,12,19,14,5,0,0,0,20,44,20,12,8,35,4,0,,,,,,
"Feb 4, 2022 6:00 PM",90,25,65,35,32,3,41,31,10,33,27,6,1,0,1,14,24,22,2,0,0,0,22,49,32,27,5,22,3,1,,,,,,
"Feb 4, 2022 7:00 PM",74,25,49,29,15,14,36,25,11,27,14,13,5,2,3,6,15,14,1,0,0,0,12,31,14,9,5,24,2,1,,,,,,
"Feb 4, 2022 8:00 PM",49,21,28,10,9,1,12,5,7,10,7,3,10,1,9,7,16,14,2,0,0,0,11,11,3,3,0,13,3,0,,,,,,
"Feb 4, 2022 9:00 PM",24,4,20,6,3,3,10,3,7,9,3,6,1,0,1,6,12,10,2,0,0,0,9,6,3,3,0,3,0,2,,,,,,
"Feb 4, 2022 10:00 PM",18,6,12,2,2,0,6,3,3,6,2,4,0,0,0,1,4,2,2,0,0,0,3,5,2,2,0,8,0,0,,,,,,
"Feb 4, 2022 11:00 PM",11,4,7,4,2,2,8,3,5,5,1,4,2,0,2,2,1,1,0,0,0,0,1,6,2,1,1,7,1,0,,,,,,
"Feb 5, 2022 12:00 AM",18,5,13,0,0,0,0,0,0,3,1,2,3,0,3,0,1,0,1,0,0,0,1,2,1,1,0,3,0,1,,,,,,
"Feb 5, 2022 1:00 AM",11,2,9,4,4,0,5,4,1,5,4,1,0,0,0,0,2,2,0,0,0,0,2,7,0,0,0,2,0,0,,,,,,
"Feb 5, 2022 2:00 AM",5,3,2,0,0,0,2,1,1,1,1,0,0,0,0,0,0,0,0,0,0,0,0,1,0,0,0,2,0,0,,,,,,
"Feb 5, 2022 3:00 AM",3,0,3,1,0,1,2,0,2,3,1,2,1,1,0,0,0,0,0,0,0,0,0,1,0,0,0,0,0,0,,,,,,
"Feb 5, 2022 4:00 AM",2,1,1,0,0,0,1,1,0,1,1,0,1,0,1,0,0,0,0,0,0,0,0,1,2,2,0,2,0,0,,,,,,
"Feb 5, 2022 5:00 AM",2,0,2,0,0,0,1,1,0,0,0,0,0,0,0,0,1,1,0,0,0,0,1,2,0,0,0,4,1,0,,,,,,
"Feb 5, 2022 6:00 AM",6,4,2,3,1,2,3,2,1,5,3,2,1,0,1,0,4,4,0,0,0,0,4,2,0,0,0,3,0,0,,,,,,
"Feb 5, 2022 7:00 AM",12,6,6,15,8,7,17,11,6,13,9,4,4,2,2,2,9,9,0,0,0,0,10,12,2,2,0,18,0,1,,,,,,
"Feb 5, 2022 8:00 AM",37,24,13,37,27,10,40,27,13,37,31,6,4,3,1,4,8,8,0,0,0,0,8,10,5,2,3,13,1,2,,,,,,
"Feb 5, 2022 9:00 AM",32,22,10,49,26,23,46,28,18,50,29,21,10,9,1,6,14,14,0,0,0,0,12,12,15,7,8,22,2,13,,,,,,
"Feb 5, 2022 10:00 AM",34,18,16,72,31,41,55,27,28,52,28,24,17,13,4,4,14,14,0,0,0,0,13,22,13,9,4,15,2,2,,,,,,
"Feb 5, 2022 11:00 AM",37,16,21,64,25,39,63,33,30,63,30,33,10,7,3,8,12,10,2,0,0,0,8,25,18,11,7,17,7,1,,,,,,
"Feb 5, 2022 12:00 PM",35,23,12,41,25,16,46,20,26,27,11,16,18,2,16,5,23,21,2,0,0,0,16,11,21,11,10,23,3,2,,,,,,
"Feb 5, 2022 1:00 PM",53,31,22,20,11,9,22,12,10,13,7,6,13,9,4,6,15,12,3,0,0,0,11,13,8,2,6,29,1,2,,,,,,
"Feb 5, 2022 2:00 PM",25,14,11,15,7,8,17,9,8,10,8,2,4,2,2,6,6,5,1,0,0,0,6,3,9,7,2,6,1,0,,,,,,
"Feb 5, 2022 3:00 PM",25,14,11,5,4,1,17,8,9,10,5,5,3,2,1,5,11,10,1,0,0,0,9,12,8,6,2,7,1,1,,,,,,
"Feb 5, 2022 4:00 PM",27,10,17,8,8,0,18,12,6,8,6,2,8,3,5,6,6,5,1,0,0,0,6,7,11,8,3,6,2,0,,,,,,
"Feb 5, 2022 5:00 PM",34,12,22,7,7,0,10,3,7,10,5,5,4,2,2,1,11,10,1,0,0,0,11,6,2,1,1,6,2,0,,,,,,
"Feb 5, 2022 6:00 PM",27,12,15,5,2,3,5,2,3,6,3,3,3,0,3,4,5,5,0,0,0,0,5,6,4,2,2,5,0,0,,,,,,
"Feb 5, 2022 7:00 PM",25,9,16,4,3,1,7,5,2,6,4,2,0,0,0,5,2,2,0,0,0,0,1,6,2,1,1,3,2,0,,,,,,
"Feb 5, 2022 8:00 PM",19,5,14,5,4,1,3,1,2,4,3,1,6,1,5,3,4,4,0,0,0,0,3,12,7,4,3,3,0,1,,,,,,
"Feb 5, 2022 9:00 PM",11,6,5,1,1,0,2,1,1,1,1,0,2,1,1,0,2,2,0,0,0,0,3,2,2,1,1,4,0,0,,,,,,
"Feb 5, 2022 10:00 PM",8,3,5,0,0,0,4,3,1,1,1,0,1,1,0,1,3,3,0,0,0,0,3,0,0,0,0,2,0,0,,,,,,
"Feb 5, 2022 11:00 PM",9,5,4,0,0,0,1,0,1,3,1,2,0,0,0,0,2,2,0,0,0,0,3,4,1,1,0,4,0,0,,,,,,
"Feb 6, 2022 12:00 AM",2,1,1,0,0,0,0,0,0,1,1,0,1,0,1,1,0,0,0,0,0,0,0,1,1,0,1,3,0,1,,,,,,
"Feb 6, 2022 1:00 AM",1,0,1,0,0,0,1,1,0,1,1,0,0,0,0,0,0,0,0,0,0,0,0,0,0,0,0,3,0,0,,,,,,
"Feb 6, 2022 2:00 AM",3,0,3,0,0,0,0,0,0,0,0,0,0,0,0,0,0,0,0,0,0,0,0,0,0,0,0,2,0,0,,,,,,
"Feb 6, 2022 3:00 AM",2,0,2,0,0,0,0,0,0,0,0,0,0,0,0,0,0,0,0,0,0,0,0,0,0,0,0,0,0,0,,,,,,
"Feb 6, 2022 4:00 AM",1,0,1,1,0,1,2,1,1,1,0,1,0,0,0,0,0,0,0,0,0,0,0,0,2,2,0,2,0,0,,,,,,
"Feb 6, 2022 5:00 AM",0,0,0,0,0,0,0,0,0,0,0,0,0,0,0,0,0,0,0,0,0,0,0,1,1,0,1,2,0,0,,,,,,
"Feb 6, 2022 6:00 AM",4,1,3,2,1,1,2,1,1,2,1,1,0,0,0,0,3,3,0,0,0,0,3,2,1,0,1,3,0,0,,,,,,
"Feb 6, 2022 7:00 AM",7,4,3,3,1,2,2,2,0,2,2,0,0,0,0,1,8,8,0,0,0,0,8,6,0,0,0,10,0,0,,,,,,
"Feb 6, 2022 8:00 AM",22,10,12,20,17,3,21,16,5,24,17,7,2,2,0,5,6,6,0,0,0,0,6,9,4,3,1,8,1,2,,,,,,
"Feb 6, 2022 9:00 AM",16,8,8,32,19,13,32,21,11,33,22,11,1,1,0,8,10,9,1,0,0,0,7,11,16,13,3,15,1,9,,,,,,
"Feb 6, 2022 10:00 AM",42,28,14,73,40,33,63,37,26,68,43,25,11,1,10,13,19,19,0,0,0,0,20,23,24,20,4,29,4,3,,,,,,
"Feb 6, 2022 11:00 AM",30,15,15,88,41,47,78,46,32,67,35,32,16,10,6,11,13,12,1,0,0,0,13,14,17,12,5,21,5,2,,,,,,
"Feb 6, 2022 12:00 PM",45,24,21,70,31,39,73,39,34,59,31,28,15,8,7,13,27,27,0,0,0,0,27,24,31,20,11,30,7,2,,,,,,
"Feb 6, 2022 1:00 PM",55,22,33,73,38,35,70,34,36,60,37,23,35,17,18,7,19,19,0,0,0,0,18,21,29,14,15,25,2,0,,,,,,
"Feb 6, 2022 2:00 PM",39,21,18,63,34,29,60,36,24,54,27,27,16,8,8,12,12,12,0,0,0,0,16,22,22,13,9,17,1,4,,,,,,
"Feb 6, 2022 3:00 PM",29,10,19,45,24,21,61,31,30,50,26,24,10,8,2,10,10,9,1,0,0,0,10,13,15,7,8,27,3,0,,,,,,
"Feb 6, 2022 4:00 PM",29,17,12,43,18,25,42,23,19,33,18,15,10,4,6,5,13,10,3,0,0,0,12,11,13,8,5,16,0,1,,,,,,
"Feb 6, 2022 5:00 PM",40,18,22,21,9,12,24,5,19,16,7,9,9,3,6,7,9,9,0,0,0,0,9,8,6,4,2,16,1,0,,,,,,
"Feb 6, 2022 6:00 PM",27,12,15,6,2,4,24,8,16,18,4,14,6,2,4,4,14,14,0,0,0,0,12,10,4,1,3,16,0,0,,,,,,
"Feb 6, 2022 7:00 PM",32,13,19,7,4,3,11,4,7,13,6,7,4,3,1,5,6,6,0,0,0,0,6,5,6,3,3,7,2,0,,,,,,
"Feb 6, 2022 8:00 PM",19,7,12,0,0,0,2,1,1,0,0,0,0,0,0,1,7,7,0,0,0,0,5,3,0,0,0,8,0,0,,,,,,
"Feb 6, 2022 9:00 PM",12,4,8,6,4,2,6,2,4,5,4,1,1,1,0,4,8,8,0,0,0,0,7,2,3,3,0,5,0,1,,,,,,
"Feb 6, 2022 10:00 PM",13,6,7,0,0,0,2,0,2,0,0,0,0,0,0,2,0,0,0,0,0,0,0,3,2,0,2,8,2,0,,,,,,
"Feb 6, 2022 11:00 PM",8,2,6,0,0,0,3,0,3,4,0,4,1,0,1,1,1,1,0,0,0,0,0,1,0,0,0,2,0,1,,,,,,
"Feb 7, 2022 12:00 AM",4,1,3,0,0,0,0,0,0,0,0,0,0,0,0,0,0,0,0,0,0,0,0,1,0,0,0,0,0,0,,,,,,
"Feb 7, 2022 1:00 AM",2,1,1,0,0,0,1,1,0,1,0,1,2,1,1,0,1,0,1,0,0,0,0,0,0,0,0,0,0,0,,,,,,
"Feb 7, 2022 2:00 AM",1,1,0,0,0,0,0,0,0,0,0,0,0,0,0,0,0,0,0,0,0,0,1,0,0,0,0,0,0,0,,,,,,
"Feb 7, 2022 3:00 AM",0,0,0,0,0,0,0,0,0,0,0,0,0,0,0,0,0,0,0,0,0,0,0,0,0,0,0,1,0,0,,,,,,
"Feb 7, 2022 4:00 AM",1,1,0,0,0,0,0,0,0,0,0,0,0,0,0,0,0,0,0,0,0,0,0,0,0,0,0,1,0,0,,,,,,
"Feb 7, 2022 5:00 AM",6,4,2,0,0,0,2,2,0,3,2,1,0,0,0,2,8,8,0,0,0,0,7,2,2,1,1,12,0,0,,,,,,
"Feb 7, 2022 6:00 AM",31,21,10,13,6,7,20,8,12,16,7,9,1,1,0,3,20,19,1,0,0,0,18,8,5,2,3,30,0,3,,,,,,
"Feb 7, 2022 7:00 AM",97,67,30,52,15,37,66,22,44,48,17,31,5,5,0,5,53,53,0,0,0,0,47,31,26,10,16,88,1,3,,,,,,
"Feb 7, 2022 8:00 AM",195,141,54,86,24,62,129,35,94,98,35,63,39,23,16,23,131,131,0,0,0,0,126,30,64,23,41,148,5,3,,,,,,
"Feb 7, 2022 9:00 AM",142,116,26,55,22,33,71,37,34,62,29,33,15,9,6,12,69,69,0,0,0,0,60,30,35,19,16,46,1,4,,,,,,
"Feb 7, 2022 10:00 AM",71,49,22,54,32,22,64,44,20,51,35,16,13,7,6,13,41,40,1,0,0,0,35,17,17,9,8,31,2,1,,,,,,
"Feb 7, 2022 11:00 AM",58,35,23,52,26,26,70,27,43,56,22,34,10,8,2,5,33,33,0,0,0,0,30,11,19,9,10,19,1,6,,,,,,
"Feb 7, 2022 12:00 PM",63,34,29,53,25,28,59,30,29,43,12,31,13,8,5,7,27,25,2,0,0,0,20,21,20,13,7,24,4,2,,,,,,
"Feb 7, 2022 1:00 PM",76,39,37,49,32,17,66,35,31,40,27,13,14,6,8,9,22,20,2,0,0,0,14,26,21,10,11,35,3,0,,,,,,
"Feb 7, 2022 2:00 PM",59,25,34,36,22,14,69,37,32,44,26,18,12,7,5,8,27,24,3,0,0,0,21,17,31,24,7,27,8,1,,,,,,
"Feb 7, 2022 3:00 PM",86,31,55,32,19,13,60,36,24,34,23,11,17,7,10,6,23,15,8,0,0,0,12,29,32,21,11,23,2,2,,,,,,
"Feb 7, 2022 4:00 PM",132,41,91,53,31,22,73,48,25,59,33,26,13,5,8,20,32,26,6,0,0,0,25,52,48,35,13,32,2,2,,,,,,
"Feb 7, 2022 5:00 PM",159,32,127,60,32,28,85,53,32,71,42,29,12,1,11,19,30,23,7,0,0,0,22,75,36,25,11,56,7,5,,,,,,
"Feb 7, 2022 6:00 PM",174,51,123,50,41,9,84,61,23,64,42,22,16,0,16,15,27,21,6,0,0,0,22,74,37,37,0,36,4,3,,,,,,
"Feb 7, 2022 7:00 PM",100,35,65,26,16,10,40,29,11,31,23,8,5,2,3,7,24,20,4,0,0,0,18,39,16,13,3,24,2,4,,,,,,
"Feb 7, 2022 8:00 PM",63,18,45,14,10,4,21,8,13,17,7,10,6,3,3,9,25,18,7,0,0,0,18,20,10,6,4,23,3,2,,,,,,
"Feb 7, 2022 9:00 PM",57,17,40,10,7,3,21,9,12,15,6,9,2,2,0,3,8,7,1,0,0,0,8,6,4,0,4,8,6,0,,,,,,
"Feb 7, 2022 10:00 PM",18,6,12,6,2,4,7,2,5,9,3,6,2,1,1,3,6,5,1,0,0,0,6,8,2,1,1,2,1,1,,,,,,
"Feb 7, 2022 11:00 PM",14,2,12,1,0,1,2,1,1,1,0,1,0,0,0,0,2,1,1,0,0,0,1,5,0,0,0,1,1,0,,,,,,
"Feb 8, 2022 12:00 AM",2,1,1,0,0,0,1,1,0,1,1,0,1,1,0,1,1,1,0,0,0,0,1,5,0,0,0,1,0,0,,,,,,
"Feb 8, 2022 1:00 AM",6,2,4,0,0,0,0,0,0,0,0,0,0,0,0,0,2,1,1,0,0,0,1,1,0,0,0,0,0,0,,,,,,
"Feb 8, 2022 2:00 AM",5,5,0,0,0,0,0,0,0,0,0,0,0,0,0,0,0,0,0,0,0,0,0,0,0,0,0,0,0,0,,,,,,
"Feb 8, 2022 3:00 AM",0,0,0,0,0,0,1,1,0,1,1,0,0,0,0,0,0,0,0,0,0,0,1,1,1,1,0,1,0,0,,,,,,
"Feb 8, 2022 4:00 AM",1,1,0,0,0,0,0,0,0,0,0,0,0,0,0,2,0,0,0,0,0,0,0,0,0,0,0,0,0,0,,,,,,
"Feb 8, 2022 5:00 AM",3,2,1,0,0,0,0,0,0,1,0,1,0,0,0,1,9,9,0,0,0,0,9,3,0,0,0,8,0,0,,,,,,
"Feb 8, 2022 6:00 AM",40,29,11,18,4,14,18,4,14,16,6,10,1,1,0,4,20,20,0,0,0,0,17,12,3,1,2,30,0,3,,,,,,
"Feb 8, 2022 7:00 AM",97,68,29,42,16,26,63,26,37,52,23,29,5,4,1,9,68,67,1,0,0,0,65,30,15,6,9,80,1,5,,,,,,
"Feb 8, 2022 8:00 AM",216,166,50,93,27,66,131,39,92,105,38,67,35,23,12,18,138,136,2,0,0,0,126,36,72,25,47,147,4,8,,,,,,
"Feb 8, 2022 9:00 AM",114,98,16,59,19,40,60,25,35,53,20,33,15,10,5,2,59,59,0,0,0,0,51,16,34,16,18,56,2,8,,,,,,
"Feb 8, 2022 10:00 AM",63,44,19,28,11,17,37,18,19,32,16,16,2,0,2,2,42,40,2,0,0,0,29,18,12,6,6,25,2,5,,,,,,
"Feb 8, 2022 11:00 AM",33,20,13,15,8,7,18,11,7,15,7,8,6,3,3,6,20,19,1,0,0,0,16,10,17,8,9,14,3,2,,,,,,
"Feb 8, 2022 12:00 PM",62,34,28,19,10,9,37,17,20,18,8,10,15,11,4,2,25,23,2,0,0,0,18,13,8,4,4,17,3,1,,,,,,
"Feb 8, 2022 1:00 PM",85,42,43,28,10,18,27,13,14,17,8,9,8,6,2,9,23,20,3,0,0,0,18,17,15,9,6,22,0,2,,,,,,
"Feb 8, 2022 2:00 PM",63,29,34,14,11,3,29,16,13,15,10,5,15,8,7,9,16,12,4,0,0,0,11,15,15,10,5,13,2,0,,,,,,
"Feb 8, 2022 3:00 PM",74,23,51,25,15,10,40,28,12,29,18,11,11,4,7,8,24,20,4,0,0,0,13,31,12,10,2,18,4,0,,,,,,
"Feb 8, 2022 4:00 PM",108,34,74,28,23,5,52,38,14,35,25,10,10,3,7,12,24,16,8,0,0,0,17,41,29,22,7,34,3,1,,,,,,
"Feb 8, 2022 5:00 PM",189,33,156,31,17,14,49,33,16,39,24,15,14,3,11,7,22,17,5,0,0,0,17,60,37,27,10,47,5,1,,,,,,
"Feb 8, 2022 6:00 PM",156,43,113,48,38,10,75,54,21,63,44,19,16,5,11,12,27,23,4,0,0,0,21,73,31,29,2,34,4,0,,,,,,
"Feb 8, 2022 7:00 PM",97,17,80,17,16,1,26,21,5,26,16,10,5,0,5,9,20,15,5,0,0,0,16,30,16,13,3,19,0,0,,,,,,
"Feb 8, 2022 8:00 PM",59,19,40,10,9,1,16,11,5,14,10,4,0,0,0,4,12,11,1,0,0,0,8,18,6,6,0,10,1,2,,,,,,
"Feb 8, 2022 9:00 PM",25,8,17,1,1,0,5,2,3,4,1,3,4,3,1,4,10,8,2,0,0,0,9,4,3,2,1,9,3,0,,,,,,
"Feb 8, 2022 10:00 PM",24,3,21,2,1,1,2,1,1,2,1,1,2,2,0,0,4,2,2,0,0,0,2,7,4,2,2,4,2,0,,,,,,
"Feb 8, 2022 11:00 PM",10,4,6,1,1,0,2,1,1,4,3,1,0,0,0,1,3,2,1,0,0,0,2,4,0,0,0,0,0,0,,,,,,
"Feb 9, 2022 12:00 AM",4,1,3,0,0,0,0,0,0,0,0,0,1,0,1,0,2,1,1,0,0,0,1,1,0,0,0,0,0,0,,,,,,
"Feb 9, 2022 1:00 AM",3,0,3,0,0,0,0,0,0,0,0,0,0,0,0,0,2,2,0,0,0,0,2,0,0,0,0,0,0,0,,,,,,
"Feb 9, 2022 2:00 AM",2,1,1,0,0,0,0,0,0,0,0,0,0,0,0,0,0,0,0,0,0,0,0,0,0,0,0,0,0,0,,,,,,
"Feb 9, 2022 3:00 AM",0,0,0,0,0,0,1,1,0,0,0,0,1,1,0,0,0,0,0,0,0,0,0,2,0,0,0,0,0,0,,,,,,
"Feb 9, 2022 4:00 AM",1,0,1,1,0,1,1,0,1,1,0,1,0,0,0,2,0,0,0,0,0,0,0,1,0,0,0,1,0,0,,,,,,
"Feb 9, 2022 5:00 AM",8,7,1,1,1,0,2,1,1,2,1,1,0,0,0,1,7,7,0,0,0,0,8,1,0,0,0,9,0,0,,,,,,
"Feb 9, 2022 6:00 AM",33,23,10,15,3,12,15,4,11,11,3,8,2,2,0,6,21,21,0,0,0,0,19,11,2,1,1,33,0,3,,,,,,
"Feb 9, 2022 7:00 AM",98,69,29,63,23,40,77,24,53,54,19,35,9,9,0,9,63,63,0,0,0,0,65,31,28,7,21,78,1,8,,,,,,
"Feb 9, 2022 8:00 AM",238,188,50,89,27,62,133,43,90,95,36,59,44,25,19,21,147,146,1,0,0,0,141,50,76,31,45,162,6,7,,,,,,
"Feb 9, 2022 9:00 AM",135,119,16,65,26,39,91,40,51,75,44,31,5,5,0,8,67,67,0,0,0,0,61,27,43,16,27,57,4,3,,,,,,
"Feb 9, 2022 10:00 AM",53,42,11,47,20,27,62,33,29,47,24,23,7,3,4,9,39,39,0,0,0,0,31,16,33,15,18,26,1,2,,,,,,
"Feb 9, 2022 11:00 AM",59,35,24,69,42,27,68,40,28,56,30,26,13,7,6,10,38,36,2,0,0,0,28,17,30,21,9,26,4,3,,,,,,
"Feb 9, 2022 12:00 PM",90,42,48,87,41,46,78,39,39,83,42,41,19,13,6,18,35,33,2,0,0,0,29,37,17,9,8,25,8,9,,,,,,
"Feb 9, 2022 1:00 PM",101,49,52,73,42,31,90,49,41,76,39,37,36,17,19,19,31,24,7,0,0,0,22,38,35,26,9,43,4,2,,,,,,
"Feb 9, 2022 2:00 PM",70,30,40,48,22,26,63,33,30,52,27,25,18,10,8,9,18,16,2,0,0,0,17,28,30,15,15,27,6,9,,,,,,
"Feb 9, 2022 3:00 PM",93,30,63,38,19,19,68,41,27,46,29,17,11,6,5,17,22,17,5,0,0,0,15,27,32,18,14,30,2,2,,,,,,
"Feb 9, 2022 4:00 PM",116,32,84,49,27,22,64,41,23,52,29,23,17,10,7,14,22,15,7,0,0,0,17,36,32,23,9,37,6,2,,,,,,
"Feb 9, 2022 5:00 PM",214,53,161,59,42,17,99,56,43,68,41,27,18,9,9,17,43,35,8,0,0,0,36,79,40,32,8,57,9,1,,,,,,
"Feb 9, 2022 6:00 PM",182,41,141,63,52,11,82,65,17,72,55,17,10,1,9,19,42,36,6,0,0,0,33,66,48,39,9,40,7,1,,,,,,
"Feb 9, 2022 7:00 PM",104,34,70,27,22,5,54,41,13,43,33,10,7,2,5,15,19,15,4,0,0,0,13,36,22,16,6,26,4,1,,,,,,
"Feb 9, 2022 8:00 PM",72,26,46,14,10,4,29,19,10,21,10,11,4,1,3,7,16,13,3,0,0,0,13,23,8,7,1,16,2,3,,,,,,
"Feb 9, 2022 9:00 PM",45,11,34,7,3,4,13,8,5,13,5,8,1,0,1,5,17,11,6,0,0,0,10,15,7,5,2,17,3,0,,,,,,
"Feb 9, 2022 10:00 PM",22,5,17,5,3,2,7,3,4,7,3,4,4,3,1,2,9,8,1,0,0,0,7,16,6,3,3,6,0,0,,,,,,
"Feb 9, 2022 11:00 PM",14,2,12,3,2,1,6,2,4,7,3,4,1,0,1,3,1,1,0,0,0,0,1,5,2,1,1,7,0,1,,,,,,
"Feb 10, 2022 12:00 AM",3,0,3,0,0,0,0,0,0,2,1,1,0,0,0,2,2,2,0,0,0,0,2,2,0,0,0,2,0,0,,,,,,
"Feb 10, 2022 1:00 AM",6,3,3,0,0,0,1,1,0,1,1,0,0,0,0,0,0,0,0,0,0,0,0,1,0,0,0,2,0,0,,,,,,
"Feb 10, 2022 2:00 AM",5,4,1,0,0,0,0,0,0,0,0,0,0,0,0,0,0,0,0,0,0,0,0,0,0,0,0,0,0,0,,,,,,
"Feb 10, 2022 3:00 AM",1,0,1,0,0,0,1,0,1,0,0,0,2,0,2,0,0,0,0,0,0,0,0,0,0,0,0,0,0,1,,,,,,
"Feb 10, 2022 4:00 AM",0,0,0,0,0,0,1,0,1,0,0,0,0,0,0,0,0,0,0,0,0,0,0,2,0,0,0,2,0,0,,,,,,
"Feb 10, 2022 5:00 AM",4,3,1,1,0,1,2,1,1,2,1,1,0,0,0,1,14,14,0,0,0,0,14,1,0,0,0,11,0,0,,,,,,
"Feb 10, 2022 6:00 AM",39,30,9,14,4,10,21,6,15,17,6,11,0,0,0,5,18,18,0,0,0,0,18,18,5,2,3,30,0,2,,,,,,
"Feb 10, 2022 7:00 AM",88,68,20,41,11,30,81,30,51,49,17,32,9,7,2,9,52,52,0,0,0,0,51,29,26,7,19,65,1,7,,,,,,
"Feb 10, 2022 8:00 AM",225,172,53,83,30,53,123,39,84,104,50,54,32,21,11,30,130,130,0,0,0,0,125,52,71,27,44,138,7,7,,,,,,
"Feb 10, 2022 9:00 AM",129,107,22,59,24,35,88,40,48,68,35,33,14,7,7,8,64,64,0,0,0,0,56,25,51,28,23,64,3,6,,,,,,
"Feb 10, 2022 10:00 AM",74,51,23,52,25,27,68,34,34,55,30,25,12,11,1,13,38,37,1,0,0,0,40,21,20,12,8,33,1,3,,,,,,
"Feb 10, 2022 11:00 AM",73,45,28,48,25,23,48,24,24,45,25,20,13,9,4,10,26,24,2,0,0,0,23,15,24,14,10,22,0,3,,,,,,
"Feb 10, 2022 12:00 PM",54,29,25,44,22,22,57,35,22,39,25,14,15,9,6,10,28,24,4,0,0,0,21,14,20,16,4,34,4,6,,,,,,
"Feb 10, 2022 1:00 PM",75,32,43,51,27,24,46,23,23,36,19,17,21,13,8,10,25,19,6,0,0,0,19,23,27,17,10,32,3,0,,,,,,
"Feb 10, 2022 2:00 PM",82,34,48,37,20,17,49,26,23,42,24,18,15,5,10,12,22,17,5,0,0,0,14,37,28,20,8,37,1,2,,,,,,
"Feb 10, 2022 3:00 PM",83,31,52,29,16,13,48,26,22,38,21,17,14,7,7,12,14,13,1,0,0,0,11,28,19,11,8,30,1,1,,,,,,
"Feb 10, 2022 4:00 PM",115,35,80,31,23,8,67,44,23,56,34,22,16,8,8,11,26,20,6,0,0,0,24,47,38,31,7,34,2,1,,,,,,
"Feb 10, 2022 5:00 PM",176,45,131,53,39,14,83,53,30,70,44,26,20,6,14,14,26,22,4,0,0,0,24,82,43,34,9,58,7,1,,,,,,
"Feb 10, 2022 6:00 PM",155,40,115,46,39,7,73,48,25,68,44,24,10,4,6,13,39,31,8,0,0,0,33,67,35,29,6,53,7,3,,,,,,
"Feb 10, 2022 7:00 PM",99,22,77,34,25,9,35,26,9,38,27,11,13,5,8,7,18,15,3,0,0,0,12,34,20,15,5,19,1,0,,,,,,
"Feb 10, 2022 8:00 PM",80,29,51,7,3,4,23,11,12,16,7,9,4,1,3,8,21,15,6,0,0,0,12,19,10,7,3,21,1,2,,,,,,
"Feb 10, 2022 9:00 PM",40,12,28,12,8,4,13,7,6,7,4,3,1,0,1,7,13,10,3,0,0,0,10,11,5,4,1,10,0,2,,,,,,
"Feb 10, 2022 10:00 PM",27,11,16,3,2,1,5,1,4,6,3,3,1,1,0,0,3,3,0,0,0,0,3,12,2,1,1,11,1,0,,,,,,
"Feb 10, 2022 11:00 PM",14,6,8,4,3,1,6,3,3,3,2,1,2,0,2,0,2,2,0,0,0,0,2,5,2,1,1,5,0,1,,,,,,
"Feb 11, 2022 12:00 AM",7,1,6,1,1,0,4,2,2,3,2,1,1,1,0,0,2,0,2,0,0,0,0,8,2,1,1,1,0,0,,,,,,
"Feb 11, 2022 1:00 AM",4,0,4,2,1,1,0,0,0,0,0,0,0,0,0,1,1,1,0,0,0,0,1,0,0,0,0,2,0,0,,,,,,
"Feb 11, 2022 2:00 AM",2,2,0,7,3,4,1,1,0,1,1,0,0,0,0,1,0,0,0,0,0,0,0,1,2,2,0,0,0,0,,,,,,
"Feb 11, 2022 3:00 AM",2,0,2,1,1,0,2,2,0,2,2,0,0,0,0,0,1,1,0,0,0,0,1,1,0,0,0,1,0,0,,,,,,
"Feb 11, 2022 4:00 AM",2,1,1,0,0,0,0,0,0,0,0,0,0,0,0,0,0,0,0,0,0,0,0,1,0,0,0,0,0,0,,,,,,
"Feb 11, 2022 5:00 AM",4,4,0,3,1,2,4,2,2,6,2,4,0,0,0,2,9,9,0,0,0,0,10,1,1,1,0,7,0,0,,,,,,
"Feb 11, 2022 6:00 AM",32,22,10,14,6,8,14,8,6,10,6,4,2,1,1,3,14,13,1,0,0,0,14,11,2,2,0,27,0,3,,,,,,
"Feb 11, 2022 7:00 AM",72,48,24,49,18,31,66,29,37,49,20,29,6,6,0,1,36,36,0,0,0,0,35,27,26,13,13,61,1,4,,,,,,
"Feb 11, 2022 8:00 AM",176,125,51,80,29,51,121,47,74,96,40,56,27,18,9,17,97,97,0,0,0,0,92,37,61,22,39,105,3,2,,,,,,
"Feb 11, 2022 9:00 AM",119,94,25,47,18,29,67,36,31,47,28,19,10,3,7,13,44,44,0,0,0,0,37,20,32,20,12,44,2,1,,,,,,
"Feb 11, 2022 10:00 AM",80,57,23,72,39,33,77,42,35,57,31,26,13,9,4,13,29,28,1,0,0,0,23,24,36,12,24,28,2,7,,,,,,
"Feb 11, 2022 11:00 AM",46,27,19,41,19,22,47,23,24,41,20,21,15,11,4,11,14,14,0,0,0,0,10,18,13,6,7,25,2,4,,,,,,
"Feb 11, 2022 12:00 PM",69,34,35,70,36,34,65,28,37,51,27,24,13,8,5,11,16,15,1,0,0,0,17,18,21,11,10,27,2,3,,,,,,
"Feb 11, 2022 1:00 PM",77,36,41,43,23,20,71,41,30,38,24,14,21,8,13,17,27,23,4,0,0,0,23,31,13,7,6,17,4,2,,,,,,
"Feb 11, 2022 2:00 PM",66,30,36,48,25,23,52,30,22,41,26,15,16,6,10,11,20,15,5,0,0,0,19,36,15,6,9,27,5,3,,,,,,
"Feb 11, 2022 3:00 PM",88,31,57,72,37,35,69,41,28,57,35,22,23,8,15,16,15,12,3,0,0,0,12,32,33,21,12,20,4,1,,,,,,
"Feb 11, 2022 4:00 PM",106,34,72,49,28,21,86,53,33,74,42,32,13,5,8,18,36,29,7,0,0,0,27,53,33,14,19,50,8,3,,,,,,
"Feb 11, 2022 5:00 PM",152,59,93,39,23,16,81,45,36,50,24,26,16,6,10,17,30,25,5,0,0,0,26,60,31,14,17,55,6,4,,,,,,
"Feb 11, 2022 6:00 PM",123,35,88,37,28,9,53,38,15,47,30,17,10,2,8,14,37,33,4,0,0,0,33,39,22,20,2,26,2,0,,,,,,
"Feb 11, 2022 7:00 PM",80,23,57,18,12,6,33,25,8,25,17,8,13,3,10,7,18,17,1,0,0,0,16,29,6,5,1,18,0,3,,,,,,
"Feb 11, 2022 8:00 PM",63,15,48,13,9,4,28,22,6,19,11,8,4,0,4,5,9,9,0,0,0,0,8,13,8,7,1,21,0,0,,,,,,
"Feb 11, 2022 9:00 PM",33,10,23,1,1,0,14,8,6,12,4,8,4,1,3,2,14,13,1,0,0,0,13,13,4,3,1,6,0,1,,,,,,
"Feb 11, 2022 10:00 PM",21,5,16,4,2,2,11,2,9,10,2,8,0,0,0,5,6,4,2,0,0,0,3,4,3,1,2,6,0,0,,,,,,
"Feb 11, 2022 11:00 PM",19,8,11,2,1,1,4,0,4,6,1,5,5,2,3,0,0,0,0,0,0,0,0,4,0,0,0,3,0,2,,,,,,
"Feb 12, 2022 12:00 AM",9,3,6,4,0,4,3,2,1,6,2,4,6,3,3,1,1,1,0,0,0,0,1,2,2,0,2,4,0,0,,,,,,
"Feb 12, 2022 1:00 AM",4,1,3,1,1,0,7,1,6,2,1,1,0,0,0,1,2,1,1,0,0,0,0,4,3,1,2,4,0,0,,,,,,
"Feb 12, 2022 2:00 AM",4,2,2,0,0,0,2,2,0,2,2,0,0,0,0,2,1,1,0,0,0,0,1,4,0,0,0,1,0,0,,,,,,
"Feb 12, 2022 3:00 AM",1,0,1,0,0,0,1,1,0,0,0,0,0,0,0,0,0,0,0,0,0,0,0,0,2,1,1,1,0,0,,,,,,
"Feb 12, 2022 4:00 AM",3,1,2,0,0,0,0,0,0,0,0,0,0,0,0,1,0,0,0,0,0,0,0,1,2,2,0,0,0,0,,,,,,
"Feb 12, 2022 5:00 AM",1,1,0,0,0,0,2,1,1,2,1,1,2,0,2,0,1,1,0,0,0,0,1,0,0,0,0,3,0,0,,,,,,
"Feb 12, 2022 6:00 AM",11,7,4,0,0,0,4,2,2,1,0,1,0,0,0,0,1,1,0,0,0,0,1,1,0,0,0,5,0,1,,,,,,
"Feb 12, 2022 7:00 AM",17,11,6,6,3,3,13,10,3,11,11,0,5,0,5,3,8,7,1,0,0,0,7,9,4,4,0,11,0,1,,,,,,
"Feb 12, 2022 8:00 AM",24,11,13,30,15,15,40,30,10,29,22,7,3,2,1,1,7,7,0,0,0,0,7,15,8,6,2,8,0,0,,,,,,
"Feb 12, 2022 9:00 AM",46,20,26,39,21,18,57,27,30,39,20,19,8,7,1,13,18,17,1,0,0,0,16,21,26,18,8,33,3,4,,,,,,
"Feb 12, 2022 10:00 AM",50,31,19,60,22,38,97,59,38,59,34,25,4,2,2,9,20,19,1,0,0,0,16,29,25,13,12,21,1,3,,,,,,
"Feb 12, 2022 11:00 AM",46,29,17,85,48,37,91,50,41,68,44,24,23,13,10,10,13,13,0,0,0,0,13,32,42,25,17,33,2,1,,,,,,
"Feb 12, 2022 12:00 PM",54,18,36,78,44,34,81,44,37,71,39,32,16,10,6,13,21,20,1,0,0,0,18,21,27,11,16,34,6,1,,,,,,
"Feb 12, 2022 1:00 PM",56,22,34,87,37,50,83,29,54,80,40,40,23,13,10,12,21,19,2,0,0,0,22,16,25,9,16,28,1,5,,,,,,
"Feb 12, 2022 2:00 PM",54,28,26,50,28,22,54,21,33,47,22,25,13,5,8,10,21,20,1,0,0,0,19,14,20,13,7,35,2,2,,,,,,
"Feb 12, 2022 3:00 PM",45,31,14,59,26,33,61,35,26,53,30,23,14,8,6,14,17,17,0,0,0,0,16,22,23,9,14,20,2,0,,,,,,
"Feb 12, 2022 4:00 PM",49,21,28,61,32,29,47,26,21,45,24,21,15,7,8,14,17,16,1,0,0,0,17,16,29,16,13,23,2,1,,,,,,
"Feb 12, 2022 5:00 PM",34,12,22,35,22,13,34,14,20,38,17,21,9,2,7,12,10,8,2,0,0,0,8,17,16,9,7,20,1,0,,,,,,
"Feb 12, 2022 6:00 PM",30,14,16,19,12,7,21,10,11,18,9,9,3,1,2,5,9,8,1,0,0,0,9,15,9,6,3,16,2,0,,,,,,
"Feb 12, 2022 7:00 PM",33,17,16,28,11,17,21,7,14,23,7,16,10,5,5,8,11,9,2,0,0,0,9,12,6,2,4,19,3,0,,,,,,
"Feb 12, 2022 8:00 PM",28,11,17,18,12,6,21,11,10,20,11,9,9,3,6,0,8,8,0,0,0,0,6,12,6,2,4,12,0,1,,,,,,
"Feb 12, 2022 9:00 PM",26,13,13,4,4,0,10,5,5,8,5,3,6,2,4,3,5,5,0,0,0,0,4,3,4,2,2,8,1,0,,,,,,
"Feb 12, 2022 10:00 PM",13,3,10,9,6,3,8,3,5,6,2,4,1,0,1,0,2,2,0,0,0,0,2,2,7,2,5,3,1,0,,,,,,
"Feb 12, 2022 11:00 PM",13,2,11,9,1,8,5,3,2,6,1,5,5,1,4,3,0,0,0,0,0,0,0,7,3,3,0,4,0,2,,,,,,
"Feb 13, 2022 12:00 AM",7,1,6,2,2,0,1,1,0,6,2,4,1,0,1,0,0,0,0,0,0,0,0,4,1,1,0,0,0,0,,,,,,
"Feb 13, 2022 1:00 AM",3,0,3,0,0,0,3,2,1,1,1,0,2,0,2,0,0,0,0,0,0,0,0,3,3,2,1,2,0,0,,,,,,
"Feb 13, 2022 2:00 AM",4,2,2,0,0,0,0,0,0,0,0,0,0,0,0,0,0,0,0,0,0,0,0,1,0,0,0,1,0,0,,,,,,
"Feb 13, 2022 3:00 AM",0,0,0,1,1,0,3,3,0,1,1,0,0,0,0,0,0,0,0,0,0,0,0,0,1,0,1,1,0,2,,,,,,
"Feb 13, 2022 4:00 AM",3,0,3,0,0,0,1,1,0,0,0,0,0,0,0,0,1,0,1,0,0,0,0,1,1,1,0,0,0,0,,,,,,
"Feb 13, 2022 5:00 AM",0,0,0,0,0,0,1,1,0,1,1,0,1,1,0,0,0,0,0,0,0,0,0,0,0,0,0,1,1,0,,,,,,
"Feb 13, 2022 6:00 AM",9,4,5,0,0,0,4,2,2,2,1,1,0,0,0,1,3,3,0,0,0,0,3,4,0,0,0,1,0,0,,,,,,
"Feb 13, 2022 7:00 AM",9,8,1,2,0,2,2,2,0,3,1,2,0,0,0,1,6,5,1,0,0,0,6,4,1,1,0,6,0,0,,,,,,
"Feb 13, 2022 8:00 AM",31,15,16,26,9,17,21,14,7,19,12,7,2,2,0,2,4,4,0,0,0,0,4,9,4,4,0,10,0,0,,,,,,
"Feb 13, 2022 9:00 AM",17,10,7,37,22,15,47,28,19,39,26,13,4,4,0,8,13,12,1,0,0,0,9,11,13,8,5,6,1,5,,,,,,
"Feb 13, 2022 10:00 AM",40,23,17,35,19,16,59,30,29,34,20,14,2,0,2,6,11,11,0,0,0,0,14,13,16,7,9,16,2,4,,,,,,
"Feb 13, 2022 11:00 AM",27,16,11,73,37,36,79,46,33,50,33,17,15,9,6,10,24,23,1,0,0,0,21,23,28,18,10,19,3,3,,,,,,
"Feb 13, 2022 12:00 PM",51,25,26,107,56,51,87,47,40,80,45,35,13,9,4,15,10,9,1,0,0,0,7,15,36,16,20,17,3,2,,,,,,
"Feb 13, 2022 1:00 PM",56,27,29,81,41,40,80,42,38,64,36,28,23,5,18,9,17,15,2,0,0,0,15,18,25,17,8,26,5,4,,,,,,
"Feb 13, 2022 2:00 PM",66,31,35,75,39,36,80,42,38,65,31,34,14,12,2,14,19,18,1,0,0,0,17,22,38,24,14,29,5,1,,,,,,
"Feb 13, 2022 3:00 PM",37,20,17,55,27,28,55,27,28,43,24,19,16,5,11,18,26,23,3,0,0,0,23,14,20,13,7,17,4,5,,,,,,
"Feb 13, 2022 4:00 PM",45,24,21,54,23,31,50,19,31,36,15,21,11,7,4,12,18,18,0,0,0,0,15,12,15,9,6,19,1,1,,,,,,
"Feb 13, 2022 5:00 PM",33,16,17,30,15,15,34,19,15,25,12,13,15,3,12,6,5,5,0,0,0,0,5,7,24,9,15,14,3,0,,,,,,
"Feb 13, 2022 6:00 PM",31,12,19,16,12,4,24,7,17,11,4,7,3,0,3,8,5,5,0,0,0,0,5,9,6,3,3,19,0,3,,,,,,
"Feb 13, 2022 7:00 PM",31,11,20,14,5,9,8,2,6,13,4,9,2,0,2,5,10,9,1,0,0,0,7,6,3,2,1,13,0,0,,,,,,
"Feb 13, 2022 8:00 PM",23,10,13,8,6,2,6,3,3,8,4,4,1,0,1,0,9,9,0,0,0,0,7,5,4,1,3,7,1,1,,,,,,
"Feb 13, 2022 9:00 PM",15,7,8,3,3,0,8,1,7,4,1,3,1,0,1,4,2,2,0,0,0,0,1,3,1,1,0,10,1,0,,,,,,
"Feb 13, 2022 10:00 PM",14,5,9,0,0,0,7,3,4,6,2,4,0,0,0,3,4,2,2,0,0,0,2,9,2,1,1,3,0,0,,,,,,
"Feb 13, 2022 11:00 PM",4,2,2,0,0,0,0,0,0,0,0,0,0,0,0,1,0,0,0,0,0,0,0,5,0,0,0,3,0,0,,,,,,
"Feb 14, 2022 12:00 AM",2,0,2,0,0,0,0,0,0,5,2,3,0,0,0,0,3,3,0,0,0,0,3,1,2,2,0,1,0,0,,,,,,
"Feb 14, 2022 1:00 AM",1,0,1,0,0,0,0,0,0,0,0,0,0,0,0,0,1,1,0,0,0,0,1,0,0,0,0,0,0,1,,,,,,
"Feb 14, 2022 2:00 AM",2,2,0,0,0,0,0,0,0,0,0,0,0,0,0,0,0,0,0,0,0,0,0,0,0,0,0,0,0,0,,,,,,
"Feb 14, 2022 3:00 AM",1,0,1,0,0,0,0,0,0,0,0,0,0,0,0,0,1,1,0,0,0,0,1,0,0,0,0,1,0,0,,,,,,
"Feb 14, 2022 4:00 AM",1,0,1,0,0,0,0,0,0,0,0,0,0,0,0,0,1,1,0,0,0,0,1,0,0,0,0,1,0,1,,,,,,
"Feb 14, 2022 5:00 AM",7,6,1,0,0,0,2,1,1,1,0,1,0,0,0,3,7,7,0,0,0,0,6,3,0,0,0,8,2,0,,,,,,
"Feb 14, 2022 6:00 AM",33,19,14,9,1,8,13,3,10,8,2,6,2,2,0,3,15,15,0,0,0,0,17,12,1,0,1,24,0,2,,,,,,
"Feb 14, 2022 7:00 AM",108,74,34,44,14,30,80,29,51,55,21,34,5,4,1,9,50,49,1,0,0,0,51,31,25,9,16,70,5,4,,,,,,
"Feb 14, 2022 8:00 AM",184,138,46,63,14,49,134,41,93,97,39,58,26,10,16,24,122,121,1,0,0,0,117,32,64,15,49,159,3,2,,,,,,
"Feb 14, 2022 9:00 AM",118,99,19,37,14,23,65,30,35,53,26,27,11,4,7,8,74,73,1,0,0,0,63,19,32,15,17,53,3,1,,,,,,
"Feb 14, 2022 10:00 AM",62,44,18,39,22,17,52,31,21,50,28,22,11,6,5,7,36,36,0,0,0,0,26,18,25,12,13,20,0,3,,,,,,
"Feb 14, 2022 11:00 AM",54,33,21,41,14,27,46,20,26,41,15,26,13,8,5,5,25,25,0,0,0,0,19,8,18,10,8,23,4,0,,,,,,
"Feb 14, 2022 12:00 PM",68,33,35,32,19,13,55,35,20,41,24,17,8,3,5,4,26,22,4,0,0,0,18,17,20,14,6,32,3,4,,,,,,
"Feb 14, 2022 1:00 PM",65,34,31,38,23,15,59,36,23,41,23,18,13,4,9,10,25,22,3,0,0,0,19,23,22,15,7,19,5,1,,,,,,
"Feb 14, 2022 2:00 PM",62,26,36,21,9,12,48,26,22,32,23,9,16,13,3,9,29,23,6,0,0,0,20,20,18,9,9,29,2,2,,,,,,
"Feb 14, 2022 3:00 PM",90,29,61,30,18,12,37,24,13,31,16,15,15,6,9,18,26,18,8,0,0,0,16,29,18,14,4,22,8,1,,,,,,
"Feb 14, 2022 4:00 PM",113,22,91,42,31,11,59,42,17,49,34,15,18,4,14,15,36,25,11,0,0,0,29,40,31,22,9,39,3,2,,,,,,
"Feb 14, 2022 5:00 PM",174,41,133,43,26,17,79,47,32,63,32,31,21,8,13,22,19,16,3,0,0,0,16,96,38,27,11,51,3,4,,,,,,
"Feb 14, 2022 6:00 PM",153,38,115,42,37,5,76,54,22,52,38,14,11,2,9,13,28,21,7,0,0,0,22,63,46,37,9,39,2,2,,,,,,
"Feb 14, 2022 7:00 PM",82,26,56,15,14,1,35,24,11,29,20,9,4,1,3,11,27,23,4,0,0,0,24,37,18,14,4,17,4,3,,,,,,
"Feb 14, 2022 8:00 PM",61,20,41,11,6,5,18,10,8,20,13,7,2,1,1,7,14,13,1,0,0,0,16,21,11,8,3,18,0,1,,,,,,
"Feb 14, 2022 9:00 PM",27,14,13,9,6,3,17,9,8,13,6,7,3,1,2,15,12,10,2,0,0,0,7,6,7,5,2,13,3,0,,,,,,
"Feb 14, 2022 10:00 PM",23,3,20,5,3,2,9,2,7,6,1,5,4,3,1,4,5,3,2,0,0,0,3,7,0,0,0,5,1,0,,,,,,
"Feb 14, 2022 11:00 PM",8,1,7,2,1,1,1,0,1,1,0,1,1,1,0,1,1,0,1,0,0,0,0,5,1,1,0,3,0,0,,,,,,
"Feb 15, 2022 12:00 AM",3,0,3,0,0,0,1,1,0,2,2,0,3,0,3,1,1,1,0,0,0,0,1,2,1,1,0,1,1,0,,,,,,
"Feb 15, 2022 1:00 AM",0,0,0,0,0,0,1,1,0,1,1,0,0,0,0,0,2,2,0,0,0,0,1,1,0,0,0,0,0,0,,,,,,
"Feb 15, 2022 2:00 AM",3,3,0,0,0,0,0,0,0,0,0,0,0,0,0,0,1,0,1,0,0,0,0,0,0,0,0,1,0,0,,,,,,
"Feb 15, 2022 3:00 AM",1,0,1,0,0,0,0,0,0,0,0,0,0,0,0,0,0,0,0,0,0,0,0,0,0,0,0,0,0,0,,,,,,
"Feb 15, 2022 4:00 AM",2,1,1,0,0,0,0,0,0,0,0,0,0,0,0,0,0,0,0,0,0,0,0,0,0,0,0,1,0,1,,,,,,
"Feb 15, 2022 5:00 AM",3,2,1,0,0,0,1,0,1,1,0,1,0,0,0,2,7,7,0,0,0,0,7,1,0,0,0,8,0,0,,,,,,
"Feb 15, 2022 6:00 AM",35,24,11,9,3,6,15,6,9,10,4,6,1,1,0,3,15,15,0,0,0,0,17,11,8,5,3,29,0,2,,,,,,
"Feb 15, 2022 7:00 AM",106,70,36,36,12,24,58,16,42,40,13,27,8,6,2,4,62,62,0,0,0,0,59,26,25,10,15,89,2,7,,,,,,
"Feb 15, 2022 8:00 AM",205,151,54,86,27,59,123,42,81,103,44,59,36,20,16,24,103,102,1,0,0,0,106,47,73,24,49,157,3,9,,,,,,
"Feb 15, 2022 9:00 AM",110,98,12,43,18,25,78,34,44,48,25,23,9,8,1,8,78,75,3,0,0,0,64,19,25,11,14,53,4,4,,,,,,
"Feb 15, 2022 10:00 AM",72,54,18,45,22,23,68,39,29,41,22,19,11,5,6,6,41,41,0,0,0,0,29,19,27,20,7,22,3,4,,,,,,
"Feb 15, 2022 11:00 AM",65,43,22,34,19,15,33,17,16,28,17,11,11,5,6,10,30,29,1,0,0,0,24,11,12,7,5,30,0,0,,,,,,
"Feb 15, 2022 12:00 PM",56,29,27,34,16,18,73,30,43,35,18,17,7,4,3,6,30,29,1,0,0,0,22,17,17,4,13,27,3,1,,,,,,
"Feb 15, 2022 1:00 PM",96,50,46,48,26,22,55,26,29,42,24,18,15,8,7,18,36,33,3,0,0,0,26,26,21,10,11,31,1,3,,,,,,
"Feb 15, 2022 2:00 PM",68,30,38,30,21,9,44,27,17,33,22,11,16,14,2,16,29,24,5,0,0,0,21,24,22,18,4,12,4,1,,,,,,
"Feb 15, 2022 3:00 PM",76,32,44,40,24,16,45,25,20,34,17,17,20,9,11,10,26,22,4,0,0,0,17,25,27,15,12,26,2,2,,,,,,
"Feb 15, 2022 4:00 PM",125,30,95,52,34,18,62,44,18,57,41,16,14,5,9,16,33,21,12,0,0,0,22,53,22,15,7,37,3,1,,,,,,
"Feb 15, 2022 5:00 PM",200,48,152,52,38,14,79,55,24,76,46,30,14,2,12,19,29,20,9,0,0,0,23,74,41,31,10,44,2,2,,,,,,
"Feb 15, 2022 6:00 PM",148,35,113,48,37,11,70,50,20,60,39,21,16,4,12,10,39,37,2,0,0,0,34,82,40,33,7,35,5,3,,,,,,
"Feb 15, 2022 7:00 PM",84,18,66,18,15,3,26,20,6,30,23,7,6,2,4,5,23,14,9,0,0,0,14,27,12,10,2,24,3,2,,,,,,
"Feb 15, 2022 8:00 PM",78,17,61,19,10,9,15,11,4,12,11,1,1,0,1,2,6,5,1,0,0,0,4,22,3,3,0,10,1,4,,,,,,
"Feb 15, 2022 9:00 PM",41,14,27,6,6,0,8,4,4,9,4,5,0,0,0,3,20,16,4,0,0,0,12,10,5,4,1,7,2,0,,,,,,
"Feb 15, 2022 10:00 PM",30,6,24,3,3,0,4,2,2,2,0,2,0,0,0,3,5,5,0,0,0,0,7,8,2,2,0,9,3,2,,,,,,
"Feb 15, 2022 11:00 PM",8,2,6,0,0,0,1,1,0,2,1,1,0,0,0,0,3,1,2,0,0,0,1,3,0,0,0,3,0,0,,,,,,
"Feb 16, 2022 12:00 AM",0,0,0,0,0,0,1,1,0,2,2,0,0,0,0,0,3,2,1,0,0,0,2,1,2,2,0,0,0,0,,,,,,
"Feb 16, 2022 1:00 AM",2,0,2,1,1,0,1,0,1,1,0,1,0,0,0,0,1,0,1,0,0,0,0,0,0,0,0,0,0,0,,,,,,
"Feb 16, 2022 2:00 AM",3,2,1,0,0,0,0,0,0,0,0,0,0,0,0,0,0,0,0,0,0,0,0,0,0,0,0,0,0,0,,,,,,
"Feb 16, 2022 3:00 AM",1,0,1,0,0,0,0,0,0,0,0,0,0,0,0,0,0,0,0,0,0,0,0,0,0,0,0,0,0,0,,,,,,
"Feb 16, 2022 4:00 AM",2,1,1,1,0,1,2,1,1,2,1,1,0,0,0,0,0,0,0,0,0,0,0,1,0,0,0,1,0,0,,,,,,
"Feb 16, 2022 5:00 AM",4,2,2,1,1,0,0,0,0,0,0,0,1,1,0,3,6,6,0,0,0,0,6,2,0,0,0,8,0,0,,,,,,
"Feb 16, 2022 6:00 AM",29,20,9,7,3,4,5,2,3,4,2,2,0,0,0,3,15,15,0,0,0,0,14,11,1,0,1,19,0,1,,,,,,
"Feb 16, 2022 7:00 AM",76,54,22,18,5,13,27,9,18,21,9,12,3,2,1,3,39,39,0,0,0,0,40,21,10,7,3,36,0,1,,,,,,
"Feb 16, 2022 8:00 AM",181,144,37,25,10,15,54,27,27,47,22,25,21,15,6,22,91,91,0,0,0,0,82,29,42,20,22,83,1,7,,,,,,
"Feb 16, 2022 9:00 AM",117,101,16,21,7,14,54,23,31,32,16,16,6,5,1,9,55,55,0,0,0,0,46,19,21,10,11,39,3,5,,,,,,
"Feb 16, 2022 10:00 AM",56,37,19,17,12,5,42,27,15,26,19,7,14,5,9,4,36,36,0,0,0,0,28,9,15,9,6,19,1,1,,,,,,
"Feb 16, 2022 11:00 AM",53,31,22,24,12,12,17,8,9,16,8,8,14,8,6,6,11,11,0,0,0,0,11,4,7,2,5,9,0,0,,,,,,
"Feb 16, 2022 12:00 PM",48,27,21,16,7,9,14,4,10,13,5,8,6,1,5,2,18,17,1,0,0,0,16,5,9,6,3,16,2,3,,,,,,
"Feb 16, 2022 1:00 PM",38,16,22,12,7,5,23,14,9,20,12,8,9,5,4,5,19,14,5,0,0,0,14,14,11,9,2,13,2,1,,,,,,
"Feb 16, 2022 2:00 PM",34,13,21,2,1,1,9,4,5,6,2,4,3,1,2,3,12,7,5,0,0,0,8,8,6,4,2,8,1,0,,,,,,
"Feb 16, 2022 3:00 PM",55,24,31,3,2,1,11,7,4,8,6,2,5,2,3,9,19,17,2,0,0,0,11,14,4,2,2,13,0,0,,,,,,
"Feb 16, 2022 4:00 PM",101,25,76,15,10,5,32,18,14,26,13,13,9,3,6,9,20,17,3,0,0,0,18,19,17,13,4,23,5,1,,,,,,
"Feb 16, 2022 5:00 PM",155,30,125,23,15,8,47,28,19,41,26,15,7,3,4,4,26,19,7,0,0,0,21,42,25,19,6,33,2,0,,,,,,
"Feb 16, 2022 6:00 PM",141,35,106,15,11,4,30,19,11,22,14,8,7,1,6,8,21,19,2,0,0,0,18,29,15,11,4,25,2,3,,,,,,
"Feb 16, 2022 7:00 PM",69,23,46,20,14,6,20,14,6,17,11,6,2,0,2,5,15,11,4,0,0,0,10,25,14,11,3,11,2,2,,,,,,
"Feb 16, 2022 8:00 PM",44,14,30,4,4,0,9,8,1,8,7,1,0,0,0,5,10,9,1,0,0,0,9,17,6,5,1,12,1,2,,,,,,
"Feb 16, 2022 9:00 PM",38,8,30,2,2,0,6,4,2,3,1,2,1,0,1,2,10,7,3,0,0,0,8,10,3,2,1,5,3,0,,,,,,
"Feb 16, 2022 10:00 PM",16,6,10,3,2,1,2,2,0,4,1,3,0,0,0,2,4,3,1,0,0,0,3,7,1,1,0,2,0,0,,,,,,
"Feb 16, 2022 11:00 PM",12,4,8,4,4,0,2,0,2,1,1,0,0,0,0,0,4,2,2,0,0,0,0,3,0,0,0,3,0,0,,,,,,
"Feb 17, 2022 12:00 AM",2,0,2,0,0,0,1,1,0,5,2,3,0,0,0,2,1,1,0,0,0,0,1,2,0,0,0,0,0,0,,,,,,
"Feb 17, 2022 1:00 AM",3,0,3,0,0,0,0,0,0,0,0,0,0,0,0,0,0,0,0,0,0,0,0,2,0,0,0,0,0,0,,,,,,
"Feb 17, 2022 2:00 AM",2,1,1,0,0,0,0,0,0,0,0,0,0,0,0,0,0,0,0,0,0,0,0,0,1,1,0,0,0,0,,,,,,
"Feb 17, 2022 3:00 AM",0,0,0,0,0,0,0,0,0,0,0,0,0,0,0,0,0,0,0,0,0,0,0,0,0,0,0,0,0,0,,,,,,
"Feb 17, 2022 4:00 AM",1,1,0,0,0,0,0,0,0,0,0,0,0,0,0,1,0,0,0,0,0,0,0,0,0,0,0,1,0,0,,,,,,
"Feb 17, 2022 5:00 AM",4,3,1,0,0,0,2,0,2,1,0,1,0,0,0,1,8,8,0,0,0,0,7,2,0,0,0,11,0,1,,,,,,
"Feb 17, 2022 6:00 AM",30,21,9,11,2,9,12,4,8,12,2,10,4,3,1,3,17,17,0,0,0,0,17,11,3,1,2,28,0,0,,,,,,
"Feb 17, 2022 7:00 AM",99,68,31,36,13,23,42,18,24,44,21,23,5,4,1,8,48,48,0,0,0,0,53,29,13,5,8,59,2,5,,,,,,
"Feb 17, 2022 8:00 AM",191,155,36,78,28,50,124,43,81,95,40,55,19,9,10,27,100,100,0,0,0,0,87,35,58,14,44,120,8,5,,,,,,
"Feb 17, 2022 9:00 AM",128,104,24,54,17,37,63,31,32,50,20,30,8,8,0,8,68,68,0,0,0,0,59,19,31,17,14,54,2,5,,,,,,
"Feb 17, 2022 10:00 AM",55,39,16,25,3,22,46,19,27,26,11,15,9,2,7,9,29,29,0,0,0,0,20,11,17,9,8,24,1,2,,,,,,
"Feb 17, 2022 11:00 AM",35,20,15,26,14,12,36,19,17,31,12,19,5,1,4,8,24,21,3,0,0,0,16,10,9,6,3,27,5,5,,,,,,
"Feb 17, 2022 12:00 PM",66,30,36,18,12,6,34,17,17,15,11,4,11,10,1,14,19,15,4,0,0,0,16,12,15,10,5,19,5,2,,,,,,
"Feb 17, 2022 1:00 PM",75,38,37,28,15,13,38,23,15,36,19,17,13,7,6,7,25,20,5,0,0,0,18,17,15,11,4,12,3,3,,,,,,
"Feb 17, 2022 2:00 PM",56,23,33,18,11,7,30,17,13,18,9,9,10,6,4,14,19,17,2,0,0,0,14,16,15,10,5,19,0,3,,,,,,
"Feb 17, 2022 3:00 PM",65,26,39,28,14,14,41,20,21,32,16,16,8,4,4,14,30,28,2,0,0,0,21,26,16,8,8,19,2,2,,,,,,
"Feb 17, 2022 4:00 PM",125,40,85,26,21,5,47,32,15,34,26,8,12,7,5,19,28,21,7,0,0,0,22,29,25,20,5,33,9,0,,,,,,
"Feb 17, 2022 5:00 PM",191,44,147,42,26,16,64,40,24,59,34,25,15,3,12,21,26,20,6,0,0,0,22,53,32,27,5,42,5,4,,,,,,
"Feb 17, 2022 6:00 PM",131,30,101,45,37,8,58,45,13,45,35,10,8,4,4,14,28,26,2,0,0,0,26,57,30,27,3,41,7,4,,,,,,
"Feb 17, 2022 7:00 PM",78,20,58,21,17,4,38,26,12,27,16,11,7,2,5,9,11,9,2,0,0,0,6,32,12,11,1,19,5,2,,,,,,
"Feb 17, 2022 8:00 PM",57,15,42,14,9,5,24,14,10,17,10,7,3,1,2,4,12,11,1,0,0,0,11,15,8,4,4,11,1,4,,,,,,
"Feb 17, 2022 9:00 PM",38,10,28,2,2,0,8,4,4,4,3,1,1,0,1,6,10,8,2,0,0,0,6,13,2,1,1,9,1,0,,,,,,
"Feb 17, 2022 10:00 PM",24,8,16,2,0,2,3,2,1,4,1,3,0,0,0,4,3,3,0,0,0,0,3,7,1,1,0,8,2,0,,,,,,
"Feb 17, 2022 11:00 PM",11,3,8,0,0,0,2,0,2,0,0,0,1,0,1,2,1,1,0,0,0,0,0,2,0,0,0,0,0,0,,,,,,
"Feb 18, 2022 12:00 AM",5,1,4,0,0,0,0,0,0,0,0,0,0,0,0,2,2,2,0,0,0,0,1,1,1,1,0,1,0,0,,,,,,
"Feb 18, 2022 1:00 AM",2,0,2,0,0,0,1,0,1,1,0,1,0,0,0,0,0,0,0,0,0,0,0,0,0,0,0,0,0,0,,,,,,
"Feb 18, 2022 2:00 AM",2,1,1,0,0,0,0,0,0,0,0,0,0,0,0,0,0,0,0,0,0,0,0,0,0,0,0,0,0,0,,,,,,
"Feb 18, 2022 3:00 AM",3,0,3,0,0,0,0,0,0,0,0,0,0,0,0,0,0,0,0,0,0,0,0,0,0,0,0,2,0,0,,,,,,
"Feb 18, 2022 4:00 AM",3,1,2,0,0,0,0,0,0,0,0,0,0,0,0,0,1,0,1,0,0,0,0,0,0,0,0,0,0,0,,,,,,
"Feb 18, 2022 5:00 AM",2,1,1,2,2,0,1,0,1,2,1,1,0,0,0,1,4,4,0,0,0,0,4,1,1,1,0,2,0,0,,,,,,
"Feb 18, 2022 6:00 AM",22,15,7,2,1,1,8,4,4,7,4,3,0,0,0,3,6,6,0,0,0,0,7,6,0,0,0,12,0,1,,,,,,
"Feb 18, 2022 7:00 AM",55,34,21,26,10,16,21,6,15,19,7,12,4,2,2,0,27,27,0,0,0,0,27,14,7,3,4,34,0,0,,,,,,
"Feb 18, 2022 8:00 AM",101,77,24,39,15,24,55,20,35,44,19,25,17,9,8,14,49,48,1,0,0,0,45,13,27,11,16,56,2,4,,,,,,
"Feb 18, 2022 9:00 AM",60,45,15,25,15,10,27,14,13,24,15,9,2,2,0,6,32,30,2,0,0,0,24,15,10,6,4,23,0,1,,,,,,
"Feb 18, 2022 10:00 AM",33,22,11,5,1,4,10,4,6,6,2,4,5,3,2,4,12,10,2,0,0,0,8,5,3,0,3,7,1,0,,,,,,
"Feb 18, 2022 11:00 AM",22,14,8,7,5,2,5,2,3,6,3,3,3,2,1,2,10,10,0,0,0,0,7,2,3,1,2,7,4,1,,,,,,
"Feb 18, 2022 12:00 PM",31,16,15,1,1,0,7,3,4,5,3,2,4,2,2,4,9,9,0,0,0,0,9,3,2,1,1,7,0,0,,,,,,
"Feb 18, 2022 1:00 PM",39,14,25,11,9,2,20,15,5,17,6,11,5,2,3,5,10,9,1,0,0,0,10,12,3,3,0,6,0,0,,,,,,
"Feb 18, 2022 2:00 PM",53,27,26,11,3,8,9,4,5,6,3,3,4,2,2,12,14,12,2,0,0,0,10,6,12,11,1,7,2,1,,,,,,
"Feb 18, 2022 3:00 PM",36,21,15,12,6,6,26,14,12,17,7,10,13,1,12,9,13,9,4,0,0,0,6,10,12,6,6,13,2,2,,,,,,
"Feb 18, 2022 4:00 PM",58,21,37,21,14,7,21,16,5,24,18,6,9,3,6,7,17,14,3,0,0,0,14,26,11,10,1,10,2,1,,,,,,
"Feb 18, 2022 5:00 PM",91,27,64,16,7,9,20,12,8,21,12,9,3,1,2,7,12,8,4,0,0,0,10,16,12,10,2,16,0,3,,,,,,
"Feb 18, 2022 6:00 PM",54,14,40,7,6,1,24,20,4,13,10,3,6,2,4,6,15,10,5,0,0,0,10,17,15,12,3,14,0,0,,,,,,
"Feb 18, 2022 7:00 PM",43,14,29,9,8,1,14,11,3,10,6,4,2,2,0,4,11,10,1,0,0,0,10,14,4,4,0,17,3,1,,,,,,
"Feb 18, 2022 8:00 PM",23,8,15,2,2,0,7,6,1,3,1,2,3,1,2,5,3,3,0,0,0,0,3,5,4,4,0,7,0,1,,,,,,
"Feb 18, 2022 9:00 PM",19,3,16,6,3,3,5,2,3,5,2,3,2,1,1,6,8,6,2,0,0,0,5,3,2,1,1,7,0,0,,,,,,
"Feb 18, 2022 10:00 PM",12,4,8,2,2,0,3,3,0,3,3,0,1,0,1,4,6,6,0,0,0,0,5,4,6,5,1,1,0,2,,,,,,
"Feb 18, 2022 11:00 PM",9,4,5,2,1,1,2,0,2,2,0,2,1,1,0,1,0,0,0,0,0,0,0,6,0,0,0,5,0,1,,,,,,
"Feb 19, 2022 12:00 AM",10,3,7,1,1,0,0,0,0,0,0,0,1,1,0,1,2,2,0,0,0,0,2,1,0,0,0,1,0,0,,,,,,
"Feb 19, 2022 1:00 AM",3,0,3,0,0,0,0,0,0,1,0,1,0,0,0,1,0,0,0,0,0,0,0,3,0,0,0,1,0,0,,,,,,
"Feb 19, 2022 2:00 AM",3,3,0,0,0,0,0,0,0,0,0,0,0,0,0,1,1,1,0,0,0,0,1,1,0,0,0,1,0,0,,,,,,
"Feb 19, 2022 3:00 AM",0,0,0,1,1,0,2,2,0,1,1,0,0,0,0,0,0,0,0,0,0,0,0,1,0,0,0,2,0,0,,,,,,
"Feb 19, 2022 4:00 AM",0,0,0,0,0,0,0,0,0,0,0,0,0,0,0,0,0,0,0,0,0,0,0,1,1,1,0,0,0,1,,,,,,
"Feb 19, 2022 5:00 AM",3,0,3,1,0,1,0,0,0,0,0,0,0,0,0,1,1,1,0,0,0,0,1,2,0,0,0,1,1,0,,,,,,
"Feb 19, 2022 6:00 AM",3,1,2,1,0,1,5,1,4,1,0,1,0,0,0,1,1,1,0,0,0,0,1,1,1,1,0,2,0,0,,,,,,
"Feb 19, 2022 7:00 AM",9,4,5,5,2,3,6,4,2,6,3,3,2,0,2,1,2,2,0,0,0,0,2,3,1,1,0,5,0,0,,,,,,
"Feb 19, 2022 8:00 AM",11,5,6,5,4,1,7,4,3,6,4,2,1,1,0,3,1,1,0,0,0,0,1,4,1,0,1,6,0,0,,,,,,
"Feb 19, 2022 9:00 AM",20,15,5,29,18,11,26,17,9,26,17,9,4,4,0,1,5,5,0,0,0,0,3,9,4,3,1,6,0,2,,,,,,
"Feb 19, 2022 10:00 AM",23,14,9,22,10,12,22,12,10,18,10,8,4,2,2,2,11,11,0,0,0,0,11,9,9,3,6,16,1,0,,,,,,
"Feb 19, 2022 11:00 AM",18,6,12,32,15,17,33,22,11,27,17,10,4,2,2,4,8,8,0,0,0,0,6,10,10,9,1,16,3,2,,,,,,
"Feb 19, 2022 12:00 PM",28,14,14,23,12,11,24,15,9,15,9,6,6,4,2,5,14,14,0,0,0,0,13,17,7,4,3,19,3,2,,,,,,
"Feb 19, 2022 1:00 PM",34,13,21,27,19,8,39,20,19,24,14,10,8,3,5,10,13,13,0,0,0,0,14,13,17,13,4,15,1,1,,,,,,
"Feb 19, 2022 2:00 PM",34,22,12,37,14,23,44,23,21,35,20,15,9,5,4,12,19,19,0,0,0,0,16,15,20,11,9,17,0,3,,,,,,
"Feb 19, 2022 3:00 PM",37,20,17,49,21,28,58,33,25,52,34,18,15,12,3,11,9,8,1,0,0,0,5,17,21,9,12,8,6,2,,,,,,
"Feb 19, 2022 4:00 PM",47,28,19,47,28,19,43,23,20,36,22,14,16,8,8,12,20,18,2,0,0,0,19,16,24,17,7,33,4,0,,,,,,
"Feb 19, 2022 5:00 PM",37,16,21,49,24,25,50,26,24,41,16,25,18,5,13,12,12,11,1,0,0,0,9,5,23,10,13,22,3,0,,,,,,
"Feb 19, 2022 6:00 PM",31,12,19,9,9,0,16,8,8,10,3,7,4,1,3,10,9,9,0,0,0,0,12,5,5,1,4,8,2,1,,,,,,
"Feb 19, 2022 7:00 PM",39,18,21,6,6,0,10,7,3,9,5,4,5,0,5,6,3,3,0,0,0,0,2,8,1,1,0,13,1,3,,,,,,
"Feb 19, 2022 8:00 PM",28,12,16,2,2,0,8,5,3,6,2,4,5,0,5,2,1,1,0,0,0,0,2,5,1,1,0,3,0,0,,,,,,
"Feb 19, 2022 9:00 PM",15,5,10,0,0,0,5,2,3,0,0,0,1,0,1,0,7,7,0,0,0,0,7,4,2,1,1,8,1,1,,,,,,
"Feb 19, 2022 10:00 PM",9,3,6,1,0,1,2,1,1,2,0,2,2,2,0,3,1,1,0,0,0,0,1,2,2,2,0,4,0,0,,,,,,
"Feb 19, 2022 11:00 PM",8,2,6,0,0,0,0,0,0,1,0,1,2,2,0,0,0,0,0,0,0,0,0,4,0,0,0,0,1,0,,,,,,
"Feb 20, 2022 12:00 AM",7,1,6,0,0,0,1,1,0,1,0,1,0,0,0,1,2,2,0,0,0,0,1,4,1,1,0,0,0,1,,,,,,
"Feb 20, 2022 1:00 AM",5,1,4,0,0,0,1,0,1,1,0,1,1,1,0,1,2,2,0,0,0,0,2,1,1,1,0,3,0,2,,,,,,
"Feb 20, 2022 2:00 AM",6,3,3,0,0,0,1,1,0,0,0,0,0,0,0,0,0,0,0,0,0,0,0,1,2,2,0,0,0,0,,,,,,
"Feb 20, 2022 3:00 AM",1,0,1,1,1,0,2,2,0,1,1,0,0,0,0,1,0,0,0,0,0,0,1,1,2,2,0,0,0,0,,,,,,
"Feb 20, 2022 4:00 AM",2,0,2,0,0,0,0,0,0,0,0,0,0,0,0,1,0,0,0,0,0,0,0,1,0,0,0,0,0,0,,,,,,
"Feb 20, 2022 5:00 AM",2,1,1,0,0,0,0,0,0,0,0,0,0,0,0,0,1,1,0,0,0,0,1,1,0,0,0,1,1,1,,,,,,
"Feb 20, 2022 6:00 AM",1,1,0,1,1,0,2,2,0,1,1,0,0,0,0,0,1,1,0,0,0,0,1,1,0,0,0,3,0,0,,,,,,
"Feb 20, 2022 7:00 AM",8,3,5,3,2,1,2,2,0,3,3,0,0,0,0,0,6,5,1,0,0,0,6,3,0,0,0,2,0,0,,,,,,
"Feb 20, 2022 8:00 AM",3,2,1,3,0,3,5,2,3,5,2,3,0,0,0,0,1,1,0,0,0,0,1,2,2,2,0,4,0,0,,,,,,
"Feb 20, 2022 9:00 AM",7,5,2,4,1,3,6,0,6,5,1,4,2,2,0,1,9,9,0,0,0,0,7,3,6,2,4,11,0,1,,,,,,
"Feb 20, 2022 10:00 AM",12,8,4,13,6,7,18,13,5,15,11,4,5,3,2,2,7,6,1,0,0,0,4,5,5,2,3,5,0,1,,,,,,
"Feb 20, 2022 11:00 AM",12,5,7,6,2,4,12,5,7,8,4,4,1,1,0,3,5,4,1,0,0,0,4,3,3,2,1,10,1,1,,,,,,
"Feb 20, 2022 12:00 PM",7,4,3,2,0,2,4,2,2,5,1,4,1,0,1,0,2,2,0,0,0,0,1,4,0,0,0,3,0,0,,,,,,
"Feb 20, 2022 1:00 PM",12,5,7,0,0,0,3,3,0,2,2,0,1,1,0,2,7,5,2,0,0,0,5,6,0,0,0,6,0,1,,,,,,
"Feb 20, 2022 2:00 PM",17,8,9,7,4,3,4,2,2,9,4,5,2,1,1,6,2,2,0,0,0,0,2,1,2,2,0,10,2,1,,,,,,
"Feb 20, 2022 3:00 PM",9,5,4,7,2,5,8,3,5,5,2,3,1,0,1,0,4,4,0,0,0,0,3,2,2,1,1,2,0,2,,,,,,
"Feb 20, 2022 4:00 PM",7,4,3,10,5,5,9,5,4,2,0,2,6,4,2,4,10,9,1,0,0,0,9,5,2,0,2,3,1,0,,,,,,
"Feb 20, 2022 5:00 PM",18,8,10,7,6,1,8,7,1,9,7,2,10,5,5,5,4,4,0,0,0,0,3,4,1,1,0,6,0,0,,,,,,
"Feb 20, 2022 6:00 PM",13,6,7,13,6,7,12,5,7,13,4,9,0,0,0,1,1,1,0,0,0,0,2,4,2,1,1,6,0,0,,,,,,
"Feb 20, 2022 7:00 PM",24,8,16,3,2,1,4,1,3,2,1,1,0,0,0,3,1,1,0,0,0,0,1,3,1,0,1,3,0,0,,,,,,
"Feb 20, 2022 8:00 PM",18,7,11,3,2,1,1,0,1,2,1,1,0,0,0,0,4,3,1,0,0,0,2,5,0,0,0,6,1,0,,,,,,
"Feb 20, 2022 9:00 PM",8,2,6,2,1,1,0,0,0,2,0,2,0,0,0,0,4,4,0,0,0,0,4,2,1,1,0,1,1,0,,,,,,
"Feb 20, 2022 10:00 PM",6,0,6,1,0,1,1,1,0,1,0,1,0,0,0,1,1,1,0,0,0,0,1,3,0,0,0,5,0,1,,,,,,
"Feb 20, 2022 11:00 PM",4,1,3,0,0,0,1,1,0,0,0,0,0,0,0,0,0,0,0,0,0,0,1,2,0,0,0,1,0,0,,,,,,
"Feb 21, 2022 12:00 AM",5,1,4,0,0,0,0,0,0,1,1,0,0,0,0,0,1,1,0,0,0,0,0,0,0,0,0,0,0,1,,,,,,
"Feb 21, 2022 1:00 AM",1,1,0,0,0,0,0,0,0,0,0,0,0,0,0,1,0,0,0,0,0,0,0,0,2,2,0,0,0,0,,,,,,
"Feb 21, 2022 2:00 AM",2,2,0,0,0,0,0,0,0,0,0,0,0,0,0,3,0,0,0,0,0,0,0,0,0,0,0,0,0,0,,,,,,
"Feb 21, 2022 3:00 AM",0,0,0,0,0,0,0,0,0,0,0,0,0,0,0,0,0,0,0,0,0,0,0,0,0,0,0,1,0,0,,,,,,
"Feb 21, 2022 4:00 AM",1,0,1,0,0,0,0,0,0,0,0,0,0,0,0,0,1,1,0,0,0,0,1,0,0,0,0,0,0,0,,,,,,
"Feb 21, 2022 5:00 AM",1,1,0,0,0,0,2,1,1,1,0,1,0,0,0,3,8,8,0,0,0,0,8,0,0,0,0,6,0,0,,,,,,
"Feb 21, 2022 6:00 AM",19,11,8,2,1,1,4,2,2,3,1,2,3,3,0,3,8,8,0,0,0,0,8,5,0,0,0,15,0,1,,,,,,
"Feb 21, 2022 7:00 AM",58,42,16,7,2,5,10,3,7,13,5,8,3,2,1,4,19,18,1,0,0,0,19,16,6,2,4,24,1,0,,,,,,
"Feb 21, 2022 8:00 AM",94,75,19,16,2,14,27,9,18,18,9,9,9,3,6,6,49,49,0,0,0,0,44,24,14,4,10,58,2,2,,,,,,
"Feb 21, 2022 9:00 AM",73,63,10,15,5,10,21,13,8,19,12,7,6,2,4,7,31,31,0,0,0,0,26,18,10,4,6,23,0,0,,,,,,
"Feb 21, 2022 10:00 AM",40,28,12,5,3,2,9,5,4,7,3,4,2,2,0,9,14,13,1,0,0,0,13,1,8,5,3,12,0,1,,,,,,
"Feb 21, 2022 11:00 AM",35,21,14,11,6,5,15,9,6,12,9,3,5,2,3,2,12,10,2,0,0,0,7,7,7,3,4,15,0,0,,,,,,
"Feb 21, 2022 12:00 PM",53,28,25,22,12,10,29,17,12,22,14,8,17,10,7,6,24,23,1,0,0,0,16,9,10,5,5,11,1,1,,,,,,
"Feb 21, 2022 1:00 PM",46,25,21,25,16,9,36,17,19,19,8,11,9,3,6,8,19,19,0,0,0,0,17,19,12,3,9,15,1,0,,,,,,
"Feb 21, 2022 2:00 PM",48,26,22,23,15,8,33,18,15,32,17,15,16,8,8,16,19,15,4,0,0,0,11,4,14,10,4,17,1,2,,,,,,
"Feb 21, 2022 3:00 PM",59,29,30,34,21,13,49,31,18,29,17,12,7,5,2,14,19,16,3,0,0,0,15,15,17,11,6,15,2,3,,,,,,
"Feb 21, 2022 4:00 PM",92,19,73,43,21,22,45,24,21,37,20,17,11,5,6,35,22,17,5,0,0,0,17,24,23,17,6,16,7,0,,,,,,
"Feb 21, 2022 5:00 PM",137,34,103,47,28,19,66,33,33,57,38,19,14,4,10,24,26,20,6,0,0,0,24,38,38,22,16,40,4,1,,,,,,
"Feb 21, 2022 6:00 PM",98,26,72,44,27,17,52,26,26,49,26,23,10,1,9,10,23,18,5,0,0,0,19,34,24,15,9,31,3,2,,,,,,
"Feb 21, 2022 7:00 PM",85,30,55,18,11,7,24,18,6,18,11,7,12,8,4,3,17,13,4,0,0,0,11,19,9,9,0,16,5,3,,,,,,
"Feb 21, 2022 8:00 PM",63,19,44,18,13,5,15,12,3,17,13,4,1,1,0,7,13,11,2,0,0,0,11,15,6,4,2,7,3,0,,,,,,
"Feb 21, 2022 9:00 PM",42,14,28,7,4,3,10,5,5,8,4,4,1,0,1,6,15,12,3,0,0,0,9,11,1,0,1,6,3,1,,,,,,
"Feb 21, 2022 10:00 PM",27,4,23,4,4,0,6,1,5,1,0,1,1,0,1,5,6,3,3,0,0,0,3,6,1,0,1,10,1,1,,,,,,
"Feb 21, 2022 11:00 PM",6,0,6,1,1,0,4,4,0,1,1,0,0,0,0,1,2,2,0,0,0,0,1,7,0,0,0,1,0,0,,,,,,
"Feb 22, 2022 12:00 AM",1,0,1,0,0,0,0,0,0,2,1,1,0,0,0,2,1,1,0,0,0,0,2,3,0,0,0,2,0,0,,,,,,
"Feb 22, 2022 1:00 AM",2,0,2,0,0,0,0,0,0,0,0,0,0,0,0,1,0,0,0,0,0,0,0,1,0,0,0,0,0,0,,,,,,
"Feb 22, 2022 2:00 AM",0,0,0,0,0,0,0,0,0,0,0,0,0,0,0,0,1,0,1,0,0,0,0,0,0,0,0,0,0,0,,,,,,
"Feb 22, 2022 3:00 AM",0,0,0,0,0,0,0,0,0,0,0,0,0,0,0,0,0,0,0,0,0,0,0,0,1,1,0,0,0,0,,,,,,
"Feb 22, 2022 4:00 AM",1,1,0,0,0,0,0,0,0,0,0,0,0,0,0,2,1,1,0,0,0,0,1,0,0,0,0,0,0,0,,,,,,
"Feb 22, 2022 5:00 AM",3,3,0,0,0,0,1,0,1,1,0,1,0,0,0,1,9,9,0,0,0,0,9,0,0,0,0,8,0,1,,,,,,
"Feb 22, 2022 6:00 AM",32,23,9,4,1,3,6,3,3,4,1,3,0,0,0,5,11,11,0,0,0,0,11,9,3,3,0,23,0,0,,,,,,
"Feb 22, 2022 7:00 AM",48,29,19,14,3,11,9,2,7,8,2,6,3,2,1,2,33,32,1,0,0,0,33,11,9,3,6,28,0,2,,,,,,
"Feb 22, 2022 8:00 AM",155,120,35,36,11,25,62,27,35,52,28,24,5,3,2,9,80,80,0,0,0,0,70,25,25,10,15,84,3,4,,,,,,
"Feb 22, 2022 9:00 AM",97,83,14,35,16,19,50,29,21,41,25,16,12,7,5,8,56,55,1,0,0,0,47,19,29,14,15,44,1,3,,,,,,
"Feb 22, 2022 10:00 AM",51,40,11,29,18,11,40,21,19,26,17,9,8,6,2,11,36,35,1,0,0,0,31,4,15,7,8,33,3,3,,,,,,
"Feb 22, 2022 11:00 AM",46,31,15,23,14,9,26,14,12,24,13,11,22,16,6,10,24,23,1,0,0,0,19,11,12,7,5,12,1,3,,,,,,
"Feb 22, 2022 12:00 PM",49,25,24,34,14,20,40,19,21,31,14,17,10,4,6,12,37,35,2,0,0,0,27,15,15,8,7,23,3,7,,,,,,
"Feb 22, 2022 1:00 PM",72,42,30,26,14,12,38,24,14,35,24,11,12,6,6,6,24,23,1,0,0,0,19,19,14,9,5,22,1,0,,,,,,
"Feb 22, 2022 2:00 PM",54,33,21,39,22,17,39,22,17,21,13,8,15,10,5,16,31,23,8,0,0,0,19,16,14,12,2,17,5,1,,,,,,
"Feb 22, 2022 3:00 PM",65,29,36,30,13,17,43,30,13,22,17,5,15,3,12,16,24,19,5,0,0,0,17,11,19,14,5,10,1,0,,,,,,
"Feb 22, 2022 4:00 PM",83,22,61,44,28,16,53,29,24,43,23,20,15,9,6,14,18,13,5,0,0,0,11,32,31,26,5,25,2,0,,,,,,
"Feb 22, 2022 5:00 PM",194,62,132,41,28,13,71,39,32,58,32,26,15,6,9,6,27,18,9,0,0,0,20,47,43,27,16,36,3,3,,,,,,
"Feb 22, 2022 6:00 PM",136,31,105,30,22,8,58,40,18,40,23,17,12,6,6,19,34,26,8,0,0,0,28,57,36,25,11,39,5,1,,,,,,
"Feb 22, 2022 7:00 PM",89,24,65,21,14,7,34,22,12,29,18,11,8,3,5,5,15,13,2,0,0,0,13,28,19,15,4,18,2,0,,,,,,
"Feb 22, 2022 8:00 PM",65,20,45,17,13,4,19,9,10,17,9,8,11,5,6,6,21,19,2,0,0,0,15,22,8,7,1,14,3,3,,,,,,
"Feb 22, 2022 9:00 PM",50,11,39,7,7,0,16,13,3,12,7,5,2,0,2,5,16,13,3,0,0,0,14,11,5,4,1,7,2,1,,,,,,
"Feb 22, 2022 10:00 PM",22,6,16,7,3,4,8,1,7,8,0,8,2,1,1,3,5,4,1,0,0,0,7,4,2,2,0,10,3,1,,,,,,
"Feb 22, 2022 11:00 PM",12,4,8,2,1,1,7,5,2,5,3,2,0,0,0,0,2,1,1,0,0,0,0,5,2,2,0,4,0,0,,,,,,
"Feb 23, 2022 12:00 AM",1,0,1,0,0,0,1,1,0,3,2,1,2,0,2,0,0,0,0,0,0,0,0,2,2,2,0,1,0,0,,,,,,
"Feb 23, 2022 1:00 AM",5,0,5,0,0,0,2,2,0,0,0,0,0,0,0,3,0,0,0,0,0,0,0,0,0,0,0,0,0,0,,,,,,
"Feb 23, 2022 2:00 AM",3,3,0,0,0,0,0,0,0,0,0,0,0,0,0,0,0,0,0,0,0,0,0,0,0,0,0,0,0,0,,,,,,
"Feb 23, 2022 3:00 AM",1,0,1,0,0,0,3,3,0,1,1,0,2,0,2,0,0,0,0,0,0,0,0,2,1,1,0,0,0,0,,,,,,
"Feb 23, 2022 4:00 AM",0,0,0,1,0,1,2,1,1,2,1,1,0,0,0,0,1,1,0,0,0,0,1,1,0,0,0,0,0,0,,,,,,
"Feb 23, 2022 5:00 AM",5,5,0,1,1,0,0,0,0,0,0,0,0,0,0,1,9,9,0,0,0,0,9,0,0,0,0,6,0,0,,,,,,
"Feb 23, 2022 6:00 AM",41,28,13,14,4,10,11,3,8,13,3,10,1,0,1,1,18,18,0,0,0,0,18,10,4,1,3,22,0,0,,,,,,
"Feb 23, 2022 7:00 AM",84,54,30,55,26,29,49,17,32,42,16,26,8,7,1,11,49,46,3,0,0,0,52,30,18,8,10,77,5,7,,,,,,
"Feb 23, 2022 8:00 AM",192,160,32,50,9,41,95,30,65,69,25,44,11,7,4,12,105,104,1,0,0,0,99,27,42,15,27,124,5,7,,,,,,
"Feb 23, 2022 9:00 AM",100,89,11,42,22,20,70,41,29,54,38,16,15,9,6,11,58,58,0,0,0,0,52,23,49,25,24,45,2,4,,,,,,
"Feb 23, 2022 10:00 AM",59,39,20,46,20,26,39,15,24,36,17,19,15,13,2,11,31,30,1,0,0,0,20,14,14,8,6,22,4,3,,,,,,
"Feb 23, 2022 11:00 AM",46,26,20,33,13,20,31,14,17,28,13,15,12,2,10,15,28,26,2,0,0,0,14,3,21,10,11,25,3,2,,,,,,
"Feb 23, 2022 12:00 PM",60,30,30,37,17,20,39,19,20,29,16,13,13,7,6,12,17,16,1,0,0,0,15,24,15,9,6,17,1,4,,,,,,
"Feb 23, 2022 1:00 PM",79,40,39,58,31,27,72,41,31,56,29,27,16,4,12,14,26,23,3,0,0,0,23,24,32,23,9,20,4,5,,,,,,
"Feb 23, 2022 2:00 PM",56,19,37,23,13,10,41,21,20,26,17,9,21,12,9,15,29,23,6,0,0,0,18,13,22,17,5,15,0,0,,,,,,
"Feb 23, 2022 3:00 PM",66,20,46,41,21,20,42,24,18,31,16,15,7,2,5,11,15,11,4,0,0,0,7,18,23,16,7,23,2,2,,,,,,
"Feb 23, 2022 4:00 PM",92,20,72,23,14,9,41,18,23,35,15,20,10,4,6,8,20,16,4,0,0,0,15,29,32,18,14,28,4,3,,,,,,
"Feb 23, 2022 5:00 PM",155,34,121,47,35,12,63,42,21,51,35,16,15,3,12,12,35,26,9,0,0,0,27,66,28,21,7,42,3,3,,,,,,
"Feb 23, 2022 6:00 PM",122,20,102,31,24,7,56,46,10,46,31,15,10,4,6,8,21,19,2,0,0,0,17,61,33,26,7,29,4,1,,,,,,
"Feb 23, 2022 7:00 PM",56,13,43,21,19,2,29,19,10,25,16,9,5,2,3,10,15,10,5,0,0,0,9,26,15,11,4,18,2,3,,,,,,
"Feb 23, 2022 8:00 PM",49,11,38,6,5,1,15,10,5,14,7,7,7,4,3,4,12,9,3,0,0,0,9,18,8,7,1,6,0,1,,,,,,
"Feb 23, 2022 9:00 PM",28,7,21,5,2,3,8,4,4,9,3,6,3,1,2,6,7,6,1,0,0,0,4,9,4,3,1,8,1,0,,,,,,
"Feb 23, 2022 10:00 PM",24,8,16,1,1,0,2,2,0,2,2,0,1,1,0,3,5,4,1,0,0,0,3,12,0,0,0,2,0,0,,,,,,
"Feb 23, 2022 11:00 PM",10,0,10,1,1,0,1,1,0,0,0,0,1,0,1,1,1,1,0,0,0,0,1,5,1,1,0,2,0,0,,,,,,
"Feb 24, 2022 12:00 AM",5,1,4,0,0,0,0,0,0,0,0,0,0,0,0,0,1,1,0,0,0,0,2,3,0,0,0,0,0,1,,,,,,
"Feb 24, 2022 1:00 AM",0,0,0,1,1,0,3,3,0,0,0,0,0,0,0,0,0,0,0,0,0,0,0,1,0,0,0,1,1,0,,,,,,
"Feb 24, 2022 2:00 AM",0,0,0,0,0,0,0,0,0,1,1,0,0,0,0,0,0,0,0,0,0,0,0,1,0,0,0,1,0,0,,,,,,
"Feb 24, 2022 3:00 AM",0,0,0,0,0,0,0,0,0,0,0,0,0,0,0,0,0,0,0,0,0,0,1,0,0,0,0,0,0,0,,,,,,
"Feb 24, 2022 4:00 AM",1,1,0,0,0,0,0,0,0,0,0,0,0,0,0,0,0,0,0,0,0,0,0,0,0,0,0,0,0,1,,,,,,
"Feb 24, 2022 5:00 AM",2,2,0,0,0,0,1,0,1,2,0,2,0,0,0,1,7,7,0,0,0,0,7,1,0,0,0,8,0,0,,,,,,
"Feb 24, 2022 6:00 AM",27,19,8,4,1,3,10,4,6,8,3,5,3,2,1,3,15,15,0,0,0,0,15,10,3,2,1,23,0,0,,,,,,
"Feb 24, 2022 7:00 AM",59,39,20,29,8,21,33,13,20,27,9,18,5,3,2,8,41,40,1,0,0,0,43,28,13,7,6,51,2,2,,,,,,
"Feb 24, 2022 8:00 AM",140,116,24,41,11,30,71,20,51,56,27,29,9,4,5,3,59,59,0,0,0,0,57,24,32,10,22,82,3,5,,,,,,
"Feb 24, 2022 9:00 AM",76,56,20,24,6,18,40,20,20,35,19,16,7,5,2,2,38,38,0,0,0,0,30,16,19,8,11,46,0,1,,,,,,
"Feb 24, 2022 10:00 AM",56,50,6,13,7,6,29,18,11,19,14,5,7,5,2,4,25,25,0,0,0,0,22,7,9,6,3,21,0,0,,,,,,
"Feb 24, 2022 11:00 AM",34,17,17,18,5,13,29,10,19,27,8,19,4,1,3,16,20,18,2,0,0,0,13,7,17,8,9,18,5,2,,,,,,
"Feb 24, 2022 12:00 PM",54,32,22,28,19,9,25,10,15,23,12,11,12,8,4,11,27,23,4,0,0,0,21,12,16,9,7,23,1,2,,,,,,
"Feb 24, 2022 1:00 PM",62,32,30,18,12,6,35,20,15,31,16,15,18,9,9,15,27,24,3,0,0,0,16,13,14,10,4,6,2,2,,,,,,
"Feb 24, 2022 2:00 PM",48,19,29,29,23,6,35,20,15,35,22,13,9,6,3,8,18,18,0,0,0,0,15,11,22,19,3,11,1,1,,,,,,
"Feb 24, 2022 3:00 PM",54,22,32,21,11,10,38,19,19,27,13,14,7,3,4,11,15,11,4,0,0,0,10,13,18,14,4,15,1,0,,,,,,
"Feb 24, 2022 4:00 PM",86,23,63,33,21,12,37,21,16,29,20,9,14,5,9,22,28,21,7,0,0,0,17,30,14,11,3,21,7,2,,,,,,
"Feb 24, 2022 5:00 PM",127,31,96,28,20,8,62,34,28,54,29,25,17,8,9,10,25,18,7,0,0,0,17,53,33,21,12,35,3,5,,,,,,
"Feb 24, 2022 6:00 PM",107,34,73,29,23,6,47,33,14,38,27,11,8,5,3,6,28,24,4,0,0,0,28,53,25,23,2,34,4,3,,,,,,
"Feb 24, 2022 7:00 PM",74,18,56,19,18,1,28,23,5,26,22,4,2,0,2,3,18,11,7,0,0,0,10,21,10,9,1,20,2,1,,,,,,
"Feb 24, 2022 8:00 PM",49,14,35,8,8,0,14,12,2,12,10,2,3,2,1,10,13,10,3,0,0,0,9,13,6,6,0,17,1,2,,,,,,
"Feb 24, 2022 9:00 PM",46,11,35,5,4,1,4,2,2,9,3,6,0,0,0,5,7,7,0,0,0,0,7,6,0,0,0,4,1,2,,,,,,
"Feb 24, 2022 10:00 PM",21,9,12,4,1,3,3,0,3,4,1,3,1,1,0,1,4,1,3,0,0,0,2,7,0,0,0,5,0,2,,,,,,
"Feb 24, 2022 11:00 PM",17,3,14,1,0,1,4,1,3,4,0,4,2,0,2,0,4,3,1,0,0,0,3,8,0,0,0,3,0,0,,,,,,
"Feb 25, 2022 12:00 AM",7,4,3,0,0,0,1,1,0,1,1,0,0,0,0,1,0,0,0,0,0,0,0,2,5,5,0,2,0,1,,,,,,
"Feb 25, 2022 1:00 AM",2,0,2,0,0,0,0,0,0,0,0,0,0,0,0,1,1,1,0,0,0,0,1,1,0,0,0,1,0,1,,,,,,
"Feb 25, 2022 2:00 AM",5,0,5,0,0,0,0,0,0,0,0,0,0,0,0,0,0,0,0,0,0,0,0,2,0,0,0,0,0,0,,,,,,
"Feb 25, 2022 3:00 AM",0,0,0,0,0,0,1,1,0,1,1,0,1,0,1,0,0,0,0,0,0,0,1,1,0,0,0,1,0,0,,,,,,
"Feb 25, 2022 4:00 AM",1,1,0,0,0,0,0,0,0,0,0,0,0,0,0,0,1,1,0,0,0,0,0,0,0,0,0,1,0,0,,,,,,
"Feb 25, 2022 5:00 AM",2,2,0,0,0,0,0,0,0,1,0,1,0,0,0,1,9,9,0,0,0,0,10,2,1,0,1,5,1,0,,,,,,
"Feb 25, 2022 6:00 AM",22,12,10,3,1,2,5,2,3,2,1,1,0,0,0,3,12,11,1,0,0,0,13,7,1,0,1,17,0,1,,,,,,
"Feb 25, 2022 7:00 AM",65,43,22,41,20,21,49,23,26,40,20,20,4,3,1,5,35,35,0,0,0,0,36,23,10,8,2,41,3,6,,,,,,
"Feb 25, 2022 8:00 AM",122,90,32,60,17,43,83,38,45,61,32,29,18,12,6,10,74,74,0,0,0,0,67,19,38,17,21,87,2,6,,,,,,
"Feb 25, 2022 9:00 AM",86,72,14,46,25,21,81,44,37,69,44,25,14,11,3,6,39,38,1,0,0,0,43,15,32,18,14,51,3,2,,,,,,
"Feb 25, 2022 10:00 AM",59,42,17,52,25,27,57,40,17,47,34,13,9,3,6,11,39,39,0,0,0,0,29,14,19,12,7,24,0,3,,,,,,
"Feb 25, 2022 11:00 AM",56,33,23,64,38,26,77,32,45,64,34,30,11,8,3,27,30,28,2,0,0,0,24,20,32,21,11,17,5,5,,,,,,
"Feb 25, 2022 12:00 PM",54,24,30,73,43,30,64,29,35,61,31,30,22,12,10,10,16,15,1,0,0,0,11,18,17,7,10,27,2,7,,,,,,
"Feb 25, 2022 1:00 PM",85,40,45,57,24,33,64,28,36,58,24,34,18,10,8,18,28,25,3,0,0,0,22,24,32,18,14,20,3,2,,,,,,
"Feb 25, 2022 2:00 PM",86,47,39,58,32,26,63,37,26,52,32,20,14,11,3,16,24,18,6,0,0,0,18,14,33,27,6,30,2,2,,,,,,
"Feb 25, 2022 3:00 PM",75,28,47,69,39,30,76,44,32,49,29,20,20,6,14,18,24,21,3,0,0,0,19,24,26,18,8,23,2,0,,,,,,
"Feb 25, 2022 4:00 PM",102,30,72,61,34,27,80,42,38,70,33,37,16,5,11,9,26,22,4,0,0,0,21,39,36,24,12,30,4,1,,,,,,
"Feb 25, 2022 5:00 PM",162,49,113,44,24,20,72,38,34,48,23,25,20,8,12,17,38,29,9,0,0,0,29,47,36,17,19,39,3,3,,,,,,
"Feb 25, 2022 6:00 PM",110,33,77,40,23,17,47,30,17,49,29,20,9,4,5,12,26,24,2,0,0,0,22,48,27,24,3,28,5,0,,,,,,
"Feb 25, 2022 7:00 PM",95,25,70,23,14,9,42,26,16,23,13,10,10,5,5,6,19,16,3,0,0,0,20,29,12,6,6,26,1,0,,,,,,
"Feb 25, 2022 8:00 PM",35,15,20,7,5,2,14,10,4,12,8,4,4,2,2,8,12,11,1,0,0,0,13,13,7,6,1,11,2,1,,,,,,
"Feb 25, 2022 9:00 PM",45,16,29,11,8,3,10,5,5,7,4,3,2,1,1,10,10,9,1,0,0,0,9,10,6,6,0,5,1,3,,,,,,
"Feb 25, 2022 10:00 PM",30,10,20,5,4,1,7,4,3,4,2,2,0,0,0,6,9,8,1,0,0,0,7,11,5,3,2,6,1,1,,,,,,
"Feb 25, 2022 11:00 PM",15,3,12,3,1,2,5,2,3,4,1,3,3,0,3,1,3,3,0,0,0,0,3,9,1,0,1,7,0,0,,,,,,
"Feb 26, 2022 12:00 AM",14,4,10,0,0,0,1,0,1,4,1,3,6,2,4,1,2,2,0,0,0,0,2,2,1,0,1,4,0,1,,,,,,
"Feb 26, 2022 1:00 AM",13,1,12,0,0,0,6,1,5,4,1,3,1,1,0,0,1,0,1,0,0,0,0,4,4,0,4,2,0,1,,,,,,
"Feb 26, 2022 2:00 AM",3,1,2,0,0,0,0,0,0,0,0,0,0,0,0,0,0,0,0,0,0,0,0,1,0,0,0,0,0,0,,,,,,
"Feb 26, 2022 3:00 AM",4,2,2,0,0,0,1,1,0,1,1,0,0,0,0,0,0,0,0,0,0,0,1,5,0,0,0,1,0,0,,,,,,
"Feb 26, 2022 4:00 AM",1,1,0,0,0,0,0,0,0,0,0,0,0,0,0,0,0,0,0,0,0,0,0,1,1,1,0,1,0,2,,,,,,
"Feb 26, 2022 5:00 AM",1,0,1,0,0,0,0,0,0,0,0,0,0,0,0,0,1,1,0,0,0,0,1,1,0,0,0,0,0,0,,,,,,
"Feb 26, 2022 6:00 AM",6,5,1,1,0,1,3,2,1,1,0,1,0,0,0,1,1,1,0,0,0,0,1,2,0,0,0,4,0,0,,,,,,
"Feb 26, 2022 7:00 AM",20,9,11,14,7,7,12,8,4,11,7,4,0,0,0,4,8,8,0,0,0,0,7,11,3,1,2,27,0,1,,,,,,
"Feb 26, 2022 8:00 AM",20,13,7,30,17,13,50,33,17,27,23,4,10,7,3,9,11,11,0,0,0,0,13,16,10,5,5,9,2,4,,,,,,
"Feb 26, 2022 9:00 AM",44,29,15,81,43,38,90,49,41,88,54,34,13,10,3,16,17,16,1,0,0,0,16,28,33,25,8,28,2,4,,,,,,
"Feb 26, 2022 10:00 AM",40,20,20,74,40,34,77,44,33,63,39,24,16,8,8,9,13,13,0,0,0,0,13,32,33,19,14,30,1,4,,,,,,
"Feb 26, 2022 11:00 AM",44,20,24,67,32,35,87,43,44,67,31,36,11,7,4,8,18,18,0,0,0,0,17,7,38,18,20,23,0,3,,,,,,
"Feb 26, 2022 12:00 PM",49,24,25,60,22,38,70,32,38,58,22,36,10,7,3,9,11,10,1,0,0,0,9,17,40,22,18,35,1,4,,,,,,
"Feb 26, 2022 1:00 PM",54,28,26,46,25,21,50,23,27,41,21,20,13,5,8,16,11,10,1,0,0,0,9,20,21,13,8,16,5,3,,,,,,
"Feb 26, 2022 2:00 PM",49,28,21,31,9,22,37,20,17,28,12,16,12,9,3,7,13,13,0,0,0,0,15,11,20,10,10,21,2,1,,,,,,
"Feb 26, 2022 3:00 PM",37,21,16,16,10,6,37,21,16,27,15,12,10,6,4,14,10,10,0,0,0,0,8,10,22,11,11,16,3,1,,,,,,
"Feb 26, 2022 4:00 PM",28,17,11,24,12,12,44,17,27,37,17,20,11,4,7,4,16,14,2,0,0,0,12,16,15,7,8,21,4,1,,,,,,
"Feb 26, 2022 5:00 PM",47,23,24,19,10,9,29,12,17,31,7,24,4,0,4,10,8,8,0,0,0,0,8,7,13,6,7,22,2,2,,,,,,
"Feb 26, 2022 6:00 PM",32,15,17,8,4,4,23,5,18,14,6,8,8,1,7,3,10,10,0,0,0,0,9,6,5,0,5,11,0,2,,,,,,
"Feb 26, 2022 7:00 PM",53,24,29,2,1,1,8,4,4,3,2,1,3,1,2,7,12,11,1,0,0,0,9,6,4,3,1,7,0,0,,,,,,
"Feb 26, 2022 8:00 PM",38,14,24,2,2,0,4,3,1,3,2,1,5,3,2,1,9,8,1,0,0,0,9,12,2,2,0,11,2,0,,,,,,
"Feb 26, 2022 9:00 PM",19,11,8,1,0,1,4,4,0,3,2,1,1,0,1,1,9,9,0,0,0,0,8,2,1,1,0,6,0,1,,,,,,
"Feb 26, 2022 10:00 PM",10,2,8,2,1,1,1,1,0,1,1,0,1,0,1,2,4,4,0,0,0,0,4,2,3,1,2,7,0,1,,,,,,
"Feb 26, 2022 11:00 PM",12,3,9,4,4,0,5,3,2,5,3,2,3,2,1,0,0,0,0,0,0,0,0,2,2,1,1,1,1,0,,,,,,
"Feb 27, 2022 12:00 AM",8,5,3,1,1,0,1,0,1,3,1,2,0,0,0,0,3,3,0,0,0,0,3,2,0,0,0,6,0,2,,,,,,
"Feb 27, 2022 1:00 AM",9,4,5,1,1,0,2,2,0,2,2,0,0,0,0,1,1,1,0,0,0,0,1,1,2,2,0,3,1,0,,,,,,
"Feb 27, 2022 2:00 AM",4,2,2,0,0,0,1,0,1,0,0,0,0,0,0,0,1,1,0,0,0,0,1,0,0,0,0,0,0,0,,,,,,
"Feb 27, 2022 3:00 AM",5,1,4,0,0,0,1,0,1,0,0,0,0,0,0,0,0,0,0,0,0,0,0,1,0,0,0,0,0,0,,,,,,
"Feb 27, 2022 4:00 AM",0,0,0,0,0,0,1,1,0,0,0,0,0,0,0,0,1,1,0,0,0,0,1,0,2,2,0,0,0,0,,,,,,
"Feb 27, 2022 5:00 AM",0,0,0,0,0,0,0,0,0,0,0,0,0,0,0,0,2,2,0,0,0,0,2,3,0,0,0,4,0,1,,,,,,
"Feb 27, 2022 6:00 AM",3,3,0,2,1,1,3,1,2,2,1,1,0,0,0,0,4,4,0,0,0,0,3,0,2,2,0,4,1,0,,,,,,
"Feb 27, 2022 7:00 AM",17,6,11,5,1,4,4,4,0,4,2,2,0,0,0,3,5,5,0,0,0,0,5,6,2,2,0,7,0,2,,,,,,
"Feb 27, 2022 8:00 AM",20,13,7,42,22,20,47,32,15,30,20,10,5,3,2,6,10,10,0,0,0,0,9,18,11,7,4,18,0,5,,,,,,
"Feb 27, 2022 9:00 AM",28,18,10,68,44,24,78,49,29,71,46,25,9,6,3,14,17,17,0,0,0,0,14,18,22,17,5,35,2,4,,,,,,
"Feb 27, 2022 10:00 AM",34,20,14,112,55,57,110,62,48,98,52,46,22,12,10,17,20,18,2,0,0,0,18,30,47,32,15,40,2,3,,,,,,
"Feb 27, 2022 11:00 AM",52,26,26,100,52,48,113,60,53,101,50,51,15,10,5,27,14,14,0,0,0,0,15,19,36,20,16,42,6,4,,,,,,
"Feb 27, 2022 12:00 PM",50,20,30,85,40,45,66,29,37,69,31,38,22,9,13,17,23,22,1,0,0,0,21,25,28,12,16,25,8,4,,,,,,
"Feb 27, 2022 1:00 PM",69,41,28,71,41,30,66,34,32,60,34,26,16,9,7,22,17,17,0,0,0,0,19,11,33,20,13,40,4,4,,,,,,
"Feb 27, 2022 2:00 PM",49,29,20,56,21,35,61,20,41,58,23,35,8,4,4,16,23,23,0,0,0,0,26,17,25,13,12,28,2,1,,,,,,
"Feb 27, 2022 3:00 PM",33,18,15,31,15,16,48,20,28,39,18,21,16,7,9,10,9,9,0,0,0,0,8,14,20,5,15,16,1,0,,,,,,
"Feb 27, 2022 4:00 PM",32,19,13,21,13,8,24,14,10,23,10,13,6,4,2,10,11,11,0,0,0,0,9,11,12,10,2,11,2,2,,,,,,
"Feb 27, 2022 5:00 PM",39,18,21,30,16,14,33,16,17,27,12,15,5,1,4,7,7,7,0,0,0,0,6,18,16,12,4,16,2,0,,,,,,
"Feb 27, 2022 6:00 PM",41,14,27,14,6,8,30,15,15,21,8,13,5,1,4,3,7,7,0,0,0,0,8,8,6,4,2,13,0,1,,,,,,
"Feb 27, 2022 7:00 PM",30,9,21,4,2,2,12,7,5,8,6,2,9,5,4,6,3,3,0,0,0,0,3,6,6,5,1,15,0,0,,,,,,
"Feb 27, 2022 8:00 PM",29,15,14,4,2,2,11,6,5,4,1,3,3,0,3,3,6,6,0,0,0,0,6,11,4,1,3,4,1,0,,,,,,
"Feb 27, 2022 9:00 PM",12,5,7,4,1,3,2,0,2,3,1,2,3,2,1,1,3,2,1,0,0,0,2,6,0,0,0,5,0,0,,,,,,
"Feb 27, 2022 10:00 PM",7,3,4,3,2,1,3,2,1,2,1,1,0,0,0,1,5,5,0,0,0,0,4,5,5,2,3,3,0,2,,,,,,
"Feb 27, 2022 11:00 PM",9,2,7,1,0,1,4,0,4,3,0,3,1,0,1,0,1,0,1,0,0,0,0,5,1,0,1,5,0,0,,,,,,
"Feb 28, 2022 12:00 AM",1,0,1,0,0,0,0,0,0,1,1,0,0,0,0,0,1,1,0,0,0,0,1,1,0,0,0,0,0,0,,,,,,
"Feb 28, 2022 1:00 AM",2,0,2,0,0,0,0,0,0,0,0,0,0,0,0,0,1,1,0,0,0,0,1,0,0,0,0,0,0,0,,,,,,
"Feb 28, 2022 2:00 AM",1,0,1,0,0,0,0,0,0,0,0,0,0,0,0,0,0,0,0,0,0,0,0,0,0,0,0,0,0,0,,,,,,
"Feb 28, 2022 3:00 AM",1,0,1,0,0,0,0,0,0,0,0,0,0,0,0,0,0,0,0,0,0,0,1,1,0,0,0,0,0,0,,,,,,
"Feb 28, 2022 4:00 AM",1,0,1,0,0,0,0,0,0,0,0,0,0,0,0,0,0,0,0,0,0,0,0,0,0,0,0,0,0,0,,,,,,
"Feb 28, 2022 5:00 AM",5,3,2,0,0,0,1,0,1,1,0,1,0,0,0,3,8,8,0,0,0,0,8,1,0,0,0,9,0,0,,,,,,
"Feb 28, 2022 6:00 AM",34,24,10,10,1,9,19,5,14,12,3,9,4,3,1,2,22,21,1,0,0,0,22,7,7,2,5,28,1,3,,,,,,
"Feb 28, 2022 7:00 AM",96,63,33,49,16,33,65,20,45,42,18,24,11,10,1,8,49,48,1,0,0,0,49,21,27,11,16,69,3,4,,,,,,
"Feb 28, 2022 8:00 AM",210,161,49,77,20,57,121,43,78,93,35,58,27,17,10,25,126,125,1,0,0,0,117,35,80,18,62,119,6,6,,,,,,
"Feb 28, 2022 9:00 AM",123,102,21,49,20,29,72,41,31,72,39,33,11,8,3,9,72,71,1,0,0,0,54,25,34,20,14,47,1,3,,,,,,
"Feb 28, 2022 10:00 AM",54,39,15,20,14,6,43,28,15,25,17,8,3,3,0,7,27,26,1,0,0,0,22,17,14,10,4,25,2,2,,,,,,
"Feb 28, 2022 11:00 AM",31,13,18,28,15,13,36,14,22,23,13,10,10,8,2,7,25,21,4,0,0,0,15,7,14,8,6,16,1,0,,,,,,
"Feb 28, 2022 12:00 PM",46,21,25,24,17,7,37,14,23,27,12,15,9,2,7,8,25,23,2,0,0,0,15,15,8,3,5,16,0,3,,,,,,
"Feb 28, 2022 1:00 PM",58,29,29,25,10,15,34,16,18,32,16,16,13,6,7,6,14,13,1,0,0,0,11,18,16,7,9,17,3,2,,,,,,
"Feb 28, 2022 2:00 PM",33,16,17,17,13,4,13,8,5,18,11,7,10,3,7,8,17,11,6,0,0,0,13,12,13,9,4,18,1,1,,,,,,
"Feb 28, 2022 3:00 PM",72,31,41,16,9,7,31,20,11,21,12,9,10,5,5,11,24,21,3,0,0,0,21,20,23,18,5,19,2,1,,,,,,
"Feb 28, 2022 4:00 PM",126,36,90,38,28,10,55,36,19,52,33,19,9,2,7,17,28,24,4,0,0,0,21,40,25,22,3,26,4,2,,,,,,
"Feb 28, 2022 5:00 PM",177,43,134,50,34,16,61,37,24,62,33,29,19,7,12,23,33,30,3,0,0,0,27,94,34,20,14,50,5,4,,,,,,
"Feb 28, 2022 6:00 PM",135,42,93,55,43,12,72,55,17,59,43,16,19,2,17,21,29,26,3,0,0,0,26,62,36,33,3,33,4,2,,,,,,
"Feb 28, 2022 7:00 PM",89,18,71,27,19,8,35,25,10,28,19,9,11,7,4,9,25,21,4,0,0,0,20,27,15,13,2,11,6,2,,,,,,
"Feb 28, 2022 8:00 PM",65,19,46,6,5,1,17,8,9,12,5,7,4,3,1,4,14,11,3,0,0,0,10,13,5,4,1,17,0,0,,,,,,
"Feb 28, 2022 9:00 PM",43,12,31,9,7,2,10,4,6,9,6,3,2,1,1,7,13,7,6,0,0,0,9,6,3,2,1,11,0,2,,,,,,
"Feb 28, 2022 10:00 PM",30,5,25,1,1,0,5,3,2,3,1,2,2,0,2,3,9,4,5,0,0,0,3,11,4,4,0,5,0,0,,,,,,
"Feb 28, 2022 11:00 PM",3,0,3,0,0,0,4,2,2,0,0,0,0,0,0,0,5,4,1,0,0,0,4,3,0,0,0,4,0,0,,,,,,
"Mar 1, 2022 12:00 AM",5,0,5,0,0,0,1,1,0,1,1,0,0,0,0,0,2,2,0,0,0,0,1,4,0,0,0,1,0,0,0,0,0,,,
"Mar 1, 2022 1:00 AM",5,3,2,1,1,0,3,2,1,2,1,1,0,0,0,0,0,0,0,0,0,0,0,2,0,0,0,0,1,0,0,0,0,,,
"Mar 1, 2022 2:00 AM",2,1,1,0,0,0,0,0,0,0,0,0,0,0,0,0,0,0,0,0,0,0,0,0,0,0,0,0,0,0,0,0,0,,,
"Mar 1, 2022 3:00 AM",0,0,0,0,0,0,0,0,0,0,0,0,0,0,0,0,0,0,0,0,0,0,1,0,0,0,0,1,0,0,0,0,0,,,
"Mar 1, 2022 4:00 AM",1,1,0,0,0,0,0,0,0,0,0,0,0,0,0,1,0,0,0,0,0,0,0,1,0,0,0,1,0,1,0,0,0,,,
"Mar 1, 2022 5:00 AM",5,4,1,0,0,0,0,0,0,1,0,1,0,0,0,3,11,11,0,0,0,0,12,1,0,0,0,7,1,0,0,0,0,,,
"Mar 1, 2022 6:00 AM",37,28,9,11,3,8,17,5,12,13,5,8,2,2,0,4,22,20,2,0,0,0,23,19,4,1,3,35,0,3,0,0,0,,,
"Mar 1, 2022 7:00 AM",125,81,44,50,15,35,76,23,53,54,18,36,11,10,1,13,59,59,0,0,0,0,59,36,32,15,17,90,4,7,0,0,0,,,
"Mar 1, 2022 8:00 AM",243,182,61,99,25,74,149,44,105,119,48,71,37,22,15,17,147,146,1,0,0,0,135,38,91,27,64,167,5,7,0,0,0,,,
"Mar 1, 2022 9:00 AM",136,117,19,61,24,37,95,46,49,78,39,39,16,15,1,8,66,65,1,0,0,0,58,23,56,31,25,59,2,5,0,0,0,,,
"Mar 1, 2022 10:00 AM",66,45,21,71,31,40,71,40,31,61,31,30,7,4,3,9,46,45,1,0,0,0,41,20,28,15,13,27,3,1,0,0,0,,,
"Mar 1, 2022 11:00 AM",53,36,17,46,22,24,58,26,32,45,27,18,15,10,5,11,25,24,1,0,0,0,18,10,29,14,15,26,0,4,0,0,0,,,
"Mar 1, 2022 12:00 PM",67,40,27,72,33,39,93,46,47,63,30,33,21,12,9,14,34,31,3,0,0,0,21,26,21,11,10,19,8,7,0,0,0,,,
"Mar 1, 2022 1:00 PM",78,34,44,54,30,24,74,39,35,59,32,27,20,14,6,12,33,30,3,0,0,0,30,28,45,18,27,23,4,2,0,0,0,,,
"Mar 1, 2022 2:00 PM",75,32,43,40,20,20,70,44,26,40,21,19,14,8,6,18,20,16,4,0,0,0,15,22,42,29,13,23,3,3,0,0,0,,,
"Mar 1, 2022 3:00 PM",76,34,42,58,32,26,70,42,28,53,34,19,16,5,11,14,29,22,7,0,0,0,24,32,47,24,23,28,4,5,0,0,0,,,
"Mar 1, 2022 4:00 PM",145,40,105,58,37,21,72,47,25,72,47,25,14,4,10,8,29,23,6,0,0,0,24,48,48,28,20,49,4,1,0,0,0,,,
"Mar 1, 2022 5:00 PM",199,50,149,69,52,17,96,61,35,88,53,35,26,9,17,21,38,32,6,0,0,0,32,98,66,47,19,58,13,4,0,0,0,,,
"Mar 1, 2022 6:00 PM",164,29,135,69,52,17,97,78,19,71,51,20,14,7,7,17,41,36,5,0,0,0,38,85,49,45,4,40,4,2,0,0,0,,,
"Mar 1, 2022 7:00 PM",107,39,68,34,23,11,39,25,14,32,19,13,11,2,9,10,24,21,3,0,0,0,21,39,21,17,4,20,5,4,0,0,0,,,
"Mar 1, 2022 8:00 PM",59,16,43,13,8,5,22,18,4,16,11,5,5,2,3,8,19,16,3,0,0,0,14,23,15,13,2,12,0,2,0,0,0,,,
"Mar 1, 2022 9:00 PM",45,11,34,5,5,0,15,9,6,11,5,6,2,2,0,9,17,13,4,0,0,0,12,11,10,8,2,12,4,2,0,0,0,,,
"Mar 1, 2022 10:00 PM",35,10,25,5,4,1,6,5,1,3,2,1,0,0,0,1,9,8,1,0,0,0,10,10,5,3,2,4,1,0,0,0,0,,,
"Mar 1, 2022 11:00 PM",8,2,6,2,1,1,6,2,4,1,1,0,0,0,0,0,2,2,0,0,0,0,1,1,2,1,1,4,0,0,0,0,0,,,
"Mar 2, 2022 12:00 AM",1,0,1,0,0,0,1,1,0,1,1,0,2,1,1,1,1,0,1,0,0,0,1,3,1,1,0,0,1,1,0,0,0,,,
"Mar 2, 2022 1:00 AM",3,2,1,1,1,0,0,0,0,0,0,0,0,0,0,0,0,0,0,1,1,0,0,1,0,0,0,0,0,0,0,0,0,,,
"Mar 2, 2022 2:00 AM",3,3,0,0,0,0,0,0,0,0,0,0,0,0,0,0,0,0,0,0,0,0,0,0,0,0,0,6,0,0,0,0,0,,,
"Mar 2, 2022 3:00 AM",0,0,0,0,0,0,0,0,0,0,0,0,0,0,0,0,0,0,0,0,0,0,0,0,0,0,0,1,0,0,0,0,0,,,
"Mar 2, 2022 4:00 AM",2,1,1,0,0,0,0,0,0,0,0,0,0,0,0,0,1,1,0,0,0,0,1,1,0,0,0,0,0,1,0,0,0,,,
"Mar 2, 2022 5:00 AM",3,2,1,0,0,0,3,1,2,3,1,2,0,0,0,3,9,9,0,0,0,0,9,1,0,0,0,7,1,0,0,0,0,,,
"Mar 2, 2022 6:00 AM",31,19,12,15,4,11,14,4,10,13,7,6,2,1,1,2,18,18,0,0,0,0,18,8,3,1,2,35,0,1,0,0,0,,,
"Mar 2, 2022 7:00 AM",94,67,27,36,7,29,50,16,34,36,10,26,12,10,2,13,58,58,0,0,0,0,57,31,22,10,12,72,2,5,0,0,0,,,
"Mar 2, 2022 8:00 AM",193,150,43,37,9,28,85,28,57,56,23,33,19,13,6,28,100,98,2,0,0,0,92,36,40,9,31,147,6,4,0,0,0,,,
"Mar 2, 2022 9:00 AM",107,91,16,23,7,16,41,17,24,40,20,20,7,7,0,7,45,45,0,0,0,0,38,16,18,6,12,44,1,2,0,0,0,,,
"Mar 2, 2022 10:00 AM",49,33,16,15,6,9,29,15,14,17,9,8,1,1,0,5,25,24,1,0,0,0,14,9,10,5,5,11,3,0,0,0,0,,,
"Mar 2, 2022 11:00 AM",34,20,14,4,1,3,11,8,3,4,4,0,3,0,3,2,21,21,0,0,0,0,15,8,6,6,0,4,2,2,0,0,0,,,
"Mar 2, 2022 12:00 PM",42,23,19,8,6,2,12,5,7,12,5,7,3,1,2,5,12,11,1,0,0,0,8,7,3,2,1,12,0,0,0,0,0,,,
"Mar 2, 2022 1:00 PM",58,29,29,17,13,4,26,15,11,19,11,8,8,3,5,10,23,18,5,0,0,0,15,12,5,2,3,10,0,1,0,0,0,,,
"Mar 2, 2022 2:00 PM",51,22,29,6,5,1,15,8,7,6,5,1,2,1,1,5,12,9,3,0,0,0,8,10,7,3,4,13,2,0,0,0,0,,,
"Mar 2, 2022 3:00 PM",53,20,33,2,2,0,12,7,5,9,5,4,5,2,3,8,18,14,4,0,0,0,12,9,9,5,4,15,1,1,0,0,0,,,
"Mar 2, 2022 4:00 PM",97,30,67,11,11,0,17,16,1,9,7,2,4,1,3,13,22,19,3,0,0,0,18,24,11,10,1,21,4,0,0,0,0,,,
"Mar 2, 2022 5:00 PM",170,45,125,22,17,5,34,22,12,30,18,12,11,3,8,17,33,25,8,0,0,0,24,60,26,23,3,29,2,2,0,0,0,,,
"Mar 2, 2022 6:00 PM",134,26,108,20,15,5,57,43,14,42,27,15,9,2,7,12,26,16,10,0,0,0,20,72,31,25,6,36,2,3,0,0,0,,,
"Mar 2, 2022 7:00 PM",92,28,64,19,15,4,34,28,6,28,19,9,13,3,10,8,14,8,6,0,0,0,5,35,14,12,2,21,2,3,0,0,0,,,
"Mar 2, 2022 8:00 PM",52,14,38,7,7,0,16,12,4,11,7,4,2,0,2,3,9,9,0,0,0,0,14,22,7,6,1,9,2,1,0,0,0,,,
"Mar 2, 2022 9:00 PM",47,13,34,5,3,2,9,6,3,4,3,1,3,2,1,5,9,8,1,0,0,0,7,5,3,1,2,11,3,2,0,0,0,,,
"Mar 2, 2022 10:00 PM",24,7,17,3,3,0,4,3,1,3,2,1,1,0,1,2,3,1,2,0,0,0,4,14,2,2,0,2,1,1,0,0,0,,,
"Mar 2, 2022 11:00 PM",7,2,5,0,0,0,1,0,1,0,0,0,0,0,0,0,1,0,1,0,0,0,1,2,0,0,0,2,0,0,0,0,0,,,
"Mar 3, 2022 12:00 AM",5,1,4,0,0,0,0,0,0,0,0,0,2,1,1,1,4,2,2,0,0,0,2,1,1,1,0,0,0,0,0,0,0,,,
"Mar 3, 2022 1:00 AM",4,2,2,0,0,0,0,0,0,0,0,0,0,0,0,0,0,0,0,0,0,0,0,2,1,1,0,0,0,1,0,0,0,,,
"Mar 3, 2022 2:00 AM",3,2,1,0,0,0,0,0,0,0,0,0,0,0,0,0,1,0,1,0,0,0,0,0,0,0,0,0,0,0,0,0,0,,,
"Mar 3, 2022 3:00 AM",0,0,0,0,0,0,0,0,0,0,0,0,0,0,0,0,0,0,0,0,0,0,1,0,0,0,0,4,0,0,0,0,0,,,
"Mar 3, 2022 4:00 AM",1,1,0,0,0,0,0,0,0,1,0,1,0,0,0,0,0,0,0,0,0,0,0,0,0,0,0,3,0,0,0,0,0,,,
"Mar 3, 2022 5:00 AM",3,3,0,0,0,0,2,1,1,1,1,0,0,0,0,0,9,9,0,0,0,0,10,1,1,1,0,9,0,0,0,0,0,,,
"Mar 3, 2022 6:00 AM",41,31,10,9,1,8,13,3,10,12,4,8,6,6,0,4,17,17,0,0,0,0,17,10,3,0,3,29,2,7,0,0,0,,,
"Mar 3, 2022 7:00 AM",94,70,24,43,9,34,67,19,48,53,18,35,8,5,3,13,67,67,0,0,0,0,66,23,25,8,17,80,1,5,0,0,0,,,
"Mar 3, 2022 8:00 AM",224,156,68,75,19,56,123,32,91,91,28,63,33,23,10,28,122,120,2,0,0,0,110,35,74,18,56,162,7,4,0,0,0,,,
"Mar 3, 2022 9:00 AM",147,120,27,47,23,24,74,45,29,66,39,27,16,12,4,12,73,73,0,0,0,0,66,19,35,17,18,55,3,3,0,0,0,,,
"Mar 3, 2022 10:00 AM",69,49,20,43,24,19,51,31,20,41,27,14,9,6,3,8,45,44,1,0,0,0,35,22,20,10,10,23,1,5,0,0,0,,,
"Mar 3, 2022 11:00 AM",57,40,17,35,13,22,61,32,29,39,20,19,10,2,8,8,28,26,2,0,0,0,21,22,18,11,7,25,7,6,0,0,0,,,
"Mar 3, 2022 12:00 PM",72,46,26,49,22,27,77,36,41,50,20,30,19,14,5,8,13,13,0,0,0,0,14,22,26,14,12,30,6,1,0,0,0,,,
"Mar 3, 2022 1:00 PM",101,48,53,69,38,31,71,33,38,55,26,29,19,11,8,20,37,31,6,0,0,0,29,26,40,24,16,35,10,2,0,0,0,,,
"Mar 3, 2022 2:00 PM",76,36,40,51,31,20,56,35,21,39,24,15,17,11,6,14,37,34,3,0,0,0,25,36,27,15,12,30,3,7,0,0,0,,,
"Mar 3, 2022 3:00 PM",89,39,50,59,37,22,59,37,22,56,31,25,16,12,4,9,33,32,1,0,0,0,32,24,28,21,7,31,3,5,0,0,0,,,
"Mar 3, 2022 4:00 PM",123,30,93,53,33,20,91,52,39,61,36,25,17,7,10,23,38,30,8,0,0,0,28,55,45,32,13,36,7,2,0,0,0,,,
"Mar 3, 2022 5:00 PM",190,53,137,62,43,19,104,64,40,95,60,35,26,14,12,32,41,32,9,0,0,0,35,98,49,32,17,50,8,1,0,0,0,,,
"Mar 3, 2022 6:00 PM",173,46,127,62,37,25,86,60,26,68,41,27,12,10,2,32,38,29,9,0,0,0,25,89,33,25,8,54,5,3,0,0,0,,,
"Mar 3, 2022 7:00 PM",103,27,76,36,23,13,34,25,9,27,22,5,10,6,4,11,30,25,5,0,0,0,23,28,14,13,1,19,6,0,0,0,0,,,
"Mar 3, 2022 8:00 PM",74,22,52,15,11,4,34,21,13,16,9,7,7,3,4,7,14,14,0,0,0,0,14,27,10,5,5,17,5,4,0,0,0,,,
"Mar 3, 2022 9:00 PM",46,9,37,10,8,2,10,7,3,8,2,6,1,1,0,8,10,9,1,0,0,0,7,8,3,2,1,14,1,0,0,0,0,,,
"Mar 3, 2022 10:00 PM",27,7,20,5,4,1,6,2,4,4,3,1,11,3,8,6,9,7,2,0,0,0,7,15,1,1,0,5,1,2,0,0,0,,,
"Mar 3, 2022 11:00 PM",13,2,11,4,3,1,4,3,1,4,0,4,0,0,0,0,3,1,2,0,0,0,1,6,2,1,1,6,0,0,0,0,0,,,
"Mar 4, 2022 12:00 AM",7,4,3,0,0,0,0,0,0,1,1,0,0,0,0,1,3,2,1,0,0,0,2,2,1,1,0,1,0,1,0,0,0,,,
"Mar 4, 2022 1:00 AM",7,3,4,0,0,0,0,0,0,1,1,0,1,0,1,0,1,1,0,0,0,0,1,4,0,0,0,1,0,1,0,0,0,,,
"Mar 4, 2022 2:00 AM",6,3,3,0,0,0,0,0,0,0,0,0,0,0,0,0,1,1,0,0,0,0,1,0,0,0,0,7,0,0,0,0,0,,,
"Mar 4, 2022 3:00 AM",2,1,1,0,0,0,0,0,0,0,0,0,0,0,0,0,0,0,0,0,0,0,0,1,0,0,0,2,0,0,0,0,0,,,
"Mar 4, 2022 4:00 AM",0,0,0,0,0,0,0,0,0,0,0,0,0,0,0,0,0,0,0,0,0,0,0,1,0,0,0,2,0,1,0,0,0,,,
"Mar 4, 2022 5:00 AM",5,5,0,1,1,0,5,4,1,3,2,1,0,0,0,1,8,8,0,0,0,0,8,1,2,2,0,9,1,0,0,0,0,,,
"Mar 4, 2022 6:00 AM",25,16,9,15,6,9,15,5,10,13,5,8,1,0,1,3,13,13,0,0,0,0,12,11,4,2,2,20,2,1,0,0,0,,,
"Mar 4, 2022 7:00 AM",96,69,27,58,26,32,66,26,40,57,24,33,6,6,0,13,33,33,0,0,0,0,33,25,25,12,13,62,4,3,0,0,0,,,
"Mar 4, 2022 8:00 AM",194,152,42,73,16,57,115,41,74,94,38,56,49,29,20,22,97,96,1,0,0,0,94,40,62,24,38,135,4,5,0,0,0,,,
"Mar 4, 2022 9:00 AM",96,80,16,60,29,31,80,39,41,61,38,23,5,3,2,8,58,57,1,0,0,0,48,26,45,24,21,56,2,4,0,0,0,,,
"Mar 4, 2022 10:00 AM",69,45,24,51,29,22,76,45,31,60,37,23,7,4,3,9,36,35,1,0,0,0,29,20,30,20,10,35,0,3,0,0,0,,,
"Mar 4, 2022 11:00 AM",53,35,18,50,22,28,64,29,35,48,23,25,8,7,1,22,20,19,1,0,0,0,14,18,17,10,7,24,10,4,0,0,0,,,
"Mar 4, 2022 12:00 PM",59,32,27,74,43,31,85,52,33,55,34,21,17,4,13,10,35,32,3,0,0,0,27,30,32,23,9,19,3,7,0,0,0,,,
"Mar 4, 2022 1:00 PM",93,39,54,65,26,39,104,44,60,62,27,35,18,9,9,11,35,33,2,0,0,0,30,24,41,25,16,39,4,1,0,0,0,,,
"Mar 4, 2022 2:00 PM",77,41,36,43,22,21,50,23,27,41,22,19,19,8,11,15,26,20,6,0,0,0,21,24,34,21,13,33,5,4,0,0,0,,,
"Mar 4, 2022 3:00 PM",85,32,53,44,23,21,52,30,22,46,21,25,24,10,14,12,26,24,2,0,0,0,20,34,34,25,9,40,7,1,0,0,0,,,
"Mar 4, 2022 4:00 PM",140,41,99,66,38,28,95,56,39,73,48,25,16,6,10,23,32,28,4,0,0,0,27,52,35,21,14,39,5,4,0,0,0,,,
"Mar 4, 2022 5:00 PM",155,55,100,72,45,27,78,47,31,88,56,32,18,3,15,21,35,29,6,0,0,0,34,58,46,35,11,51,3,5,0,0,0,,,
"Mar 4, 2022 6:00 PM",125,29,96,49,31,18,68,51,17,49,30,19,5,2,3,17,25,23,2,0,0,0,24,55,34,29,5,39,10,2,0,0,0,,,
"Mar 4, 2022 7:00 PM",94,41,53,23,17,6,28,20,8,24,16,8,13,4,9,17,12,8,4,0,0,0,9,28,4,3,1,18,3,2,0,0,0,,,
"Mar 4, 2022 8:00 PM",67,27,40,11,8,3,20,14,6,12,7,5,2,2,0,9,8,6,2,0,0,0,3,16,10,8,2,16,1,1,0,0,0,,,
"Mar 4, 2022 9:00 PM",33,12,21,7,4,3,7,2,5,10,4,6,2,2,0,7,14,14,0,0,0,0,13,6,4,4,0,14,1,0,0,0,0,,,
"Mar 4, 2022 10:00 PM",19,5,14,10,6,4,8,3,5,9,4,5,1,0,1,6,8,8,0,0,0,0,9,1,2,2,0,8,0,1,0,0,0,,,
"Mar 4, 2022 11:00 PM",18,8,10,1,1,0,4,1,3,3,0,3,0,0,0,3,2,1,1,0,0,0,1,4,1,1,0,5,0,1,0,0,0,,,
"Mar 5, 2022 12:00 AM",14,9,5,1,0,1,3,1,2,7,1,6,2,2,0,1,2,2,0,0,0,0,0,3,1,1,0,4,1,0,0,0,0,,,
"Mar 5, 2022 1:00 AM",7,1,6,2,1,1,1,0,1,1,0,1,3,2,1,0,1,1,0,0,0,0,1,3,2,2,0,3,1,0,0,0,0,,,
"Mar 5, 2022 2:00 AM",6,3,3,1,1,0,1,1,0,2,2,0,0,0,0,0,1,1,0,0,0,0,1,1,0,0,0,2,0,0,0,0,0,,,
"Mar 5, 2022 3:00 AM",5,1,4,1,1,0,1,1,0,1,1,0,0,0,0,0,0,0,0,0,0,0,2,1,0,0,0,1,0,0,0,0,0,,,
"Mar 5, 2022 4:00 AM",1,0,1,0,0,0,0,0,0,0,0,0,0,0,0,0,0,0,0,0,0,0,0,2,0,0,0,1,0,0,0,0,0,,,
"Mar 5, 2022 5:00 AM",3,1,2,1,0,1,1,0,1,1,0,1,0,0,0,0,0,0,0,0,0,0,0,2,1,1,0,4,0,0,0,0,0,,,
"Mar 5, 2022 6:00 AM",6,4,2,4,3,1,5,3,2,5,4,1,1,0,1,0,3,3,0,0,0,0,2,6,0,0,0,7,0,0,0,0,0,,,
"Mar 5, 2022 7:00 AM",16,8,8,20,13,7,20,14,6,16,10,6,2,1,1,2,8,7,1,0,0,0,7,9,7,4,3,13,0,4,0,0,0,,,
"Mar 5, 2022 8:00 AM",36,16,20,59,34,25,53,35,18,49,33,16,7,4,3,4,11,11,0,0,0,0,10,14,23,16,7,19,3,3,0,0,0,,,
"Mar 5, 2022 9:00 AM",49,33,16,99,53,46,85,51,34,85,53,32,15,13,2,6,11,11,0,0,0,0,13,23,31,20,11,24,1,6,0,0,0,,,
"Mar 5, 2022 10:00 AM",52,31,21,134,59,75,135,81,54,116,67,49,15,12,3,16,17,16,1,0,0,0,18,41,47,35,12,28,9,11,0,0,0,,,
"Mar 5, 2022 11:00 AM",82,44,38,108,58,50,128,77,51,103,65,38,21,10,11,14,23,23,0,0,0,0,20,26,53,47,6,40,7,3,0,0,0,,,
"Mar 5, 2022 12:00 PM",86,40,46,134,71,63,151,72,79,104,63,41,33,24,9,28,19,18,1,0,0,0,18,29,60,32,28,44,4,1,0,0,0,,,
"Mar 5, 2022 1:00 PM",81,43,38,120,65,55,158,91,67,131,77,54,29,12,17,17,33,28,5,0,0,0,28,43,76,46,30,46,3,8,0,0,0,,,
"Mar 5, 2022 2:00 PM",57,32,25,112,65,47,122,77,45,115,75,40,13,8,5,24,26,25,1,0,0,0,19,39,59,44,15,34,3,7,0,0,0,,,
"Mar 5, 2022 3:00 PM",74,49,25,103,48,55,127,58,69,95,48,47,32,20,12,27,22,20,2,0,0,0,19,22,76,40,36,29,6,3,0,0,0,,,
"Mar 5, 2022 4:00 PM",60,21,39,110,56,54,120,51,69,96,45,51,26,11,15,24,25,20,5,0,0,0,19,24,56,20,36,30,6,1,0,0,0,,,
"Mar 5, 2022 5:00 PM",67,25,42,72,41,31,86,30,56,71,27,44,27,8,19,13,28,23,5,0,0,0,25,16,37,19,18,35,4,1,0,0,0,,,
"Mar 5, 2022 6:00 PM",44,16,28,33,18,15,55,18,37,48,16,32,10,7,3,10,13,11,2,0,0,0,10,16,24,9,15,21,0,1,0,0,0,,,
"Mar 5, 2022 7:00 PM",41,18,23,17,12,5,21,10,11,15,10,5,12,8,4,10,10,10,0,0,0,0,10,7,16,8,8,16,2,1,0,0,0,,,
"Mar 5, 2022 8:00 PM",35,12,23,8,6,2,14,10,4,10,5,5,4,2,2,4,7,6,1,0,0,0,5,6,6,2,4,6,2,0,0,0,0,,,
"Mar 5, 2022 9:00 PM",12,5,7,6,3,3,11,6,5,7,4,3,3,1,2,2,11,10,1,0,0,0,11,1,6,5,1,6,0,2,0,0,0,,,
"Mar 5, 2022 10:00 PM",15,6,9,13,8,5,7,3,4,9,2,7,3,3,0,2,6,6,0,0,0,0,8,5,4,1,3,3,1,1,0,0,0,,,
"Mar 5, 2022 11:00 PM",8,4,4,2,2,0,2,2,0,1,1,0,2,0,2,3,3,2,1,0,0,0,2,4,3,3,0,3,1,1,0,0,0,,,
"Mar 6, 2022 12:00 AM",10,2,8,0,0,0,4,0,4,5,0,5,0,0,0,3,2,2,0,0,0,0,2,3,1,1,0,7,1,2,0,0,0,,,
"Mar 6, 2022 1:00 AM",10,5,5,3,2,1,3,1,2,3,2,1,3,1,2,0,0,0,0,0,0,0,0,3,0,0,0,2,0,0,0,0,0,,,
"Mar 6, 2022 2:00 AM",8,4,4,2,0,2,3,1,2,2,1,1,1,0,1,0,0,0,0,0,0,0,0,1,1,0,1,0,0,0,0,0,0,,,
"Mar 6, 2022 3:00 AM",7,1,6,0,0,0,0,0,0,0,0,0,2,0,2,0,0,0,0,0,0,0,0,0,1,1,0,2,0,0,0,0,0,,,
"Mar 6, 2022 4:00 AM",3,0,3,0,0,0,0,0,0,0,0,0,0,0,0,1,1,1,0,0,0,0,1,1,0,0,0,0,0,1,0,0,0,,,
"Mar 6, 2022 5:00 AM",3,2,1,0,0,0,0,0,0,0,0,0,0,0,0,0,0,0,0,0,0,0,0,0,0,0,0,5,0,0,0,0,0,,,
"Mar 6, 2022 6:00 AM",4,3,1,3,1,2,5,2,3,3,1,2,0,0,0,0,10,9,1,0,0,0,7,4,3,3,0,4,0,0,0,0,0,,,
"Mar 6, 2022 7:00 AM",11,6,5,9,9,0,11,11,0,14,11,3,0,0,0,3,7,7,0,0,0,0,6,6,3,2,1,11,0,1,0,0,0,,,
"Mar 6, 2022 8:00 AM",42,16,26,63,41,22,56,38,18,60,46,14,5,1,4,9,6,6,0,0,0,0,7,16,16,8,8,13,0,6,0,0,0,,,
"Mar 6, 2022 9:00 AM",41,24,17,90,50,40,89,54,35,83,53,30,12,10,2,9,20,20,0,0,0,0,20,28,32,24,8,41,4,19,0,0,0,,,
"Mar 6, 2022 10:00 AM",46,25,21,145,84,61,152,85,67,140,84,56,13,9,4,16,14,13,1,0,0,0,13,48,51,34,17,51,7,8,0,0,0,,,
"Mar 6, 2022 11:00 AM",62,38,24,156,86,70,145,79,66,139,78,61,14,5,9,16,22,20,2,0,0,0,14,47,65,37,28,38,10,7,0,0,0,,,
"Mar 6, 2022 12:00 PM",79,41,38,182,83,99,179,104,75,153,81,72,22,15,7,20,26,25,1,0,0,0,25,36,76,44,32,48,11,8,0,0,0,,,
"Mar 6, 2022 1:00 PM",66,33,33,147,86,61,174,96,78,138,77,61,25,11,14,23,24,21,3,0,0,0,19,48,62,37,25,44,8,1,0,0,0,,,
"Mar 6, 2022 2:00 PM",54,33,21,183,91,92,164,82,82,129,68,61,36,12,24,23,19,18,1,0,0,0,20,35,72,53,19,39,6,3,0,0,0,,,
"Mar 6, 2022 3:00 PM",53,31,22,121,59,62,157,70,87,111,49,62,21,9,12,24,16,16,0,0,0,0,16,28,97,43,54,49,4,4,0,0,0,,,
"Mar 6, 2022 4:00 PM",63,20,43,121,60,61,149,65,84,118,51,67,35,16,19,23,24,23,1,0,0,0,25,26,57,26,31,45,10,2,0,0,0,,,
"Mar 6, 2022 5:00 PM",60,26,34,74,37,37,90,33,57,75,28,47,18,7,11,15,21,19,2,0,0,0,18,22,40,20,20,23,0,2,0,0,0,,,
"Mar 6, 2022 6:00 PM",44,18,26,20,8,12,59,15,44,42,10,32,6,1,5,10,14,12,2,0,0,0,9,9,23,12,11,30,5,4,0,0,0,,,
"Mar 6, 2022 7:00 PM",29,11,18,11,4,7,20,13,7,13,5,8,1,0,1,11,9,9,0,0,0,0,9,11,6,5,1,14,1,0,0,0,0,,,
"Mar 6, 2022 8:00 PM",30,13,17,3,2,1,10,4,6,5,3,2,0,0,0,5,3,2,1,0,0,0,1,8,4,3,1,9,0,2,0,0,0,,,
"Mar 6, 2022 9:00 PM",21,12,9,1,0,1,9,4,5,3,1,2,0,0,0,1,5,5,0,0,0,0,5,4,0,0,0,11,0,1,0,0,0,,,
"Mar 6, 2022 10:00 PM",6,1,5,2,1,1,4,1,3,2,0,2,1,0,1,0,6,6,0,0,0,0,6,4,1,0,1,5,1,1,0,0,0,,,
"Mar 6, 2022 11:00 PM",6,3,3,1,0,1,5,1,4,2,1,1,1,0,1,0,2,2,0,0,0,0,2,2,1,0,1,1,0,0,0,0,0,,,
"Mar 7, 2022 12:00 AM",6,0,6,0,0,0,1,1,0,1,0,1,1,1,0,1,1,1,0,0,0,0,1,3,0,0,0,0,0,0,0,0,0,,,
"Mar 7, 2022 1:00 AM",1,1,0,0,0,0,0,0,0,0,0,0,0,0,0,0,0,0,0,0,0,0,0,1,0,0,0,0,0,1,0,0,0,,,
"Mar 7, 2022 2:00 AM",3,2,1,0,0,0,1,1,0,0,0,0,0,0,0,0,0,0,0,0,0,0,0,0,1,1,0,0,0,0,0,0,0,,,
"Mar 7, 2022 3:00 AM",0,0,0,0,0,0,0,0,0,0,0,0,0,0,0,0,0,0,0,0,0,0,0,1,0,0,0,0,0,0,0,0,0,,,
"Mar 7, 2022 4:00 AM",0,0,0,0,0,0,0,0,0,0,0,0,0,0,0,0,2,2,0,0,0,0,2,0,0,0,0,1,0,0,0,0,0,,,
"Mar 7, 2022 5:00 AM",3,3,0,0,0,0,2,1,1,2,1,1,0,0,0,1,12,11,1,0,0,0,13,1,1,1,0,11,0,0,0,0,0,,,
"Mar 7, 2022 6:00 AM",42,27,15,12,4,8,20,8,12,13,4,9,3,3,0,2,21,20,1,0,0,0,21,11,6,2,4,23,1,3,0,0,0,,,
"Mar 7, 2022 7:00 AM",104,73,31,53,18,35,70,19,51,59,27,32,6,6,0,13,55,55,0,0,0,0,56,36,35,15,20,87,4,5,0,0,0,,,
"Mar 7, 2022 8:00 AM",194,137,57,86,24,62,136,47,89,107,48,59,33,23,10,26,115,112,3,0,0,0,113,61,60,19,41,165,7,3,0,0,0,,,
"Mar 7, 2022 9:00 AM",94,74,20,42,18,24,71,37,34,65,37,28,10,6,4,6,55,55,0,0,0,0,47,20,31,15,16,51,2,0,0,0,0,,,
"Mar 7, 2022 10:00 AM",53,35,18,43,25,18,44,29,15,35,19,16,8,5,3,10,25,24,1,0,0,0,21,11,10,9,1,24,3,0,0,0,0,,,
"Mar 7, 2022 11:00 AM",44,29,15,27,10,17,43,20,23,30,14,16,10,6,4,10,25,21,4,0,0,0,24,12,12,9,3,21,1,2,0,0,0,,,
"Mar 7, 2022 12:00 PM",46,24,22,21,11,10,46,20,26,26,11,15,12,5,7,8,23,21,2,0,0,0,18,17,15,9,6,25,5,2,0,0,0,,,
"Mar 7, 2022 1:00 PM",65,29,36,22,10,12,44,22,22,25,10,15,10,5,5,10,11,11,0,0,0,0,10,20,20,10,10,12,3,2,0,0,0,,,
"Mar 7, 2022 2:00 PM",55,35,20,22,16,6,47,33,14,27,18,9,21,12,9,14,14,13,1,0,0,0,13,18,29,16,13,14,2,3,0,0,0,,,
"Mar 7, 2022 3:00 PM",67,25,42,29,18,11,49,30,19,25,20,5,14,5,9,10,26,24,2,0,0,0,21,28,28,17,11,30,4,0,0,0,0,,,
"Mar 7, 2022 4:00 PM",84,31,53,45,28,17,54,31,23,54,28,26,14,4,10,12,35,29,6,0,0,0,28,44,25,18,7,34,9,4,0,0,0,,,
"Mar 7, 2022 5:00 PM",180,50,130,49,33,16,78,48,30,65,36,29,16,4,12,16,23,21,2,0,0,0,20,81,59,44,15,65,3,3,0,0,0,,,
"Mar 7, 2022 6:00 PM",138,38,100,42,34,8,90,72,18,58,42,16,10,1,9,32,33,30,3,0,0,0,29,93,41,38,3,44,4,4,0,0,0,,,
"Mar 7, 2022 7:00 PM",83,25,58,29,16,13,36,24,12,31,17,14,7,5,2,9,14,10,4,0,0,0,10,27,12,8,4,20,2,3,0,0,0,,,
"Mar 7, 2022 8:00 PM",57,16,41,12,9,3,17,10,7,17,8,9,2,0,2,7,7,4,3,0,0,0,7,19,13,6,7,14,3,2,0,0,0,,,
"Mar 7, 2022 9:00 PM",30,12,18,5,2,3,9,2,7,9,3,6,2,1,1,7,12,11,1,0,0,0,11,5,5,3,2,12,2,0,0,0,0,,,
"Mar 7, 2022 10:00 PM",14,3,11,0,0,0,6,2,4,1,0,1,2,1,1,2,11,8,3,0,0,0,10,7,3,1,2,2,1,1,0,0,0,,,
"Mar 7, 2022 11:00 PM",7,1,6,3,2,1,4,2,2,3,2,1,0,0,0,1,1,1,0,0,0,0,1,2,0,0,0,4,1,1,0,0,0,,,
"Mar 8, 2022 12:00 AM",2,0,2,0,0,0,3,1,2,5,3,2,1,0,1,0,0,0,0,0,0,0,0,6,0,0,0,1,0,0,0,0,0,,,
"Mar 8, 2022 1:00 AM",3,1,2,0,0,0,1,0,1,0,0,0,0,0,0,0,0,0,0,0,0,0,0,0,0,0,0,3,0,0,0,0,0,,,
"Mar 8, 2022 2:00 AM",2,2,0,0,0,0,0,0,0,0,0,0,0,0,0,0,0,0,0,0,0,0,0,0,0,0,0,0,0,0,0,0,0,,,
"Mar 8, 2022 3:00 AM",1,0,1,0,0,0,0,0,0,0,0,0,0,0,0,0,0,0,0,0,0,0,0,0,1,1,0,0,0,0,0,0,0,,,
"Mar 8, 2022 4:00 AM",2,1,1,0,0,0,1,1,0,0,0,0,0,0,0,0,0,0,0,0,0,0,1,0,0,0,0,0,0,0,0,0,0,,,
"Mar 8, 2022 5:00 AM",1,1,0,1,1,0,2,1,1,2,1,1,0,0,0,0,7,7,0,0,0,0,6,1,0,0,0,9,0,0,0,0,0,,,
"Mar 8, 2022 6:00 AM",29,21,8,2,0,2,9,3,6,8,3,5,1,1,0,6,11,11,0,0,0,0,12,9,2,1,1,27,0,4,0,0,0,,,
"Mar 8, 2022 7:00 AM",88,60,28,26,6,20,31,7,24,27,10,17,4,4,0,14,50,50,0,0,0,0,52,21,17,6,11,53,1,1,0,0,0,,,
"Mar 8, 2022 8:00 AM",188,139,49,26,7,19,65,26,39,51,22,29,24,17,7,18,103,101,2,0,0,0,95,30,29,5,24,119,2,3,0,0,0,,,
"Mar 8, 2022 9:00 AM",77,61,16,29,8,21,30,15,15,29,17,12,6,2,4,8,36,36,0,0,0,0,36,15,10,3,7,31,1,1,0,0,0,,,
"Mar 8, 2022 10:00 AM",47,30,17,13,5,8,16,9,7,9,5,4,5,1,4,7,17,17,0,0,0,0,14,4,4,1,3,10,2,1,0,0,0,,,
"Mar 8, 2022 11:00 AM",21,16,5,6,3,3,9,3,6,9,4,5,3,0,3,4,11,11,0,0,0,0,9,4,4,1,3,9,4,2,0,0,0,,,
"Mar 8, 2022 12:00 PM",23,8,15,5,4,1,7,3,4,5,2,3,9,5,4,5,11,7,4,0,0,0,9,8,3,2,1,11,2,0,0,0,0,,,
"Mar 8, 2022 1:00 PM",42,13,29,6,2,4,10,8,2,9,6,3,9,3,6,9,9,7,2,0,0,0,9,9,9,1,8,15,0,0,0,0,0,,,
"Mar 8, 2022 2:00 PM",32,17,15,6,4,2,18,12,6,4,3,1,5,1,4,9,6,6,0,0,0,0,4,12,9,5,4,5,1,0,0,0,0,,,
"Mar 8, 2022 3:00 PM",49,20,29,16,12,4,22,14,8,14,10,4,8,6,2,8,13,10,3,0,0,0,9,19,10,8,2,19,1,0,0,0,0,,,
"Mar 8, 2022 4:00 PM",89,31,58,24,15,9,34,20,14,28,16,12,8,3,5,7,22,17,5,0,0,0,18,38,22,19,3,21,2,3,0,0,0,,,
"Mar 8, 2022 5:00 PM",156,37,119,32,20,12,60,33,27,45,22,23,4,2,2,11,21,19,2,0,0,0,22,54,38,29,9,32,3,4,0,0,0,,,
"Mar 8, 2022 6:00 PM",131,34,97,38,24,14,64,41,23,57,36,21,17,7,10,9,31,25,6,0,0,0,27,50,33,28,5,42,2,2,0,0,0,,,
"Mar 8, 2022 7:00 PM",85,28,57,17,14,3,31,19,12,21,16,5,9,5,4,8,15,12,3,0,0,0,12,38,14,10,4,14,1,3,0,0,0,,,
"Mar 8, 2022 8:00 PM",70,16,54,9,7,2,20,17,3,15,11,4,5,3,2,8,15,15,0,0,0,0,15,18,13,9,4,15,1,2,0,0,0,,,
"Mar 8, 2022 9:00 PM",33,9,24,5,5,0,7,6,1,6,4,2,1,0,1,9,6,6,0,0,0,0,5,11,5,4,1,4,0,0,0,0,0,,,
"Mar 8, 2022 10:00 PM",19,6,13,2,2,0,4,2,2,2,1,1,1,0,1,4,8,7,1,0,0,0,7,14,1,1,0,2,1,0,0,0,0,,,
"Mar 8, 2022 11:00 PM",7,1,6,2,1,1,8,4,4,1,0,1,1,1,0,2,1,1,0,0,0,0,1,2,1,1,0,6,0,0,0,0,0,,,
"Mar 9, 2022 12:00 AM",3,1,2,0,0,0,2,2,0,1,1,0,1,0,1,0,0,0,0,0,0,0,0,3,1,1,0,0,1,0,0,0,0,,,
"Mar 9, 2022 1:00 AM",4,2,2,1,1,0,0,0,0,0,0,0,0,0,0,0,0,0,0,0,0,0,0,0,0,0,0,0,0,0,0,0,0,,,
"Mar 9, 2022 2:00 AM",2,2,0,0,0,0,0,0,0,0,0,0,0,0,0,0,0,0,0,0,0,0,0,0,0,0,0,0,0,0,0,0,0,,,
"Mar 9, 2022 3:00 AM",0,0,0,0,0,0,0,0,0,0,0,0,0,0,0,0,0,0,0,0,0,0,1,3,0,0,0,0,0,0,0,0,0,,,
"Mar 9, 2022 4:00 AM",1,1,0,1,0,1,1,0,1,1,0,1,0,0,0,0,1,1,0,0,0,0,1,0,0,0,0,1,0,0,0,0,0,,,
"Mar 9, 2022 5:00 AM",5,3,2,1,1,0,3,2,1,3,2,1,0,0,0,1,9,9,0,0,0,0,8,1,0,0,0,6,0,0,0,0,0,,,
"Mar 9, 2022 6:00 AM",35,23,12,5,1,4,9,1,8,6,0,6,0,0,0,3,10,10,0,0,0,0,12,8,1,0,1,29,0,2,0,0,0,,,
"Mar 9, 2022 7:00 AM",92,58,34,26,8,18,40,13,27,22,10,12,4,3,1,9,41,41,0,0,0,0,47,17,18,3,15,52,2,2,0,0,0,,,
"Mar 9, 2022 8:00 AM",156,114,42,39,10,29,70,19,51,67,22,45,8,6,2,13,66,66,0,0,0,0,64,33,34,10,24,108,2,2,0,0,0,,,
"Mar 9, 2022 9:00 AM",66,49,17,17,8,9,25,13,12,25,16,9,3,3,0,5,25,25,0,0,0,0,22,12,16,4,12,30,2,3,0,0,0,,,
"Mar 9, 2022 10:00 AM",26,15,11,6,3,3,11,7,4,8,5,3,4,3,1,5,16,16,0,0,0,0,15,4,1,1,0,8,0,1,0,0,0,,,
"Mar 9, 2022 11:00 AM",14,10,4,1,1,0,8,3,5,5,2,3,1,1,0,4,5,4,1,0,0,0,4,4,4,2,2,10,0,2,0,0,0,,,
"Mar 9, 2022 12:00 PM",20,9,11,3,0,3,6,4,2,4,1,3,6,2,4,3,7,7,0,0,0,0,6,5,1,0,1,14,1,0,0,0,0,,,
"Mar 9, 2022 1:00 PM",34,16,18,12,8,4,10,4,6,11,5,6,9,5,4,4,9,8,1,0,0,0,7,8,5,4,1,6,0,0,0,0,0,,,
"Mar 9, 2022 2:00 PM",20,6,14,2,1,1,11,6,5,9,5,4,1,0,1,5,0,0,0,0,0,0,0,6,6,6,0,12,1,0,0,0,0,,,
"Mar 9, 2022 3:00 PM",40,16,24,8,7,1,9,9,0,9,8,1,2,1,1,6,9,6,3,0,0,0,4,13,11,7,4,4,1,1,0,0,0,,,
"Mar 9, 2022 4:00 PM",61,25,36,2,2,0,12,9,3,5,3,2,5,5,0,8,8,6,2,0,0,0,7,22,11,9,2,12,2,0,0,0,0,,,
"Mar 9, 2022 5:00 PM",122,39,83,21,15,6,29,18,11,22,14,8,6,1,5,7,15,12,3,0,0,0,12,39,20,19,1,22,2,1,0,0,0,,,
"Mar 9, 2022 6:00 PM",88,27,61,15,12,3,26,21,5,23,16,7,3,1,2,6,7,7,0,0,0,0,9,48,15,12,3,25,2,2,0,0,0,,,
"Mar 9, 2022 7:00 PM",52,17,35,8,7,1,16,15,1,11,9,2,2,1,1,3,12,11,1,0,0,0,9,21,12,12,0,7,3,2,0,0,0,,,
"Mar 9, 2022 8:00 PM",25,7,18,5,5,0,11,8,3,8,5,3,2,0,2,3,6,6,0,0,0,0,6,16,4,4,0,7,0,1,0,0,0,,,
"Mar 9, 2022 9:00 PM",24,9,15,1,0,1,8,4,4,6,3,3,0,0,0,3,2,2,0,0,0,0,4,5,4,3,1,4,3,0,0,0,0,,,
"Mar 9, 2022 10:00 PM",12,5,7,0,0,0,2,1,1,1,0,1,0,0,0,3,2,2,0,0,0,0,1,2,2,2,0,2,0,0,0,0,0,,,
"Mar 9, 2022 11:00 PM",2,0,2,0,0,0,3,2,1,1,0,1,1,0,1,4,2,2,0,0,0,0,2,2,0,0,0,1,0,0,0,0,0,,,
"Mar 10, 2022 12:00 AM",3,0,3,0,0,0,0,0,0,0,0,0,0,0,0,1,0,0,0,0,0,0,0,0,1,1,0,0,0,0,0,0,0,,,
"Mar 10, 2022 1:00 AM",3,2,1,0,0,0,0,0,0,0,0,0,0,0,0,0,0,0,0,0,0,0,0,1,0,0,0,0,0,0,0,0,0,,,
"Mar 10, 2022 2:00 AM",1,1,0,0,0,0,0,0,0,0,0,0,0,0,0,0,0,0,0,0,0,0,0,1,0,0,0,1,0,0,0,0,0,,,
"Mar 10, 2022 3:00 AM",1,0,1,0,0,0,0,0,0,0,0,0,0,0,0,0,0,0,0,0,0,0,0,1,0,0,0,0,0,0,0,0,0,,,
"Mar 10, 2022 4:00 AM",0,0,0,0,0,0,0,0,0,0,0,0,0,0,0,0,0,0,0,0,0,0,0,2,0,0,0,0,0,0,0,0,0,,,
"Mar 10, 2022 5:00 AM",3,3,0,0,0,0,1,0,1,1,0,1,0,0,0,0,7,7,0,0,0,0,9,0,0,0,0,6,0,0,0,0,0,,,
"Mar 10, 2022 6:00 AM",31,21,10,11,6,5,13,5,8,12,6,6,0,0,0,6,17,17,0,0,0,0,17,10,3,2,1,33,0,4,0,0,0,,,
"Mar 10, 2022 7:00 AM",78,57,21,49,15,34,65,19,46,52,17,35,6,5,1,9,62,61,1,0,0,0,59,25,30,13,17,82,2,6,0,0,0,,,
"Mar 10, 2022 8:00 AM",221,166,55,74,22,52,119,38,81,94,38,56,24,14,10,29,117,115,2,0,0,0,114,33,74,22,52,162,8,5,0,0,0,,,
"Mar 10, 2022 9:00 AM",111,84,27,47,23,24,65,35,30,58,37,21,5,4,1,5,48,47,1,0,0,0,48,24,37,21,16,47,3,1,0,0,0,,,
"Mar 10, 2022 10:00 AM",46,30,16,57,25,32,56,27,29,46,24,22,5,4,1,9,31,30,1,0,0,0,28,13,20,9,11,25,4,6,0,0,0,,,
"Mar 10, 2022 11:00 AM",43,30,13,64,34,30,80,42,38,74,36,38,18,10,8,17,22,21,1,0,0,0,13,21,31,16,15,29,4,0,0,0,0,,,
"Mar 10, 2022 12:00 PM",71,34,37,48,19,29,61,33,28,52,28,24,15,8,7,13,22,22,0,0,0,0,18,19,29,17,12,27,0,1,0,0,0,,,
"Mar 10, 2022 1:00 PM",86,29,57,64,40,24,73,42,31,75,42,33,21,11,10,24,31,30,1,0,0,0,25,28,27,16,11,22,6,3,0,0,0,,,
"Mar 10, 2022 2:00 PM",59,29,30,48,20,28,71,34,37,47,20,27,9,5,4,14,25,23,2,0,0,0,24,27,30,22,8,34,2,3,0,0,0,,,
"Mar 10, 2022 3:00 PM",75,33,42,37,17,20,76,45,31,49,27,22,21,11,10,17,21,20,1,0,0,0,22,30,50,32,18,21,5,2,0,0,0,,,
"Mar 10, 2022 4:00 PM",115,37,78,51,31,20,73,45,28,41,23,18,16,9,7,34,26,24,2,0,0,0,26,42,47,21,26,35,7,3,0,0,0,,,
"Mar 10, 2022 5:00 PM",183,52,131,66,39,27,84,48,36,69,40,29,17,1,16,19,44,33,11,0,0,0,30,70,61,42,19,48,10,3,0,0,0,,,
"Mar 10, 2022 6:00 PM",160,45,115,55,38,17,95,53,42,64,39,25,15,3,12,22,23,21,2,0,0,0,26,91,45,34,11,38,6,4,0,0,0,,,
"Mar 10, 2022 7:00 PM",112,43,69,13,10,3,31,20,11,35,22,13,7,5,2,9,22,20,2,0,0,0,21,38,13,9,4,26,1,1,0,0,0,,,
"Mar 10, 2022 8:00 PM",66,19,47,14,12,2,20,14,6,14,9,5,4,1,3,9,17,17,0,0,0,0,16,24,5,4,1,15,2,1,0,0,0,,,
"Mar 10, 2022 9:00 PM",26,9,17,6,5,1,14,11,3,10,8,2,0,0,0,8,9,6,3,0,0,0,6,9,4,3,1,9,0,3,0,0,0,,,
"Mar 10, 2022 10:00 PM",26,5,21,5,3,2,12,5,7,11,4,7,2,1,1,4,13,11,2,0,0,0,10,5,3,2,1,9,2,2,0,0,0,,,
"Mar 10, 2022 11:00 PM",15,1,14,4,1,3,11,5,6,8,2,6,4,1,3,1,0,0,0,0,0,0,1,8,1,1,0,6,0,1,0,0,0,,,
"Mar 11, 2022 12:00 AM",7,1,6,0,0,0,2,1,1,3,0,3,0,0,0,0,3,2,1,0,0,0,2,5,1,0,1,5,0,0,0,0,0,,,
"Mar 11, 2022 1:00 AM",2,0,2,1,0,1,0,0,0,2,1,1,0,0,0,0,1,0,1,0,0,0,0,4,0,0,0,1,0,0,0,0,0,,,
"Mar 11, 2022 2:00 AM",2,1,1,0,0,0,0,0,0,0,0,0,0,0,0,0,0,0,0,0,0,0,0,0,0,0,0,1,0,0,0,0,0,,,
"Mar 11, 2022 3:00 AM",0,0,0,0,0,0,0,0,0,0,0,0,0,0,0,0,0,0,0,0,0,0,1,1,0,0,0,0,0,0,0,0,0,,,
"Mar 11, 2022 4:00 AM",2,1,1,0,0,0,1,1,0,0,0,0,0,0,0,1,1,1,0,0,0,0,1,0,0,0,0,1,0,1,0,0,0,,,
"Mar 11, 2022 5:00 AM",5,4,1,0,0,0,2,1,1,2,1,1,0,0,0,0,5,5,0,0,0,0,7,2,1,1,0,11,0,0,0,0,0,,,
"Mar 11, 2022 6:00 AM",30,18,12,10,3,7,7,3,4,7,2,5,1,0,1,4,23,23,0,0,0,0,22,10,0,0,0,25,0,2,0,0,0,,,
"Mar 11, 2022 7:00 AM",68,43,25,21,9,12,36,16,20,20,9,11,10,5,5,5,42,42,0,0,0,0,45,21,15,7,8,60,1,3,0,0,0,,,
"Mar 11, 2022 8:00 AM",120,86,34,21,5,16,50,17,33,32,12,20,14,9,5,14,50,50,0,0,0,0,50,22,22,9,13,70,3,1,0,0,0,,,
"Mar 11, 2022 9:00 AM",49,36,13,11,5,6,23,11,12,21,14,7,2,1,1,4,19,19,0,0,0,0,19,13,6,2,4,16,0,4,0,0,0,,,
"Mar 11, 2022 10:00 AM",27,16,11,6,2,4,6,2,4,5,3,2,0,0,0,1,11,9,2,0,0,0,12,7,1,0,1,11,0,1,0,0,0,,,
"Mar 11, 2022 11:00 AM",11,7,4,2,1,1,6,4,2,7,3,4,3,3,0,1,2,2,0,0,0,0,2,2,0,0,0,3,0,0,0,0,0,,,
"Mar 11, 2022 12:00 PM",23,16,7,6,4,2,7,3,4,8,5,3,6,1,5,2,12,10,2,0,0,0,10,5,3,2,1,12,1,1,0,0,0,,,
"Mar 11, 2022 1:00 PM",58,31,27,9,6,3,21,15,6,14,11,3,5,3,2,6,8,7,1,0,0,0,7,17,9,8,1,15,0,0,0,0,0,,,
"Mar 11, 2022 2:00 PM",58,34,24,17,8,9,39,28,11,22,13,9,13,7,6,9,16,15,1,0,0,0,14,15,13,10,3,22,1,2,0,0,0,,,
"Mar 11, 2022 3:00 PM",55,27,28,52,26,26,54,29,25,41,22,19,16,6,10,6,18,16,2,0,0,0,17,26,16,11,5,20,2,2,0,0,0,,,
"Mar 11, 2022 4:00 PM",78,27,51,42,24,18,68,30,38,47,23,24,9,4,5,29,24,23,1,0,0,0,24,36,27,15,12,24,1,3,0,0,0,,,
"Mar 11, 2022 5:00 PM",100,33,67,45,28,17,69,34,35,50,29,21,14,5,9,13,23,20,3,0,0,0,14,37,24,15,9,31,5,3,0,0,0,,,
"Mar 11, 2022 6:00 PM",101,39,62,32,19,13,47,31,16,34,19,15,8,5,3,16,19,17,2,0,0,0,18,36,20,14,6,32,2,2,0,0,0,,,
"Mar 11, 2022 7:00 PM",68,24,44,17,10,7,25,19,6,20,13,7,5,1,4,15,12,12,0,0,0,0,7,25,11,7,4,17,2,2,0,0,0,,,
"Mar 11, 2022 8:00 PM",48,18,30,8,5,3,10,5,5,7,3,4,1,1,0,5,11,7,4,0,0,0,7,15,2,2,0,16,1,1,0,0,0,,,
"Mar 11, 2022 9:00 PM",24,8,16,2,1,1,6,2,4,5,2,3,1,0,1,9,9,8,1,0,0,0,8,5,3,2,1,5,1,1,0,0,0,,,
"Mar 11, 2022 10:00 PM",24,8,16,3,3,0,5,1,4,4,0,4,3,2,1,4,6,5,1,0,0,0,5,4,4,3,1,6,1,1,0,0,0,,,
"Mar 11, 2022 11:00 PM",11,4,7,2,1,1,6,3,3,5,2,3,0,0,0,1,1,1,0,0,0,0,1,3,1,0,1,5,0,1,0,0,0,,,
"Mar 12, 2022 12:00 AM",9,2,7,0,0,0,4,2,2,4,1,3,1,1,0,0,1,1,0,0,0,0,1,2,2,2,0,6,1,0,0,0,0,,,
"Mar 12, 2022 1:00 AM",9,2,7,1,1,0,2,1,1,1,1,0,0,0,0,0,1,1,0,0,0,0,1,5,0,0,0,2,1,2,0,0,0,,,
"Mar 12, 2022 2:00 AM",4,0,4,0,0,0,1,0,1,2,0,2,0,0,0,1,2,1,1,0,0,0,1,2,0,0,0,4,0,0,0,0,0,,,
"Mar 12, 2022 3:00 AM",0,0,0,0,0,0,0,0,0,0,0,0,0,0,0,0,0,0,0,0,0,0,4,1,0,0,0,0,0,0,0,0,0,,,
"Mar 12, 2022 4:00 AM",4,1,3,1,1,0,0,0,0,0,0,0,0,0,0,0,0,0,0,0,0,0,0,2,1,1,0,0,0,0,0,0,0,,,
"Mar 12, 2022 5:00 AM",4,1,3,0,0,0,0,0,0,0,0,0,0,0,0,0,0,0,0,0,0,0,0,2,1,1,0,0,1,0,0,0,0,,,
"Mar 12, 2022 6:00 AM",5,2,3,1,0,1,3,1,2,2,0,2,0,0,0,1,1,1,0,0,0,0,1,4,1,1,0,6,0,2,0,0,0,,,
"Mar 12, 2022 7:00 AM",21,12,9,12,6,6,18,9,9,12,8,4,0,0,0,1,11,11,0,0,0,0,14,12,6,5,1,17,0,1,0,0,0,,,
"Mar 12, 2022 8:00 AM",36,20,16,55,25,30,74,42,32,45,29,16,10,7,3,7,10,10,0,0,0,0,11,18,29,18,11,19,2,2,0,0,0,,,
"Mar 12, 2022 9:00 AM",54,33,21,73,39,34,87,51,36,64,37,27,13,5,8,9,21,21,0,0,0,0,19,28,34,19,15,25,3,5,0,0,0,,,
"Mar 12, 2022 10:00 AM",59,35,24,128,69,59,133,87,46,113,80,33,19,12,7,19,27,26,1,0,0,0,23,35,68,49,19,37,5,8,0,0,0,,,
"Mar 12, 2022 11:00 AM",60,42,18,155,81,74,146,70,76,130,74,56,43,26,17,15,19,18,1,0,0,0,18,33,54,34,20,41,13,6,0,0,0,,,
"Mar 12, 2022 12:00 PM",68,34,34,165,71,94,151,75,76,132,59,73,43,25,18,30,24,21,3,0,0,0,18,29,64,27,37,43,7,12,0,0,0,,,
"Mar 12, 2022 1:00 PM",74,32,42,105,41,64,125,54,71,99,43,56,31,13,18,14,22,22,0,0,0,0,21,35,56,28,28,41,8,0,0,0,0,,,
"Mar 12, 2022 2:00 PM",52,37,15,87,54,33,73,37,36,72,37,35,26,13,13,18,26,25,1,0,0,0,23,18,26,14,12,25,4,1,0,0,0,,,
"Mar 12, 2022 3:00 PM",48,14,34,54,20,34,46,18,28,53,21,32,19,15,4,16,17,15,2,0,0,0,14,12,19,10,9,17,4,0,0,0,0,,,
"Mar 12, 2022 4:00 PM",32,14,18,12,8,4,12,4,8,10,4,6,16,10,6,5,10,10,0,0,0,0,13,12,5,2,3,8,3,0,0,0,0,,,
"Mar 12, 2022 5:00 PM",20,6,14,4,3,1,6,1,5,8,1,7,6,0,6,6,2,2,0,0,0,0,1,3,3,3,0,7,1,0,0,0,0,,,
"Mar 12, 2022 6:00 PM",31,10,21,4,3,1,4,2,2,2,0,2,3,3,0,1,3,3,0,0,0,0,2,0,0,0,0,8,0,0,0,0,0,,,
"Mar 12, 2022 7:00 PM",22,12,10,2,1,1,4,2,2,5,3,2,3,0,3,2,7,7,0,0,0,0,9,3,0,0,0,4,1,0,0,0,0,,,
"Mar 12, 2022 8:00 PM",7,3,4,1,1,0,4,3,1,5,3,2,2,0,2,0,4,4,0,0,0,0,3,7,1,1,0,3,0,1,0,0,0,,,
"Mar 12, 2022 9:00 PM",11,5,6,1,1,0,1,1,0,0,0,0,0,0,0,0,3,2,1,0,0,0,1,2,0,0,0,6,1,0,0,0,0,,,
"Mar 12, 2022 10:00 PM",12,5,7,0,0,0,0,0,0,1,1,0,0,0,0,0,4,4,0,0,0,0,4,4,2,0,2,0,0,1,0,0,0,,,
"Mar 12, 2022 11:00 PM",4,1,3,0,0,0,2,1,1,2,0,2,0,0,0,0,6,5,1,0,0,0,5,0,0,0,0,1,0,0,0,0,0,,,
"Mar 13, 2022 12:00 AM",4,0,4,1,0,1,0,0,0,3,0,3,5,2,3,2,0,0,0,0,0,0,0,1,0,0,0,1,0,1,0,0,0,,,
"Mar 13, 2022 1:00 AM",5,0,5,0,0,0,0,0,0,0,0,0,1,1,0,0,0,0,0,0,0,0,0,1,0,0,0,2,0,0,0,0,0,,,
"Mar 13, 2022 2:00 AM",2,1,1,0,0,0,2,2,0,0,0,0,0,0,0,0,1,0,1,0,0,0,0,0,1,1,0,2,0,1,0,0,0,,,
"Mar 13, 2022 3:00 AM",0,0,0,0,0,0,0,0,0,0,0,0,1,0,1,0,0,0,0,0,0,0,0,0,0,0,0,1,0,0,0,0,0,,,
"Mar 13, 2022 4:00 AM",2,0,2,0,0,0,0,0,0,0,0,0,0,0,0,0,1,1,0,0,0,0,1,1,0,0,0,0,0,0,0,0,0,,,
"Mar 13, 2022 5:00 AM",1,0,1,0,0,0,0,0,0,0,0,0,0,0,0,0,1,1,0,0,0,0,1,1,0,0,0,1,0,1,0,0,0,,,
"Mar 13, 2022 6:00 AM",3,3,0,0,0,0,1,1,0,1,1,0,0,0,0,2,1,1,0,0,0,0,1,4,0,0,0,2,0,0,0,0,0,,,
"Mar 13, 2022 7:00 AM",6,2,4,2,0,2,7,4,3,4,1,3,0,0,0,0,2,2,0,0,0,0,2,3,0,0,0,6,0,1,0,0,0,,,
"Mar 13, 2022 8:00 AM",11,7,4,17,11,6,14,11,3,9,9,0,2,2,0,2,7,7,0,0,0,0,7,3,2,2,0,4,0,0,0,0,0,,,
"Mar 13, 2022 9:00 AM",31,8,23,41,17,24,36,18,18,34,18,16,4,2,2,8,6,6,0,0,0,0,6,15,15,13,2,15,1,5,0,0,0,,,
"Mar 13, 2022 10:00 AM",27,17,10,73,54,19,70,42,28,58,37,21,13,2,11,5,7,7,0,0,0,0,8,17,15,6,9,24,2,8,0,0,0,,,
"Mar 13, 2022 11:00 AM",32,18,14,92,39,53,102,56,46,92,49,43,13,12,1,7,12,11,1,0,0,0,11,27,31,20,11,25,4,2,0,0,0,,,
"Mar 13, 2022 12:00 PM",67,44,23,95,41,54,96,52,44,80,47,33,24,12,12,18,7,7,0,0,0,0,9,16,38,23,15,36,3,5,0,0,0,,,
"Mar 13, 2022 1:00 PM",58,21,37,101,52,49,101,50,51,97,44,53,22,7,15,18,14,11,3,0,0,0,10,20,41,23,18,25,4,3,0,0,0,,,
"Mar 13, 2022 2:00 PM",60,29,31,106,47,59,81,40,41,88,48,40,32,15,17,10,18,18,0,0,0,0,15,19,33,22,11,25,2,2,0,0,0,,,
"Mar 13, 2022 3:00 PM",44,19,25,116,68,48,119,61,58,120,58,62,18,8,10,17,18,17,1,0,0,0,17,32,31,16,15,29,5,2,0,0,0,,,
"Mar 13, 2022 4:00 PM",43,19,24,109,53,56,107,46,61,83,32,51,16,7,9,11,23,21,2,0,0,0,20,20,36,21,15,19,5,2,0,0,0,,,
"Mar 13, 2022 5:00 PM",48,24,24,76,41,35,89,34,55,63,31,32,10,7,3,12,13,13,0,0,0,0,11,13,27,18,9,17,7,3,0,0,0,,,
"Mar 13, 2022 6:00 PM",48,14,34,34,18,16,44,15,29,41,8,33,3,3,0,9,12,10,2,0,0,0,10,9,16,6,10,19,0,2,0,0,0,,,
"Mar 13, 2022 7:00 PM",39,18,21,18,6,12,22,14,8,8,5,3,3,0,3,8,10,10,0,0,0,0,9,9,9,3,6,10,2,1,0,0,0,,,
"Mar 13, 2022 8:00 PM",25,8,17,7,3,4,4,2,2,7,6,1,3,2,1,2,7,7,0,0,0,0,7,8,1,1,0,12,1,0,0,0,0,,,
"Mar 13, 2022 9:00 PM",18,7,11,2,1,1,9,4,5,4,1,3,0,0,0,1,4,3,1,0,0,0,3,2,4,2,2,9,0,0,0,0,0,,,
"Mar 13, 2022 10:00 PM",14,5,9,2,2,0,4,1,3,4,1,3,0,0,0,0,4,3,1,0,0,0,3,3,1,0,1,7,1,2,0,0,0,,,
"Mar 13, 2022 11:00 PM",5,2,3,0,0,0,1,0,1,1,0,1,0,0,0,0,1,1,0,0,0,0,1,2,0,0,0,2,0,0,0,0,0,,,
"Mar 14, 2022 12:00 AM",2,1,1,0,0,0,1,1,0,1,1,0,3,3,0,0,0,0,0,0,0,0,0,6,0,0,0,0,1,1,0,0,0,,,
"Mar 14, 2022 1:00 AM",4,0,4,0,0,0,0,0,0,0,0,0,0,0,0,0,0,0,0,0,0,0,0,0,0,0,0,0,0,0,0,0,0,,,
"Mar 14, 2022 2:00 AM",1,0,1,0,0,0,0,0,0,0,0,0,0,0,0,0,0,0,0,0,0,0,0,1,0,0,0,0,0,0,0,0,0,,,
"Mar 14, 2022 3:00 AM",0,0,0,0,0,0,0,0,0,0,0,0,0,0,0,0,0,0,0,0,0,0,1,0,0,0,0,0,0,0,0,0,0,,,
"Mar 14, 2022 4:00 AM",1,0,1,0,0,0,0,0,0,0,0,0,0,0,0,0,1,1,0,0,0,0,1,1,0,0,0,0,0,0,0,0,0,,,
"Mar 14, 2022 5:00 AM",7,5,2,0,0,0,1,0,1,1,0,1,0,0,0,0,7,7,0,0,0,0,6,1,0,0,0,8,1,1,0,0,0,,,
"Mar 14, 2022 6:00 AM",37,25,12,13,3,10,16,3,13,13,2,11,2,2,0,3,21,21,0,0,0,0,22,14,7,3,4,33,0,2,0,0,0,,,
"Mar 14, 2022 7:00 AM",97,69,28,47,14,33,70,25,45,49,16,33,9,9,0,15,54,53,1,0,0,0,55,30,28,12,16,94,3,4,0,0,0,,,
"Mar 14, 2022 8:00 AM",202,152,50,78,17,61,128,42,86,101,37,64,44,29,15,22,113,112,1,0,0,0,114,36,91,24,67,134,6,3,0,0,0,,,
"Mar 14, 2022 9:00 AM",90,70,20,21,9,12,45,23,22,34,20,14,8,6,2,7,43,43,0,0,0,0,38,16,22,10,12,40,2,1,0,0,0,,,
"Mar 14, 2022 10:00 AM",26,19,7,13,5,8,21,14,7,9,6,3,1,1,0,6,13,13,0,0,0,0,13,8,6,4,2,8,3,0,0,0,0,,,
"Mar 14, 2022 11:00 AM",31,21,10,18,11,7,33,15,18,26,15,11,12,5,7,6,19,18,1,0,0,0,17,5,4,3,1,17,1,2,0,0,0,,,
"Mar 14, 2022 12:00 PM",52,35,17,41,19,22,37,17,20,23,9,14,9,5,4,6,15,14,1,0,0,0,12,9,13,9,4,15,1,1,0,0,0,,,
"Mar 14, 2022 1:00 PM",46,22,24,27,13,14,39,27,12,25,14,11,14,3,11,16,28,26,2,0,0,0,27,18,20,9,11,12,3,3,0,0,0,,,
"Mar 14, 2022 2:00 PM",36,15,21,22,10,12,35,20,15,26,19,7,12,9,3,14,11,11,0,0,0,0,9,14,22,17,5,15,3,0,0,0,0,,,
"Mar 14, 2022 3:00 PM",67,24,43,50,34,16,38,26,12,41,27,14,17,8,9,18,27,25,2,0,0,0,18,19,27,18,9,24,3,1,0,0,0,,,
"Mar 14, 2022 4:00 PM",113,36,77,50,31,19,51,32,19,56,30,26,18,10,8,14,22,19,3,0,0,0,18,49,22,20,2,25,8,2,0,0,0,,,
"Mar 14, 2022 5:00 PM",144,36,108,56,38,18,93,55,38,68,38,30,20,9,11,17,31,27,4,0,0,0,31,80,52,37,15,47,5,5,0,0,0,,,
"Mar 14, 2022 6:00 PM",137,40,97,73,54,19,94,68,26,73,44,29,24,12,12,29,25,22,3,0,0,0,27,84,47,36,11,38,3,3,0,0,0,,,
"Mar 14, 2022 7:00 PM",76,23,53,27,18,9,43,25,18,30,20,10,14,3,11,10,24,21,3,0,0,0,18,41,23,17,6,17,2,2,0,0,0,,,
"Mar 14, 2022 8:00 PM",58,17,41,18,12,6,37,21,16,25,12,13,6,4,2,7,13,11,2,0,0,0,10,26,9,6,3,15,2,0,0,0,0,,,
"Mar 14, 2022 9:00 PM",25,6,19,8,4,4,16,10,6,15,8,7,4,3,1,7,4,3,1,0,0,0,4,6,8,4,4,12,0,0,0,0,0,,,
"Mar 14, 2022 10:00 PM",24,8,16,2,2,0,7,3,4,5,2,3,1,0,1,6,8,6,2,0,0,0,6,6,6,5,1,4,3,1,0,0,0,,,
"Mar 14, 2022 11:00 PM",6,1,5,1,1,0,5,5,0,1,0,1,1,0,1,0,6,6,0,0,0,0,6,7,1,1,0,3,1,0,0,0,0,,,
"Mar 15, 2022 12:00 AM",6,1,5,1,1,0,1,1,0,2,2,0,0,0,0,0,0,0,0,0,0,0,0,3,0,0,0,1,0,0,0,0,0,,,
"Mar 15, 2022 1:00 AM",3,2,1,0,0,0,1,0,1,0,0,0,1,0,1,0,0,0,0,0,0,0,0,1,1,0,1,0,0,0,0,0,0,,,
"Mar 15, 2022 2:00 AM",5,5,0,0,0,0,0,0,0,0,0,0,0,0,0,0,0,0,0,0,0,0,0,0,0,0,0,0,0,0,0,0,0,,,
"Mar 15, 2022 3:00 AM",0,0,0,0,0,0,0,0,0,0,0,0,0,0,0,0,0,0,0,0,0,0,0,0,0,0,0,1,0,0,0,0,0,,,
"Mar 15, 2022 4:00 AM",1,0,1,0,0,0,0,0,0,0,0,0,0,0,0,0,1,1,0,0,0,0,1,0,0,0,0,0,0,0,0,0,0,,,
"Mar 15, 2022 5:00 AM",6,5,1,0,0,0,1,0,1,1,0,1,0,0,0,1,5,5,0,0,0,0,5,0,0,0,0,9,,,0,0,0,,,
"Mar 15, 2022 6:00 AM",39,26,13,20,6,14,22,6,16,21,8,13,2,1,1,7,20,20,0,0,0,0,20,16,6,2,4,34,,,0,0,0,,,
"Mar 15, 2022 7:00 AM",110,77,33,43,14,29,62,21,41,49,17,32,6,5,1,16,73,71,2,0,0,0,72,27,28,13,15,93,,,0,0,0,,,
"Mar 15, 2022 8:00 AM",201,148,53,91,23,68,135,41,94,112,50,62,36,21,15,17,114,113,1,0,0,0,109,38,73,25,48,174,,,0,0,0,,,
"Mar 15, 2022 9:00 AM",120,91,29,54,19,35,79,46,33,66,39,27,6,5,1,16,43,43,0,0,0,0,43,23,41,22,19,42,,,0,0,0,,,
"Mar 15, 2022 10:00 AM",61,44,17,49,31,18,58,38,20,48,34,14,8,2,6,7,24,23,1,0,0,0,28,21,12,9,3,22,,,0,0,0,,,
"Mar 15, 2022 11:00 AM",31,24,7,33,15,18,57,26,31,41,15,26,10,7,3,8,19,18,1,0,0,0,16,17,33,21,12,32,,,0,0,0,,,
"Mar 15, 2022 12:00 PM",50,25,25,52,31,21,47,22,25,42,23,19,12,5,7,8,17,17,0,0,0,0,19,11,18,8,10,27,,,0,0,0,,,
"Mar 15, 2022 1:00 PM",58,29,29,46,18,28,50,22,28,45,20,25,11,5,6,16,22,18,4,0,0,0,20,22,26,16,10,30,,,0,0,0,,,
"Mar 15, 2022 2:00 PM",55,29,26,41,22,19,46,28,18,34,16,18,8,6,2,10,20,19,1,6,6,0,17,27,18,14,4,20,,,0,0,0,,,
"Mar 15, 2022 3:00 PM",67,26,41,42,24,18,52,29,23,34,20,14,16,5,11,12,14,14,0,16,13,3,17,29,28,20,8,36,,2,0,0,0,,,
"Mar 15, 2022 4:00 PM",111,34,77,40,27,13,63,41,22,55,33,22,10,3,7,13,31,28,3,33,30,3,27,42,28,16,12,32,2,4,2,0,2,,,
"Mar 15, 2022 5:00 PM",208,52,156,84,53,31,99,64,35,86,55,31,19,4,15,19,39,34,5,84,77,7,35,89,53,42,11,45,3,4,8,6,2,,,
"Mar 15, 2022 6:00 PM",151,44,107,56,40,16,85,59,26,65,41,24,14,2,12,21,27,26,1,71,71,0,25,78,53,43,10,45,7,4,4,3,1,,,
"Mar 15, 2022 7:00 PM",90,24,66,25,14,11,47,29,18,37,23,14,6,2,4,6,14,11,3,43,40,3,15,49,17,12,5,17,5,1,5,3,2,,,
"Mar 15, 2022 8:00 PM",76,28,48,23,17,6,23,16,7,18,11,7,1,0,1,11,12,9,3,21,20,1,12,34,8,4,4,17,2,1,6,4,2,,,
"Mar 15, 2022 9:00 PM",38,14,24,10,5,5,16,8,8,11,6,5,0,0,0,4,8,8,0,10,10,0,7,6,3,2,1,7,0,0,0,0,0,,,
"Mar 15, 2022 10:00 PM",18,8,10,2,2,0,2,1,1,2,1,1,2,0,2,3,4,3,1,15,14,1,3,6,1,1,0,6,1,0,0,0,0,,,
"Mar 15, 2022 11:00 PM",16,3,13,3,2,1,12,6,6,6,2,4,1,1,0,0,2,2,0,8,7,1,2,7,3,3,0,4,1,0,1,1,0,,,
"Mar 16, 2022 12:00 AM",2,0,2,0,0,0,0,0,0,2,1,1,0,0,0,0,0,0,0,0,0,0,0,,1,1,0,2,0,0,1,1,0,,,
"Mar 16, 2022 1:00 AM",3,0,3,1,0,1,0,0,0,1,0,1,0,0,0,0,2,1,1,3,3,0,1,,0,0,0,0,0,0,0,0,0,,,
"Mar 16, 2022 2:00 AM",4,3,1,0,0,0,0,0,0,0,0,0,0,0,0,0,0,0,0,0,0,0,0,,0,0,0,0,0,0,0,0,0,,,
"Mar 16, 2022 3:00 AM",1,1,0,0,0,0,0,0,0,0,0,0,0,0,0,0,0,0,0,1,0,1,1,,0,0,0,0,0,0,0,0,0,,,
"Mar 16, 2022 4:00 AM",1,1,0,0,0,0,0,0,0,0,0,0,0,0,0,0,0,0,0,0,0,0,0,,0,0,0,0,0,1,0,0,0,,,
"Mar 16, 2022 5:00 AM",6,6,0,0,0,0,0,0,0,0,0,0,0,0,0,1,7,7,0,1,1,0,6,,0,0,0,10,0,0,0,0,0,,,
"Mar 16, 2022 6:00 AM",31,18,13,6,0,6,11,1,10,6,0,6,2,2,0,4,16,16,0,6,5,1,16,,4,1,3,25,1,2,0,0,0,,,
"Mar 16, 2022 7:00 AM",100,68,32,45,16,29,64,23,41,42,16,26,10,9,1,9,47,47,0,18,15,3,47,,21,12,9,63,2,6,3,3,0,,,
"Mar 16, 2022 8:00 AM",178,125,53,75,22,53,98,31,67,80,28,52,28,14,14,15,89,88,1,35,28,7,96,,61,15,46,146,9,6,16,14,2,,,
"Mar 16, 2022 9:00 AM",89,75,14,33,13,20,47,26,21,41,22,19,16,7,9,4,47,46,1,15,11,4,34,,24,9,15,42,1,4,2,1,1,,,
"Mar 16, 2022 10:00 AM",49,34,15,27,12,15,47,26,21,33,20,13,11,6,5,10,23,23,0,9,7,2,22,,16,10,6,27,1,2,0,0,0,,,
"Mar 16, 2022 11:00 AM",45,23,22,22,7,15,37,18,19,36,15,21,14,8,6,3,20,19,1,8,6,2,16,,15,12,3,19,1,1,5,1,4,,,
"Mar 16, 2022 12:00 PM",81,37,44,47,21,26,65,30,35,41,16,25,8,2,6,4,27,27,0,16,12,4,20,,26,18,8,39,3,4,5,3,2,,,
"Mar 16, 2022 1:00 PM",81,40,41,47,31,16,78,48,30,56,40,16,23,13,10,16,28,27,1,21,18,3,18,,35,24,11,20,6,2,3,3,0,,,
"Mar 16, 2022 2:00 PM",64,33,31,45,26,19,57,33,24,49,32,17,21,14,7,5,13,10,3,15,13,2,12,,32,24,8,24,1,4,5,4,1,,,
"Mar 16, 2022 3:00 PM",83,39,44,58,33,25,63,32,31,50,28,22,21,14,7,19,24,23,1,23,16,7,22,,25,19,6,27,1,1,10,5,5,,,
"Mar 16, 2022 4:00 PM",104,32,72,61,33,28,65,44,21,53,33,20,14,3,11,17,31,28,3,29,27,2,30,,26,18,8,40,5,4,11,5,6,,,
"Mar 16, 2022 5:00 PM",161,48,113,71,38,33,86,44,42,67,34,33,24,11,13,19,33,29,4,60,58,2,29,,53,38,15,48,9,1,12,10,2,,,
"Mar 16, 2022 6:00 PM",157,52,105,57,36,21,74,42,32,56,33,23,11,6,5,18,21,17,4,46,42,4,19,,47,34,13,36,8,1,4,2,2,,,
"Mar 16, 2022 7:00 PM",76,24,52,29,17,12,45,33,12,38,26,12,7,4,3,6,16,14,2,33,29,4,13,,21,16,5,29,5,2,6,3,3,,,
"Mar 16, 2022 8:00 PM",87,32,55,17,14,3,31,19,12,18,11,7,4,1,3,3,11,10,1,18,18,0,9,,10,6,4,13,1,2,2,2,0,,,
"Mar 16, 2022 9:00 PM",45,19,26,7,5,2,26,17,9,12,7,5,1,0,1,4,5,4,1,13,13,0,4,,7,5,2,10,4,3,4,1,3,,,
"Mar 16, 2022 10:00 PM",38,10,28,3,3,0,9,6,3,4,2,2,5,1,4,1,7,5,2,17,17,0,3,,4,4,0,7,1,0,0,0,0,,,
"Mar 16, 2022 11:00 PM",9,3,6,4,4,0,4,3,1,4,3,1,3,3,0,2,5,3,2,8,8,0,4,,2,2,0,1,1,0,0,0,0,,,
"Mar 17, 2022 12:00 AM",16,5,11,0,0,0,1,1,0,6,4,2,0,0,0,1,0,0,0,3,3,0,0,,0,0,0,1,1,1,0,0,0,,,
"Mar 17, 2022 1:00 AM",8,0,8,0,0,0,0,0,0,0,0,0,0,0,0,0,0,0,0,1,1,0,0,,1,1,0,1,0,1,0,0,0,,,
"Mar 17, 2022 2:00 AM",9,4,5,2,2,0,2,2,0,1,1,0,0,0,0,0,0,0,0,2,2,0,0,,1,1,0,1,0,0,1,1,0,,,
"Mar 17, 2022 3:00 AM",2,0,2,0,0,0,2,2,0,1,0,1,1,0,1,0,0,0,0,0,0,0,1,1,0,0,0,0,0,0,2,1,1,,,
"Mar 17, 2022 4:00 AM",1,1,0,0,0,0,1,0,1,0,0,0,1,0,1,0,0,0,0,1,1,0,0,0,0,0,0,0,0,0,0,0,0,,,
"Mar 17, 2022 5:00 AM",0,0,0,1,1,0,2,1,1,2,1,1,2,2,0,0,0,0,0,0,0,0,0,1,0,0,0,5,1,0,0,0,0,,,
"Mar 17, 2022 6:00 AM",6,4,2,6,2,4,10,7,3,8,5,3,1,0,1,0,6,6,0,5,5,0,5,7,3,2,1,7,0,2,1,0,1,,,
"Mar 17, 2022 7:00 AM",24,12,12,21,13,8,18,11,7,21,15,6,1,1,0,6,10,10,0,8,8,0,10,9,11,8,3,19,0,2,0,0,0,,,
"Mar 17, 2022 8:00 AM",27,11,16,41,22,19,39,21,18,31,18,13,7,3,4,3,14,13,1,1,1,0,14,13,12,7,5,21,3,1,3,3,0,,,
"Mar 17, 2022 9:00 AM",33,19,14,73,48,25,79,52,27,70,47,23,12,10,2,6,13,13,0,10,9,1,12,30,37,16,21,21,0,8,3,2,1,,,
"Mar 17, 2022 10:00 AM",57,28,29,117,72,45,119,75,44,103,65,38,5,5,0,6,16,15,1,12,11,1,12,37,47,31,16,38,1,11,3,1,2,,,
"Mar 17, 2022 11:00 AM",62,43,19,135,60,75,151,82,69,110,59,51,24,12,12,26,29,28,1,15,13,2,27,32,57,22,35,45,2,8,5,3,2,,,
"Mar 17, 2022 12:00 PM",57,34,23,127,62,65,186,94,92,116,59,57,10,1,9,14,27,25,2,6,5,1,25,31,74,37,37,42,5,6,4,3,1,,,
"Mar 17, 2022 1:00 PM",61,25,36,100,49,51,102,54,48,86,52,34,25,13,12,19,18,18,0,13,8,5,20,35,43,21,22,33,6,5,3,2,1,,,
"Mar 17, 2022 2:00 PM",41,18,23,101,49,52,126,61,65,111,49,62,6,3,3,6,15,15,0,12,12,0,18,30,41,26,15,32,4,3,4,3,1,,,
"Mar 17, 2022 3:00 PM",54,29,25,110,63,47,122,56,66,111,64,47,24,6,18,15,19,19,0,19,19,0,16,14,37,19,18,31,6,1,3,2,1,,,
"Mar 17, 2022 4:00 PM",35,12,23,87,42,45,85,37,48,79,36,43,26,16,10,18,17,17,0,16,16,0,18,17,42,29,13,38,2,0,3,2,1,,,
"Mar 17, 2022 5:00 PM",45,12,33,55,20,35,62,23,39,56,19,37,12,8,4,16,12,11,1,9,9,0,10,20,28,16,12,19,0,0,3,2,1,,,
"Mar 17, 2022 6:00 PM",38,17,21,35,17,18,50,24,26,31,10,21,14,5,9,8,5,5,0,8,8,0,4,11,20,9,11,21,1,3,2,1,1,,,
"Mar 17, 2022 7:00 PM",32,13,19,11,7,4,23,8,15,21,6,15,4,2,2,5,17,16,1,12,12,0,16,12,10,5,5,10,3,0,2,1,1,,,
"Mar 17, 2022 8:00 PM",20,8,12,6,3,3,8,2,6,9,3,6,5,4,1,2,5,4,1,14,14,0,4,9,2,1,1,12,1,2,4,3,1,,,
"Mar 17, 2022 9:00 PM",11,5,6,2,1,1,7,2,5,7,3,4,1,1,0,1,7,7,0,1,1,0,7,3,1,1,0,6,1,1,2,0,2,,,
"Mar 17, 2022 10:00 PM",11,3,8,1,0,1,8,3,5,8,2,6,2,1,1,0,7,7,0,6,6,0,7,3,6,3,3,5,0,1,1,1,0,,,
"Mar 17, 2022 11:00 PM",12,6,6,1,1,0,8,5,3,3,1,2,2,1,1,1,1,1,0,2,2,0,0,7,2,1,1,6,0,0,0,0,0,,,
"Mar 18, 2022 12:00 AM",9,2,7,0,0,0,0,0,0,3,2,1,0,0,0,0,1,1,0,5,4,1,2,,4,4,0,2,0,0,1,1,0,,,
"Mar 18, 2022 1:00 AM",8,1,7,0,0,0,1,1,0,3,2,1,2,0,2,2,1,1,0,3,3,0,1,,1,1,0,0,1,0,0,0,0,,,
"Mar 18, 2022 2:00 AM",15,6,9,0,0,0,1,1,0,1,1,0,1,1,0,0,2,2,0,0,0,0,3,,1,1,0,0,0,0,0,0,0,,,
"Mar 18, 2022 3:00 AM",4,0,4,2,0,2,1,1,0,1,1,0,2,2,0,0,0,0,0,1,1,0,0,,0,0,0,1,0,0,1,0,1,,,
"Mar 18, 2022 4:00 AM",5,1,4,3,2,1,4,2,2,3,2,1,0,0,0,0,1,1,0,5,5,0,1,,2,2,0,1,0,1,1,1,0,,,
"Mar 18, 2022 5:00 AM",5,2,3,3,1,2,2,2,0,1,1,0,0,0,0,0,1,1,0,1,1,0,0,,0,0,0,4,0,0,0,0,0,,,
"Mar 18, 2022 6:00 AM",18,13,5,6,5,1,5,5,0,5,4,1,2,1,1,1,3,3,0,3,3,0,3,,1,1,0,6,1,1,2,1,1,,,
"Mar 18, 2022 7:00 AM",18,13,5,18,8,10,18,11,7,20,12,8,1,1,0,4,8,8,0,3,3,0,9,,7,5,2,16,1,2,1,1,0,,,
"Mar 18, 2022 8:00 AM",19,5,14,48,27,21,46,28,18,39,26,13,2,1,1,10,10,10,0,10,8,2,9,,16,13,3,17,1,8,4,2,2,,,
"Mar 18, 2022 9:00 AM",34,16,18,81,51,30,89,54,35,69,41,28,6,6,0,5,16,15,1,8,7,1,15,,44,30,14,28,7,4,1,1,0,,,
"Mar 18, 2022 10:00 AM",30,15,15,118,62,56,117,70,47,97,56,41,18,6,12,9,13,12,1,7,5,2,18,,51,29,22,27,4,8,1,1,0,,,
"Mar 18, 2022 11:00 AM",52,33,19,147,79,68,155,93,62,107,63,44,24,13,11,19,22,22,0,11,11,0,17,,54,32,22,35,7,4,9,4,5,,,
"Mar 18, 2022 12:00 PM",63,36,27,132,57,75,181,90,91,105,64,41,30,18,12,22,30,30,0,15,15,0,30,,78,38,40,52,2,5,7,6,1,,,
"Mar 18, 2022 1:00 PM",70,30,40,148,75,73,197,105,92,138,73,65,40,14,26,9,30,28,2,22,16,6,29,,84,50,34,34,4,6,5,3,2,,,
"Mar 18, 2022 2:00 PM",61,35,26,114,55,59,153,77,76,106,56,50,20,8,12,31,24,24,0,21,20,1,25,,92,72,20,31,4,4,14,10,4,,,
"Mar 18, 2022 3:00 PM",60,25,35,133,72,61,146,85,61,113,67,46,26,11,15,13,19,19,0,28,27,1,16,,76,38,38,38,10,2,11,10,1,,,
"Mar 18, 2022 4:00 PM",64,33,31,97,60,37,119,52,67,110,60,50,22,9,13,18,19,19,0,15,12,3,21,,67,17,50,32,6,1,10,8,2,,,
"Mar 18, 2022 5:00 PM",53,26,27,90,42,48,119,43,76,91,39,52,16,11,5,17,19,19,0,17,17,0,18,,52,20,32,38,3,4,3,2,1,,,
"Mar 18, 2022 6:00 PM",56,20,36,47,24,23,51,26,25,59,29,30,9,6,3,11,15,15,0,9,8,1,17,,35,19,16,20,3,2,5,5,0,,,
"Mar 18, 2022 7:00 PM",58,14,44,13,4,9,27,9,18,29,9,20,4,2,2,5,10,9,1,4,4,0,8,,14,7,7,11,0,0,3,1,2,,,
"Mar 18, 2022 8:00 PM",22,13,9,5,5,0,15,8,7,12,8,4,2,1,1,7,5,5,0,2,2,0,6,,13,9,4,10,0,3,9,4,5,,,
"Mar 18, 2022 9:00 PM",12,6,6,7,5,2,9,6,3,4,2,2,0,0,0,4,3,3,0,3,2,1,4,,4,3,1,7,1,1,1,0,1,,,
"Mar 18, 2022 10:00 PM",13,3,10,0,0,0,9,3,6,3,2,1,0,0,0,2,4,4,0,6,6,0,4,,0,0,0,5,0,1,0,0,0,,,
"Mar 18, 2022 11:00 PM",12,3,9,6,5,1,9,5,4,8,4,4,3,1,2,3,6,5,1,5,5,0,5,,2,1,1,4,0,1,0,0,0,,,
"Mar 19, 2022 12:00 AM",4,1,3,1,1,0,0,0,0,0,0,0,2,1,1,0,0,0,0,2,2,0,0,,3,2,1,3,0,0,0,0,0,,,
"Mar 19, 2022 1:00 AM",7,2,5,0,0,0,4,4,0,3,3,0,0,0,0,0,1,1,0,1,1,0,1,,0,0,0,1,0,0,0,0,0,,,
"Mar 19, 2022 2:00 AM",4,0,4,0,0,0,2,1,1,6,5,1,0,0,0,0,0,0,0,0,0,0,0,,1,0,1,2,0,0,0,0,0,,,
"Mar 19, 2022 3:00 AM",4,1,3,4,4,0,0,0,0,0,0,0,0,0,0,0,0,0,0,0,0,0,1,,0,0,0,1,0,0,0,0,0,,,
"Mar 19, 2022 4:00 AM",1,1,0,0,0,0,0,0,0,0,0,0,0,0,0,0,0,0,0,3,3,0,0,,1,1,0,0,0,0,0,0,0,,,
"Mar 19, 2022 5:00 AM",1,0,1,0,0,0,0,0,0,0,0,0,0,0,0,0,2,2,0,0,0,0,2,,0,0,0,5,0,1,0,0,0,,,
"Mar 19, 2022 6:00 AM",3,2,1,5,1,4,7,4,3,8,3,5,3,2,1,1,3,3,0,3,3,0,3,,2,1,1,4,0,1,1,1,0,,,
"Mar 19, 2022 7:00 AM",11,7,4,12,5,7,18,13,5,21,14,7,3,0,3,5,6,5,1,9,8,1,5,,8,6,2,17,1,3,0,0,0,,,
"Mar 19, 2022 8:00 AM",22,9,13,37,21,16,29,17,12,27,19,8,5,3,2,9,17,17,0,12,12,0,18,,13,7,6,10,0,4,1,1,0,,,
"Mar 19, 2022 9:00 AM",50,25,25,75,44,31,76,49,27,67,45,22,8,4,4,2,18,17,1,4,4,0,17,,27,23,4,25,1,10,1,0,1,,,
"Mar 19, 2022 10:00 AM",52,31,21,97,46,51,130,74,56,76,44,32,25,16,9,10,18,16,2,12,12,0,14,,44,25,19,37,3,12,8,3,5,,,
"Mar 19, 2022 11:00 AM",48,27,21,136,66,70,152,81,71,132,82,50,17,11,6,14,16,14,2,11,10,1,11,,92,52,40,23,8,4,3,3,0,,,
"Mar 19, 2022 12:00 PM",63,30,33,120,62,58,136,69,67,105,52,53,25,11,14,16,28,28,0,12,12,0,27,,78,39,39,39,4,4,13,10,3,,,
"Mar 19, 2022 1:00 PM",55,25,30,90,40,50,128,77,51,100,53,47,32,10,22,15,24,22,2,15,11,4,19,,58,37,21,35,5,4,8,6,2,,,
"Mar 19, 2022 2:00 PM",52,32,20,95,49,46,110,60,50,100,52,48,35,17,18,17,24,22,2,14,13,1,21,,37,26,11,24,7,1,7,6,1,,,
"Mar 19, 2022 3:00 PM",48,24,24,83,44,39,118,67,51,80,48,32,12,6,6,17,12,11,1,14,13,1,11,,48,28,20,45,5,3,2,1,1,,,
"Mar 19, 2022 4:00 PM",57,31,26,83,43,40,96,36,60,87,36,51,19,6,13,13,25,22,3,13,8,5,26,,43,15,28,41,2,3,3,1,2,,,
"Mar 19, 2022 5:00 PM",38,14,24,39,17,22,61,26,35,57,28,29,14,5,9,13,18,15,3,10,10,0,15,,30,14,16,27,1,1,4,3,1,,,
"Mar 19, 2022 6:00 PM",34,17,17,9,6,3,29,13,16,14,4,10,5,2,3,14,11,9,2,13,9,4,8,,12,6,6,19,3,2,5,4,1,,,
"Mar 19, 2022 7:00 PM",43,21,22,13,7,6,21,10,11,17,8,9,2,1,1,13,4,4,0,8,7,1,6,,7,3,4,18,1,1,4,2,2,,,
"Mar 19, 2022 8:00 PM",30,14,16,7,5,2,8,3,5,6,3,3,4,0,4,1,5,5,0,8,8,0,7,,1,0,1,8,1,1,3,2,1,,,
"Mar 19, 2022 9:00 PM",20,7,13,3,3,0,2,2,0,1,0,1,1,1,0,1,3,3,0,8,8,0,4,,1,1,0,5,2,1,5,2,3,,,
"Mar 19, 2022 10:00 PM",19,3,16,2,2,0,8,3,5,7,4,3,2,2,0,1,8,6,2,6,6,0,6,,1,1,0,4,1,1,2,1,1,,,
"Mar 19, 2022 11:00 PM",15,7,8,0,0,0,2,0,2,3,0,3,0,0,0,3,1,1,0,5,5,0,1,,0,0,0,8,0,1,3,2,1,,,
"Mar 20, 2022 12:00 AM",4,1,3,0,0,0,2,2,0,3,1,2,2,0,2,0,1,1,0,5,5,0,1,,1,1,0,4,0,0,0,0,0,,,
"Mar 20, 2022 1:00 AM",5,1,4,0,0,0,3,2,1,1,1,0,0,0,0,1,1,1,0,0,0,0,1,,2,2,0,0,0,0,1,0,1,,,
"Mar 20, 2022 2:00 AM",6,1,5,0,0,0,0,0,0,0,0,0,0,0,0,0,0,0,0,3,3,0,0,,4,4,0,1,0,0,0,0,0,,,
"Mar 20, 2022 3:00 AM",1,0,1,0,0,0,0,0,0,0,0,0,0,0,0,0,0,0,0,2,2,0,0,,0,0,0,0,0,0,0,0,0,,,
"Mar 20, 2022 4:00 AM",0,0,0,0,0,0,0,0,0,0,0,0,0,0,0,0,0,0,0,1,0,1,0,,0,0,0,1,0,0,1,0,1,,,
"Mar 20, 2022 5:00 AM",1,1,0,1,1,0,0,0,0,2,1,1,0,0,0,1,1,1,0,0,0,0,0,,0,0,0,3,0,0,0,0,0,,,
"Mar 20, 2022 6:00 AM",7,2,5,6,1,5,8,4,4,5,1,4,2,0,2,0,2,2,0,1,1,0,2,,1,1,0,4,0,0,0,0,0,,,
"Mar 20, 2022 7:00 AM",12,7,5,31,14,17,21,13,8,27,16,11,0,0,0,0,9,9,0,7,6,1,9,,2,1,1,9,2,2,0,0,0,,,
"Mar 20, 2022 8:00 AM",29,17,12,43,24,19,57,36,21,49,32,17,5,3,2,8,10,10,0,3,2,1,12,,23,15,8,18,2,9,0,0,0,,,
"Mar 20, 2022 9:00 AM",41,18,23,100,58,42,109,70,39,102,69,33,7,3,4,9,17,16,1,8,8,0,15,,34,20,14,27,3,8,4,3,1,,,
"Mar 20, 2022 10:00 AM",49,30,19,140,81,59,148,90,58,117,74,43,16,6,10,11,19,19,0,10,7,3,19,,69,49,20,26,8,4,2,1,1,,,
"Mar 20, 2022 11:00 AM",80,46,34,149,61,88,132,62,70,120,58,62,19,15,4,12,17,16,1,13,13,0,14,,81,49,32,57,7,6,5,3,2,,,
"Mar 20, 2022 12:00 PM",65,29,36,204,87,117,226,118,108,152,71,81,44,32,12,22,21,20,1,19,17,2,18,,87,45,42,69,8,4,3,1,2,,,
"Mar 20, 2022 1:00 PM",73,33,40,122,46,76,146,62,84,108,42,66,40,20,20,20,24,22,2,14,11,3,21,,80,46,34,37,5,5,6,5,1,,,
"Mar 20, 2022 2:00 PM",49,22,27,118,56,62,129,67,62,116,52,64,22,11,11,25,19,18,1,21,18,3,15,,54,39,15,40,3,5,3,3,0,,,
"Mar 20, 2022 3:00 PM",51,27,24,126,74,52,143,65,78,102,54,48,34,16,18,25,18,17,1,12,9,3,14,,99,45,54,44,4,7,9,6,3,,,
"Mar 20, 2022 4:00 PM",46,24,22,110,54,56,116,61,55,101,48,53,18,13,5,42,27,26,1,9,7,2,28,,42,19,23,47,2,2,5,4,1,,,
"Mar 20, 2022 5:00 PM",43,20,23,59,28,31,91,29,62,89,27,62,25,13,12,14,13,12,1,11,6,5,12,,47,16,31,33,2,0,0,0,0,,,
"Mar 20, 2022 6:00 PM",34,15,19,38,19,19,52,25,27,39,17,22,14,10,4,11,14,14,0,10,7,3,16,,19,7,12,25,2,1,6,6,0,,,
"Mar 20, 2022 7:00 PM",40,20,20,12,8,4,13,8,5,8,5,3,5,3,2,2,8,7,1,10,10,0,7,,11,6,5,19,1,0,3,2,1,,,
"Mar 20, 2022 8:00 PM",38,11,27,7,5,2,20,11,9,11,4,7,3,1,2,8,10,10,0,10,8,2,10,,9,2,7,14,0,0,2,1,1,,,
"Mar 20, 2022 9:00 PM",28,10,18,5,3,2,9,4,5,4,1,3,3,0,3,3,14,13,1,11,11,0,11,,3,1,2,11,1,0,0,0,0,,,
"Mar 20, 2022 10:00 PM",12,2,10,1,0,1,6,1,5,5,1,4,2,2,0,1,5,5,0,4,4,0,5,,0,0,0,8,1,1,0,0,0,,,
"Mar 20, 2022 11:00 PM",10,1,9,4,3,1,1,1,0,0,0,0,1,1,0,1,0,0,0,3,2,1,0,,0,0,0,3,0,0,1,1,0,,,
"Mar 21, 2022 12:00 AM",3,0,3,0,0,0,1,0,1,2,1,1,3,3,0,0,0,0,0,0,0,0,0,,0,0,0,2,0,0,0,0,0,,,
"Mar 21, 2022 1:00 AM",2,2,0,0,0,0,0,0,0,0,0,0,0,0,0,0,0,0,0,2,1,1,0,,0,0,0,0,0,0,0,0,0,,,
"Mar 21, 2022 2:00 AM",1,1,0,0,0,0,0,0,0,0,0,0,0,0,0,0,0,0,0,1,1,0,0,,0,0,0,1,0,0,0,0,0,,,
"Mar 21, 2022 3:00 AM",0,0,0,0,0,0,0,0,0,0,0,0,0,0,0,0,1,1,0,2,2,0,2,,0,0,0,0,0,0,0,0,0,,,
"Mar 21, 2022 4:00 AM",0,0,0,0,0,0,0,0,0,0,0,0,0,0,0,1,2,2,0,0,0,0,2,,0,0,0,3,0,1,0,0,0,,,
"Mar 21, 2022 5:00 AM",5,5,0,0,0,0,0,0,0,0,0,0,0,0,0,1,10,10,0,0,0,0,7,,1,1,0,11,1,0,0,0,0,,,
"Mar 21, 2022 6:00 AM",50,36,14,11,5,6,23,8,15,22,11,11,3,3,0,3,22,22,0,6,3,3,22,,4,2,2,29,1,2,1,1,0,,,
"Mar 21, 2022 7:00 AM",83,55,28,42,13,29,63,19,44,41,16,25,14,11,3,9,72,71,1,18,15,3,66,,27,9,18,94,4,5,6,5,1,,,
"Mar 21, 2022 8:00 AM",205,150,55,77,19,58,132,40,92,90,30,60,25,9,16,16,127,126,1,44,32,12,120,,72,22,50,161,6,7,9,8,1,,,
"Mar 21, 2022 9:00 AM",133,114,19,49,25,24,66,34,32,57,34,23,15,11,4,6,70,68,2,15,9,6,60,,32,19,13,42,4,1,7,4,3,,,
"Mar 21, 2022 10:00 AM",79,54,25,37,16,21,66,36,30,47,26,21,5,4,1,6,40,40,0,8,5,3,30,,36,27,9,20,3,5,0,0,0,,,
"Mar 21, 2022 11:00 AM",59,34,25,51,29,22,56,31,25,59,36,23,31,14,17,10,31,27,4,10,8,2,22,,13,9,4,22,2,2,3,1,2,,,
"Mar 21, 2022 12:00 PM",80,50,30,69,28,41,65,26,39,52,24,28,29,13,16,9,19,17,2,21,19,2,16,,41,15,26,30,5,3,9,8,1,,,
"Mar 21, 2022 1:00 PM",76,37,39,52,29,23,65,36,29,47,23,24,30,16,14,15,32,29,3,22,17,5,24,,32,17,15,21,4,1,2,1,1,,,
"Mar 21, 2022 2:00 PM",63,31,32,23,11,12,66,37,29,26,19,7,17,14,3,9,25,24,1,32,27,5,19,,37,28,9,20,1,4,7,3,4,,,
"Mar 21, 2022 3:00 PM",108,35,73,40,24,16,69,46,23,48,29,19,22,18,4,11,27,19,8,29,20,9,23,,30,18,12,35,7,2,6,4,2,,,
"Mar 21, 2022 4:00 PM",124,46,78,51,30,21,82,50,32,82,40,42,25,8,17,27,34,26,8,44,39,5,26,,43,26,17,53,12,4,6,3,3,,,
"Mar 21, 2022 5:00 PM",211,49,162,53,34,19,111,56,55,79,42,37,21,8,13,29,39,32,7,96,89,7,31,,60,42,18,66,7,2,5,2,3,,,
"Mar 21, 2022 6:00 PM",163,49,114,83,49,34,99,65,34,79,48,31,25,12,13,20,29,26,3,90,87,3,24,,43,36,7,39,4,2,4,4,0,,,
"Mar 21, 2022 7:00 PM",97,26,71,37,25,12,55,31,24,41,21,20,9,4,5,13,27,20,7,37,35,2,23,,26,18,8,24,1,3,12,8,4,,,
"Mar 21, 2022 8:00 PM",68,18,50,17,9,8,16,11,5,21,13,8,1,1,0,3,11,10,1,20,18,2,8,,7,6,1,22,3,1,0,0,0,,,
"Mar 21, 2022 9:00 PM",44,11,33,7,5,2,11,7,4,11,6,5,3,0,3,7,14,8,6,17,17,0,8,,3,3,0,14,1,0,3,1,2,,,
"Mar 21, 2022 10:00 PM",24,7,17,0,0,0,7,2,5,1,0,1,3,2,1,6,8,6,2,17,17,0,6,,5,2,3,9,1,0,2,1,1,,,
"Mar 21, 2022 11:00 PM",5,1,4,0,0,0,3,1,2,1,0,1,0,0,0,1,2,2,0,4,4,0,2,,1,0,1,1,1,0,2,2,0,,,
"Mar 22, 2022 12:00 AM",4,2,2,1,1,0,3,1,2,6,4,2,0,0,0,0,2,1,1,3,3,0,2,,2,1,1,0,0,0,1,0,1,,,
"Mar 22, 2022 1:00 AM",1,0,1,2,2,0,0,0,0,0,0,0,1,1,0,0,0,0,0,2,2,0,0,,0,0,0,1,0,0,0,0,0,,,
"Mar 22, 2022 2:00 AM",6,4,2,2,2,0,0,0,0,0,0,0,0,0,0,0,0,0,0,0,0,0,0,,0,0,0,0,0,0,0,0,0,,,
"Mar 22, 2022 3:00 AM",2,0,2,0,0,0,0,0,0,0,0,0,2,1,1,0,0,0,0,2,2,0,1,,1,1,0,0,0,0,0,0,0,,,
"Mar 22, 2022 4:00 AM",2,1,1,0,0,0,0,0,0,0,0,0,0,0,0,0,1,1,0,0,0,0,1,,0,0,0,0,0,0,0,0,0,,,
"Mar 22, 2022 5:00 AM",8,6,2,0,0,0,2,1,1,2,1,1,0,0,0,3,9,9,0,1,1,0,9,,0,0,0,14,0,1,0,0,0,,,
"Mar 22, 2022 6:00 AM",53,38,15,23,10,13,32,15,17,27,13,14,3,2,1,5,24,24,0,11,8,3,24,,11,6,5,41,0,3,2,2,0,,,
"Mar 22, 2022 7:00 AM",123,86,37,50,14,36,85,26,59,56,18,38,10,9,1,12,78,78,0,19,14,5,72,,34,10,24,99,6,4,5,5,0,,,
"Mar 22, 2022 8:00 AM",256,193,63,97,24,73,150,46,104,117,50,67,45,29,16,35,156,153,3,52,37,15,147,,86,32,54,177,6,10,19,13,6,,,
"Mar 22, 2022 9:00 AM",140,120,20,62,26,36,100,48,52,78,41,37,18,13,5,14,71,70,1,21,17,4,64,,80,43,37,53,2,3,6,5,1,,,
"Mar 22, 2022 10:00 AM",84,65,19,48,25,23,61,35,26,44,28,16,16,13,3,16,44,43,1,11,8,3,30,,59,32,27,27,4,5,3,2,1,,,
"Mar 22, 2022 11:00 AM",52,30,22,55,30,25,68,35,33,53,28,25,14,6,8,14,28,26,2,8,7,1,26,,39,19,20,38,7,4,10,7,3,,,
"Mar 22, 2022 12:00 PM",56,37,19,72,38,34,95,47,48,58,30,28,19,9,10,13,42,39,3,27,21,6,35,,35,19,16,47,4,4,4,2,2,,,
"Mar 22, 2022 1:00 PM",107,55,52,71,30,41,120,62,58,64,33,31,16,7,9,14,35,30,5,25,21,4,27,,48,30,18,32,3,3,4,4,0,,,
"Mar 22, 2022 2:00 PM",78,35,43,70,38,32,87,51,36,68,42,26,21,10,11,14,27,24,3,36,33,3,23,,37,25,12,25,4,4,7,3,4,,,
"Mar 22, 2022 3:00 PM",95,39,56,89,58,31,113,72,41,77,51,26,22,9,13,18,35,28,7,36,28,8,26,,53,32,21,35,2,4,5,4,1,,,
"Mar 22, 2022 4:00 PM",160,45,115,95,53,42,125,67,58,91,48,43,25,8,17,20,32,23,9,52,51,1,21,,55,25,30,58,7,5,7,3,4,,,
"Mar 22, 2022 5:00 PM",265,58,207,87,56,31,152,84,68,99,56,43,22,6,16,39,52,47,5,122,117,5,47,,100,60,40,58,5,6,9,5,4,,,
"Mar 22, 2022 6:00 PM",179,52,127,103,70,33,127,85,42,120,80,40,24,8,16,26,42,35,7,83,79,4,37,,46,34,12,66,3,5,7,5,2,,,
"Mar 22, 2022 7:00 PM",107,35,72,52,34,18,78,40,38,60,27,33,12,3,9,15,33,31,2,46,45,1,30,,35,23,12,33,4,4,4,2,2,,,
"Mar 22, 2022 8:00 PM",101,33,68,25,17,8,42,26,16,37,23,14,5,3,2,13,24,18,6,33,32,1,19,,25,15,10,20,4,1,8,6,2,,,
"Mar 22, 2022 9:00 PM",59,10,49,5,4,1,20,11,9,14,6,8,3,2,1,9,10,6,4,21,18,3,7,,11,8,3,8,2,1,4,2,2,,,
"Mar 22, 2022 10:00 PM",41,10,31,9,4,5,8,4,4,10,4,6,3,1,2,7,10,10,0,18,17,1,9,,9,4,5,7,4,0,0,0,0,,,
"Mar 22, 2022 11:00 PM",11,2,9,3,1,2,6,4,2,5,3,2,1,1,0,1,2,1,1,5,5,0,3,,0,0,0,2,0,0,1,1,0,,,
"Mar 23, 2022 12:00 AM",4,0,4,0,0,0,3,3,0,1,1,0,0,0,0,0,2,2,0,5,5,0,0,,4,3,1,0,0,0,0,0,0,,,
"Mar 23, 2022 1:00 AM",8,3,5,1,1,0,0,0,0,0,0,0,0,0,0,0,1,0,1,3,2,1,0,,0,0,0,0,0,0,0,0,0,,,
"Mar 23, 2022 2:00 AM",5,3,2,0,0,0,0,0,0,0,0,0,0,0,0,0,0,0,0,0,0,0,0,,0,0,0,0,0,1,0,0,0,,,
"Mar 23, 2022 3:00 AM",0,0,0,0,0,0,1,1,0,1,1,0,1,1,0,0,0,0,0,0,0,0,1,,0,0,0,0,0,0,0,0,0,,,
"Mar 23, 2022 4:00 AM",3,2,1,0,0,0,0,0,0,0,0,0,0,0,0,0,2,1,1,0,0,0,1,,0,0,0,0,0,3,0,0,0,,,
"Mar 23, 2022 5:00 AM",6,4,2,0,0,0,0,0,0,1,0,1,0,0,0,7,12,12,0,3,2,1,12,,0,0,0,11,1,0,0,0,0,,,
"Mar 23, 2022 6:00 AM",45,32,13,23,8,15,31,12,19,24,11,13,1,1,0,6,23,22,1,11,8,3,21,,14,9,5,33,0,2,2,2,0,,,
"Mar 23, 2022 7:00 AM",148,107,41,67,20,47,93,23,70,60,18,42,12,11,1,12,76,76,0,24,20,4,73,,35,13,22,111,2,7,4,2,2,,,
"Mar 23, 2022 8:00 AM",249,189,60,107,33,74,158,57,101,115,48,67,51,31,20,34,157,157,0,47,34,13,140,,94,35,59,191,7,7,21,17,4,,,
"Mar 23, 2022 9:00 AM",146,119,27,86,44,42,96,48,48,76,49,27,11,8,3,9,82,81,1,20,14,6,64,,51,32,19,67,5,7,6,3,3,,,
"Mar 23, 2022 10:00 AM",78,59,19,70,30,40,90,49,41,72,38,34,9,7,2,12,50,50,0,18,13,5,39,,32,22,10,35,4,10,4,4,0,,,
"Mar 23, 2022 11:00 AM",58,40,18,53,29,24,67,36,31,56,33,23,10,6,4,14,38,30,8,20,15,5,28,,24,11,13,36,2,2,7,5,2,,,
"Mar 23, 2022 12:00 PM",99,53,46,62,30,32,102,59,43,64,32,32,17,8,9,6,29,26,3,18,17,1,28,,60,34,26,32,5,0,2,2,0,,,
"Mar 23, 2022 1:00 PM",96,43,53,86,48,38,137,82,55,95,55,40,31,15,16,17,48,44,4,36,31,5,37,,63,39,24,35,4,4,4,2,2,,,
"Mar 23, 2022 2:00 PM",96,42,54,89,46,43,133,73,60,92,53,39,13,4,9,19,28,25,3,25,22,3,25,,60,41,19,45,6,4,8,4,4,,,
"Mar 23, 2022 3:00 PM",94,36,58,76,38,38,122,66,56,82,47,35,16,9,7,24,37,34,3,38,34,4,28,,46,24,22,48,2,7,11,4,7,,,
"Mar 23, 2022 4:00 PM",143,41,102,98,59,39,140,75,65,85,43,42,22,12,10,19,39,33,6,56,50,6,32,,57,27,30,56,11,1,8,6,2,,,
"Mar 23, 2022 5:00 PM",220,46,174,114,69,45,167,91,76,132,68,64,25,7,18,21,32,23,9,76,74,2,28,,78,41,37,90,2,3,10,6,4,,,
"Mar 23, 2022 6:00 PM",190,47,143,106,63,43,169,105,64,112,69,43,14,2,12,31,44,37,7,87,86,1,37,,89,69,20,68,8,4,8,5,3,,,
"Mar 23, 2022 7:00 PM",115,35,80,49,30,19,77,42,35,48,27,21,11,5,6,15,26,23,3,53,49,4,19,,34,24,10,36,6,5,11,6,5,,,
"Mar 23, 2022 8:00 PM",80,21,59,14,11,3,31,18,13,26,12,14,1,1,0,10,15,8,7,29,29,0,11,,10,6,4,24,1,2,8,6,2,,,
"Mar 23, 2022 9:00 PM",36,7,29,11,6,5,22,9,13,16,8,8,3,2,1,5,11,8,3,20,18,2,9,,6,4,2,15,6,1,3,1,2,,,
"Mar 23, 2022 10:00 PM",36,10,26,11,7,4,18,11,7,14,7,7,4,3,1,0,6,5,1,16,14,2,6,,5,2,3,7,0,0,2,1,1,,,
"Mar 23, 2022 11:00 PM",15,3,12,4,4,0,7,5,2,7,3,4,0,0,0,0,2,1,1,12,12,0,2,,5,4,1,9,1,0,1,1,0,,,
"Mar 24, 2022 12:00 AM",5,2,3,0,0,0,1,1,0,3,3,0,0,0,0,0,1,1,0,2,2,0,1,,4,4,0,3,0,0,0,0,0,,,
"Mar 24, 2022 1:00 AM",2,0,2,0,0,0,0,0,0,0,0,0,0,0,0,0,1,1,0,0,0,0,1,,0,0,0,1,0,1,1,1,0,,,
"Mar 24, 2022 2:00 AM",5,4,1,0,0,0,0,0,0,0,0,0,0,0,0,0,0,0,0,0,0,0,0,,0,0,0,0,0,0,0,0,0,,,
"Mar 24, 2022 3:00 AM",0,0,0,0,0,0,0,0,0,0,0,0,0,0,0,0,0,0,0,0,0,0,2,,0,0,0,1,0,0,0,0,0,,,
"Mar 24, 2022 4:00 AM",1,1,0,0,0,0,0,0,0,0,0,0,0,0,0,0,0,0,0,1,1,0,0,,0,0,0,3,0,0,1,1,0,,,
"Mar 24, 2022 5:00 AM",3,3,0,1,1,0,1,1,0,3,2,1,0,0,0,3,9,9,0,1,1,0,9,,1,1,0,7,0,0,0,0,0,,,
"Mar 24, 2022 6:00 AM",45,29,16,23,13,10,30,19,11,28,20,8,3,2,1,5,20,20,0,14,12,2,20,,8,4,4,32,1,2,4,4,0,,,
"Mar 24, 2022 7:00 AM",116,74,42,61,19,42,94,21,73,65,21,44,13,10,3,7,74,74,0,15,9,6,72,,33,8,25,108,3,6,6,5,1,,,
"Mar 24, 2022 8:00 AM",268,205,63,112,40,72,150,53,97,113,50,63,42,21,21,29,141,141,0,43,31,12,133,,95,26,69,159,8,6,18,16,2,,,
"Mar 24, 2022 9:00 AM",154,131,23,68,22,46,89,38,51,84,38,46,15,12,3,17,85,85,0,19,16,3,71,,50,25,25,72,2,3,3,3,0,,,
"Mar 24, 2022 10:00 AM",63,48,15,50,20,30,79,43,36,53,25,28,12,11,1,4,39,37,2,13,9,4,34,,27,11,16,42,2,4,3,2,1,,,
"Mar 24, 2022 11:00 AM",62,35,27,68,31,37,82,31,51,71,33,38,19,11,8,5,41,37,4,7,7,0,29,,34,15,19,34,2,1,0,0,0,,,
"Mar 24, 2022 12:00 PM",80,47,33,72,36,36,79,42,37,58,29,29,34,14,20,9,40,34,6,22,20,2,31,,43,25,18,38,3,6,1,0,1,,,
"Mar 24, 2022 1:00 PM",90,36,54,68,37,31,107,63,44,85,48,37,23,14,9,19,28,23,5,30,25,5,21,,52,33,19,30,7,2,3,3,0,,,
"Mar 24, 2022 2:00 PM",76,29,47,67,32,35,109,62,47,65,37,28,16,9,7,11,32,26,6,33,27,6,22,,42,26,16,27,7,3,7,5,2,,,
"Mar 24, 2022 3:00 PM",83,29,54,76,42,34,80,54,26,70,44,26,28,15,13,21,30,25,5,37,31,6,21,,42,24,18,30,4,6,7,6,1,,,
"Mar 24, 2022 4:00 PM",141,42,99,91,62,29,99,64,35,78,47,31,24,11,13,24,40,34,6,46,44,2,31,,53,26,27,45,5,5,5,4,1,,,
"Mar 24, 2022 5:00 PM",232,62,170,108,69,39,164,97,67,117,74,43,26,7,19,30,43,38,5,95,89,6,39,,72,32,40,67,6,8,7,4,3,,,
"Mar 24, 2022 6:00 PM",182,67,115,110,66,44,148,93,55,117,71,46,18,7,11,40,32,28,4,93,86,7,29,,67,40,27,57,13,1,11,9,2,,,
"Mar 24, 2022 7:00 PM",117,35,82,52,40,12,76,40,36,56,34,22,12,6,6,18,23,21,2,45,42,3,15,,33,22,11,32,4,3,12,7,5,,,
"Mar 24, 2022 8:00 PM",80,28,52,20,11,9,32,14,18,22,11,11,8,1,7,10,31,25,6,38,36,2,23,,20,10,10,26,2,0,7,2,5,,,
"Mar 24, 2022 9:00 PM",66,18,48,3,2,1,14,10,4,8,4,4,3,3,0,2,15,12,3,18,18,0,13,,7,6,1,10,2,1,2,1,1,,,
"Mar 24, 2022 10:00 PM",42,9,33,5,4,1,12,10,2,9,5,4,4,0,4,4,8,7,1,13,13,0,7,,8,8,0,10,0,2,1,0,1,,,
"Mar 24, 2022 11:00 PM",23,6,17,4,1,3,10,5,5,8,3,5,0,0,0,3,2,1,1,11,10,1,1,,5,2,3,3,0,0,2,2,0,,,
"Mar 25, 2022 12:00 AM",11,2,9,0,0,0,1,0,1,6,0,6,4,1,3,0,1,1,0,8,8,0,1,,0,0,0,2,0,0,1,1,0,,,
"Mar 25, 2022 1:00 AM",2,2,0,0,0,0,0,0,0,0,0,0,2,0,2,1,1,1,0,2,2,0,1,,0,0,0,1,0,0,0,0,0,,,
"Mar 25, 2022 2:00 AM",5,3,2,0,0,0,2,0,2,0,0,0,0,0,0,0,1,1,0,2,2,0,1,,0,0,0,3,0,0,0,0,0,,,
"Mar 25, 2022 3:00 AM",2,0,2,0,0,0,0,0,0,0,0,0,0,0,0,0,0,0,0,1,1,0,0,,0,0,0,0,0,0,0,0,0,,,
"Mar 25, 2022 4:00 AM",2,1,1,2,1,1,2,1,1,2,1,1,0,0,0,0,1,1,0,0,0,0,1,,0,0,0,2,0,0,0,0,0,,,
"Mar 25, 2022 5:00 AM",7,7,0,1,1,0,2,2,0,2,1,1,0,0,0,5,5,5,0,0,0,0,5,,1,1,0,11,0,0,0,0,0,,,
"Mar 25, 2022 6:00 AM",44,31,13,17,9,8,25,17,8,20,13,7,5,5,0,7,19,19,0,15,13,2,19,,7,4,3,28,0,2,3,2,1,,,
"Mar 25, 2022 7:00 AM",91,54,37,87,45,42,106,38,68,81,39,42,15,11,4,7,43,43,0,17,16,1,46,,32,12,20,79,3,5,2,2,0,,,
"Mar 25, 2022 8:00 AM",211,156,55,126,46,80,139,54,85,125,56,69,37,20,17,20,106,105,1,46,38,8,92,,72,26,46,121,7,7,20,17,3,,,
"Mar 25, 2022 9:00 AM",126,99,27,73,28,45,86,44,42,74,40,34,17,12,5,5,70,69,1,16,13,3,61,,41,22,19,47,4,2,8,6,2,,,
"Mar 25, 2022 10:00 AM",69,41,28,65,25,40,67,37,30,54,29,25,18,12,6,13,33,32,1,12,11,1,30,,21,13,8,28,5,2,2,1,1,,,
"Mar 25, 2022 11:00 AM",57,41,16,81,34,47,67,27,40,59,27,32,17,13,4,11,38,35,3,18,11,7,27,,23,9,14,24,5,5,5,2,3,,,
"Mar 25, 2022 12:00 PM",76,44,32,72,36,36,86,48,38,78,45,33,24,10,14,19,26,23,3,14,12,2,21,,44,23,21,35,3,4,3,3,0,,,
"Mar 25, 2022 1:00 PM",107,52,55,89,46,43,108,58,50,83,48,35,20,11,9,28,33,27,6,28,20,8,30,,39,20,19,32,5,2,11,8,3,,,
"Mar 25, 2022 2:00 PM",79,43,36,75,44,31,102,57,45,58,33,25,19,10,9,13,24,19,5,23,21,2,19,,37,25,12,30,5,7,8,3,5,,,
"Mar 25, 2022 3:00 PM",103,35,68,71,43,28,98,63,35,60,38,22,20,10,10,17,31,28,3,30,28,2,24,,70,42,28,27,3,3,12,8,4,,,
"Mar 25, 2022 4:00 PM",142,57,85,107,57,50,147,83,64,102,57,45,24,8,16,22,29,25,4,44,40,4,28,,58,19,39,53,6,8,12,9,3,,,
"Mar 25, 2022 5:00 PM",175,54,121,114,62,52,180,101,79,132,71,61,22,4,18,25,38,37,1,69,63,6,40,,87,43,44,67,3,3,12,7,5,,,
"Mar 25, 2022 6:00 PM",151,46,105,71,41,30,124,64,60,79,43,36,17,8,9,24,29,23,6,61,58,3,22,,67,37,30,44,7,3,9,6,3,,,
"Mar 25, 2022 7:00 PM",98,31,67,39,19,20,59,31,28,39,24,15,11,3,8,13,16,15,1,29,27,2,12,,32,12,20,28,4,3,3,2,1,,,
"Mar 25, 2022 8:00 PM",79,35,44,20,12,8,26,14,12,23,10,13,7,4,3,6,15,13,2,21,20,1,11,,8,5,3,20,1,0,3,2,1,,,
"Mar 25, 2022 9:00 PM",32,6,26,15,9,6,18,8,10,19,10,9,5,4,1,5,8,8,0,9,9,0,8,,6,2,4,10,3,1,5,1,4,,,
"Mar 25, 2022 10:00 PM",27,10,17,9,7,2,18,8,10,13,6,7,1,0,1,8,9,7,2,15,15,0,6,,6,3,3,11,0,1,0,0,0,,,
"Mar 25, 2022 11:00 PM",16,5,11,3,1,2,11,3,8,5,2,3,1,0,1,2,1,1,0,10,10,0,1,,4,1,3,3,0,1,1,1,0,,,
"Mar 26, 2022 12:00 AM",9,3,6,0,0,0,3,2,1,5,2,3,2,2,0,1,2,1,1,6,6,0,1,,6,5,1,7,0,1,1,1,0,,,
"Mar 26, 2022 1:00 AM",13,5,8,1,1,0,3,3,0,0,0,0,2,0,2,2,5,4,1,3,3,0,4,,4,4,0,0,0,0,0,0,0,,,
"Mar 26, 2022 2:00 AM",5,2,3,1,1,0,1,1,0,0,0,0,0,0,0,0,0,0,0,3,3,0,0,,2,2,0,2,0,0,0,0,0,,,
"Mar 26, 2022 3:00 AM",2,0,2,1,0,1,1,1,0,2,1,1,0,0,0,0,1,1,0,2,2,0,2,,0,0,0,0,0,0,0,0,0,,,
"Mar 26, 2022 4:00 AM",1,0,1,2,1,1,1,0,1,2,0,2,0,0,0,0,0,0,0,2,2,0,0,,0,0,0,3,0,0,0,0,0,,,
"Mar 26, 2022 5:00 AM",6,2,4,0,0,0,3,3,0,0,0,0,0,0,0,0,0,0,0,2,2,0,0,,0,0,0,2,0,0,0,0,0,,,
"Mar 26, 2022 6:00 AM",10,7,3,9,3,6,9,4,5,7,3,4,2,1,1,2,6,6,0,3,3,0,5,,4,3,1,9,0,0,1,0,1,,,
"Mar 26, 2022 7:00 AM",15,6,9,31,20,11,53,35,18,42,27,15,2,2,0,1,20,19,1,5,5,0,19,,11,8,3,15,0,2,0,0,0,,,
"Mar 26, 2022 8:00 AM",47,22,25,89,57,32,103,64,39,76,58,18,8,4,4,4,20,20,0,12,10,2,17,,22,10,12,37,3,13,1,0,1,,,
"Mar 26, 2022 9:00 AM",55,39,16,108,54,54,117,69,48,112,68,44,10,7,3,11,23,22,1,15,13,2,22,,39,22,17,43,4,8,3,2,1,,,
"Mar 26, 2022 10:00 AM",64,40,24,153,86,67,128,82,46,123,90,33,17,10,7,15,25,23,2,15,14,1,26,,55,46,9,32,5,5,6,3,3,,,
"Mar 26, 2022 11:00 AM",72,36,36,167,92,75,177,105,72,183,121,62,28,14,14,18,27,26,1,16,14,2,25,,75,52,23,33,11,3,6,4,2,,,
"Mar 26, 2022 12:00 PM",82,43,39,214,116,98,223,129,94,198,116,82,38,18,20,28,30,29,1,26,23,3,24,,94,49,45,66,14,5,7,5,2,,,
"Mar 26, 2022 1:00 PM",91,49,42,193,100,93,200,111,89,191,112,79,50,24,26,22,28,26,2,16,14,2,29,,98,68,30,56,8,11,3,3,0,,,
"Mar 26, 2022 2:00 PM",68,36,32,173,101,72,204,114,90,184,98,86,29,15,14,34,39,36,3,28,22,6,37,,101,62,39,73,10,7,11,6,5,,,
"Mar 26, 2022 3:00 PM",77,39,38,216,101,115,191,101,90,168,90,78,28,18,10,31,35,34,1,16,15,1,28,,78,47,31,51,9,0,3,2,1,,,
"Mar 26, 2022 4:00 PM",71,44,27,211,98,113,294,122,172,205,92,113,56,22,34,20,33,33,0,23,20,3,33,,90,47,43,71,8,0,7,6,1,,,
"Mar 26, 2022 5:00 PM",84,34,50,140,46,94,179,58,121,128,45,83,35,16,19,23,18,17,1,18,17,1,17,,75,26,49,65,4,2,8,6,2,,,
"Mar 26, 2022 6:00 PM",69,24,45,75,32,43,127,50,77,84,32,52,14,6,8,21,18,16,2,15,15,0,14,,50,27,23,49,2,2,3,1,2,,,
"Mar 26, 2022 7:00 PM",68,20,48,26,13,13,57,18,39,33,6,27,14,6,8,4,21,16,5,20,19,1,17,,29,10,19,26,0,1,3,2,1,,,
"Mar 26, 2022 8:00 PM",56,27,29,15,7,8,15,10,5,20,13,7,2,1,1,5,13,11,2,12,12,0,10,,7,3,4,11,1,0,2,2,0,,,
"Mar 26, 2022 9:00 PM",36,19,17,5,1,4,15,6,9,11,2,9,1,0,1,3,7,7,0,9,8,1,8,,5,3,2,9,1,0,4,2,2,,,
"Mar 26, 2022 10:00 PM",18,7,11,6,3,3,6,3,3,8,4,4,2,1,1,4,8,7,1,3,3,0,7,,10,6,4,3,1,2,0,0,0,,,
"Mar 26, 2022 11:00 PM",19,9,10,9,4,5,15,8,7,5,1,4,8,5,3,1,5,5,0,7,6,1,4,,0,0,0,5,0,0,1,1,0,,,
"Mar 27, 2022 12:00 AM",16,2,14,0,0,0,2,0,2,3,0,3,1,0,1,1,3,3,0,5,5,0,4,,3,0,3,7,0,0,0,0,0,,,
"Mar 27, 2022 2:00 AM",,,,,,,,,,,,,,,,,,,,,,,,,,,,,,,,,,,,
"Mar 27, 2022 2:00 AM",6,2,4,1,0,1,3,2,1,2,0,2,2,0,2,1,2,1,1,3,3,0,1,,4,2,2,3,1,0,0,0,0,,,
"Mar 27, 2022 3:00 AM",4,3,1,0,0,0,3,2,1,1,0,1,0,0,0,1,2,2,0,3,3,0,2,,0,0,0,1,2,0,0,0,0,,,
"Mar 27, 2022 4:00 AM",6,3,3,0,0,0,1,0,1,1,0,1,1,0,1,1,0,0,0,0,0,0,0,,2,2,0,1,0,1,1,1,0,,,
"Mar 27, 2022 5:00 AM",3,2,1,0,0,0,0,0,0,0,0,0,0,0,0,0,2,2,0,1,0,1,2,,0,0,0,3,0,0,0,0,0,,,
"Mar 27, 2022 6:00 AM",10,6,4,2,2,0,9,9,0,5,4,1,0,0,0,1,3,3,0,3,3,0,2,,3,2,1,4,1,0,1,1,0,,,
"Mar 27, 2022 7:00 AM",15,5,10,9,4,5,18,8,10,11,7,4,2,2,0,3,6,6,0,7,6,1,6,,6,2,4,15,1,1,0,0,0,,,
"Mar 27, 2022 8:00 AM",40,20,20,49,26,23,66,36,30,34,17,17,3,2,1,5,16,16,0,3,2,1,14,,11,8,3,17,0,7,0,0,0,,,
"Mar 27, 2022 9:00 AM",41,24,17,86,60,26,97,59,38,73,55,18,11,4,7,9,18,17,1,12,9,3,17,,44,30,14,44,5,12,4,3,1,,,
"Mar 27, 2022 10:00 AM",43,22,21,115,61,54,172,98,74,108,68,40,9,4,5,7,13,13,0,15,13,2,14,,56,40,16,67,6,6,4,2,2,,,
"Mar 27, 2022 11:00 AM",51,33,18,157,85,72,196,98,98,135,73,62,23,11,12,19,20,18,2,16,14,2,15,,76,56,20,37,13,12,9,3,6,,,
"Mar 27, 2022 12:00 PM",75,34,41,235,139,96,219,130,89,210,142,68,51,33,18,19,17,16,1,18,16,2,19,,85,62,23,50,11,5,7,5,2,,,
"Mar 27, 2022 1:00 PM",75,35,40,183,104,79,187,113,74,181,106,75,42,28,14,35,31,28,3,25,21,4,28,,77,36,41,45,14,12,6,5,1,,,
"Mar 27, 2022 2:00 PM",73,33,40,229,109,120,237,146,91,206,128,78,32,21,11,26,28,27,1,17,14,3,23,,106,57,49,71,16,5,7,7,0,,,
"Mar 27, 2022 3:00 PM",74,39,35,209,104,105,183,86,97,183,85,98,36,17,19,28,18,18,0,18,14,4,14,,91,61,30,47,5,4,4,2,2,,,
"Mar 27, 2022 4:00 PM",70,37,33,205,93,112,248,109,139,213,92,121,46,15,31,34,34,32,2,25,25,0,29,,95,40,55,62,6,8,14,12,2,,,
"Mar 27, 2022 5:00 PM",73,31,42,153,84,69,173,60,113,136,47,89,39,19,20,31,31,28,3,16,12,4,26,,83,30,53,49,8,0,7,4,3,,,
"Mar 27, 2022 6:00 PM",61,21,40,97,44,53,125,50,75,85,42,43,25,12,13,23,14,13,1,22,18,4,15,,43,19,24,49,4,4,5,1,4,,,
"Mar 27, 2022 7:00 PM",71,32,39,47,20,27,70,20,50,47,9,38,17,11,6,23,15,14,1,10,9,1,15,,37,18,19,44,8,1,4,3,1,,,
"Mar 27, 2022 8:00 PM",30,10,20,19,9,10,32,9,23,29,10,19,7,2,5,7,19,16,3,9,8,1,15,,13,4,9,17,2,1,3,1,2,,,
"Mar 27, 2022 9:00 PM",22,10,12,7,4,3,20,2,18,10,3,7,2,0,2,7,12,11,1,8,8,0,9,,7,4,3,18,1,0,3,2,1,,,
"Mar 27, 2022 10:00 PM",18,10,8,3,1,2,7,4,3,4,2,2,2,0,2,0,11,11,0,8,6,2,12,,2,2,0,5,1,2,3,1,2,,,
"Mar 27, 2022 11:00 PM",6,1,5,2,2,0,2,1,1,0,0,0,4,1,3,0,3,3,0,3,2,1,3,,2,2,0,2,0,0,0,0,0,,,
"Mar 28, 2022 12:00 AM",8,1,7,0,0,0,3,1,2,2,0,2,2,1,1,0,4,4,0,1,1,0,4,,0,0,0,4,0,2,0,0,0,,,
"Mar 28, 2022 1:00 AM",5,1,4,0,0,0,0,0,0,2,0,2,0,0,0,0,0,0,0,0,0,0,0,,0,0,0,1,0,1,0,0,0,,,
"Mar 28, 2022 2:00 AM",2,2,0,0,0,0,0,0,0,0,0,0,0,0,0,0,0,0,0,1,1,0,0,,0,0,0,0,0,0,0,0,0,,,
"Mar 28, 2022 3:00 AM",1,1,0,0,0,0,0,0,0,0,0,0,0,0,0,0,0,0,0,1,1,0,0,,1,1,0,0,0,0,0,0,0,,,
"Mar 28, 2022 4:00 AM",1,0,1,0,0,0,0,0,0,0,0,0,0,0,0,0,0,0,0,0,0,0,0,,0,0,0,1,0,0,0,0,0,,,
"Mar 28, 2022 5:00 AM",7,7,0,2,0,2,2,0,2,1,0,1,0,0,0,3,9,9,0,0,0,0,8,,0,0,0,9,0,0,0,0,0,,,
"Mar 28, 2022 6:00 AM",47,35,12,14,4,10,15,7,8,15,7,8,3,3,0,4,30,30,0,8,7,1,27,,8,5,3,39,0,4,2,2,0,,,
"Mar 28, 2022 7:00 AM",103,64,39,54,13,41,97,29,68,61,16,45,14,10,4,8,71,70,1,16,12,4,68,,38,13,25,86,3,2,5,2,3,,,
"Mar 28, 2022 8:00 AM",244,181,63,92,28,64,153,52,101,105,38,67,43,28,15,35,127,125,2,42,33,9,126,,92,28,64,168,8,5,17,15,2,,,
"Mar 28, 2022 9:00 AM",156,129,27,55,25,30,87,39,48,55,30,25,18,11,7,14,83,82,1,22,14,8,73,,44,23,21,69,4,1,2,1,1,,,
"Mar 28, 2022 10:00 AM",92,62,30,58,25,33,84,48,36,70,37,33,14,10,4,11,36,36,0,17,13,4,33,,42,28,14,33,0,2,1,0,1,,,
"Mar 28, 2022 11:00 AM",63,41,22,49,34,15,67,32,35,35,25,10,15,4,11,9,37,34,3,9,7,2,28,,32,16,16,20,1,3,3,3,0,,,
"Mar 28, 2022 12:00 PM",68,35,33,81,41,40,105,54,51,73,36,37,14,9,5,8,29,26,3,22,21,1,21,,40,27,13,33,8,3,6,4,2,,,
"Mar 28, 2022 1:00 PM",80,35,45,73,41,32,88,51,37,58,38,20,37,24,13,9,48,37,11,21,20,1,28,,48,25,23,22,5,1,9,6,3,,,
"Mar 28, 2022 2:00 PM",85,48,37,52,22,30,76,37,39,56,30,26,11,4,7,24,38,35,3,37,26,11,27,,35,15,20,34,5,8,6,3,3,,,
"Mar 28, 2022 3:00 PM",94,38,56,71,40,31,90,55,35,72,44,28,23,8,15,18,39,37,2,32,27,5,27,,47,30,17,32,7,5,1,1,0,,,
"Mar 28, 2022 4:00 PM",135,39,96,86,56,30,108,68,40,92,61,31,20,6,14,28,42,31,11,52,46,6,30,,63,37,26,34,7,5,7,6,1,,,
"Mar 28, 2022 5:00 PM",216,53,163,124,77,47,145,80,65,117,65,52,21,7,14,27,40,35,5,104,101,3,33,,83,37,46,69,5,5,9,5,4,,,
"Mar 28, 2022 6:00 PM",191,60,131,127,82,45,179,123,56,136,89,47,34,18,16,22,34,28,6,82,77,5,27,,82,26,56,57,4,3,12,7,5,,,
"Mar 28, 2022 7:00 PM",114,41,73,63,30,33,114,67,47,63,34,29,16,11,5,23,33,24,9,40,39,1,20,,53,28,25,24,7,2,21,16,5,,,
"Mar 28, 2022 8:00 PM",88,22,66,30,19,11,48,17,31,31,12,19,8,5,3,14,18,15,3,25,25,0,13,,26,13,13,33,2,1,9,5,4,,,
"Mar 28, 2022 9:00 PM",48,11,37,4,3,1,18,10,8,7,3,4,1,0,1,8,14,11,3,19,17,2,12,,8,6,2,23,2,0,1,1,0,,,
"Mar 28, 2022 10:00 PM",26,4,22,5,5,0,7,5,2,7,4,3,2,0,2,5,5,3,2,14,14,0,3,,2,2,0,10,0,0,3,0,3,,,
"Mar 28, 2022 11:00 PM",8,2,6,2,1,1,4,3,1,2,2,0,0,0,0,1,4,2,2,3,3,0,2,,0,0,0,2,1,0,0,0,0,,,
"Mar 29, 2022 12:00 AM",8,3,5,0,0,0,1,1,0,0,0,0,0,0,0,0,2,2,0,6,6,0,2,,3,2,1,0,0,0,0,0,0,,,
"Mar 29, 2022 1:00 AM",8,3,5,0,0,0,0,0,0,0,0,0,0,0,0,0,0,0,0,2,2,0,0,,0,0,0,0,0,0,0,0,0,,,
"Mar 29, 2022 2:00 AM",6,3,3,0,0,0,0,0,0,0,0,0,0,0,0,0,2,1,1,0,0,0,1,,0,0,0,0,0,0,0,0,0,,,
"Mar 29, 2022 3:00 AM",1,0,1,0,0,0,0,0,0,0,0,0,0,0,0,0,0,0,0,1,1,0,1,,0,0,0,0,0,0,0,0,0,,,
"Mar 29, 2022 4:00 AM",2,1,1,1,0,1,1,0,1,1,0,1,0,0,0,0,1,1,0,0,0,0,1,,0,0,0,3,0,0,0,0,0,,,
"Mar 29, 2022 5:00 AM",6,4,2,2,2,0,2,1,1,2,1,1,0,0,0,3,9,9,0,0,0,0,9,,0,0,0,8,0,1,0,0,0,,,
"Mar 29, 2022 6:00 AM",41,25,16,21,10,11,25,12,13,22,11,11,1,1,0,3,27,27,0,6,5,1,29,,6,2,4,34,1,4,2,2,0,,,
"Mar 29, 2022 7:00 AM",131,87,44,56,16,40,92,30,62,58,20,38,10,9,1,13,77,76,1,21,16,5,82,,46,20,26,103,5,8,4,3,1,,,
"Mar 29, 2022 8:00 AM",286,216,70,94,20,74,139,40,99,111,41,70,44,28,16,24,168,168,0,57,45,12,161,,84,23,61,185,11,11,19,14,5,,,
"Mar 29, 2022 9:00 AM",154,127,27,58,21,37,89,41,48,65,33,32,17,11,6,8,67,64,3,22,18,4,60,,45,19,26,64,4,4,7,3,4,,,
"Mar 29, 2022 10:00 AM",81,57,24,54,29,25,64,36,28,45,24,21,9,6,3,12,54,53,1,10,7,3,38,,30,17,13,37,1,5,2,2,0,,,
"Mar 29, 2022 11:00 AM",72,43,29,40,18,22,47,22,25,46,26,20,3,1,2,5,26,25,1,11,9,2,22,,16,4,12,24,4,5,5,3,2,,,
"Mar 29, 2022 12:00 PM",63,34,29,39,22,17,33,16,17,41,21,20,8,3,5,7,28,26,2,18,18,0,26,,25,15,10,24,4,9,3,3,0,,,
"Mar 29, 2022 1:00 PM",89,46,43,57,33,24,62,37,25,44,27,17,12,6,6,2,31,27,4,26,24,2,27,,25,19,6,42,6,4,2,1,1,,,
"Mar 29, 2022 2:00 PM",95,43,52,56,28,28,63,36,27,50,27,23,17,11,6,14,31,26,5,34,29,5,19,,34,22,12,28,4,4,4,1,3,,,
"Mar 29, 2022 3:00 PM",92,34,58,51,23,28,65,39,26,45,28,17,16,8,8,16,37,30,7,33,25,8,16,,47,33,14,29,3,3,6,2,4,,,
"Mar 29, 2022 4:00 PM",146,42,104,76,50,26,102,60,42,95,57,38,18,8,10,22,36,28,8,47,44,3,32,,50,27,23,43,8,3,6,2,4,,,
"Mar 29, 2022 5:00 PM",243,55,188,116,73,43,159,98,61,114,66,48,22,5,17,31,49,38,11,108,101,7,36,,92,37,55,72,11,6,14,8,6,,,
"Mar 29, 2022 6:00 PM",197,55,142,117,83,34,150,99,51,124,77,47,23,8,15,23,47,46,1,87,81,6,42,,87,46,41,74,14,6,13,9,4,,,
"Mar 29, 2022 7:00 PM",151,48,103,86,36,50,98,49,49,81,39,42,11,5,6,20,36,31,5,54,53,1,30,,48,27,21,31,5,8,11,6,5,,,
"Mar 29, 2022 8:00 PM",103,27,76,24,17,7,41,19,22,28,17,11,3,2,1,7,13,13,0,37,34,3,11,,18,8,10,23,3,3,3,1,2,,,
"Mar 29, 2022 9:00 PM",61,15,46,7,4,3,18,8,10,14,6,8,2,1,1,5,19,16,3,20,18,2,17,,16,9,7,11,2,0,6,2,4,,,
"Mar 29, 2022 10:00 PM",58,9,49,6,5,1,8,5,3,7,2,5,0,0,0,2,15,9,6,15,14,1,6,,3,3,0,7,2,1,1,0,1,,,
"Mar 29, 2022 11:00 PM",17,2,15,0,0,0,4,1,3,3,0,3,0,0,0,0,9,6,3,3,3,0,6,,2,2,0,4,0,1,1,1,0,,,
"Mar 30, 2022 12:00 AM",12,4,8,0,0,0,2,1,1,1,0,1,0,0,0,0,5,4,1,4,4,0,2,,4,3,1,2,0,2,0,0,0,,,
"Mar 30, 2022 1:00 AM",3,1,2,1,1,0,2,2,0,0,0,0,0,0,0,0,1,0,1,1,1,0,0,,0,0,0,0,0,0,0,0,0,,,
"Mar 30, 2022 2:00 AM",4,3,1,0,0,0,1,1,0,1,1,0,0,0,0,0,0,0,0,0,0,0,0,,0,0,0,1,0,0,0,0,0,,,
"Mar 30, 2022 3:00 AM",1,0,1,0,0,0,0,0,0,0,0,0,0,0,0,1,0,0,0,1,1,0,1,,0,0,0,0,0,0,0,0,0,,,
"Mar 30, 2022 4:00 AM",2,1,1,0,0,0,0,0,0,0,0,0,0,0,0,0,1,1,0,0,0,0,1,,0,0,0,1,0,0,1,1,0,,,
"Mar 30, 2022 5:00 AM",3,1,2,0,0,0,0,0,0,0,0,0,0,0,0,1,10,10,0,1,1,0,10,,0,0,0,7,0,0,0,0,0,,,
"Mar 30, 2022 6:00 AM",43,30,13,12,5,7,17,8,9,15,9,6,0,0,0,3,24,24,0,6,5,1,23,,4,4,0,35,0,2,2,2,0,,,
"Mar 30, 2022 7:00 AM",105,73,32,41,12,29,67,17,50,52,15,37,10,10,0,11,65,65,0,18,15,3,66,,32,12,20,81,6,8,2,2,0,,,
"Mar 30, 2022 8:00 AM",238,183,55,85,21,64,154,43,111,108,39,69,26,19,7,27,146,144,2,41,30,11,136,,74,22,52,179,5,8,14,11,3,,,
"Mar 30, 2022 9:00 AM",143,113,30,49,22,27,63,32,31,50,26,24,15,9,6,9,68,67,1,21,18,3,59,,32,11,21,66,2,2,1,1,0,,,
"Mar 30, 2022 10:00 AM",72,51,21,29,12,17,39,23,16,30,17,13,11,8,3,6,37,36,1,10,5,5,27,,14,10,4,20,1,1,3,3,0,,,
"Mar 30, 2022 11:00 AM",50,42,8,25,12,13,42,21,21,25,14,11,9,3,6,6,26,26,0,4,4,0,18,,18,10,8,25,4,0,4,2,2,,,
"Mar 30, 2022 12:00 PM",72,33,39,31,13,18,45,19,26,26,6,20,18,7,11,7,32,28,4,19,14,5,20,,17,9,8,27,5,2,4,4,0,,,
"Mar 30, 2022 1:00 PM",86,42,44,40,22,18,66,44,22,45,27,18,12,3,9,16,37,31,6,25,23,2,31,,27,21,6,23,1,3,3,1,2,,,
"Mar 30, 2022 2:00 PM",55,21,34,32,23,9,40,18,22,26,14,12,12,9,3,22,24,21,3,25,22,3,15,,15,10,5,26,4,3,13,8,5,,,
"Mar 30, 2022 3:00 PM",86,36,50,21,14,7,38,26,12,28,18,10,14,7,7,11,27,25,2,46,34,12,21,,12,9,3,28,2,3,5,2,3,,,
"Mar 30, 2022 4:00 PM",113,40,73,23,14,9,39,23,16,31,19,12,11,7,4,14,32,21,11,39,34,5,25,,31,21,10,32,1,4,4,3,1,,,
"Mar 30, 2022 5:00 PM",185,47,138,37,25,12,59,42,17,40,26,14,12,1,11,22,22,16,6,86,84,2,22,,41,31,10,45,5,2,9,5,4,,,
"Mar 30, 2022 6:00 PM",178,52,126,47,33,14,81,62,19,55,38,17,8,3,5,22,38,36,2,81,78,3,34,,50,43,7,37,2,8,3,2,1,,,
"Mar 30, 2022 7:00 PM",86,26,60,40,27,13,67,41,26,42,27,15,7,2,5,11,20,19,1,41,38,3,17,,25,20,5,30,3,2,8,5,3,,,
"Mar 30, 2022 8:00 PM",68,14,54,10,10,0,21,16,5,10,8,2,6,3,3,10,14,10,4,24,23,1,9,,8,7,1,16,3,2,3,2,1,,,
"Mar 30, 2022 9:00 PM",59,17,42,11,9,2,15,10,5,11,6,5,0,0,0,2,14,9,5,11,10,1,11,,6,5,1,6,1,2,4,2,2,,,
"Mar 30, 2022 10:00 PM",25,8,17,1,1,0,6,5,1,2,2,0,0,0,0,4,10,6,4,16,15,1,4,,3,2,1,5,0,0,1,0,1,,,
"Mar 30, 2022 11:00 PM",16,4,12,1,1,0,2,0,2,3,1,2,2,0,2,5,2,2,0,7,6,1,3,,0,0,0,3,1,0,0,0,0,,,
"Mar 31, 2022 12:00 AM",5,1,4,0,0,0,0,0,0,1,0,1,0,0,0,0,1,1,0,5,5,0,1,,0,0,0,0,0,0,0,0,0,,,
"Mar 31, 2022 1:00 AM",6,2,4,0,0,0,1,1,0,1,1,0,0,0,0,1,0,0,0,3,3,0,0,,0,0,0,0,0,0,0,0,0,,,
"Mar 31, 2022 2:00 AM",7,4,3,0,0,0,1,0,1,1,1,0,0,0,0,0,1,1,0,0,0,0,1,,0,0,0,1,0,0,0,0,0,,,
"Mar 31, 2022 3:00 AM",2,2,0,0,0,0,1,1,0,1,1,0,1,0,1,0,0,0,0,1,0,1,0,,0,0,0,1,0,0,0,0,0,,,
"Mar 31, 2022 4:00 AM",3,1,2,0,0,0,0,0,0,0,0,0,0,0,0,0,0,0,0,0,0,0,0,,0,0,0,2,0,0,0,0,0,,,
"Mar 31, 2022 5:00 AM",8,8,0,0,0,0,1,0,1,1,0,1,0,0,0,2,6,6,0,0,0,0,6,,0,0,0,9,0,1,0,0,0,,,
"Mar 31, 2022 6:00 AM",43,27,16,15,5,10,18,6,12,17,7,10,2,1,1,5,22,21,1,5,4,1,23,,4,2,2,25,0,2,2,2,0,,,
"Mar 31, 2022 7:00 AM",101,66,35,29,12,17,46,20,26,31,18,13,13,10,3,12,48,48,0,18,14,4,50,,15,8,7,63,3,4,5,5,0,,,
"Mar 31, 2022 8:00 AM",231,179,52,66,20,46,97,24,73,76,26,50,31,20,11,21,104,103,1,38,28,10,96,,53,18,35,142,6,4,17,14,3,,,
"Mar 31, 2022 9:00 AM",149,122,27,24,7,17,56,25,31,38,17,21,9,7,2,11,62,61,1,17,13,4,52,,23,14,9,58,2,1,1,1,0,,,
"Mar 31, 2022 10:00 AM",75,61,14,29,17,12,54,32,22,32,20,12,3,1,2,11,35,35,0,11,8,3,23,,15,10,5,21,3,1,4,2,2,,,
"Mar 31, 2022 11:00 AM",59,34,25,29,16,13,37,22,15,31,20,11,13,7,6,8,28,27,1,15,13,2,24,,11,9,2,22,3,4,4,2,2,,,
"Mar 31, 2022 12:00 PM",77,39,38,53,21,32,42,24,18,33,18,15,10,1,9,9,26,24,2,13,12,1,25,,19,13,6,30,2,3,6,4,2,,,
"Mar 31, 2022 1:00 PM",77,37,40,36,19,17,35,19,16,40,22,18,16,8,8,12,29,25,4,27,25,2,22,,18,10,8,19,3,1,5,4,1,,,
"Mar 31, 2022 2:00 PM",99,45,54,29,16,13,51,29,22,32,16,16,10,6,4,9,23,21,2,17,15,2,14,,26,12,14,20,3,4,7,6,1,,,
"Mar 31, 2022 3:00 PM",80,36,44,33,21,12,59,34,25,38,23,15,15,12,3,12,30,26,4,28,21,7,23,,16,11,5,21,4,1,7,5,2,,,
"Mar 31, 2022 4:00 PM",135,42,93,52,38,14,64,49,15,60,49,11,22,8,14,28,34,26,8,40,38,2,26,,31,20,11,31,5,1,6,1,5,,,
"Mar 31, 2022 5:00 PM",224,62,162,63,39,24,105,61,44,76,48,28,21,6,15,21,41,33,8,73,70,3,36,,41,22,19,57,5,3,10,7,3,,,
"Mar 31, 2022 6:00 PM",154,47,107,69,42,27,99,59,40,74,50,24,10,1,9,29,42,39,3,72,68,4,37,,42,25,17,55,6,2,6,5,1,,,
"Mar 31, 2022 7:00 PM",133,37,96,42,27,15,54,36,18,40,25,15,5,3,2,13,22,17,5,30,27,3,15,,23,17,6,26,4,1,6,3,3,,,
"Mar 31, 2022 8:00 PM",73,17,56,14,9,5,32,19,13,23,12,11,3,0,3,4,14,12,2,29,28,1,11,,14,7,7,26,4,3,7,4,3,,,
"Mar 31, 2022 9:00 PM",54,15,39,15,10,5,18,9,9,13,4,9,2,1,1,5,14,13,1,22,22,0,13,,3,2,1,14,1,1,7,4,3,,,
"Mar 31, 2022 10:00 PM",20,4,16,6,3,3,6,4,2,4,2,2,1,0,1,2,13,9,4,16,15,1,8,,2,2,0,11,1,2,0,0,0,,,
"Mar 31, 2022 11:00 PM",24,8,16,2,1,1,5,3,2,7,5,2,0,0,0,0,4,2,2,13,13,0,1,,2,1,1,1,0,0,1,0,1,,,
"Apr 1, 2022 12:00 AM",12,3,9,0,0,0,1,0,1,3,1,2,1,0,1,2,0,0,0,5,5,0,0,,0,0,0,3,0,0,0,0,0,,,
"Apr 1, 2022 1:00 AM",7,3,4,1,1,0,5,3,2,3,2,1,1,0,1,1,1,0,1,4,4,0,0,,0,0,0,0,0,0,0,0,0,,,
"Apr 1, 2022 2:00 AM",4,3,1,0,0,0,0,0,0,0,0,0,0,0,0,0,2,1,1,0,0,0,1,,0,0,0,2,0,0,0,0,0,,,
"Apr 1, 2022 3:00 AM",0,0,0,0,0,0,1,1,0,1,1,0,0,0,0,0,0,0,0,0,0,0,0,,1,1,0,0,0,0,0,0,0,,,
"Apr 1, 2022 4:00 AM",2,1,1,1,0,1,0,0,0,1,0,1,0,0,0,0,0,0,0,1,1,0,0,,0,0,0,0,0,0,0,0,0,,,
"Apr 1, 2022 5:00 AM",5,5,0,2,2,0,5,3,2,4,3,1,0,0,0,3,9,9,0,1,1,0,8,,1,1,0,9,0,0,0,0,0,,,
"Apr 1, 2022 6:00 AM",33,20,13,21,10,11,28,12,16,22,10,12,3,3,0,4,14,13,1,7,6,1,14,,8,7,1,21,0,1,1,0,1,,,
"Apr 1, 2022 7:00 AM",73,47,26,35,8,27,61,21,40,48,18,30,8,7,1,10,41,41,0,11,9,2,40,,21,10,11,64,2,5,3,3,0,,,
"Apr 1, 2022 8:00 AM",184,135,49,76,33,43,90,32,58,77,36,41,26,17,9,26,105,103,2,36,31,5,96,,49,23,26,109,9,6,16,13,3,,,
"Apr 1, 2022 9:00 AM",122,96,26,43,18,25,63,38,25,64,39,25,25,13,12,12,49,47,2,24,19,5,45,,28,16,12,58,2,6,4,2,2,,,
"Apr 1, 2022 10:00 AM",68,40,28,51,31,20,58,30,28,40,21,19,13,8,5,13,28,28,0,13,11,2,24,,12,11,1,34,1,1,5,3,2,,,
"Apr 1, 2022 11:00 AM",59,34,25,42,23,19,62,30,32,47,26,21,11,10,1,13,35,34,1,6,6,0,26,,24,15,9,29,7,5,8,7,1,,,
"Apr 1, 2022 12:00 PM",67,39,28,64,33,31,95,50,45,65,38,27,20,5,15,15,18,15,3,21,18,3,14,,30,20,10,23,9,5,4,3,1,,,
"Apr 1, 2022 1:00 PM",105,37,68,47,25,22,77,38,39,50,27,23,20,11,9,10,32,30,2,27,20,7,33,,34,23,11,36,7,3,3,3,0,,,
"Apr 1, 2022 2:00 PM",75,31,44,51,25,26,61,25,36,57,26,31,17,6,11,26,21,21,0,16,12,4,20,,27,15,12,26,6,3,13,6,7,,,
"Apr 1, 2022 3:00 PM",98,41,57,54,24,30,63,40,23,55,30,25,12,5,7,20,26,20,6,31,28,3,19,,18,7,11,30,1,2,6,4,2,,,
"Apr 1, 2022 4:00 PM",129,37,92,64,42,22,74,42,32,66,44,22,13,5,8,20,33,29,4,39,35,4,24,,35,22,13,46,2,2,5,3,2,,,
"Apr 1, 2022 5:00 PM",160,48,112,64,35,29,82,47,35,73,36,37,22,7,15,22,36,28,8,61,59,2,24,,41,28,13,41,2,2,5,5,0,,,
"Apr 1, 2022 6:00 PM",97,26,71,27,14,13,38,30,8,26,13,13,10,5,5,17,25,21,4,43,41,2,20,,21,17,4,29,4,2,9,3,6,,,
"Apr 1, 2022 7:00 PM",72,24,48,11,8,3,12,7,5,10,7,3,3,3,0,8,13,11,2,25,23,2,7,,10,7,3,12,3,0,5,2,3,,,
"Apr 1, 2022 8:00 PM",52,14,38,4,2,2,7,5,2,6,4,2,2,1,1,4,12,10,2,16,13,3,10,,8,7,1,20,2,1,1,1,0,,,
"Apr 1, 2022 9:00 PM",46,14,32,2,2,0,6,5,1,4,2,2,0,0,0,11,13,12,1,7,7,0,10,,5,4,1,7,0,2,2,0,2,,,
"Apr 1, 2022 10:00 PM",34,15,19,6,5,1,12,7,5,9,7,2,3,0,3,1,8,7,1,8,7,1,7,,5,4,1,5,0,1,0,0,0,,,
"Apr 1, 2022 11:00 PM",18,8,10,3,3,0,2,1,1,2,0,2,3,1,2,2,4,4,0,2,2,0,3,,4,3,1,6,0,2,0,0,0,,,
"Apr 2, 2022 12:00 AM",8,2,6,0,0,0,0,0,0,5,2,3,0,0,0,0,2,2,0,5,5,0,1,,5,4,1,1,1,0,0,0,0,,,
"Apr 2, 2022 1:00 AM",6,1,5,0,0,0,3,2,1,0,0,0,2,0,2,1,2,2,0,4,4,0,2,,0,0,0,1,0,0,0,0,0,,,
"Apr 2, 2022 2:00 AM",9,4,5,0,0,0,1,1,0,2,2,0,0,0,0,0,1,1,0,0,0,0,1,,1,1,0,1,0,0,0,0,0,,,
"Apr 2, 2022 3:00 AM",4,0,4,0,0,0,0,0,0,0,0,0,0,0,0,0,0,0,0,1,1,0,1,,0,0,0,0,0,0,0,0,0,,,
"Apr 2, 2022 4:00 AM",2,0,2,0,0,0,0,0,0,0,0,0,1,0,1,0,0,0,0,2,2,0,0,,0,0,0,0,0,0,0,0,0,,,
"Apr 2, 2022 5:00 AM",7,3,4,0,0,0,1,0,1,1,0,1,0,0,0,1,1,0,1,0,0,0,0,,0,0,0,2,0,0,2,2,0,,,
"Apr 2, 2022 6:00 AM",6,4,2,2,0,2,2,2,0,3,2,1,0,0,0,0,2,1,1,2,2,0,4,,5,4,1,5,0,0,1,1,0,,,
"Apr 2, 2022 7:00 AM",15,6,9,5,2,3,5,5,0,5,3,2,2,2,0,0,8,8,0,5,5,0,8,,2,2,0,8,0,1,0,0,0,,,
"Apr 2, 2022 8:00 AM",32,18,14,27,18,9,21,14,7,25,18,7,4,3,1,10,11,11,0,3,3,0,10,,3,0,3,16,2,3,1,1,0,,,
"Apr 2, 2022 9:00 AM",29,17,12,39,17,22,34,22,12,32,22,10,9,6,3,4,12,12,0,9,7,2,13,,14,11,3,15,3,7,4,2,2,,,
"Apr 2, 2022 10:00 AM",59,31,28,44,23,21,62,40,22,45,29,16,16,13,3,8,18,18,0,6,6,0,13,,30,22,8,15,2,3,2,2,0,,,
"Apr 2, 2022 11:00 AM",40,22,18,73,33,40,89,40,49,66,34,32,30,18,12,8,19,16,3,10,7,3,17,,45,32,13,38,2,1,6,4,2,,,
"Apr 2, 2022 12:00 PM",46,33,13,64,31,33,77,47,30,64,37,27,15,9,6,13,29,26,3,17,13,4,23,,31,18,13,32,2,6,6,4,2,,,
"Apr 2, 2022 1:00 PM",61,37,24,63,36,27,84,43,41,51,33,18,34,25,9,16,21,20,1,15,14,1,21,,45,28,17,32,6,3,5,3,2,,,
"Apr 2, 2022 2:00 PM",56,28,28,78,46,32,93,48,45,76,39,37,20,10,10,17,19,16,3,17,14,3,17,,32,22,10,35,6,4,2,1,1,,,
"Apr 2, 2022 3:00 PM",67,32,35,69,34,35,79,40,39,63,32,31,15,9,6,15,16,15,1,13,8,5,17,,47,29,18,28,6,1,5,4,1,,,
"Apr 2, 2022 4:00 PM",55,31,24,57,28,29,76,36,40,62,29,33,17,9,8,15,14,14,0,20,17,3,12,,41,22,19,34,2,8,9,6,3,,,
"Apr 2, 2022 5:00 PM",46,16,30,85,48,37,71,21,50,69,19,50,19,8,11,15,19,17,2,11,11,0,18,,36,12,24,38,4,2,6,3,3,,,
"Apr 2, 2022 6:00 PM",67,32,35,51,28,23,47,30,17,52,26,26,25,16,9,7,12,11,1,14,11,3,12,,18,11,7,24,2,2,3,1,2,,,
"Apr 2, 2022 7:00 PM",58,27,31,33,13,20,35,10,25,30,10,20,13,6,7,15,9,9,0,7,5,2,9,,12,5,7,31,6,4,4,4,0,,,
"Apr 2, 2022 8:00 PM",29,17,12,16,6,10,13,4,9,7,3,4,6,3,3,2,11,9,2,11,10,1,6,,3,3,0,10,0,2,2,1,1,,,
"Apr 2, 2022 9:00 PM",36,11,25,3,3,0,9,4,5,7,3,4,2,0,2,1,13,12,1,8,7,1,9,,2,1,1,5,0,1,0,0,0,,,
"Apr 2, 2022 10:00 PM",28,13,15,3,2,1,7,2,5,6,2,4,2,1,1,1,15,12,3,8,8,0,11,,1,1,0,4,1,1,1,1,0,,,
"Apr 2, 2022 11:00 PM",21,9,12,3,1,2,7,2,5,7,3,4,5,3,2,2,3,2,1,4,4,0,2,,3,0,3,1,0,0,1,1,0,,,
"Apr 3, 2022 12:00 AM",14,3,11,0,0,0,1,0,1,3,0,3,2,1,1,4,2,1,1,3,3,0,1,,5,5,0,8,0,1,0,0,0,,,
"Apr 3, 2022 1:00 AM",13,3,10,1,1,0,4,4,0,3,2,1,0,0,0,1,1,1,0,6,6,0,1,,4,4,0,2,0,0,1,1,0,,,
"Apr 3, 2022 2:00 AM",6,1,5,2,1,1,5,2,3,4,1,3,0,0,0,0,4,3,1,1,1,0,3,,0,0,0,3,0,0,0,0,0,,,
"Apr 3, 2022 3:00 AM",5,1,4,0,0,0,3,3,0,0,0,0,0,0,0,0,0,0,0,5,4,1,0,,5,4,1,1,0,0,0,0,0,,,
"Apr 3, 2022 4:00 AM",3,0,3,0,0,0,1,1,0,1,1,0,0,0,0,1,0,0,0,0,0,0,0,,1,1,0,1,1,1,1,1,0,,,
"Apr 3, 2022 5:00 AM",3,2,1,0,0,0,0,0,0,0,0,0,2,0,2,0,0,0,0,0,0,0,1,,0,0,0,4,0,0,0,0,0,,,
"Apr 3, 2022 6:00 AM",4,3,1,6,3,3,11,9,2,9,7,2,0,0,0,0,2,1,1,1,1,0,2,,3,3,0,5,1,0,0,0,0,,,
"Apr 3, 2022 7:00 AM",10,5,5,17,10,7,22,17,5,22,15,7,4,1,3,3,10,10,0,6,4,2,10,,2,1,1,11,0,2,0,0,0,,,
"Apr 3, 2022 8:00 AM",41,15,26,63,35,28,66,31,35,62,29,33,2,2,0,2,11,9,2,13,9,4,8,,21,17,4,31,1,14,1,1,0,,,
"Apr 3, 2022 9:00 AM",44,22,22,118,84,34,113,86,27,108,82,26,15,11,4,6,18,18,0,18,15,3,18,,40,32,8,38,7,10,3,2,1,,,
"Apr 3, 2022 10:00 AM",59,34,25,165,87,78,169,84,85,149,86,63,20,12,8,13,19,19,0,20,16,4,21,,54,38,16,38,4,18,11,0,11,,,
"Apr 3, 2022 11:00 AM",71,49,22,165,85,80,198,107,91,154,87,67,22,18,4,10,23,21,2,10,8,2,21,,72,45,27,51,13,10,10,8,2,,,
"Apr 3, 2022 12:00 PM",75,35,40,210,107,103,200,117,83,182,109,73,31,13,18,18,42,41,1,22,14,8,35,,98,67,31,66,13,4,9,5,4,,,
"Apr 3, 2022 1:00 PM",59,28,31,152,69,83,186,99,87,144,72,72,31,17,14,21,23,22,1,17,17,0,16,,74,43,31,46,8,5,7,3,4,,,
"Apr 3, 2022 2:00 PM",56,32,24,161,72,89,166,84,82,130,71,59,36,16,20,18,28,27,1,17,16,1,19,,88,57,31,42,5,3,8,6,2,,,
"Apr 3, 2022 3:00 PM",77,37,40,149,86,63,186,92,94,144,86,58,29,14,15,29,19,18,1,25,24,1,12,,72,54,18,34,2,2,5,5,0,,,
"Apr 3, 2022 4:00 PM",78,48,30,137,71,66,146,53,93,125,49,76,24,11,13,24,23,23,0,10,7,3,21,,44,23,21,50,1,6,6,5,1,,,
"Apr 3, 2022 5:00 PM",76,38,38,126,59,67,114,50,64,108,39,69,22,10,12,23,21,20,1,18,18,0,23,,63,25,38,36,5,2,7,3,4,,,
"Apr 3, 2022 6:00 PM",63,19,44,67,30,37,57,26,31,50,20,30,20,17,3,24,18,13,5,19,18,1,10,,31,14,17,32,3,2,5,5,0,,,
"Apr 3, 2022 7:00 PM",42,19,23,20,7,13,38,13,25,18,5,13,3,3,0,9,13,13,0,10,9,1,14,,23,7,16,21,3,0,4,2,2,,,
"Apr 3, 2022 8:00 PM",34,14,20,7,2,5,17,5,12,8,3,5,3,2,1,2,7,6,1,12,10,2,8,,4,2,2,13,1,1,3,2,1,,,
"Apr 3, 2022 9:00 PM",23,10,13,4,3,1,10,3,7,9,2,7,6,1,5,3,11,11,0,8,7,1,10,,4,0,4,6,2,0,2,2,0,,,
"Apr 3, 2022 10:00 PM",10,5,5,2,0,2,4,2,2,2,0,2,6,3,3,0,9,9,0,4,4,0,9,,2,2,0,8,2,2,2,1,1,,,
"Apr 3, 2022 11:00 PM",13,3,10,3,0,3,5,2,3,6,0,6,3,3,0,0,0,0,0,2,2,0,0,,1,0,1,4,0,0,0,0,0,,,
"Apr 4, 2022 12:00 AM",4,1,3,0,0,0,0,0,0,2,0,2,0,0,0,0,3,3,0,2,2,0,1,,0,0,0,0,0,0,1,0,1,,,
"Apr 4, 2022 1:00 AM",0,0,0,0,0,0,1,0,1,1,0,1,0,0,0,0,0,0,0,2,2,0,0,,0,0,0,0,0,0,0,0,0,,,
"Apr 4, 2022 2:00 AM",1,1,0,0,0,0,0,0,0,0,0,0,0,0,0,0,2,1,1,2,2,0,0,,0,0,0,2,0,0,0,0,0,,,
"Apr 4, 2022 3:00 AM",0,0,0,0,0,0,0,0,0,0,0,0,0,0,0,0,0,0,0,1,1,0,1,,0,0,0,0,0,0,0,0,0,,,
"Apr 4, 2022 4:00 AM",0,0,0,0,0,0,0,0,0,0,0,0,0,0,0,0,1,1,0,0,0,0,1,,0,0,0,1,0,0,0,0,0,,,
"Apr 4, 2022 5:00 AM",6,4,2,0,0,0,1,0,1,1,0,1,0,0,0,0,9,9,0,0,0,0,7,,0,0,0,11,1,0,0,0,0,,,
"Apr 4, 2022 6:00 AM",37,20,17,10,3,7,17,6,11,11,4,7,4,3,1,4,22,21,1,5,4,1,21,,7,3,4,33,0,2,1,1,0,,,
"Apr 4, 2022 7:00 AM",86,51,35,46,17,29,61,18,43,48,18,30,9,7,2,13,54,54,0,18,14,4,58,,26,11,15,81,2,2,4,3,1,,,
"Apr 4, 2022 8:00 AM",219,167,52,64,17,47,131,32,99,93,31,62,31,21,10,22,125,123,2,43,33,10,127,,75,26,49,151,3,2,8,7,1,,,
"Apr 4, 2022 9:00 AM",112,90,22,35,15,20,55,28,27,46,31,15,14,10,4,8,61,61,0,23,18,5,60,,35,14,21,66,2,0,1,1,0,,,
"Apr 4, 2022 10:00 AM",61,46,15,28,13,15,28,15,13,20,8,12,6,3,3,5,32,32,0,12,6,6,26,,13,8,5,21,1,4,2,1,1,,,
"Apr 4, 2022 11:00 AM",57,34,23,24,10,14,26,13,13,17,9,8,7,2,5,6,28,27,1,7,7,0,23,,19,9,10,17,2,3,5,1,4,,,
"Apr 4, 2022 12:00 PM",68,39,29,30,13,17,44,19,25,32,16,16,19,8,11,21,27,21,6,11,8,3,15,,22,11,11,19,3,3,2,1,1,,,
"Apr 4, 2022 1:00 PM",63,31,32,30,18,12,39,20,19,32,20,12,10,4,6,5,31,28,3,17,12,5,23,,15,9,6,23,2,0,6,3,3,,,
"Apr 4, 2022 2:00 PM",49,23,26,31,20,11,43,30,13,35,28,7,8,3,5,11,19,18,1,15,14,1,12,,20,13,7,22,2,2,5,2,3,,,
"Apr 4, 2022 3:00 PM",92,28,64,45,25,20,55,34,21,44,24,20,24,7,17,16,25,19,6,34,31,3,15,,28,21,7,31,1,1,5,2,3,,,
"Apr 4, 2022 4:00 PM",123,40,83,31,22,9,62,33,29,56,28,28,18,9,9,29,30,24,6,51,39,12,25,,32,24,8,35,5,2,5,2,3,,,
"Apr 4, 2022 5:00 PM",202,59,143,60,42,18,87,56,31,83,49,34,18,2,16,21,39,29,10,76,75,1,32,,48,34,14,60,1,8,8,4,4,,,
"Apr 4, 2022 6:00 PM",152,43,109,38,28,10,95,80,15,50,35,15,10,4,6,17,42,35,7,79,75,4,32,,48,43,5,33,5,2,5,3,2,,,
"Apr 4, 2022 7:00 PM",110,34,76,39,27,12,62,41,21,45,29,16,9,4,5,11,29,25,4,37,37,0,22,,27,19,8,23,5,1,6,4,2,,,
"Apr 4, 2022 8:00 PM",60,13,47,12,10,2,22,13,9,19,11,8,9,3,6,6,17,10,7,19,18,1,10,,6,4,2,13,1,2,3,1,2,,,
"Apr 4, 2022 9:00 PM",45,8,37,7,3,4,12,8,4,11,4,7,3,2,1,7,8,5,3,14,14,0,6,,5,3,2,11,5,0,2,2,0,,,
"Apr 4, 2022 10:00 PM",27,5,22,1,0,1,3,1,2,4,2,2,3,0,3,2,4,2,2,13,13,0,3,,0,0,0,7,1,2,2,1,1,,,
"Apr 4, 2022 11:00 PM",16,9,7,2,2,0,4,3,1,2,1,1,1,0,1,0,1,0,1,4,4,0,0,,2,1,1,0,0,0,0,0,0,,,
"Apr 5, 2022 12:00 AM",6,3,3,0,0,0,2,2,0,0,0,0,2,0,2,0,1,0,1,3,3,0,0,,1,1,0,1,0,0,0,0,0,,,
"Apr 5, 2022 1:00 AM",2,1,1,0,0,0,0,0,0,0,0,0,0,0,0,0,1,0,1,0,0,0,0,,0,0,0,0,0,0,0,0,0,,,
"Apr 5, 2022 2:00 AM",3,2,1,3,0,3,3,0,3,1,0,1,0,0,0,0,1,1,0,1,1,0,1,,0,0,0,1,0,0,0,0,0,,,
"Apr 5, 2022 3:00 AM",1,0,1,0,0,0,1,1,0,1,1,0,0,0,0,0,0,0,0,1,1,0,2,,0,0,0,1,0,0,0,0,0,,,
"Apr 5, 2022 4:00 AM",2,1,1,0,0,0,1,0,1,1,0,1,0,0,0,0,1,1,0,0,0,0,1,,0,0,0,1,0,0,0,0,0,,,
"Apr 5, 2022 5:00 AM",7,4,3,0,0,0,0,0,0,0,0,0,0,0,0,3,7,7,0,0,0,0,7,,0,0,0,8,0,0,0,0,0,,,
"Apr 5, 2022 6:00 AM",47,26,21,12,3,9,13,7,6,12,5,7,2,2,0,8,23,22,1,10,7,3,21,,5,3,2,30,0,3,0,0,0,,,
"Apr 5, 2022 7:00 AM",129,84,45,41,14,27,76,23,53,53,19,34,10,9,1,19,71,71,0,17,13,4,70,,41,15,26,116,6,3,4,3,1,,,
"Apr 5, 2022 8:00 AM",285,217,68,75,24,51,144,45,99,106,44,62,42,29,13,26,166,164,2,55,41,14,149,,82,23,59,174,2,12,15,13,2,,,
"Apr 5, 2022 9:00 AM",130,114,16,48,18,30,77,35,42,71,37,34,20,17,3,10,63,63,0,20,14,6,59,,43,15,28,64,4,3,8,7,1,,,
"Apr 5, 2022 10:00 AM",78,60,18,28,16,12,36,17,19,25,15,10,11,3,8,12,37,37,0,14,9,5,27,,22,12,10,33,1,4,2,2,0,,,
"Apr 5, 2022 11:00 AM",49,35,14,29,11,18,37,20,17,22,10,12,12,8,4,4,37,34,3,8,6,2,31,,10,6,4,23,6,5,6,5,1,,,
"Apr 5, 2022 12:00 PM",60,37,23,23,11,12,41,26,15,24,12,12,17,6,11,8,42,41,1,16,13,3,37,,17,11,6,17,3,0,6,4,2,,,
"Apr 5, 2022 1:00 PM",85,38,47,31,15,16,54,30,24,42,28,14,12,5,7,13,29,25,4,22,19,3,20,,24,13,11,18,4,3,7,3,4,,,
"Apr 5, 2022 2:00 PM",61,23,38,23,9,14,35,17,18,36,23,13,16,9,7,13,17,14,3,34,30,4,11,,25,17,8,16,4,3,11,7,4,,,
"Apr 5, 2022 3:00 PM",102,41,61,23,12,11,45,24,21,33,16,17,16,8,8,24,29,23,6,30,23,7,19,,15,11,4,25,6,1,8,6,2,,,
"Apr 5, 2022 4:00 PM",137,56,81,43,27,16,66,39,27,54,25,29,19,6,13,15,36,31,5,44,40,4,30,,29,20,9,46,6,8,8,4,4,,,
"Apr 5, 2022 5:00 PM",223,51,172,59,39,20,105,66,39,86,54,32,12,6,6,17,48,39,9,100,96,4,36,,59,45,14,60,5,5,9,5,4,,,
"Apr 5, 2022 6:00 PM",212,55,157,62,42,20,100,74,26,71,44,27,23,13,10,33,36,31,5,83,82,1,32,,67,60,7,52,6,3,6,4,2,,,
"Apr 5, 2022 7:00 PM",120,26,94,34,22,12,54,43,11,46,31,15,6,4,2,11,24,21,3,46,43,3,17,,23,20,3,26,2,1,10,6,4,,,
"Apr 5, 2022 8:00 PM",97,33,64,14,13,1,34,21,13,23,16,7,5,1,4,7,19,13,6,25,23,2,11,,12,4,8,15,3,4,6,4,2,,,
"Apr 5, 2022 9:00 PM",51,12,39,6,5,1,11,10,1,10,9,1,3,0,3,4,17,12,5,17,16,1,11,,3,2,1,11,2,1,3,1,2,,,
"Apr 5, 2022 10:00 PM",34,12,22,5,4,1,10,2,8,7,1,6,5,3,2,5,12,9,3,14,13,1,9,,1,0,1,6,1,0,1,1,0,,,
"Apr 5, 2022 11:00 PM",15,7,8,1,0,1,1,0,1,3,0,3,2,1,1,2,1,1,0,9,9,0,1,,0,0,0,4,1,0,0,0,0,,,
"Apr 6, 2022 12:00 AM",6,3,3,0,0,0,1,1,0,0,0,0,0,0,0,0,1,0,1,3,3,0,0,,1,1,0,1,0,1,0,0,0,,,
"Apr 6, 2022 1:00 AM",5,0,5,1,1,0,1,1,0,1,1,0,0,0,0,0,2,1,1,2,2,0,1,,0,0,0,0,0,0,0,0,0,,,
"Apr 6, 2022 2:00 AM",7,5,2,0,0,0,0,0,0,0,0,0,0,0,0,0,1,0,1,3,3,0,0,,0,0,0,0,0,0,0,0,0,,,
"Apr 6, 2022 3:00 AM",0,0,0,0,0,0,0,0,0,0,0,0,0,0,0,0,1,1,0,2,2,0,1,,0,0,0,0,0,0,0,0,0,,,
"Apr 6, 2022 4:00 AM",1,0,1,0,0,0,0,0,0,0,0,0,0,0,0,0,1,1,0,1,1,0,1,,0,0,0,1,0,0,1,1,0,,,
"Apr 6, 2022 5:00 AM",6,4,2,0,0,0,1,1,0,1,1,0,0,0,0,4,6,6,0,0,0,0,7,,1,1,0,9,0,0,0,0,0,,,
"Apr 6, 2022 6:00 AM",31,19,12,20,7,13,26,13,13,20,8,12,1,1,0,1,15,15,0,7,6,1,15,,6,3,3,31,0,1,3,3,0,,,
"Apr 6, 2022 7:00 AM",75,49,26,34,8,26,50,8,42,32,6,26,7,6,1,9,61,61,0,15,13,2,51,,21,8,13,81,3,4,2,2,0,,,
"Apr 6, 2022 8:00 AM",216,171,45,65,14,51,116,34,82,82,34,48,25,14,11,21,136,135,1,39,31,8,122,,63,21,42,147,4,6,14,13,1,,,
"Apr 6, 2022 9:00 AM",117,93,24,41,15,26,51,24,27,54,32,22,10,6,4,3,58,57,1,20,15,5,55,,26,14,12,54,4,2,5,1,4,,,
"Apr 6, 2022 10:00 AM",62,47,15,31,15,16,53,38,15,38,29,9,10,9,1,9,33,33,0,12,6,6,22,,20,14,6,24,2,0,5,3,2,,,
"Apr 6, 2022 11:00 AM",55,35,20,31,11,20,36,20,16,35,17,18,16,8,8,7,29,28,1,8,7,1,18,,21,11,10,20,2,0,5,2,3,,,
"Apr 6, 2022 12:00 PM",74,42,32,36,20,16,41,17,24,38,18,20,10,6,4,6,22,19,3,10,10,0,16,,8,3,5,18,2,0,5,3,2,,,
"Apr 6, 2022 1:00 PM",77,30,47,35,21,14,52,29,23,39,23,16,14,10,4,14,38,31,7,23,21,2,26,,20,13,7,34,1,2,3,3,0,,,
"Apr 6, 2022 2:00 PM",61,25,36,22,12,10,35,17,18,21,6,15,18,11,7,12,25,22,3,26,22,4,16,,17,14,3,21,1,2,8,4,4,,,
"Apr 6, 2022 3:00 PM",77,26,51,36,22,14,43,25,18,31,21,10,12,3,9,11,18,16,2,25,20,5,15,,26,19,7,20,1,1,7,2,5,,,
"Apr 6, 2022 4:00 PM",108,39,69,33,23,10,58,38,20,45,34,11,22,10,12,19,35,27,8,49,45,4,27,,23,15,8,23,4,2,8,4,4,,,
"Apr 6, 2022 5:00 PM",171,45,126,43,24,19,63,39,24,50,27,23,18,7,11,14,35,24,11,68,67,1,30,,35,29,6,53,3,2,7,4,3,,,
"Apr 6, 2022 6:00 PM",171,46,125,45,33,12,75,55,20,61,36,25,7,2,5,14,36,26,10,74,72,2,28,,47,41,6,33,2,1,9,6,3,,,
"Apr 6, 2022 7:00 PM",102,34,68,27,21,6,41,33,8,34,25,9,2,1,1,8,17,14,3,38,37,1,10,,21,17,4,25,4,0,1,0,1,,,
"Apr 6, 2022 8:00 PM",51,13,38,9,7,2,15,11,4,10,7,3,4,2,2,7,13,11,2,19,19,0,12,,9,8,1,7,2,8,4,3,1,,,
"Apr 6, 2022 9:00 PM",46,9,37,4,2,2,5,3,2,7,2,5,2,0,2,4,12,6,6,17,16,1,8,,5,3,2,14,7,0,2,2,0,,,
"Apr 6, 2022 10:00 PM",30,7,23,0,0,0,5,1,4,3,1,2,2,0,2,1,5,4,1,7,7,0,4,,1,1,0,7,1,0,6,2,4,,,
"Apr 6, 2022 11:00 PM",13,2,11,3,3,0,5,2,3,0,0,0,0,0,0,0,1,1,0,5,4,1,1,,1,0,1,1,0,0,1,0,1,,,
"Apr 7, 2022 12:00 AM",6,0,6,0,0,0,0,0,0,0,0,0,0,0,0,0,3,3,0,3,3,0,2,,0,0,0,0,0,0,0,0,0,,,
"Apr 7, 2022 1:00 AM",5,2,3,0,0,0,1,1,0,1,0,1,0,0,0,0,1,1,0,2,2,0,1,,0,0,0,0,1,0,0,0,0,,,
"Apr 7, 2022 2:00 AM",3,1,2,0,0,0,0,0,0,0,0,0,0,0,0,0,0,0,0,0,0,0,0,,0,0,0,0,0,0,0,0,0,,,
"Apr 7, 2022 3:00 AM",2,0,2,0,0,0,1,1,0,0,0,0,0,0,0,0,0,0,0,0,0,0,0,,0,0,0,1,0,0,0,0,0,,,
"Apr 7, 2022 4:00 AM",2,1,1,0,0,0,0,0,0,0,0,0,0,0,0,0,1,1,0,0,0,0,1,,0,0,0,0,0,0,1,1,0,,,
"Apr 7, 2022 5:00 AM",2,2,0,0,0,0,1,0,1,1,0,1,0,0,0,1,9,9,0,1,1,0,9,,0,0,0,5,0,0,0,0,0,,,
"Apr 7, 2022 6:00 AM",20,12,8,10,3,7,13,6,7,12,5,7,0,0,0,5,18,18,0,9,7,2,19,,3,1,2,23,0,2,2,2,0,,,
"Apr 7, 2022 7:00 AM",102,68,34,30,11,19,48,11,37,36,14,22,6,5,1,11,63,63,0,16,13,3,60,,16,7,9,61,2,3,6,5,1,,,
"Apr 7, 2022 8:00 AM",213,150,63,49,19,30,79,28,51,63,28,35,22,15,7,18,117,115,2,30,19,11,116,,44,16,28,146,4,6,12,8,4,,,
"Apr 7, 2022 9:00 AM",131,109,22,29,8,21,38,18,20,35,16,19,11,11,0,8,64,64,0,19,15,4,58,,22,10,12,54,1,2,2,1,1,,,
"Apr 7, 2022 10:00 AM",54,42,12,17,11,6,25,14,11,19,15,4,2,2,0,7,28,26,2,8,4,4,20,,22,14,8,26,2,1,3,2,1,,,
"Apr 7, 2022 11:00 AM",43,30,13,15,7,8,21,9,12,16,6,10,8,3,5,6,18,18,0,11,8,3,15,,6,3,3,16,0,0,2,1,1,,,
"Apr 7, 2022 12:00 PM",59,28,31,22,9,13,26,13,13,17,8,9,17,9,8,9,24,21,3,13,12,1,18,,7,7,0,25,1,1,3,3,0,,,
"Apr 7, 2022 1:00 PM",66,25,41,26,13,13,25,14,11,23,15,8,12,4,8,8,30,26,4,13,13,0,22,,8,6,2,19,2,1,3,0,3,,,
"Apr 7, 2022 2:00 PM",66,27,39,25,17,8,35,17,18,29,19,10,8,7,1,7,26,23,3,18,14,4,17,,20,14,6,16,3,1,5,3,2,,,
"Apr 7, 2022 3:00 PM",71,29,42,34,17,17,43,25,18,29,17,12,7,5,2,20,27,21,6,24,19,5,18,,17,14,3,24,3,2,7,3,4,,,
"Apr 7, 2022 4:00 PM",125,45,80,56,37,19,77,48,29,53,36,17,26,18,8,18,29,27,2,55,49,6,22,,35,30,5,41,2,6,5,2,3,,,
"Apr 7, 2022 5:00 PM",190,59,131,51,34,17,93,57,36,69,43,26,17,6,11,16,39,34,5,62,60,2,34,,55,40,15,53,7,7,4,4,0,,,
"Apr 7, 2022 6:00 PM",146,43,103,51,40,11,97,68,29,60,44,16,14,7,7,14,38,33,5,71,68,3,32,,49,38,11,37,3,3,8,5,3,,,
"Apr 7, 2022 7:00 PM",131,62,69,37,26,11,53,32,21,40,25,15,5,2,3,17,32,25,7,41,36,5,21,,29,18,11,23,8,1,11,6,5,,,
"Apr 7, 2022 8:00 PM",99,28,71,23,12,11,32,16,16,29,13,16,9,5,4,11,21,15,6,39,35,4,13,,17,9,8,16,3,3,6,4,2,,,
"Apr 7, 2022 9:00 PM",53,19,34,11,10,1,20,12,8,17,9,8,2,2,0,3,19,13,6,21,21,0,15,,5,3,2,9,5,0,1,0,1,,,
"Apr 7, 2022 10:00 PM",34,9,25,8,6,2,11,5,6,8,4,4,3,0,3,3,6,4,2,17,16,1,4,,4,3,1,9,1,3,1,1,0,,,
"Apr 7, 2022 11:00 PM",26,6,20,0,0,0,9,5,4,3,1,2,0,0,0,0,1,1,0,11,11,0,1,,8,5,3,1,1,0,0,0,0,,,
"Apr 8, 2022 12:00 AM",13,4,9,0,0,0,4,1,3,4,2,2,2,0,2,2,2,1,1,7,6,1,1,,0,0,0,2,0,1,1,1,0,,,
"Apr 8, 2022 1:00 AM",8,5,3,0,0,0,0,0,0,0,0,0,2,1,1,0,0,0,0,3,3,0,0,,0,0,0,1,0,0,0,0,0,,,
"Apr 8, 2022 2:00 AM",5,2,3,0,0,0,0,0,0,0,0,0,0,0,0,0,0,0,0,0,0,0,0,,0,0,0,1,0,0,0,0,0,,,
"Apr 8, 2022 3:00 AM",1,0,1,0,0,0,0,0,0,0,0,0,0,0,0,0,0,0,0,2,2,0,1,,1,1,0,0,1,0,1,1,0,,,
"Apr 8, 2022 4:00 AM",2,1,1,0,0,0,0,0,0,0,0,0,0,0,0,1,0,0,0,0,0,0,0,,0,0,0,2,0,0,0,0,0,,,
"Apr 8, 2022 5:00 AM",5,2,3,1,1,0,3,2,1,2,1,1,1,1,0,1,13,13,0,1,1,0,12,,0,0,0,6,0,0,0,0,0,,,
"Apr 8, 2022 6:00 AM",34,21,13,26,10,16,26,12,14,24,10,14,2,2,0,1,12,11,1,8,6,2,15,,4,3,1,30,2,3,3,3,0,,,
"Apr 8, 2022 7:00 AM",97,69,28,59,29,30,73,27,46,62,28,34,9,6,3,9,45,44,1,14,13,1,45,,26,15,11,79,4,2,4,3,1,,,
"Apr 8, 2022 8:00 AM",193,142,51,79,27,52,126,51,75,88,43,45,21,15,6,25,106,104,2,41,31,10,107,,68,34,34,120,10,7,16,14,2,,,
"Apr 8, 2022 9:00 AM",114,87,27,65,26,39,73,37,36,60,35,25,16,10,6,10,49,49,0,15,11,4,45,,23,9,14,54,2,2,5,3,2,,,
"Apr 8, 2022 10:00 AM",80,53,27,60,30,30,79,38,41,63,34,29,25,15,10,6,43,42,1,14,12,2,32,,33,23,10,38,3,3,5,4,1,,,
"Apr 8, 2022 11:00 AM",62,40,22,55,22,33,53,27,26,52,24,28,22,15,7,7,24,21,3,14,12,2,21,,27,15,12,24,6,3,8,6,2,,,
"Apr 8, 2022 12:00 PM",82,39,43,53,30,23,44,21,23,38,20,18,19,9,10,12,20,18,2,21,18,3,18,,28,13,15,24,9,6,6,2,4,,,
"Apr 8, 2022 1:00 PM",88,42,46,38,21,17,44,25,19,36,25,11,9,3,6,13,30,28,2,40,32,8,20,,15,11,4,32,4,4,3,2,1,,,
"Apr 8, 2022 2:00 PM",77,42,35,17,12,5,27,16,11,23,14,9,17,6,11,11,20,15,5,19,18,1,13,,16,10,6,23,3,3,2,2,0,,,
"Apr 8, 2022 3:00 PM",79,23,56,25,16,9,43,29,14,37,25,12,13,8,5,15,14,12,2,22,21,1,8,,13,9,4,28,2,3,2,1,1,,,
"Apr 8, 2022 4:00 PM",110,33,77,27,18,9,56,40,16,47,29,18,10,1,9,11,19,19,0,33,32,1,20,,32,27,5,24,3,2,5,4,1,,,
"Apr 8, 2022 5:00 PM",154,42,112,56,43,13,89,59,30,64,45,19,13,6,7,23,39,31,8,59,58,1,34,,42,33,9,46,5,4,12,8,4,,,
"Apr 8, 2022 6:00 PM",115,38,77,49,32,17,73,52,21,64,38,26,8,2,6,13,31,20,11,52,50,2,25,,48,38,10,20,4,5,9,3,6,,,
"Apr 8, 2022 7:00 PM",105,42,63,26,18,8,50,35,15,28,19,9,6,4,2,11,19,15,4,35,31,4,13,,27,23,4,33,5,2,6,4,2,,,
"Apr 8, 2022 8:00 PM",48,16,32,9,3,6,19,12,7,17,9,8,6,3,3,7,15,12,3,15,13,2,11,,9,5,4,12,1,0,4,3,1,,,
"Apr 8, 2022 9:00 PM",56,24,32,7,6,1,8,4,4,5,3,2,1,1,0,5,16,14,2,20,20,0,14,,1,1,0,9,1,1,2,1,1,,,
"Apr 8, 2022 10:00 PM",24,8,16,9,8,1,6,3,3,5,3,2,2,0,2,8,5,3,2,15,13,2,4,,3,1,2,10,0,1,1,1,0,,,
"Apr 8, 2022 11:00 PM",26,10,16,7,5,2,9,5,4,6,3,3,1,1,0,3,5,5,0,4,3,1,8,,5,4,1,8,0,1,1,0,1,,,
"Apr 9, 2022 12:00 AM",17,4,13,0,0,0,3,2,1,5,1,4,0,0,0,0,1,1,0,7,7,0,1,,6,1,5,5,1,1,3,2,1,,,
"Apr 9, 2022 1:00 AM",9,4,5,0,0,0,5,4,1,1,1,0,0,0,0,0,1,0,1,2,2,0,0,,4,2,2,0,0,0,1,1,0,,,
"Apr 9, 2022 2:00 AM",6,3,3,0,0,0,2,1,1,1,1,0,0,0,0,1,0,0,0,0,0,0,0,,1,1,0,0,0,0,0,0,0,,,
"Apr 9, 2022 3:00 AM",4,0,4,4,2,2,0,0,0,0,0,0,0,0,0,0,0,0,0,5,5,0,0,,0,0,0,1,0,0,0,0,0,,,
"Apr 9, 2022 4:00 AM",4,2,2,0,0,0,0,0,0,0,0,0,0,0,0,0,0,0,0,1,1,0,0,,0,0,0,0,0,0,0,0,0,,,
"Apr 9, 2022 5:00 AM",6,3,3,0,0,0,3,3,0,3,3,0,0,0,0,1,0,0,0,2,2,0,0,,0,0,0,4,1,0,1,1,0,,,
"Apr 9, 2022 6:00 AM",12,9,3,11,4,7,14,5,9,10,5,5,1,1,0,1,7,6,1,2,2,0,6,,6,6,0,8,0,1,1,1,0,,,
"Apr 9, 2022 7:00 AM",10,3,7,23,13,10,25,16,9,20,12,8,5,2,3,2,13,13,0,5,3,2,15,,7,7,0,14,1,5,0,0,0,,,
"Apr 9, 2022 8:00 AM",42,22,20,55,40,15,65,39,26,53,41,12,8,4,4,9,18,17,1,11,10,1,16,,17,13,4,25,1,2,2,1,1,,,
"Apr 9, 2022 9:00 AM",46,26,20,91,58,33,83,51,32,73,50,23,12,7,5,27,33,32,1,10,7,3,32,,37,32,5,26,5,2,3,3,0,,,
"Apr 9, 2022 10:00 AM",67,40,27,118,62,56,123,75,48,108,67,41,15,12,3,13,27,27,0,13,13,0,22,,45,26,19,26,6,8,4,2,2,,,
"Apr 9, 2022 11:00 AM",55,33,22,138,75,63,133,80,53,115,74,41,38,15,23,15,27,25,2,19,19,0,22,,48,30,18,33,6,6,4,4,0,,,
"Apr 9, 2022 12:00 PM",64,30,34,158,77,81,131,75,56,129,68,61,21,14,7,24,19,18,1,17,15,2,18,,45,32,13,45,17,7,12,10,2,,,
"Apr 9, 2022 1:00 PM",87,38,49,108,57,51,98,50,48,102,56,46,19,8,11,28,25,22,3,26,22,4,22,,57,33,24,42,11,4,9,7,2,,,
"Apr 9, 2022 2:00 PM",78,46,32,105,44,61,110,61,49,92,48,44,34,23,11,15,32,31,1,16,14,2,27,,49,32,17,31,10,1,1,1,0,,,
"Apr 9, 2022 3:00 PM",60,33,27,86,55,31,118,65,53,90,60,30,14,4,10,13,30,28,2,23,22,1,25,,54,24,30,30,4,1,3,2,1,,,
"Apr 9, 2022 4:00 PM",57,20,37,84,42,42,123,50,73,111,41,70,18,8,10,23,20,13,7,13,12,1,16,,50,23,27,36,10,6,7,6,1,,,
"Apr 9, 2022 5:00 PM",72,34,38,52,26,26,62,25,37,37,13,24,13,4,9,14,13,11,2,11,9,2,12,,22,11,11,39,8,0,4,2,2,,,
"Apr 9, 2022 6:00 PM",54,18,36,29,15,14,51,28,23,43,19,24,15,7,8,20,8,7,1,13,13,0,7,,26,14,12,36,1,3,4,3,1,,,
"Apr 9, 2022 7:00 PM",43,19,24,20,13,7,36,20,16,31,19,12,8,3,5,10,11,8,3,12,10,2,10,,13,6,7,16,2,1,0,0,0,,,
"Apr 9, 2022 8:00 PM",43,19,24,25,15,10,26,12,14,13,7,6,10,2,8,9,8,7,1,8,8,0,8,,8,6,2,19,3,0,0,0,0,,,
"Apr 9, 2022 9:00 PM",33,13,20,17,10,7,13,6,7,10,4,6,1,1,0,5,12,12,0,10,8,2,10,,2,2,0,11,0,0,0,0,0,,,
"Apr 9, 2022 10:00 PM",23,8,15,5,2,3,7,4,3,5,4,1,3,0,3,2,13,11,2,6,5,1,10,,3,0,3,6,0,1,0,0,0,,,
"Apr 9, 2022 11:00 PM",21,9,12,4,4,0,5,0,5,4,1,3,3,1,2,0,3,2,1,7,7,0,2,,2,1,1,4,0,1,1,0,1,,,
"Apr 10, 2022 12:00 AM",15,7,8,0,0,0,1,1,0,3,2,1,2,2,0,1,0,0,0,3,3,0,1,,1,1,0,9,1,0,1,0,1,,,
"Apr 10, 2022 1:00 AM",12,6,6,0,0,0,0,0,0,0,0,0,0,0,0,1,2,2,0,2,2,0,1,,0,0,0,5,0,1,0,0,0,,,
"Apr 10, 2022 2:00 AM",7,4,3,1,0,1,1,0,1,1,0,1,0,0,0,2,1,0,1,2,2,0,1,,0,0,0,2,1,0,0,0,0,,,
"Apr 10, 2022 3:00 AM",4,2,2,0,0,0,1,1,0,0,0,0,0,0,0,0,0,0,0,0,0,0,0,,1,1,0,1,0,0,0,0,0,,,
"Apr 10, 2022 4:00 AM",2,0,2,0,0,0,1,1,0,0,0,0,0,0,0,2,0,0,0,1,1,0,0,,0,0,0,1,0,0,0,0,0,,,
"Apr 10, 2022 5:00 AM",3,2,1,1,1,0,0,0,0,0,0,0,0,0,0,1,0,0,0,1,1,0,0,,2,0,2,4,1,0,0,0,0,,,
"Apr 10, 2022 6:00 AM",7,7,0,2,0,2,11,6,5,7,4,3,0,0,0,0,7,6,1,0,0,0,7,,3,3,0,2,1,1,0,0,0,,,
"Apr 10, 2022 7:00 AM",11,5,6,17,12,5,12,7,5,12,7,5,1,0,1,4,10,9,1,6,5,1,9,,5,4,1,10,1,2,0,0,0,,,
"Apr 10, 2022 8:00 AM",44,18,26,47,26,21,70,35,35,48,25,23,5,3,2,5,11,10,1,9,8,1,10,,10,5,5,43,0,15,2,2,0,,,
"Apr 10, 2022 9:00 AM",38,19,19,77,58,19,102,69,33,78,56,22,11,7,4,6,14,14,0,9,8,1,14,,30,15,15,15,4,10,2,0,2,,,
"Apr 10, 2022 10:00 AM",57,35,22,124,59,65,115,64,51,102,58,44,11,8,3,17,27,25,2,11,8,3,23,,42,32,10,28,9,6,6,5,1,,,
"Apr 10, 2022 11:00 AM",56,38,18,120,66,54,133,70,63,114,65,49,20,10,10,13,19,18,1,16,14,2,14,,53,34,19,53,8,2,8,6,2,,,
"Apr 10, 2022 12:00 PM",68,41,27,124,58,66,149,62,87,135,60,75,27,18,9,24,22,20,2,9,8,1,21,,47,29,18,44,11,4,9,5,4,,,
"Apr 10, 2022 1:00 PM",64,36,28,80,45,35,88,42,46,71,32,39,30,15,15,16,18,18,0,19,17,2,16,,44,24,20,35,2,1,3,3,0,,,
"Apr 10, 2022 2:00 PM",72,36,36,70,33,37,83,40,43,63,36,27,22,12,10,20,31,29,2,10,8,2,27,,35,15,20,31,7,2,5,4,1,,,
"Apr 10, 2022 3:00 PM",57,30,27,63,38,25,65,38,27,50,30,20,22,12,10,18,21,20,1,17,16,1,16,,39,22,17,28,5,2,1,0,1,,,
"Apr 10, 2022 4:00 PM",65,29,36,48,23,25,60,23,37,55,25,30,17,6,11,17,17,15,2,15,14,1,12,,33,18,15,30,3,0,2,2,0,,,
"Apr 10, 2022 5:00 PM",53,19,34,27,11,16,48,15,33,35,12,23,10,2,8,9,12,9,3,10,10,0,4,,9,3,6,17,1,0,2,2,0,,,
"Apr 10, 2022 6:00 PM",53,20,33,16,7,9,39,23,16,21,9,12,5,4,1,14,8,6,2,9,8,1,5,,13,10,3,12,0,2,1,1,0,,,
"Apr 10, 2022 7:00 PM",52,23,29,10,7,3,17,7,10,19,8,11,4,3,1,5,10,9,1,10,8,2,9,,4,0,4,13,3,1,2,1,1,,,
"Apr 10, 2022 8:00 PM",28,12,16,9,5,4,20,10,10,13,8,5,4,0,4,5,10,8,2,7,6,1,6,,6,4,2,9,2,1,2,0,2,,,
"Apr 10, 2022 9:00 PM",20,7,13,3,0,3,5,2,3,4,1,3,2,1,1,1,11,9,2,4,4,0,8,,0,0,0,12,5,0,1,1,0,,,
"Apr 10, 2022 10:00 PM",19,7,12,1,0,1,7,2,5,5,1,4,0,0,0,3,3,3,0,5,5,0,3,,1,1,0,6,1,2,0,0,0,,,
"Apr 10, 2022 11:00 PM",13,5,8,0,0,0,1,1,0,0,0,0,0,0,0,0,5,3,2,3,2,1,3,,0,0,0,1,1,1,2,1,1,,,
"Apr 11, 2022 12:00 AM",6,3,3,1,1,0,0,0,0,3,1,2,1,0,1,1,1,1,0,5,5,0,1,,1,1,0,2,0,0,1,0,1,,,
"Apr 11, 2022 1:00 AM",4,0,4,0,0,0,0,0,0,0,0,0,0,0,0,0,1,0,1,0,0,0,0,,2,1,1,0,0,0,2,1,1,,,
"Apr 11, 2022 2:00 AM",2,1,1,0,0,0,0,0,0,0,0,0,0,0,0,1,1,0,1,0,0,0,0,,0,0,0,0,0,0,0,0,0,,,
"Apr 11, 2022 3:00 AM",2,1,1,0,0,0,0,0,0,0,0,0,0,0,0,0,0,0,0,1,1,0,0,,0,0,0,0,0,0,0,0,0,,,
"Apr 11, 2022 4:00 AM",2,1,1,0,0,0,0,0,0,0,0,0,0,0,0,0,2,2,0,0,0,0,2,,0,0,0,0,0,1,0,0,0,,,
"Apr 11, 2022 5:00 AM",6,5,1,0,0,0,0,0,0,1,0,1,0,0,0,2,9,9,0,0,0,0,9,,0,0,0,7,0,0,0,0,0,,,
"Apr 11, 2022 6:00 AM",43,34,9,14,2,12,21,8,13,17,6,11,2,2,0,3,18,17,1,6,4,2,19,,10,5,5,31,1,4,1,1,0,,,
"Apr 11, 2022 7:00 AM",104,74,30,27,7,20,46,16,30,35,12,23,5,4,1,9,64,64,0,15,14,1,61,,24,14,10,87,1,2,6,5,1,,,
"Apr 11, 2022 8:00 AM",203,149,54,57,14,43,116,41,75,57,24,33,15,11,4,11,105,104,1,23,13,10,113,,63,22,41,123,4,4,1,0,1,,,
"Apr 11, 2022 9:00 AM",122,94,28,33,13,20,67,33,34,55,29,26,14,11,3,8,64,64,0,15,12,3,55,,26,17,9,47,2,1,4,2,2,,,
"Apr 11, 2022 10:00 AM",83,69,14,40,16,24,49,26,23,35,18,17,13,6,7,15,39,39,0,16,10,6,29,,11,7,4,29,1,1,2,1,1,,,
"Apr 11, 2022 11:00 AM",61,42,19,30,15,15,43,17,26,33,17,16,17,12,5,20,43,43,0,11,11,0,37,,19,10,9,22,2,3,4,3,1,,,
"Apr 11, 2022 12:00 PM",58,28,30,6,2,4,19,9,10,21,13,8,17,6,11,9,21,18,3,7,5,2,21,,14,6,8,13,1,2,2,2,0,,,
"Apr 11, 2022 1:00 PM",64,29,35,16,11,5,30,19,11,18,8,10,7,3,4,6,15,13,2,21,18,3,8,,10,8,2,21,4,3,14,8,6,,,
"Apr 11, 2022 2:00 PM",35,14,21,16,6,10,24,13,11,21,13,8,17,10,7,20,19,19,0,18,14,4,15,,23,15,8,26,4,0,6,5,1,,,
"Apr 11, 2022 3:00 PM",70,18,52,19,12,7,24,14,10,20,14,6,8,5,3,9,20,17,3,25,22,3,16,,11,7,4,15,1,2,2,1,1,,,
"Apr 11, 2022 4:00 PM",87,26,61,31,15,16,38,20,18,41,18,23,7,1,6,13,20,14,6,30,29,1,12,,27,17,10,29,7,3,9,6,3,,,
"Apr 11, 2022 5:00 PM",191,59,132,51,32,19,84,49,35,65,34,31,24,9,15,26,35,26,9,74,71,3,27,,42,28,14,52,4,3,8,5,3,,,
"Apr 11, 2022 6:00 PM",185,47,138,55,36,19,101,70,31,60,43,17,13,1,12,22,24,18,6,77,74,3,19,,50,36,14,32,8,3,8,4,4,,,
"Apr 11, 2022 7:00 PM",105,34,71,29,23,6,48,34,14,39,27,12,11,4,7,10,26,20,6,38,38,0,16,,23,19,4,23,1,1,3,0,3,,,
"Apr 11, 2022 8:00 PM",62,16,46,22,12,10,35,19,16,32,17,15,3,2,1,8,16,15,1,22,22,0,13,,11,7,4,11,4,2,1,1,0,,,
"Apr 11, 2022 9:00 PM",57,8,49,8,4,4,19,11,8,8,5,3,2,1,1,12,17,12,5,20,17,3,14,,5,2,3,16,4,2,3,3,0,,,
"Apr 11, 2022 10:00 PM",37,8,29,3,3,0,8,6,2,1,1,0,3,0,3,5,6,3,3,11,11,0,3,,3,3,0,4,1,2,1,0,1,,,
"Apr 11, 2022 11:00 PM",19,5,14,1,1,0,2,1,1,1,0,1,2,0,2,3,4,1,3,4,4,0,0,,1,1,0,3,1,0,0,0,0,,,
"Apr 12, 2022 12:00 AM",5,1,4,0,0,0,0,0,0,1,1,0,0,0,0,0,3,2,1,7,7,0,2,,0,0,0,4,0,0,0,0,0,,,
"Apr 12, 2022 1:00 AM",3,1,2,0,0,0,0,0,0,1,0,1,2,1,1,0,1,0,1,2,1,1,0,,0,0,0,0,0,0,1,1,0,,,
"Apr 12, 2022 2:00 AM",2,2,0,0,0,0,0,0,0,0,0,0,0,0,0,0,0,0,0,0,0,0,0,,0,0,0,0,0,0,0,0,0,,,
"Apr 12, 2022 3:00 AM",0,0,0,0,0,0,0,0,0,0,0,0,0,0,0,0,0,0,0,0,0,0,0,,0,0,0,0,0,0,0,0,0,,,
"Apr 12, 2022 4:00 AM",2,1,1,0,0,0,0,0,0,0,0,0,0,0,0,0,3,1,2,2,2,0,1,,0,0,0,1,0,0,0,0,0,,,
"Apr 12, 2022 5:00 AM",4,3,1,1,0,1,3,2,1,3,1,2,1,1,0,3,6,6,0,1,1,0,6,,1,1,0,7,0,1,0,0,0,,,
"Apr 12, 2022 6:00 AM",49,38,11,12,5,7,21,9,12,20,10,10,1,1,0,5,27,26,1,8,6,2,25,,12,7,5,31,2,3,1,1,0,,,
"Apr 12, 2022 7:00 AM",105,73,32,37,9,28,56,20,36,42,16,26,6,5,1,9,46,46,0,12,9,3,52,,26,12,14,82,2,7,3,3,0,,,
"Apr 12, 2022 8:00 AM",173,127,46,26,8,18,70,21,49,39,14,25,6,4,2,15,78,78,0,19,11,8,75,,33,7,26,121,1,3,2,0,2,,,
"Apr 12, 2022 9:00 AM",78,69,9,17,4,13,29,12,17,23,12,11,6,5,1,2,46,45,1,10,7,3,37,,13,3,10,39,0,1,1,1,0,,,
"Apr 12, 2022 10:00 AM",46,36,10,6,1,5,11,4,7,5,1,4,5,3,2,3,17,17,0,7,5,2,13,,4,1,3,13,1,0,0,0,0,,,
"Apr 12, 2022 11:00 AM",16,13,3,1,0,1,4,2,2,3,1,2,3,1,2,2,12,12,0,3,3,0,10,,2,0,2,6,2,2,2,1,1,,,
"Apr 12, 2022 12:00 PM",39,28,11,6,3,3,7,6,1,3,3,0,0,0,0,4,7,6,1,4,4,0,3,,1,0,1,11,1,0,0,0,0,,,
"Apr 12, 2022 1:00 PM",55,24,31,7,5,2,12,6,6,9,2,7,6,5,1,4,29,25,4,12,11,1,22,,6,4,2,7,3,1,2,2,0,,,
"Apr 12, 2022 2:00 PM",44,20,24,3,0,3,14,9,5,8,5,3,1,1,0,7,9,8,1,10,9,1,5,,7,5,2,12,2,0,0,0,0,,,
"Apr 12, 2022 3:00 PM",59,22,37,12,9,3,17,8,9,18,9,9,6,3,3,5,13,12,1,14,12,2,6,,2,1,1,15,0,0,1,0,1,,,
"Apr 12, 2022 4:00 PM",79,21,58,20,14,6,26,13,13,23,12,11,20,8,12,17,19,14,5,28,27,1,13,,8,7,1,24,3,0,1,1,0,,,
"Apr 12, 2022 5:00 PM",154,35,119,28,24,4,65,48,17,45,28,17,11,4,7,20,33,29,4,62,59,3,30,,42,36,6,36,1,4,7,5,2,,,
"Apr 12, 2022 6:00 PM",149,45,104,47,35,12,60,44,16,54,35,19,11,3,8,16,21,18,3,44,40,4,16,,31,24,7,34,3,2,2,1,1,,,
"Apr 12, 2022 7:00 PM",106,28,78,24,16,8,39,26,13,26,18,8,4,2,2,7,25,20,5,45,42,3,20,,20,15,5,14,2,0,6,2,4,,,
"Apr 12, 2022 8:00 PM",69,20,49,17,9,8,29,16,13,23,13,10,8,4,4,11,12,11,1,27,26,1,8,,20,13,7,14,2,2,3,2,1,,,
"Apr 12, 2022 9:00 PM",46,11,35,11,4,7,19,11,8,14,7,7,0,0,0,5,16,12,4,15,15,0,12,,6,3,3,12,3,0,2,1,1,,,
"Apr 12, 2022 10:00 PM",32,6,26,8,6,2,5,4,1,4,3,1,1,1,0,0,13,10,3,13,12,1,10,,3,3,0,2,1,0,1,0,1,,,
"Apr 12, 2022 11:00 PM",8,4,4,0,0,0,4,4,0,2,0,2,0,0,0,2,1,1,0,6,6,0,1,,1,0,1,4,0,0,0,0,0,,,
"Apr 13, 2022 12:00 AM",9,4,5,0,0,0,0,0,0,0,0,0,1,0,1,0,2,1,1,1,1,0,1,,1,1,0,2,0,0,0,0,0,,,
"Apr 13, 2022 1:00 AM",4,1,3,1,0,1,3,3,0,0,0,0,0,0,0,1,1,0,1,1,1,0,0,,1,1,0,0,0,0,0,0,0,,,
"Apr 13, 2022 2:00 AM",1,1,0,0,0,0,0,0,0,0,0,0,0,0,0,0,0,0,0,1,1,0,0,,0,0,0,0,0,0,0,0,0,,,
"Apr 13, 2022 3:00 AM",0,0,0,0,0,0,0,0,0,0,0,0,1,0,1,0,0,0,0,0,0,0,0,,0,0,0,0,0,0,0,0,0,,,
"Apr 13, 2022 4:00 AM",4,2,2,0,0,0,0,0,0,0,0,0,0,0,0,0,1,1,0,1,1,0,1,,0,0,0,2,0,1,0,0,0,,,
"Apr 13, 2022 5:00 AM",9,5,4,2,0,2,1,1,0,2,1,1,1,1,0,0,8,8,0,0,0,0,8,,1,1,0,9,0,0,0,0,0,,,
"Apr 13, 2022 6:00 AM",45,31,14,23,15,8,20,12,8,20,14,6,0,0,0,4,22,22,0,9,7,2,23,,9,7,2,27,1,3,3,3,0,,,
"Apr 13, 2022 7:00 AM",104,75,29,44,16,28,69,23,46,53,23,30,10,9,1,9,60,60,0,21,15,6,63,,26,16,10,100,2,5,2,2,0,,,
"Apr 13, 2022 8:00 AM",221,165,56,55,10,45,111,37,74,73,28,45,13,11,2,19,130,129,1,31,20,11,119,,75,28,47,126,3,10,3,1,2,,,
"Apr 13, 2022 9:00 AM",134,113,21,66,26,40,107,38,69,74,41,33,16,11,5,8,73,73,0,25,15,10,62,,51,18,33,71,3,6,3,0,3,,,
"Apr 13, 2022 10:00 AM",90,66,24,47,23,24,76,44,32,36,22,14,12,11,1,17,34,34,0,14,11,3,22,,28,16,12,37,4,1,9,6,3,,,
"Apr 13, 2022 11:00 AM",55,32,23,48,22,26,65,33,32,52,33,19,25,12,13,13,26,26,0,11,9,2,22,,28,15,13,29,4,2,1,1,0,,,
"Apr 13, 2022 12:00 PM",81,48,33,58,31,27,64,30,34,50,25,25,23,14,9,25,34,31,3,10,10,0,29,,21,13,8,28,9,3,7,5,2,,,
"Apr 13, 2022 1:00 PM",105,48,57,68,31,37,86,42,44,70,33,37,23,11,12,19,29,27,2,21,19,2,22,,43,25,18,27,6,7,9,6,3,,,
"Apr 13, 2022 2:00 PM",77,29,48,68,44,24,72,37,35,57,32,25,22,13,9,14,22,19,3,23,19,4,18,,36,19,17,22,6,1,4,2,2,,,
"Apr 13, 2022 3:00 PM",91,31,60,50,22,28,70,41,29,55,31,24,19,10,9,20,30,26,4,21,20,1,24,,31,18,13,22,7,1,4,3,1,,,
"Apr 13, 2022 4:00 PM",99,28,71,63,42,21,83,46,37,69,40,29,18,4,14,8,27,22,5,37,35,2,24,,38,22,16,31,9,2,6,5,1,,,
"Apr 13, 2022 5:00 PM",205,67,138,69,35,34,121,61,60,106,51,55,23,10,13,36,46,35,11,87,80,7,35,,59,38,21,84,4,4,5,1,4,,,
"Apr 13, 2022 6:00 PM",192,71,121,79,55,24,165,119,46,103,71,32,19,2,17,25,50,40,10,94,88,6,39,,75,59,16,66,9,7,7,5,2,,,
"Apr 13, 2022 7:00 PM",132,38,94,74,34,40,113,56,57,68,34,34,12,7,5,19,20,16,4,47,46,1,15,,48,30,18,39,6,1,1,0,1,,,
"Apr 13, 2022 8:00 PM",94,28,66,44,25,19,70,39,31,43,22,21,9,5,4,21,24,15,9,27,26,1,10,,22,11,11,27,6,6,8,4,4,,,
"Apr 13, 2022 9:00 PM",53,12,41,18,10,8,29,10,19,18,8,10,4,4,0,3,17,13,4,28,27,1,14,,7,5,2,14,5,2,3,2,1,,,
"Apr 13, 2022 10:00 PM",47,11,36,9,5,4,18,12,6,11,8,3,3,1,2,5,10,8,2,17,17,0,7,,9,7,2,13,1,1,2,1,1,,,
"Apr 13, 2022 11:00 PM",22,7,15,7,7,0,7,4,3,4,2,2,1,0,1,1,8,4,4,7,7,0,6,,3,2,1,7,2,1,2,0,2,,,
"Apr 14, 2022 12:00 AM",15,7,8,0,0,0,1,1,0,3,2,1,2,0,2,0,2,2,0,7,7,0,4,,5,3,2,4,0,0,0,0,0,,,
"Apr 14, 2022 1:00 AM",6,3,3,1,1,0,5,4,1,1,1,0,1,0,1,0,1,1,0,5,5,0,1,,0,0,0,1,0,1,0,0,0,,,
"Apr 14, 2022 2:00 AM",1,1,0,0,0,0,1,0,1,1,0,1,0,0,0,0,0,0,0,0,0,0,0,,0,0,0,0,0,1,0,0,0,,,
"Apr 14, 2022 3:00 AM",3,0,3,0,0,0,0,0,0,0,0,0,0,0,0,0,0,0,0,1,0,1,0,,0,0,0,0,0,0,1,1,0,,,
"Apr 14, 2022 4:00 AM",3,1,2,0,0,0,0,0,0,0,0,0,0,0,0,0,0,0,0,0,0,0,0,,0,0,0,2,0,0,0,0,0,,,
"Apr 14, 2022 5:00 AM",3,3,0,2,0,2,2,0,2,1,0,1,0,0,0,1,10,10,0,0,0,0,9,,1,0,1,5,0,0,0,0,0,,,
"Apr 14, 2022 6:00 AM",50,35,15,22,12,10,26,16,10,22,13,9,3,3,0,4,14,14,0,12,12,0,15,,10,6,4,17,0,3,0,0,0,,,
"Apr 14, 2022 7:00 AM",103,72,31,59,24,35,77,28,49,55,22,33,4,3,1,19,59,59,0,15,12,3,57,,25,14,11,96,0,7,4,4,0,,,
"Apr 14, 2022 8:00 AM",199,150,49,61,16,45,100,35,65,65,30,35,14,10,4,13,129,129,0,24,15,9,123,,50,15,35,111,4,6,3,2,1,,,
"Apr 14, 2022 9:00 AM",106,84,22,55,25,30,77,41,36,77,45,32,21,17,4,11,72,72,0,16,11,5,71,,38,20,18,50,0,3,2,0,2,,,
"Apr 14, 2022 10:00 AM",74,56,18,70,26,44,85,38,47,59,28,31,18,12,6,14,35,34,1,17,13,4,24,,30,11,19,22,3,4,5,5,0,,,
"Apr 14, 2022 11:00 AM",63,43,20,68,35,33,89,43,46,68,36,32,14,7,7,10,31,26,5,18,16,2,23,,36,16,20,32,4,6,3,3,0,,,
"Apr 14, 2022 12:00 PM",66,37,29,62,27,35,76,40,36,65,35,30,17,10,7,19,29,25,4,18,15,3,21,,40,22,18,32,6,4,4,3,1,,,
"Apr 14, 2022 1:00 PM",74,28,46,63,38,25,83,42,41,55,27,28,19,11,8,13,35,32,3,27,23,4,33,,49,28,21,23,3,3,7,6,1,,,
"Apr 14, 2022 2:00 PM",74,36,38,41,18,23,54,21,33,44,22,22,21,10,11,14,18,13,5,19,18,1,9,,26,6,20,19,5,2,9,7,2,,,
"Apr 14, 2022 3:00 PM",76,35,41,46,22,24,45,29,16,42,24,18,15,10,5,13,17,14,3,29,27,2,14,,23,11,12,15,4,1,4,3,1,,,
"Apr 14, 2022 4:00 PM",102,26,76,59,42,17,64,40,24,72,38,34,28,16,12,20,27,22,5,34,31,3,22,,43,29,14,43,4,4,6,5,1,,,
"Apr 14, 2022 5:00 PM",205,58,147,56,28,28,88,45,43,78,40,38,20,2,18,28,35,28,7,71,69,2,32,,40,27,13,45,3,3,6,4,2,,,
"Apr 14, 2022 6:00 PM",167,58,109,49,32,17,90,54,36,70,37,33,21,6,15,20,31,28,3,77,73,4,29,,49,37,12,42,4,2,6,5,1,,,
"Apr 14, 2022 7:00 PM",103,46,57,38,18,20,69,37,32,53,27,26,10,4,6,10,19,17,2,28,26,2,16,,36,21,15,22,5,1,6,1,5,,,
"Apr 14, 2022 8:00 PM",76,21,55,26,22,4,45,30,15,35,22,13,3,2,1,17,14,10,4,19,16,3,8,,11,7,4,15,2,0,6,3,3,,,
"Apr 14, 2022 9:00 PM",60,19,41,9,3,6,20,7,13,11,7,4,2,1,1,10,14,9,5,16,15,1,12,,6,4,2,15,3,1,2,1,1,,,
"Apr 14, 2022 10:00 PM",55,9,46,9,7,2,8,6,2,10,6,4,6,2,4,3,9,6,3,16,16,0,6,,3,3,0,6,1,2,4,1,3,,,
"Apr 14, 2022 11:00 PM",30,7,23,6,5,1,15,10,5,12,7,5,2,1,1,0,6,4,2,10,10,0,3,,2,1,1,11,0,1,1,1,0,,,
"Apr 15, 2022 12:00 AM",16,4,12,0,0,0,3,2,1,8,3,5,0,0,0,3,3,3,0,6,6,0,3,,2,2,0,3,0,1,0,0,0,,,
"Apr 15, 2022 1:00 AM",12,1,11,1,1,0,3,0,3,0,0,0,1,0,1,1,0,0,0,2,2,0,0,,1,1,0,0,0,0,0,0,0,,,
"Apr 15, 2022 2:00 AM",8,3,5,0,0,0,1,1,0,0,0,0,0,0,0,0,0,0,0,3,3,0,0,,0,0,0,0,0,0,0,0,0,,,
"Apr 15, 2022 3:00 AM",5,1,4,1,1,0,1,1,0,1,1,0,0,0,0,0,0,0,0,3,3,0,0,,0,0,0,1,0,0,0,0,0,,,
"Apr 15, 2022 4:00 AM",5,3,2,1,1,0,2,2,0,1,1,0,1,0,1,1,0,0,0,2,2,0,0,,0,0,0,0,0,0,0,0,0,,,
"Apr 15, 2022 5:00 AM",2,1,1,1,1,0,2,1,1,2,1,1,0,0,0,1,6,6,0,1,1,0,6,,1,1,0,4,0,0,0,0,0,,,
"Apr 15, 2022 6:00 AM",29,20,9,16,6,10,22,10,12,18,9,9,3,1,2,4,10,9,1,6,6,0,10,,11,8,3,19,2,2,2,2,0,,,
"Apr 15, 2022 7:00 AM",51,31,20,42,27,15,60,28,32,32,17,15,2,2,0,5,22,22,0,10,7,3,21,,12,8,4,32,0,6,2,2,0,,,
"Apr 15, 2022 8:00 AM",54,24,30,53,23,30,62,29,33,42,25,17,12,6,6,9,27,27,0,13,10,3,25,,18,11,7,38,1,8,0,0,0,,,
"Apr 15, 2022 9:00 AM",58,32,26,56,31,25,79,41,38,60,41,19,15,10,5,10,32,32,0,14,11,3,27,,33,21,12,33,2,5,6,6,0,,,
"Apr 15, 2022 10:00 AM",50,28,22,88,42,46,120,75,45,91,54,37,26,15,11,7,32,30,2,18,14,4,28,,32,18,14,32,5,4,7,4,3,,,
"Apr 15, 2022 11:00 AM",60,41,19,105,47,58,139,77,62,104,64,40,18,9,9,12,25,24,1,20,20,0,20,,47,34,13,32,3,9,0,0,0,,,
"Apr 15, 2022 12:00 PM",63,35,28,96,52,44,129,63,66,92,52,40,21,7,14,18,26,24,2,12,12,0,27,,59,37,22,33,12,3,3,2,1,,,
"Apr 15, 2022 1:00 PM",87,41,46,92,45,47,106,56,50,98,53,45,14,3,11,27,23,21,2,17,15,2,20,,32,21,11,44,7,8,4,3,1,,,
"Apr 15, 2022 2:00 PM",66,33,33,92,34,58,94,34,60,82,29,53,15,9,6,20,27,25,2,20,19,1,24,,45,21,24,49,12,3,5,3,2,,,
"Apr 15, 2022 3:00 PM",68,35,33,61,29,32,98,35,63,77,26,51,25,13,12,17,19,18,1,18,18,0,19,,61,21,40,40,3,1,1,1,0,,,
"Apr 15, 2022 4:00 PM",97,47,50,70,32,38,105,61,44,70,48,22,18,6,12,26,44,43,1,20,20,0,38,,53,27,26,49,4,4,2,1,1,,,
"Apr 15, 2022 5:00 PM",89,30,59,77,43,34,83,45,38,67,36,31,20,12,8,12,23,20,3,15,15,0,20,,54,30,24,37,4,2,10,5,5,,,
"Apr 15, 2022 6:00 PM",73,36,37,63,32,31,66,36,30,69,32,37,14,2,12,10,16,14,2,22,20,2,15,,38,12,26,29,7,0,9,4,5,,,
"Apr 15, 2022 7:00 PM",68,23,45,49,22,27,61,36,25,47,24,23,5,3,2,16,10,8,2,11,11,0,8,,33,23,10,18,5,5,0,0,0,,,
"Apr 15, 2022 8:00 PM",62,15,47,26,9,17,39,20,19,35,15,20,5,2,3,4,15,11,4,12,11,1,13,,18,11,7,15,3,1,9,7,2,,,
"Apr 15, 2022 9:00 PM",31,13,18,8,5,3,13,6,7,9,5,4,9,7,2,9,8,6,2,5,4,1,7,,7,6,1,13,0,3,3,2,1,,,
"Apr 15, 2022 10:00 PM",26,6,20,0,0,0,7,6,1,6,2,4,1,0,1,1,2,2,0,13,11,2,2,,9,5,4,6,1,1,3,1,2,,,
"Apr 15, 2022 11:00 PM",30,10,20,2,2,0,10,4,6,8,3,5,1,1,0,1,4,4,0,6,6,0,3,,3,1,2,5,1,2,3,2,1,,,
"Apr 16, 2022 12:00 AM",15,7,8,0,0,0,6,2,4,6,2,4,1,1,0,0,1,1,0,3,3,0,0,,3,2,1,3,1,0,2,2,0,,,
"Apr 16, 2022 1:00 AM",5,1,4,1,0,1,5,4,1,0,0,0,3,1,2,1,0,0,0,3,3,0,0,,3,2,1,2,0,0,0,0,0,,,
"Apr 16, 2022 2:00 AM",7,2,5,1,1,0,4,3,1,2,1,1,0,0,0,3,0,0,0,3,3,0,0,,1,0,1,2,0,0,0,0,0,,,
"Apr 16, 2022 3:00 AM",6,1,5,0,0,0,0,0,0,0,0,0,0,0,0,1,0,0,0,1,1,0,0,,0,0,0,0,0,0,1,1,0,,,
"Apr 16, 2022 4:00 AM",6,1,5,3,3,0,2,2,0,1,1,0,0,0,0,0,0,0,0,1,1,0,0,,2,2,0,0,0,0,0,0,0,,,
"Apr 16, 2022 5:00 AM",3,3,0,0,0,0,0,0,0,0,0,0,0,0,0,1,1,1,0,1,1,0,1,,0,0,0,3,0,1,0,0,0,,,
"Apr 16, 2022 6:00 AM",10,4,6,4,2,2,8,5,3,5,3,2,0,0,0,1,7,6,1,4,4,0,7,,4,3,1,11,0,4,0,0,0,,,
"Apr 16, 2022 7:00 AM",15,6,9,26,14,12,29,15,14,18,10,8,3,3,0,3,12,11,1,9,9,0,11,,12,8,4,20,1,1,1,1,0,,,
"Apr 16, 2022 8:00 AM",26,13,13,54,38,16,61,41,20,54,39,15,8,3,5,11,16,15,1,11,10,1,15,,16,9,7,15,4,8,3,2,1,,,
"Apr 16, 2022 9:00 AM",36,15,21,64,31,33,94,61,33,73,50,23,5,3,2,6,17,17,0,12,10,2,14,,29,20,9,29,1,13,3,3,0,,,
"Apr 16, 2022 10:00 AM",44,25,19,110,59,51,125,76,49,97,59,38,21,13,8,19,19,19,0,14,13,1,20,,41,29,12,41,6,10,4,3,1,,,
"Apr 16, 2022 11:00 AM",55,33,22,122,53,69,151,84,67,107,51,56,21,13,8,6,18,18,0,16,13,3,13,,56,32,24,46,7,5,8,6,2,,,
"Apr 16, 2022 12:00 PM",63,33,30,106,42,64,134,62,72,106,62,44,27,8,19,21,20,19,1,5,5,0,19,,62,28,34,51,6,3,10,5,5,,,
"Apr 16, 2022 1:00 PM",65,37,28,104,66,38,140,91,49,96,62,34,22,5,17,32,19,17,2,14,10,4,16,,66,44,22,38,11,2,8,8,0,,,
"Apr 16, 2022 2:00 PM",52,25,27,143,81,62,166,97,69,150,91,59,13,10,3,14,30,30,0,16,15,1,31,,86,61,25,42,13,2,13,10,3,,,
"Apr 16, 2022 3:00 PM",63,32,31,144,69,75,187,103,84,147,81,66,45,30,15,21,17,14,3,17,16,1,17,,64,38,26,42,7,4,7,4,3,,,
"Apr 16, 2022 4:00 PM",61,33,28,172,92,80,144,58,86,139,63,76,21,8,13,20,28,24,4,13,13,0,23,,71,34,37,52,4,1,8,5,3,,,
"Apr 16, 2022 5:00 PM",60,20,40,89,38,51,124,53,71,101,41,60,28,10,18,11,11,10,1,9,7,2,9,,34,10,24,26,5,4,8,2,6,,,
"Apr 16, 2022 6:00 PM",56,23,33,55,21,34,67,27,40,62,25,37,17,11,6,12,16,16,0,12,12,0,17,,29,10,19,28,6,2,9,6,3,,,
"Apr 16, 2022 7:00 PM",46,20,26,26,11,15,46,17,29,37,12,25,9,6,3,10,14,14,0,14,14,0,14,,25,11,14,36,1,2,0,0,0,,,
"Apr 16, 2022 8:00 PM",40,16,24,18,12,6,28,10,18,21,7,14,6,3,3,4,16,16,0,9,8,1,14,,15,7,8,15,3,1,5,2,3,,,
"Apr 16, 2022 9:00 PM",31,15,16,11,9,2,14,8,6,11,7,4,0,0,0,5,3,3,0,4,4,0,3,,10,5,5,10,0,2,1,1,0,,,
"Apr 16, 2022 10:00 PM",21,7,14,7,2,5,10,5,5,10,3,7,4,2,2,1,2,2,0,5,4,1,2,,0,0,0,6,0,1,0,0,0,,,
"Apr 16, 2022 11:00 PM",19,7,12,3,2,1,6,3,3,6,3,3,3,2,1,2,6,6,0,4,4,0,7,,6,2,4,7,0,0,5,4,1,,,
"Apr 17, 2022 12:00 AM",5,2,3,0,0,0,2,1,1,2,1,1,0,0,0,3,1,1,0,4,4,0,1,,2,2,0,1,1,0,2,1,1,,,
"Apr 17, 2022 1:00 AM",8,2,6,0,0,0,2,1,1,1,1,0,0,0,0,1,3,2,1,4,3,1,3,,2,1,1,2,0,0,0,0,0,,,
"Apr 17, 2022 2:00 AM",7,3,4,1,0,1,3,1,2,2,1,1,0,0,0,0,0,0,0,2,2,0,0,,2,2,0,2,0,0,0,0,0,,,
"Apr 17, 2022 3:00 AM",7,3,4,2,2,0,2,2,0,2,2,0,0,0,0,0,1,1,0,3,2,1,1,,2,2,0,3,0,0,0,0,0,,,
"Apr 17, 2022 4:00 AM",8,2,6,0,0,0,0,0,0,0,0,0,1,0,1,0,0,0,0,2,2,0,0,,1,1,0,2,0,0,0,0,0,,,
"Apr 17, 2022 5:00 AM",4,3,1,0,0,0,0,0,0,0,0,0,0,0,0,0,0,0,0,0,0,0,0,,0,0,0,1,0,1,1,0,1,,,
"Apr 17, 2022 6:00 AM",3,2,1,6,2,4,4,3,1,5,2,3,0,0,0,0,4,3,1,2,2,0,4,,0,0,0,1,1,0,1,1,0,,,
"Apr 17, 2022 7:00 AM",13,8,5,14,10,4,15,9,6,14,11,3,0,0,0,5,9,8,1,11,10,1,7,,6,4,2,9,0,1,0,0,0,,,
"Apr 17, 2022 8:00 AM",21,10,11,29,18,11,37,24,13,32,22,10,1,0,1,5,9,9,0,6,5,1,11,,11,10,1,15,5,1,2,2,0,,,
"Apr 17, 2022 9:00 AM",32,14,18,66,33,33,78,42,36,63,33,30,13,6,7,7,5,4,1,7,6,1,5,,23,12,11,26,4,3,3,2,1,,,
"Apr 17, 2022 10:00 AM",40,20,20,103,64,39,112,68,44,95,60,35,16,10,6,10,15,15,0,8,7,1,20,,33,20,13,31,2,9,2,2,0,,,
"Apr 17, 2022 11:00 AM",28,19,9,70,25,45,97,38,59,65,25,40,28,14,14,12,8,6,2,8,7,1,7,,34,14,20,26,3,2,2,0,2,,,
"Apr 17, 2022 12:00 PM",35,19,16,61,26,35,108,54,54,83,49,34,22,12,10,20,13,12,1,6,4,2,12,,37,22,15,16,5,3,2,1,1,,,
"Apr 17, 2022 1:00 PM",39,16,23,38,17,21,75,35,40,40,17,23,10,2,8,5,13,13,0,6,5,1,10,,52,30,22,11,2,2,2,2,0,,,
"Apr 17, 2022 2:00 PM",24,11,13,18,6,12,26,12,14,17,10,7,10,3,7,5,10,10,0,6,5,1,10,,10,4,6,10,3,1,4,1,3,,,
"Apr 17, 2022 3:00 PM",27,13,14,14,7,7,26,14,12,24,12,12,0,0,0,4,4,4,0,3,3,0,4,,4,2,2,8,1,1,2,2,0,,,
"Apr 17, 2022 4:00 PM",27,15,12,17,7,10,33,17,16,19,8,11,5,2,3,1,7,7,0,7,6,1,5,,12,5,7,12,1,0,4,2,2,,,
"Apr 17, 2022 5:00 PM",30,15,15,26,15,11,27,19,8,18,12,6,3,2,1,10,8,8,0,4,4,0,10,,10,6,4,13,1,2,1,1,0,,,
"Apr 17, 2022 6:00 PM",33,18,15,23,12,11,38,17,21,28,18,10,4,1,3,4,13,13,0,6,4,2,12,,19,7,12,11,2,0,3,3,0,,,
"Apr 17, 2022 7:00 PM",32,19,13,24,10,14,36,17,19,41,21,20,6,2,4,5,3,3,0,4,3,1,4,,11,6,5,13,1,0,3,1,2,,,
"Apr 17, 2022 8:00 PM",22,4,18,16,8,8,31,8,23,24,7,17,4,2,2,4,6,6,0,7,7,0,6,,4,2,2,13,0,2,3,2,1,,,
"Apr 17, 2022 9:00 PM",22,8,14,8,3,5,14,4,10,14,4,10,5,3,2,0,10,9,1,6,5,1,9,,8,5,3,8,3,0,2,2,0,,,
"Apr 17, 2022 10:00 PM",20,8,12,5,3,2,7,2,5,5,1,4,3,2,1,0,5,3,2,3,3,0,4,,1,0,1,5,0,0,1,1,0,,,
"Apr 17, 2022 11:00 PM",7,2,5,1,0,1,7,2,5,5,0,5,0,0,0,1,2,2,0,3,3,0,2,,2,0,2,4,1,0,2,1,1,,,
"Apr 18, 2022 12:00 AM",12,4,8,0,0,0,0,0,0,2,0,2,2,1,1,0,3,2,1,2,2,0,1,,0,0,0,0,1,0,1,1,0,,,
"Apr 18, 2022 1:00 AM",4,1,3,0,0,0,0,0,0,0,0,0,1,0,1,0,1,1,0,3,3,0,1,,0,0,0,0,0,0,0,0,0,,,
"Apr 18, 2022 2:00 AM",1,0,1,0,0,0,0,0,0,0,0,0,0,0,0,0,0,0,0,2,2,0,0,,0,0,0,1,0,1,1,0,1,,,
"Apr 18, 2022 3:00 AM",2,0,2,0,0,0,1,1,0,0,0,0,1,0,1,0,1,1,0,1,1,0,4,,0,0,0,0,0,0,0,0,0,,,
"Apr 18, 2022 4:00 AM",2,0,2,0,0,0,0,0,0,0,0,0,0,0,0,0,0,0,0,0,0,0,0,,0,0,0,0,0,0,0,0,0,,,
"Apr 18, 2022 5:00 AM",2,0,2,0,0,0,1,1,0,0,0,0,0,0,0,1,1,1,0,0,0,0,0,,1,1,0,2,0,0,0,0,0,,,
"Apr 18, 2022 6:00 AM",16,8,8,7,3,4,10,5,5,9,6,3,4,3,1,0,1,0,1,4,4,0,1,,3,2,1,5,1,0,0,0,0,,,
"Apr 18, 2022 7:00 AM",14,5,9,8,4,4,12,9,3,12,9,3,1,1,0,3,14,14,0,6,5,1,14,,1,1,0,14,2,2,1,1,0,,,
"Apr 18, 2022 8:00 AM",26,9,17,47,33,14,42,25,17,45,32,13,10,3,7,8,24,23,1,10,9,1,21,,13,12,1,21,2,2,3,0,3,,,
"Apr 18, 2022 9:00 AM",42,27,15,100,54,46,79,41,38,74,42,32,15,12,3,7,23,23,0,9,8,1,23,,29,21,8,26,2,13,3,3,0,,,
"Apr 18, 2022 10:00 AM",60,27,33,115,59,56,149,87,62,122,63,59,25,18,7,13,22,21,1,12,11,1,18,,55,35,20,38,4,7,4,3,1,,,
"Apr 18, 2022 11:00 AM",61,39,22,172,88,84,179,91,88,141,74,67,23,13,10,7,26,23,3,19,15,4,19,,61,33,28,48,3,0,9,6,3,,,
"Apr 18, 2022 12:00 PM",55,37,18,133,62,71,177,91,86,139,80,59,29,17,12,23,27,27,0,19,17,2,20,,58,35,23,32,8,5,2,1,1,,,
"Apr 18, 2022 1:00 PM",52,28,24,99,53,46,133,64,69,90,41,49,10,9,1,25,19,16,3,8,8,0,13,,60,37,23,36,9,2,3,2,1,,,
"Apr 18, 2022 2:00 PM",43,22,21,69,29,40,82,27,55,69,37,32,11,10,1,9,10,9,1,13,11,2,6,,43,15,28,39,15,0,9,8,1,,,
"Apr 18, 2022 3:00 PM",49,30,19,58,27,31,62,30,32,51,29,22,16,11,5,11,12,10,2,8,5,3,12,,32,20,12,32,1,1,4,3,1,,,
"Apr 18, 2022 4:00 PM",62,24,38,44,17,27,54,25,29,35,15,20,17,8,9,9,14,13,1,14,13,1,11,,23,13,10,18,2,1,8,7,1,,,
"Apr 18, 2022 5:00 PM",54,21,33,36,23,13,38,16,22,43,16,27,11,7,4,15,17,14,3,15,14,1,13,,17,11,6,22,4,1,5,2,3,,,
"Apr 18, 2022 6:00 PM",48,18,30,30,12,18,40,20,20,36,13,23,9,5,4,10,17,16,1,13,12,1,12,,18,10,8,18,1,2,4,4,0,,,
"Apr 18, 2022 7:00 PM",57,21,36,40,22,18,49,18,31,36,13,23,6,4,2,20,16,15,1,13,10,3,12,,19,9,10,25,2,0,2,0,2,,,
"Apr 18, 2022 8:00 PM",43,17,26,20,11,9,36,19,17,26,12,14,1,1,0,3,14,12,2,11,11,0,14,,16,11,5,15,1,0,2,1,1,,,
"Apr 18, 2022 9:00 PM",32,11,21,5,1,4,11,1,10,7,2,5,5,4,1,2,6,4,2,6,6,0,2,,4,1,3,2,0,0,1,1,0,,,
"Apr 18, 2022 10:00 PM",19,8,11,6,5,1,3,1,2,4,3,1,3,0,3,3,4,3,1,7,6,1,4,,2,0,2,6,1,1,7,4,3,,,
"Apr 18, 2022 11:00 PM",15,3,12,1,1,0,5,5,0,2,1,1,2,0,2,0,3,1,2,3,3,0,1,,2,2,0,3,0,0,1,1,0,,,
"Apr 19, 2022 12:00 AM",4,1,3,0,0,0,2,1,1,1,1,0,0,0,0,1,0,0,0,4,3,1,0,,0,0,0,2,0,0,0,0,0,,,
"Apr 19, 2022 1:00 AM",3,2,1,0,0,0,0,0,0,0,0,0,0,0,0,0,1,0,1,0,0,0,0,,0,0,0,1,0,0,0,0,0,,,
"Apr 19, 2022 2:00 AM",2,1,1,0,0,0,2,1,1,0,0,0,0,0,0,0,0,0,0,0,0,0,0,,0,0,0,1,0,0,1,1,0,,,
"Apr 19, 2022 3:00 AM",0,0,0,0,0,0,1,0,1,0,0,0,0,0,0,1,0,0,0,1,1,0,1,,0,0,0,1,0,0,0,0,0,,,
"Apr 19, 2022 4:00 AM",1,0,1,0,0,0,0,0,0,0,0,0,0,0,0,1,1,1,0,0,0,0,1,,0,0,0,1,1,0,1,1,0,,,
"Apr 19, 2022 5:00 AM",5,4,1,1,0,1,0,0,0,1,0,1,0,0,0,3,9,9,0,2,2,0,8,,0,0,0,6,0,1,0,0,0,,,
"Apr 19, 2022 6:00 AM",40,27,13,13,2,11,26,12,14,19,9,10,0,0,0,4,21,21,0,9,9,0,18,,12,8,4,36,1,7,3,3,0,,,
"Apr 19, 2022 7:00 AM",108,76,32,52,20,32,76,27,49,58,28,30,9,8,1,13,59,59,0,13,9,4,60,,34,11,23,85,2,4,7,6,1,,,
"Apr 19, 2022 8:00 AM",198,153,45,59,17,42,119,37,82,86,32,54,16,11,5,23,107,107,0,24,16,8,105,,57,20,37,148,7,9,3,2,1,,,
"Apr 19, 2022 9:00 AM",120,101,19,58,26,32,64,30,34,56,33,23,10,4,6,7,70,69,1,22,17,5,58,,45,26,19,52,3,3,5,3,2,,,
"Apr 19, 2022 10:00 AM",85,67,18,49,21,28,67,45,22,50,33,17,15,10,5,19,37,36,1,10,8,2,28,,21,10,11,35,5,2,2,1,1,,,
"Apr 19, 2022 11:00 AM",61,42,19,72,36,36,83,35,48,65,33,32,18,12,6,10,31,30,1,6,5,1,18,,36,23,13,21,5,2,6,6,0,,,
"Apr 19, 2022 12:00 PM",68,38,30,68,27,41,80,43,37,61,28,33,24,7,17,20,32,28,4,8,7,1,29,,42,23,19,32,2,1,7,4,3,,,
"Apr 19, 2022 1:00 PM",85,48,37,58,34,24,89,46,43,63,36,27,33,11,22,12,36,29,7,17,14,3,22,,40,26,14,27,3,6,6,4,2,,,
"Apr 19, 2022 2:00 PM",64,26,38,48,24,24,68,37,31,51,29,22,29,23,6,10,24,19,5,21,17,4,12,,47,27,20,22,4,0,4,4,0,,,
"Apr 19, 2022 3:00 PM",85,30,55,67,40,27,80,44,36,58,30,28,25,8,17,9,23,18,5,23,21,2,17,,34,21,13,20,4,4,8,7,1,,,
"Apr 19, 2022 4:00 PM",113,35,78,95,53,42,112,56,56,93,57,36,23,7,16,16,33,27,6,45,43,2,27,,52,38,14,44,2,2,10,8,2,,,
"Apr 19, 2022 5:00 PM",207,59,148,101,66,35,137,87,50,115,72,43,39,15,24,45,42,33,9,84,83,1,33,,77,39,38,54,14,9,8,5,3,,,
"Apr 19, 2022 6:00 PM",187,56,131,113,69,44,159,97,62,131,79,52,23,8,15,29,39,32,7,71,69,2,32,,63,25,38,53,8,7,3,1,2,,,
"Apr 19, 2022 7:00 PM",109,33,76,115,60,55,134,73,61,120,72,48,10,3,7,21,24,19,5,48,43,5,19,,53,33,20,41,5,2,5,2,3,,,
"Apr 19, 2022 8:00 PM",78,27,51,40,22,18,67,30,37,54,23,31,10,4,6,18,13,11,2,35,35,0,13,,23,14,9,28,6,3,14,9,5,,,
"Apr 19, 2022 9:00 PM",52,11,41,15,11,4,20,8,12,22,11,11,3,1,2,5,15,12,3,9,9,0,10,,4,1,3,13,4,1,1,0,1,,,
"Apr 19, 2022 10:00 PM",28,9,19,5,3,2,8,6,2,4,3,1,4,3,1,4,8,5,3,19,17,2,5,,5,5,0,3,0,1,0,0,0,,,
"Apr 19, 2022 11:00 PM",24,8,16,7,4,3,7,2,5,8,1,7,5,4,1,0,7,4,3,7,6,1,4,,0,0,0,5,0,0,1,1,0,,,
"Apr 20, 2022 12:00 AM",6,2,4,0,0,0,1,1,0,1,0,1,2,1,1,0,3,1,2,3,3,0,1,,0,0,0,1,0,1,3,3,0,,,
"Apr 20, 2022 1:00 AM",4,2,2,0,0,0,0,0,0,0,0,0,3,1,2,0,0,0,0,0,0,0,0,,1,1,0,2,0,0,0,0,0,,,
"Apr 20, 2022 2:00 AM",2,1,1,0,0,0,0,0,0,0,0,0,0,0,0,0,1,1,0,0,0,0,1,,0,0,0,3,0,0,2,2,0,,,
"Apr 20, 2022 3:00 AM",3,0,3,0,0,0,0,0,0,0,0,0,0,0,0,0,0,0,0,2,1,1,1,,0,0,0,0,0,0,0,0,0,,,
"Apr 20, 2022 4:00 AM",2,1,1,1,0,1,3,2,1,2,1,1,0,0,0,0,3,3,0,0,0,0,3,,1,1,0,1,0,0,0,0,0,,,
"Apr 20, 2022 5:00 AM",4,3,1,2,2,0,9,8,1,2,1,1,1,1,0,1,7,7,0,0,0,0,8,,0,0,0,11,0,0,0,0,0,,,
"Apr 20, 2022 6:00 AM",47,36,11,28,13,15,39,21,18,33,18,15,3,0,3,1,22,21,1,9,7,2,22,,15,11,4,39,0,3,1,1,0,,,
"Apr 20, 2022 7:00 AM",118,81,37,56,21,35,73,24,49,60,29,31,10,8,2,13,66,66,0,13,10,3,68,,33,27,6,85,2,5,4,3,1,,,
"Apr 20, 2022 8:00 AM",216,166,50,77,14,63,110,35,75,85,36,49,17,10,7,14,133,133,0,19,11,8,120,,52,28,24,158,4,8,6,3,3,,,
"Apr 20, 2022 9:00 AM",154,122,32,61,24,37,80,41,39,71,38,33,12,6,6,10,72,71,1,28,18,10,62,,46,28,18,59,3,4,3,1,2,,,
"Apr 20, 2022 10:00 AM",68,52,16,58,29,29,53,33,20,51,36,15,22,17,5,12,38,38,0,12,8,4,35,,32,20,12,36,6,3,9,6,3,,,
"Apr 20, 2022 11:00 AM",52,31,21,70,31,39,81,35,46,65,31,34,14,6,8,8,30,28,2,5,5,0,21,,37,22,15,36,4,2,8,4,4,,,
"Apr 20, 2022 12:00 PM",71,37,34,75,39,36,83,50,33,50,29,21,17,4,13,14,37,33,4,12,7,5,28,,46,25,21,30,3,3,3,1,2,,,
"Apr 20, 2022 1:00 PM",85,41,44,95,47,48,117,47,70,93,39,54,28,17,11,15,24,22,2,24,22,2,19,,71,29,42,26,1,4,6,6,0,,,
"Apr 20, 2022 2:00 PM",81,33,48,72,33,39,95,49,46,71,39,32,21,14,7,21,22,20,2,19,16,3,20,,50,29,21,36,2,4,11,7,4,,,
"Apr 20, 2022 3:00 PM",83,41,42,94,61,33,121,74,47,100,67,33,13,5,8,8,35,29,6,33,29,4,26,,45,30,15,25,7,2,9,7,2,,,
"Apr 20, 2022 4:00 PM",133,41,92,122,71,51,139,84,55,111,63,48,24,5,19,19,44,35,9,38,35,3,29,,86,39,47,38,7,2,9,7,2,,,
"Apr 20, 2022 5:00 PM",226,69,157,129,77,52,183,98,85,128,73,55,24,12,12,27,40,32,8,90,88,2,35,,75,32,43,71,9,9,9,8,1,,,
"Apr 20, 2022 6:00 PM",211,65,146,124,70,54,192,112,80,136,86,50,13,6,7,21,37,30,7,81,80,1,34,,85,30,55,71,9,5,10,5,5,,,
"Apr 20, 2022 7:00 PM",141,49,92,100,49,51,127,68,59,105,52,53,13,5,8,17,25,19,6,39,35,4,15,,58,37,21,33,7,6,7,2,5,,,
"Apr 20, 2022 8:00 PM",70,19,51,58,30,28,87,32,55,58,27,31,10,6,4,10,9,8,1,33,33,0,5,,36,16,20,35,8,3,6,5,1,,,
"Apr 20, 2022 9:00 PM",53,13,40,34,15,19,35,13,22,35,15,20,4,1,3,9,14,13,1,18,17,1,14,,17,11,6,12,6,0,3,0,3,,,
"Apr 20, 2022 10:00 PM",48,9,39,9,9,0,11,9,2,3,2,1,1,0,1,3,9,6,3,16,16,0,7,,10,6,4,12,0,4,1,1,0,,,
"Apr 20, 2022 11:00 PM",29,10,19,6,5,1,9,8,1,6,4,2,3,2,1,0,6,5,1,8,8,0,5,,8,6,2,3,2,0,3,0,3,,,
"Apr 21, 2022 12:00 AM",11,2,9,0,0,0,1,1,0,5,2,3,3,2,1,0,1,1,0,8,8,0,2,,1,1,0,3,0,0,0,0,0,,,
"Apr 21, 2022 1:00 AM",6,5,1,0,0,0,2,1,1,0,0,0,1,0,1,0,0,0,0,0,0,0,0,,1,1,0,0,0,0,0,0,0,,,
"Apr 21, 2022 2:00 AM",3,2,1,0,0,0,2,1,1,0,0,0,0,0,0,0,2,1,1,1,1,0,2,,0,0,0,1,0,1,0,0,0,,,
"Apr 21, 2022 3:00 AM",1,0,1,0,0,0,0,0,0,0,0,0,0,0,0,0,0,0,0,1,1,0,0,,0,0,0,0,1,0,0,0,0,,,
"Apr 21, 2022 4:00 AM",5,1,4,1,0,1,0,0,0,0,0,0,0,0,0,0,1,1,0,1,1,0,1,,0,0,0,0,0,0,0,0,0,,,
"Apr 21, 2022 5:00 AM",8,7,1,0,0,0,2,1,1,0,0,0,0,0,0,3,10,10,0,1,1,0,9,,0,0,0,10,0,0,0,0,0,,,
"Apr 21, 2022 6:00 AM",36,25,11,16,11,5,18,8,10,21,14,7,1,1,0,5,22,22,0,8,7,1,24,,10,4,6,27,0,9,1,1,0,,,
"Apr 21, 2022 7:00 AM",115,77,38,67,20,47,83,28,55,67,25,42,10,8,2,15,64,64,0,17,16,1,67,,38,14,24,88,5,8,7,5,2,,,
"Apr 21, 2022 8:00 AM",215,157,58,70,24,46,108,32,76,94,40,54,22,14,8,13,139,139,0,25,17,8,126,,62,17,45,134,7,5,3,1,2,,,
"Apr 21, 2022 9:00 AM",127,106,21,55,19,36,81,41,40,58,30,28,15,11,4,11,76,75,1,19,13,6,60,,43,20,23,63,3,3,4,2,2,,,
"Apr 21, 2022 10:00 AM",72,52,20,40,18,22,65,37,28,48,28,20,13,8,5,10,41,41,0,13,10,3,39,,34,21,13,36,6,1,3,3,0,,,
"Apr 21, 2022 11:00 AM",66,43,23,80,44,36,79,40,39,82,40,42,21,13,8,11,27,24,3,14,12,2,19,,27,15,12,30,1,4,6,4,2,,,
"Apr 21, 2022 12:00 PM",79,45,34,68,28,40,88,46,42,79,41,38,14,9,5,15,33,29,4,17,13,4,27,,45,26,19,33,3,4,3,2,1,,,
"Apr 21, 2022 1:00 PM",69,30,39,87,52,35,84,46,38,63,34,29,29,17,12,18,29,24,5,26,23,3,22,,47,23,24,29,4,6,4,3,1,,,
"Apr 21, 2022 2:00 PM",78,39,39,63,35,28,91,57,34,73,43,30,24,13,11,26,24,20,4,28,24,4,17,,31,18,13,26,1,0,3,2,1,,,
"Apr 21, 2022 3:00 PM",75,33,42,85,45,40,108,55,53,81,41,40,18,7,11,23,29,27,2,27,24,3,23,,43,25,18,27,5,4,7,4,3,,,
"Apr 21, 2022 4:00 PM",143,48,95,95,55,40,124,58,66,102,48,54,32,10,22,29,42,32,10,39,39,0,29,,65,34,31,43,6,8,10,4,6,,,
"Apr 21, 2022 5:00 PM",196,48,148,104,69,35,166,98,68,130,77,53,23,7,16,24,53,44,9,91,90,1,47,,97,54,43,70,13,4,12,10,2,,,
"Apr 21, 2022 6:00 PM",156,38,118,93,54,39,148,92,56,100,66,34,17,4,13,26,33,30,3,82,80,2,36,,58,39,19,54,6,4,8,4,4,,,
"Apr 21, 2022 7:00 PM",123,47,76,53,28,25,88,49,39,69,40,29,13,7,6,15,29,27,2,35,28,7,27,,41,31,10,25,6,3,7,4,3,,,
"Apr 21, 2022 8:00 PM",77,23,54,43,28,15,75,40,35,59,36,23,9,4,5,12,25,21,4,27,27,0,19,,27,19,8,22,2,1,3,2,1,,,
"Apr 21, 2022 9:00 PM",66,18,48,18,11,7,28,13,15,20,9,11,4,2,2,16,12,9,3,24,23,1,11,,8,6,2,13,4,0,4,2,2,,,
"Apr 21, 2022 10:00 PM",44,9,35,9,8,1,14,6,8,13,5,8,3,1,2,7,10,6,4,26,25,1,5,,5,3,2,6,1,2,1,0,1,,,
"Apr 21, 2022 11:00 PM",28,6,22,4,3,1,8,4,4,6,4,2,3,0,3,2,5,4,1,16,13,3,4,,2,1,1,6,0,0,1,1,0,,,
"Apr 22, 2022 12:00 AM",19,4,15,0,0,0,1,1,0,0,0,0,3,2,1,2,4,3,1,5,5,0,2,,2,2,0,2,0,0,1,0,1,,,
"Apr 22, 2022 1:00 AM",4,0,4,1,1,0,0,0,0,0,0,0,2,0,2,0,0,0,0,4,4,0,0,,0,0,0,0,0,0,0,0,0,,,
"Apr 22, 2022 2:00 AM",1,0,1,1,0,1,0,0,0,1,0,1,0,0,0,1,0,0,0,3,3,0,0,,0,0,0,0,0,0,0,0,0,,,
"Apr 22, 2022 3:00 AM",3,0,3,0,0,0,0,0,0,0,0,0,0,0,0,0,0,0,0,0,0,0,1,,0,0,0,1,0,0,0,0,0,,,
"Apr 22, 2022 4:00 AM",4,2,2,1,0,1,2,1,1,2,0,2,0,0,0,0,1,1,0,0,0,0,1,2,0,0,0,2,0,0,0,0,0,,,
"Apr 22, 2022 5:00 AM",9,8,1,1,1,0,5,3,2,5,3,2,0,0,0,1,9,9,0,0,0,0,9,4,0,0,0,13,0,0,0,0,0,,,
"Apr 22, 2022 6:00 AM",45,30,15,15,6,9,19,9,10,16,7,9,0,0,0,2,13,12,1,12,9,3,13,14,12,8,4,26,0,2,0,0,0,,,
"Apr 22, 2022 7:00 AM",98,73,25,54,27,27,61,29,32,52,25,27,7,5,2,8,59,59,0,16,12,4,57,29,25,9,16,63,2,1,2,2,0,,,
"Apr 22, 2022 8:00 AM",179,138,41,64,20,44,125,45,80,86,37,49,13,10,3,12,102,100,2,18,12,6,94,41,49,20,29,130,3,3,5,5,0,,,
"Apr 22, 2022 9:00 AM",103,90,13,56,22,34,64,31,33,52,31,21,20,11,9,10,60,60,0,17,15,2,54,16,38,18,20,46,5,4,6,2,4,,,
"Apr 22, 2022 10:00 AM",77,48,29,52,29,23,59,33,26,41,26,15,11,8,3,12,48,46,2,8,4,4,34,19,28,20,8,25,5,3,8,7,1,,,
"Apr 22, 2022 11:00 AM",57,31,26,29,7,22,31,9,22,31,10,21,19,12,7,16,20,18,2,12,9,3,21,10,15,6,9,24,5,2,3,2,1,,,
"Apr 22, 2022 12:00 PM",71,41,30,45,23,22,63,39,24,48,29,19,11,6,5,14,23,20,3,20,19,1,11,25,26,15,11,24,2,3,2,1,1,,,
"Apr 22, 2022 1:00 PM",111,50,61,39,22,17,55,29,26,41,24,17,19,4,15,18,23,23,0,18,18,0,17,18,32,19,13,28,2,2,4,2,2,,,
"Apr 22, 2022 2:00 PM",86,43,43,30,13,17,38,18,20,39,18,21,13,6,7,18,28,26,2,22,20,2,27,27,26,15,11,24,4,0,5,2,3,,,
"Apr 22, 2022 3:00 PM",95,39,56,47,33,14,67,42,25,48,32,16,13,4,9,6,33,27,6,20,19,1,27,33,33,23,10,20,3,0,7,4,3,,,
"Apr 22, 2022 4:00 PM",105,33,72,72,49,23,98,62,36,57,33,24,22,17,5,30,32,23,9,43,39,4,21,47,54,36,18,37,3,6,8,5,3,,,
"Apr 22, 2022 5:00 PM",186,54,132,92,53,39,136,86,50,82,49,33,22,9,13,32,28,22,6,58,57,1,28,80,52,33,19,64,7,3,5,5,0,,,
"Apr 22, 2022 6:00 PM",122,37,85,89,41,48,110,57,53,95,50,45,11,2,9,18,25,20,5,54,53,1,19,65,48,25,23,40,7,2,6,2,4,,,
"Apr 22, 2022 7:00 PM",111,42,69,46,27,19,67,32,35,58,28,30,8,1,7,11,27,19,8,28,25,3,21,34,23,11,12,35,6,2,9,7,2,,,
"Apr 22, 2022 8:00 PM",56,11,45,36,19,17,40,19,21,27,16,11,5,2,3,16,22,19,3,21,20,1,17,27,21,8,13,24,3,1,5,3,2,,,
"Apr 22, 2022 9:00 PM",52,16,36,15,10,5,14,6,8,19,8,11,3,2,1,5,14,13,1,13,10,3,10,10,6,4,2,10,2,1,6,4,2,,,
"Apr 22, 2022 10:00 PM",53,15,38,8,5,3,16,8,8,12,2,10,6,4,2,2,12,8,4,8,8,0,5,6,4,3,1,7,2,2,0,0,0,,,
"Apr 22, 2022 11:00 PM",29,7,22,3,3,0,5,3,2,4,2,2,2,2,0,1,3,3,0,13,13,0,3,4,2,1,1,5,2,1,0,0,0,,,
"Apr 23, 2022 12:00 AM",15,6,9,0,0,0,5,2,3,4,2,2,4,3,1,1,8,6,2,4,4,0,6,,2,2,0,4,0,0,0,0,0,,,
"Apr 23, 2022 1:00 AM",15,4,11,1,1,0,2,2,0,0,0,0,2,1,1,2,2,2,0,4,4,0,1,,1,1,0,2,0,0,1,1,0,,,
"Apr 23, 2022 2:00 AM",7,2,5,0,0,0,2,2,0,1,1,0,0,0,0,0,1,1,0,3,3,0,1,,3,1,2,0,1,1,3,2,1,,,
"Apr 23, 2022 3:00 AM",5,0,5,0,0,0,0,0,0,1,1,0,0,0,0,1,0,0,0,0,0,0,1,,1,0,1,0,0,0,1,1,0,,,
"Apr 23, 2022 4:00 AM",3,1,2,0,0,0,1,1,0,1,1,0,1,1,0,1,0,0,0,1,1,0,0,,0,0,0,0,0,0,0,0,0,,,
"Apr 23, 2022 5:00 AM",2,0,2,0,0,0,5,4,1,2,1,1,0,0,0,1,5,1,4,2,2,0,1,,0,0,0,4,0,0,0,0,0,,,
"Apr 23, 2022 6:00 AM",21,12,9,4,3,1,12,9,3,6,5,1,0,0,0,0,6,5,1,5,5,0,6,,3,3,0,5,0,0,0,0,0,,,
"Apr 23, 2022 7:00 AM",24,15,9,29,15,14,32,17,15,26,17,9,4,2,2,3,12,12,0,7,7,0,13,,10,8,2,14,0,4,1,1,0,,,
"Apr 23, 2022 8:00 AM",43,22,21,68,49,19,73,52,21,58,46,12,10,8,2,11,12,12,0,5,3,2,12,,18,14,4,21,2,6,1,0,1,,,
"Apr 23, 2022 9:00 AM",38,18,20,87,53,34,77,52,25,75,57,18,19,5,14,7,26,25,1,15,12,3,22,,35,24,11,34,4,4,2,1,1,,,
"Apr 23, 2022 10:00 AM",50,25,25,113,65,48,97,56,41,92,57,35,14,5,9,19,24,21,3,19,16,3,21,,45,35,10,25,10,3,7,7,0,,,
"Apr 23, 2022 11:00 AM",53,27,26,111,56,55,100,58,42,92,60,32,23,12,11,35,17,14,3,15,14,1,16,,63,40,23,37,10,7,8,6,2,,,
"Apr 23, 2022 12:00 PM",83,45,38,147,45,102,120,59,61,111,50,61,28,16,12,15,24,20,4,16,14,2,18,,54,26,28,42,12,1,9,5,4,,,
"Apr 23, 2022 1:00 PM",63,35,28,96,52,44,105,47,58,98,48,50,33,13,20,28,31,29,2,21,19,2,28,,40,20,20,42,7,1,6,4,2,,,
"Apr 23, 2022 2:00 PM",69,42,27,97,42,55,96,39,57,85,43,42,17,10,7,28,21,21,0,19,17,2,21,,41,14,27,33,8,1,11,7,4,,,
"Apr 23, 2022 3:00 PM",46,24,22,56,36,20,80,43,37,72,37,35,14,7,7,8,19,16,3,13,12,1,13,,37,22,15,37,5,3,5,3,2,,,
"Apr 23, 2022 4:00 PM",58,33,25,69,42,27,75,36,39,62,28,34,20,9,11,9,18,17,1,11,9,2,15,,32,12,20,34,4,2,6,0,6,,,
"Apr 23, 2022 5:00 PM",58,24,34,42,28,14,73,27,46,47,20,27,7,3,4,22,15,14,1,7,7,0,12,,22,11,11,26,14,2,13,9,4,,,
"Apr 23, 2022 6:00 PM",60,23,37,26,6,20,48,18,30,30,7,23,12,5,7,13,20,17,3,11,10,1,15,,20,11,9,18,2,2,6,3,3,,,
"Apr 23, 2022 7:00 PM",55,25,30,20,15,5,34,23,11,34,25,9,1,1,0,20,7,6,1,13,9,4,8,,15,11,4,14,0,1,2,1,1,,,
"Apr 23, 2022 8:00 PM",44,12,32,17,7,10,28,8,20,15,5,10,10,6,4,5,9,8,1,11,11,0,9,,10,4,6,16,0,1,3,2,1,,,
"Apr 23, 2022 9:00 PM",32,12,20,6,3,3,12,4,8,9,3,6,2,2,0,3,3,3,0,9,9,0,4,,6,4,2,5,0,2,0,0,0,,,
"Apr 23, 2022 10:00 PM",29,9,20,2,0,2,3,0,3,2,0,2,1,1,0,1,8,8,0,3,3,0,8,,5,2,3,3,0,1,1,1,0,,,
"Apr 23, 2022 11:00 PM",15,4,11,5,4,1,9,6,3,6,3,3,1,0,1,2,2,1,1,5,4,1,1,,1,1,0,1,0,1,2,2,0,,,
"Apr 24, 2022 12:00 AM",11,7,4,0,0,0,3,1,2,11,6,5,1,1,0,2,1,1,0,4,4,0,1,,6,4,2,1,0,0,0,0,0,,,
"Apr 24, 2022 1:00 AM",9,4,5,0,0,0,12,7,5,4,2,2,3,0,3,0,0,0,0,4,4,0,0,,1,1,0,6,0,0,3,3,0,,,
"Apr 24, 2022 2:00 AM",6,2,4,0,0,0,10,4,6,1,0,1,0,0,0,3,2,1,1,2,2,0,1,,0,0,0,1,0,0,0,0,0,,,
"Apr 24, 2022 3:00 AM",4,2,2,0,0,0,1,0,1,1,0,1,0,0,0,0,0,0,0,0,0,0,0,,1,1,0,3,0,0,0,0,0,,,
"Apr 24, 2022 4:00 AM",4,1,3,0,0,0,0,0,0,0,0,0,0,0,0,0,1,1,0,1,1,0,1,,0,0,0,0,0,1,0,0,0,,,
"Apr 24, 2022 5:00 AM",1,1,0,4,3,1,4,4,0,5,5,0,0,0,0,0,0,0,0,0,0,0,0,,1,1,0,3,0,1,1,0,1,,,
"Apr 24, 2022 6:00 AM",11,6,5,6,5,1,12,7,5,11,7,4,1,0,1,0,6,5,1,1,1,0,7,,7,7,0,8,1,2,0,0,0,,,
"Apr 24, 2022 7:00 AM",22,11,11,22,8,14,34,16,18,22,11,11,0,0,0,9,15,14,1,5,5,0,15,,14,6,8,14,3,3,3,3,0,,,
"Apr 24, 2022 8:00 AM",50,16,34,70,41,29,64,34,30,72,45,27,4,2,2,4,15,15,0,7,5,2,15,,34,21,13,28,2,19,2,2,0,,,
"Apr 24, 2022 9:00 AM",51,21,30,88,62,26,128,86,42,95,72,23,8,1,7,9,22,22,0,9,7,2,18,,49,38,11,30,5,8,2,2,0,,,
"Apr 24, 2022 10:00 AM",75,56,19,166,89,77,157,88,69,128,70,58,10,5,5,16,33,32,1,13,9,4,30,,57,39,18,60,8,6,4,3,1,,,
"Apr 24, 2022 11:00 AM",66,44,22,180,100,80,163,89,74,140,80,60,26,20,6,24,17,17,0,15,14,1,14,,47,31,16,42,17,10,6,4,2,,,
"Apr 24, 2022 12:00 PM",67,39,28,137,59,78,123,63,60,129,65,64,15,5,10,19,27,23,4,12,10,2,17,,52,33,19,44,15,2,4,3,1,,,
"Apr 24, 2022 1:00 PM",94,45,49,139,64,75,150,77,73,121,66,55,26,21,5,18,30,30,0,29,26,3,27,,53,39,14,32,9,6,6,4,2,,,
"Apr 24, 2022 2:00 PM",62,32,30,147,76,71,139,77,62,136,65,71,22,12,10,14,17,16,1,13,12,1,17,,73,54,19,24,6,2,8,4,4,,,
"Apr 24, 2022 3:00 PM",67,31,36,144,69,75,146,85,61,123,71,52,23,11,12,31,20,19,1,17,11,6,11,,63,32,31,29,3,5,12,7,5,,,
"Apr 24, 2022 4:00 PM",65,35,30,136,73,63,139,68,71,113,61,52,38,25,13,23,19,18,1,17,15,2,22,,64,32,32,37,4,2,8,3,5,,,
"Apr 24, 2022 5:00 PM",68,34,34,109,56,53,111,47,64,99,42,57,29,7,22,21,20,20,0,13,12,1,17,,47,22,25,38,6,2,12,8,4,,,
"Apr 24, 2022 6:00 PM",65,23,42,57,22,35,86,39,47,54,24,30,14,6,8,23,34,33,1,17,16,1,24,,38,18,20,38,0,3,6,4,2,,,
"Apr 24, 2022 7:00 PM",70,31,39,47,25,22,58,22,36,46,27,19,18,11,7,6,14,14,0,11,11,0,12,,25,8,17,32,4,3,4,4,0,,,
"Apr 24, 2022 8:00 PM",44,20,24,26,8,18,40,17,23,22,3,19,6,2,4,9,22,15,7,19,18,1,14,,16,9,7,21,1,1,2,1,1,,,
"Apr 24, 2022 9:00 PM",44,14,30,13,10,3,27,14,13,20,9,11,3,2,1,5,14,14,0,14,13,1,16,,9,5,4,13,1,0,1,0,1,,,
"Apr 24, 2022 10:00 PM",30,10,20,9,4,5,14,4,10,11,5,6,0,0,0,2,6,6,0,4,4,0,6,,8,3,5,5,0,3,2,1,1,,,
"Apr 24, 2022 11:00 PM",7,3,4,1,1,0,6,4,2,4,2,2,1,1,0,0,5,3,2,3,3,0,3,,4,3,1,6,1,0,3,2,1,,,
"Apr 25, 2022 12:00 AM",3,1,2,0,0,0,2,2,0,2,1,1,2,0,2,0,0,0,0,4,4,0,0,,1,1,0,1,0,0,1,1,0,,,
"Apr 25, 2022 1:00 AM",2,1,1,0,0,0,0,0,0,0,0,0,0,0,0,0,2,1,1,1,1,0,1,,0,0,0,0,0,0,0,0,0,,,
"Apr 25, 2022 2:00 AM",2,0,2,0,0,0,0,0,0,0,0,0,0,0,0,0,0,0,0,0,0,0,0,,0,0,0,0,0,0,1,0,1,,,
"Apr 25, 2022 3:00 AM",1,0,1,0,0,0,1,1,0,1,1,0,1,1,0,0,0,0,0,0,0,0,0,,0,0,0,0,0,0,0,0,0,,,
"Apr 25, 2022 4:00 AM",1,0,1,0,0,0,1,1,0,1,1,0,0,0,0,0,1,1,0,0,0,0,1,,0,0,0,0,0,0,1,1,0,,,
"Apr 25, 2022 5:00 AM",6,5,1,1,1,0,2,1,1,1,1,0,0,0,0,2,8,7,1,0,0,0,9,,0,0,0,10,0,0,1,1,0,,,
"Apr 25, 2022 6:00 AM",52,34,18,22,5,17,26,10,16,21,6,15,2,2,0,3,28,27,1,5,4,1,27,,10,4,6,37,0,5,1,1,0,,,
"Apr 25, 2022 7:00 AM",139,91,48,63,20,43,94,31,63,66,26,40,15,9,6,16,67,67,0,16,12,4,67,,53,24,29,117,4,6,10,8,2,,,
"Apr 25, 2022 8:00 AM",249,189,60,72,29,43,145,48,97,100,41,59,41,28,13,34,152,150,2,45,36,9,141,,81,26,55,196,12,4,12,9,3,,,
"Apr 25, 2022 9:00 AM",142,120,22,41,12,29,90,49,41,58,34,24,16,13,3,6,63,62,1,17,13,4,51,,40,20,20,62,1,2,4,2,2,,,
"Apr 25, 2022 10:00 AM",64,51,13,44,15,29,83,37,46,51,25,26,14,8,6,10,37,36,1,13,8,5,34,,34,21,13,29,3,3,3,3,0,,,
"Apr 25, 2022 11:00 AM",49,32,17,54,38,16,58,29,29,47,32,15,19,12,7,10,25,22,3,6,5,1,25,,14,5,9,26,3,1,2,2,0,,,
"Apr 25, 2022 12:00 PM",64,37,27,58,26,32,61,23,38,44,20,24,19,9,10,9,24,24,0,17,16,1,21,,22,12,10,28,3,2,4,4,0,,,
"Apr 25, 2022 1:00 PM",80,37,43,59,35,24,56,38,18,50,32,18,15,8,7,13,24,21,3,27,24,3,20,,27,18,9,28,4,3,3,1,2,,,
"Apr 25, 2022 2:00 PM",62,33,29,54,33,21,62,41,21,52,33,19,22,7,15,19,30,28,2,18,17,1,27,,28,17,11,27,2,7,6,5,1,,,
"Apr 25, 2022 3:00 PM",94,39,55,63,34,29,79,45,34,55,33,22,17,10,7,18,34,32,2,33,28,5,25,,27,15,12,40,6,4,14,10,4,,,
"Apr 25, 2022 4:00 PM",156,51,105,82,46,36,88,55,33,82,50,32,27,11,16,18,28,25,3,44,36,8,27,,43,27,16,33,3,2,17,8,9,,,
"Apr 25, 2022 5:00 PM",234,63,171,68,39,29,138,72,66,119,60,59,33,13,20,27,48,45,3,107,104,3,41,,75,53,22,75,2,4,8,4,4,,,
"Apr 25, 2022 6:00 PM",202,53,149,120,79,41,162,122,40,120,77,43,23,8,15,26,32,29,3,92,89,3,27,,75,34,41,51,17,4,12,2,10,,,
"Apr 25, 2022 7:00 PM",112,41,71,84,42,42,115,70,45,90,58,32,13,4,9,15,34,33,1,50,50,0,27,,49,35,14,36,6,5,4,3,1,,,
"Apr 25, 2022 8:00 PM",83,25,58,52,25,27,64,32,32,59,24,35,11,5,6,9,18,14,4,29,29,0,12,,20,11,9,25,3,2,4,2,2,,,
"Apr 25, 2022 9:00 PM",59,15,44,13,10,3,38,11,27,26,8,18,3,1,2,8,7,4,3,24,24,0,6,,16,10,6,24,5,0,2,2,0,,,
"Apr 25, 2022 10:00 PM",47,12,35,5,3,2,11,3,8,12,0,12,1,1,0,4,9,5,4,13,13,0,6,,6,4,2,9,1,1,4,2,2,,,
"Apr 25, 2022 11:00 PM",9,2,7,3,3,0,2,2,0,1,1,0,0,0,0,1,3,1,2,5,5,0,1,,2,1,1,1,1,0,0,0,0,,,
"Apr 26, 2022 12:00 AM",13,3,10,0,0,0,2,2,0,1,1,0,0,0,0,0,3,2,1,6,3,3,1,,1,1,0,3,0,1,0,0,0,,,
"Apr 26, 2022 1:00 AM",3,3,0,0,0,0,0,0,0,0,0,0,0,0,0,0,0,0,0,1,1,0,0,,0,0,0,1,0,0,2,2,0,,,
"Apr 26, 2022 2:00 AM",3,1,2,0,0,0,0,0,0,0,0,0,0,0,0,0,1,1,0,0,0,0,1,,0,0,0,0,0,0,1,0,1,,,
"Apr 26, 2022 3:00 AM",3,2,1,0,0,0,0,0,0,0,0,0,0,0,0,0,0,0,0,0,0,0,0,,0,0,0,0,0,0,0,0,0,,,
"Apr 26, 2022 4:00 AM",4,2,2,0,0,0,1,1,0,1,1,0,0,0,0,0,2,2,0,2,2,0,2,,0,0,0,0,0,0,1,1,0,,,
"Apr 26, 2022 5:00 AM",10,9,1,0,0,0,6,4,2,6,5,1,0,0,0,1,8,8,0,1,1,0,9,,0,0,0,13,0,0,0,0,0,,,
"Apr 26, 2022 6:00 AM",47,29,18,34,15,19,31,14,17,22,8,14,3,2,1,5,26,25,1,13,9,4,21,,19,9,10,45,1,4,1,1,0,,,
"Apr 26, 2022 7:00 AM",151,101,50,54,11,43,108,23,85,63,14,49,16,15,1,21,81,81,0,22,19,3,86,,41,13,28,107,4,8,6,5,1,,,
"Apr 26, 2022 8:00 AM",294,215,79,113,38,75,174,54,120,130,54,76,41,27,14,30,161,159,2,60,45,15,147,,111,36,75,225,7,6,16,14,2,,,
"Apr 26, 2022 9:00 AM",141,115,26,64,23,41,97,43,54,74,39,35,21,15,6,24,78,78,0,19,17,2,66,,52,22,30,77,4,6,8,5,3,,,
"Apr 26, 2022 10:00 AM",75,60,15,47,23,24,62,33,29,40,21,19,6,3,3,10,38,37,1,11,8,3,32,,27,12,15,26,5,3,3,2,1,,,
"Apr 26, 2022 11:00 AM",65,44,21,46,27,19,67,32,35,48,27,21,9,4,5,7,20,20,0,10,8,2,19,,23,15,8,28,6,7,7,6,1,,,
"Apr 26, 2022 12:00 PM",70,40,30,52,17,35,62,29,33,38,18,20,12,6,6,11,22,22,0,17,12,5,20,,18,5,13,30,3,6,3,2,1,,,
"Apr 26, 2022 1:00 PM",78,39,39,62,43,19,80,44,36,60,35,25,14,5,9,9,29,27,2,21,17,4,23,,23,14,9,28,4,3,5,4,1,,,
"Apr 26, 2022 2:00 PM",70,27,43,54,27,27,52,28,24,51,25,26,16,10,6,14,28,26,2,33,28,5,24,,38,21,17,17,8,6,7,5,2,,,
"Apr 26, 2022 3:00 PM",92,41,51,33,18,15,62,34,28,43,22,21,16,6,10,17,29,26,3,31,24,7,24,,38,21,17,26,5,1,8,6,2,,,
"Apr 26, 2022 4:00 PM",149,57,92,73,42,31,90,53,37,76,45,31,23,5,18,21,36,32,4,60,54,6,33,,44,35,9,31,10,1,9,7,2,,,
"Apr 26, 2022 5:00 PM",235,61,174,83,52,31,134,85,49,105,63,42,24,10,14,32,53,44,9,110,106,4,47,,84,36,48,68,10,8,12,8,4,,,
"Apr 26, 2022 6:00 PM",228,65,163,121,83,38,185,137,48,142,100,42,23,4,19,17,50,46,4,90,86,4,43,,90,36,54,50,7,5,9,6,3,,,
"Apr 26, 2022 7:00 PM",164,52,112,91,51,40,140,78,62,89,54,35,24,13,11,21,26,23,3,65,63,2,17,,42,31,11,40,11,4,10,5,5,,,
"Apr 26, 2022 8:00 PM",103,35,68,32,20,12,54,26,28,50,30,20,7,2,5,18,18,16,2,36,34,2,16,,39,16,23,26,4,7,4,1,3,,,
"Apr 26, 2022 9:00 PM",83,22,61,36,25,11,43,22,21,36,18,18,1,1,0,8,14,12,2,23,22,1,12,,8,4,4,22,4,1,5,5,0,,,
"Apr 26, 2022 10:00 PM",43,12,31,15,10,5,17,10,7,15,6,9,6,0,6,4,11,8,3,19,18,1,7,,11,6,5,12,0,2,4,1,3,,,
"Apr 26, 2022 11:00 PM",13,5,8,2,1,1,10,6,4,6,2,4,0,0,0,0,4,1,3,7,7,0,1,,7,5,2,2,1,0,1,1,0,,,
"Apr 27, 2022 12:00 AM",10,1,9,0,0,0,1,0,1,1,1,0,0,0,0,0,3,1,2,8,8,0,1,,1,1,0,4,0,0,1,0,1,,,
"Apr 27, 2022 1:00 AM",4,1,3,0,0,0,1,1,0,0,0,0,0,0,0,0,1,0,1,1,1,0,0,,0,0,0,0,0,1,0,0,0,,,
"Apr 27, 2022 2:00 AM",5,4,1,0,0,0,0,0,0,0,0,0,0,0,0,0,1,1,0,0,0,0,1,,0,0,0,0,0,0,1,1,0,,,
"Apr 27, 2022 3:00 AM",2,0,2,3,3,0,0,0,0,0,0,0,0,0,0,0,0,0,0,1,1,0,1,,0,0,0,0,0,0,0,0,0,,,
"Apr 27, 2022 4:00 AM",3,1,2,1,0,1,2,1,1,2,1,1,0,0,0,0,1,1,0,0,0,0,4,,0,0,0,2,0,0,0,0,0,,,
"Apr 27, 2022 5:00 AM",7,7,0,2,1,1,4,2,2,5,1,4,0,0,0,1,7,7,0,1,1,0,7,,0,0,0,13,0,2,0,0,0,,,
"Apr 27, 2022 6:00 AM",53,38,15,19,7,12,28,12,16,22,8,14,1,1,0,8,23,23,0,13,11,2,22,,14,8,6,37,1,3,3,3,0,,,
"Apr 27, 2022 7:00 AM",139,90,49,71,22,49,111,32,79,72,24,48,13,11,2,12,88,86,2,18,14,4,81,,49,19,30,122,8,4,6,6,0,,,
"Apr 27, 2022 8:00 AM",322,242,80,114,32,82,180,60,120,135,50,85,41,26,15,38,183,178,5,50,38,12,185,,95,34,61,248,3,8,15,12,3,,,
"Apr 27, 2022 9:00 AM",123,95,28,75,38,37,127,58,69,77,49,28,14,8,6,11,95,95,0,25,13,12,81,,58,24,34,72,4,4,3,1,2,,,
"Apr 27, 2022 10:00 AM",75,56,19,67,27,40,74,40,34,54,30,24,9,5,4,7,28,26,2,13,12,1,22,,20,12,8,40,5,5,3,2,1,,,
"Apr 27, 2022 11:00 AM",80,51,29,45,28,17,58,31,27,45,24,21,10,4,6,10,21,20,1,10,8,2,18,,26,17,9,22,1,6,0,0,0,,,
"Apr 27, 2022 12:00 PM",69,35,34,51,28,23,54,30,24,49,29,20,20,8,12,12,27,27,0,14,14,0,21,,24,11,13,19,9,2,8,5,3,,,
"Apr 27, 2022 1:00 PM",85,41,44,69,44,25,77,48,29,70,49,21,25,15,10,18,31,29,2,30,22,8,26,,30,20,10,40,5,2,9,4,5,,,
"Apr 27, 2022 2:00 PM",92,34,58,44,23,21,53,26,27,43,23,20,27,20,7,10,20,20,0,29,25,4,24,,35,17,18,34,3,5,6,4,2,,,
"Apr 27, 2022 3:00 PM",91,44,47,50,26,24,60,33,27,59,30,29,10,3,7,13,22,18,4,46,35,11,14,,23,17,6,35,7,1,8,7,1,,,
"Apr 27, 2022 4:00 PM",162,51,111,63,36,27,80,54,26,56,35,21,16,5,11,19,41,38,3,51,48,3,35,,36,27,9,44,9,6,8,3,5,,,
"Apr 27, 2022 5:00 PM",215,67,148,76,50,26,121,84,37,88,54,34,30,12,18,32,37,32,5,100,96,4,32,,67,36,31,71,6,8,4,3,1,,,
"Apr 27, 2022 6:00 PM",247,64,183,94,64,30,164,122,42,115,75,40,18,6,12,24,46,36,10,118,115,3,39,,90,59,31,52,13,4,8,5,3,,,
"Apr 27, 2022 7:00 PM",143,40,103,91,50,41,137,79,58,109,70,39,12,2,10,22,27,26,1,57,52,5,21,,61,44,17,41,6,7,16,7,9,,,
"Apr 27, 2022 8:00 PM",85,32,53,37,19,18,62,33,29,39,18,21,13,7,6,17,17,13,4,34,30,4,13,,30,14,16,24,11,3,5,3,2,,,
"Apr 27, 2022 9:00 PM",74,19,55,13,7,6,26,13,13,21,9,12,7,3,4,8,17,15,2,25,24,1,14,,14,9,5,15,5,1,5,3,2,,,
"Apr 27, 2022 10:00 PM",40,7,33,9,6,3,16,9,7,18,8,10,3,0,3,3,10,9,1,14,13,1,11,,3,3,0,13,0,1,3,1,2,,,
"Apr 27, 2022 11:00 PM",15,2,13,5,3,2,9,5,4,12,5,7,1,1,0,0,4,1,3,10,10,0,2,,2,2,0,7,1,0,5,1,4,,,
"Apr 28, 2022 12:00 AM",14,4,10,0,0,0,1,1,0,6,3,3,1,1,0,1,3,3,0,3,3,0,3,,1,1,0,3,1,0,0,0,0,,,
"Apr 28, 2022 1:00 AM",0,0,0,5,4,1,1,0,1,1,0,1,0,0,0,0,0,0,0,0,0,0,0,,0,0,0,0,0,0,0,0,0,,,
"Apr 28, 2022 2:00 AM",5,4,1,1,0,1,0,0,0,0,0,0,0,0,0,0,0,0,0,0,0,0,0,,0,0,0,1,0,0,0,0,0,,,
"Apr 28, 2022 3:00 AM",2,1,1,0,0,0,0,0,0,0,0,0,0,0,0,0,0,0,0,0,0,0,0,,0,0,0,0,0,0,0,0,0,,,
"Apr 28, 2022 4:00 AM",1,0,1,0,0,0,1,1,0,1,1,0,0,0,0,0,2,2,0,1,1,0,2,,1,0,1,1,0,0,0,0,0,,,
"Apr 28, 2022 5:00 AM",7,5,2,1,0,1,4,2,2,1,0,1,0,0,0,2,6,6,0,0,0,0,6,,0,0,0,6,0,1,0,0,0,,,
"Apr 28, 2022 6:00 AM",53,37,16,22,9,13,27,11,16,21,12,9,1,1,0,4,22,22,0,12,11,1,21,,14,5,9,27,1,6,2,2,0,,,
"Apr 28, 2022 7:00 AM",129,98,31,63,21,42,107,29,78,71,24,47,9,7,2,19,61,61,0,17,14,3,62,,52,14,38,108,3,3,9,6,3,,,
"Apr 28, 2022 8:00 AM",284,199,85,98,28,70,171,50,121,120,51,69,34,21,13,23,165,164,1,56,40,16,151,,84,32,52,206,7,9,22,18,4,,,
"Apr 28, 2022 9:00 AM",150,122,28,50,18,32,93,45,48,69,33,36,11,10,1,11,76,76,0,26,21,5,67,,40,16,24,75,1,5,3,2,1,,,
"Apr 28, 2022 10:00 AM",57,42,15,37,21,16,72,42,30,38,24,14,17,10,7,7,41,41,0,13,10,3,40,,30,19,11,27,2,4,1,0,1,,,
"Apr 28, 2022 11:00 AM",51,31,20,28,15,13,65,32,33,39,14,25,12,6,6,10,27,25,2,19,15,4,21,,24,15,9,25,2,2,6,4,2,,,
"Apr 28, 2022 12:00 PM",69,37,32,63,32,31,77,43,34,50,29,21,20,11,9,13,26,23,3,18,16,2,20,,31,17,14,27,8,2,7,5,2,,,
"Apr 28, 2022 1:00 PM",73,37,36,49,23,26,65,26,39,46,21,25,12,5,7,12,30,26,4,23,16,7,17,,32,11,21,29,11,1,9,8,1,,,
"Apr 28, 2022 2:00 PM",78,36,42,43,25,18,42,26,16,39,26,13,19,12,7,10,18,16,2,19,16,3,14,,29,22,7,38,5,5,7,1,6,,,
"Apr 28, 2022 3:00 PM",74,31,43,31,15,16,63,39,24,35,22,13,15,7,8,18,31,29,2,34,31,3,25,,23,18,5,29,2,0,8,6,2,,,
"Apr 28, 2022 4:00 PM",145,44,101,82,47,35,107,79,28,83,53,30,22,11,11,26,42,35,7,49,44,5,30,,51,32,19,38,7,5,13,9,4,,,
"Apr 28, 2022 5:00 PM",210,65,145,120,57,63,139,101,38,115,83,32,26,12,14,45,45,43,2,95,92,3,49,,62,34,28,69,6,5,8,6,2,,,
"Apr 28, 2022 6:00 PM",197,60,137,112,74,38,142,107,35,112,76,36,24,10,14,24,43,35,8,77,73,4,35,,66,25,41,57,5,6,7,5,2,,,
"Apr 28, 2022 7:00 PM",137,51,86,60,32,28,101,61,40,85,50,35,11,4,7,28,17,16,1,44,40,4,18,,33,23,10,46,4,2,12,6,6,,,
"Apr 28, 2022 8:00 PM",90,33,57,53,30,23,66,34,32,58,25,33,9,4,5,11,17,13,4,30,27,3,13,,23,13,10,22,4,5,3,1,2,,,
"Apr 28, 2022 9:00 PM",56,12,44,41,32,9,41,14,27,34,9,25,13,3,10,6,19,18,1,27,25,2,18,,11,4,7,18,3,2,4,2,2,,,
"Apr 28, 2022 10:00 PM",45,9,36,23,20,3,23,7,16,23,6,17,4,2,2,4,14,10,4,20,18,2,11,,9,3,6,12,0,3,2,1,1,,,
"Apr 28, 2022 11:00 PM",29,4,25,10,9,1,14,4,10,11,1,10,3,0,3,3,5,2,3,14,14,0,6,,2,2,0,10,0,0,4,2,2,,,
"Apr 29, 2022 12:00 AM",14,6,8,0,0,0,1,0,1,6,2,4,2,1,1,0,3,2,1,6,6,0,3,,0,0,0,7,0,0,1,0,1,,,
"Apr 29, 2022 1:00 AM",9,2,7,1,1,0,2,1,1,1,0,1,3,1,2,0,2,1,1,4,4,0,2,,1,1,0,0,0,0,0,0,0,,,
"Apr 29, 2022 2:00 AM",5,4,1,0,0,0,0,0,0,0,0,0,0,0,0,0,3,3,0,1,1,0,3,,0,0,0,1,0,0,0,0,0,,,
"Apr 29, 2022 3:00 AM",0,0,0,0,0,0,1,1,0,0,0,0,0,0,0,0,0,0,0,0,0,0,0,,1,1,0,0,0,0,0,0,0,,,
"Apr 29, 2022 4:00 AM",4,0,4,1,0,1,3,2,1,2,1,1,0,0,0,0,1,1,0,2,2,0,1,,0,0,0,1,0,0,0,0,0,,,
"Apr 29, 2022 5:00 AM",9,9,0,4,3,1,6,4,2,6,4,2,0,0,0,1,6,6,0,1,1,0,5,,1,0,1,8,0,0,0,0,0,,,
"Apr 29, 2022 6:00 AM",45,26,19,12,5,7,26,14,12,17,9,8,2,2,0,7,14,12,2,10,8,2,14,,8,6,2,25,1,2,2,2,0,,,
"Apr 29, 2022 7:00 AM",109,77,32,72,32,40,67,25,42,50,18,32,12,11,1,10,66,66,0,14,11,3,64,,22,10,12,88,2,2,4,3,1,,,
"Apr 29, 2022 8:00 AM",185,137,48,101,35,66,143,53,90,104,41,63,30,17,13,27,93,92,1,36,26,10,95,,83,35,48,132,10,5,20,18,2,,,
"Apr 29, 2022 9:00 AM",117,85,32,57,25,32,77,40,37,59,35,24,17,13,4,12,64,63,1,19,14,5,55,,35,13,22,53,2,2,4,2,2,,,
"Apr 29, 2022 10:00 AM",78,50,28,51,23,28,83,41,42,40,22,18,12,3,9,6,36,34,2,10,7,3,31,,30,16,14,42,2,2,3,2,1,,,
"Apr 29, 2022 11:00 AM",55,25,30,48,26,22,79,44,35,50,29,21,15,7,8,12,21,20,1,12,10,2,19,,32,13,19,23,6,9,8,4,4,,,
"Apr 29, 2022 12:00 PM",64,29,35,67,39,28,90,47,43,55,30,25,24,13,11,14,23,21,2,18,14,4,16,,35,21,14,26,7,5,7,6,1,,,
"Apr 29, 2022 1:00 PM",89,37,52,41,20,21,102,48,54,44,26,18,31,10,21,9,36,33,3,22,20,2,28,,44,30,14,45,7,1,6,3,3,,,
"Apr 29, 2022 2:00 PM",83,46,37,50,24,26,63,31,32,52,25,27,11,6,5,12,24,22,2,23,20,3,24,,53,45,8,33,10,4,6,4,2,,,
"Apr 29, 2022 3:00 PM",99,42,57,53,33,20,86,44,42,46,26,20,26,14,12,29,24,22,2,28,26,2,20,,30,22,8,25,7,1,6,6,0,,,
"Apr 29, 2022 4:00 PM",131,48,83,85,48,37,88,57,31,80,52,28,29,6,23,19,38,36,2,44,40,4,31,,45,31,14,36,3,7,11,4,7,,,
"Apr 29, 2022 5:00 PM",197,61,136,101,46,55,91,54,37,74,43,31,21,8,13,24,24,22,2,55,51,4,25,,48,34,14,68,9,3,10,7,3,,,
"Apr 29, 2022 6:00 PM",136,50,86,64,37,27,85,57,28,71,44,27,12,6,6,13,28,24,4,62,59,3,25,,46,30,16,33,5,3,7,5,2,,,
"Apr 29, 2022 7:00 PM",75,27,48,46,25,21,55,35,20,46,32,14,9,2,7,11,23,19,4,35,33,2,18,,40,31,9,28,5,2,6,3,3,,,
"Apr 29, 2022 8:00 PM",60,15,45,37,20,17,46,23,23,35,17,18,8,1,7,11,24,18,6,22,20,2,22,,25,14,11,26,2,3,2,1,1,,,
"Apr 29, 2022 9:00 PM",39,7,32,21,13,8,24,15,9,15,5,10,7,5,2,5,13,10,3,16,16,0,10,,13,7,6,14,2,4,5,3,2,,,
"Apr 29, 2022 10:00 PM",39,9,30,15,11,4,13,6,7,14,7,7,7,2,5,5,5,3,2,14,14,0,3,,5,5,0,6,0,2,2,1,1,,,
"Apr 29, 2022 11:00 PM",23,4,19,9,7,2,13,4,9,11,2,9,3,3,0,3,6,4,2,9,9,0,4,,2,0,2,8,0,1,1,0,1,,,
"Apr 30, 2022 12:00 AM",20,7,13,1,1,0,2,2,0,6,4,2,0,0,0,2,3,3,0,5,5,0,3,,4,2,2,4,0,1,0,0,0,,,
"Apr 30, 2022 1:00 AM",14,7,7,2,1,1,9,4,5,2,0,2,0,0,0,1,3,3,0,4,4,0,3,,4,4,0,2,1,2,1,1,0,,,
"Apr 30, 2022 2:00 AM",6,3,3,2,1,1,3,1,2,0,0,0,0,0,0,3,0,0,0,3,3,0,0,,1,0,1,6,0,0,0,0,0,,,
"Apr 30, 2022 3:00 AM",9,2,7,0,0,0,1,0,1,1,0,1,0,0,0,0,0,0,0,0,0,0,1,,0,0,0,1,0,1,0,0,0,,,
"Apr 30, 2022 4:00 AM",5,1,4,0,0,0,0,0,0,0,0,0,0,0,0,0,0,0,0,1,1,0,0,,0,0,0,0,0,0,0,0,0,,,
"Apr 30, 2022 5:00 AM",6,2,4,0,0,0,2,1,1,0,0,0,0,0,0,1,0,0,0,1,1,0,0,,3,3,0,2,0,0,0,0,0,,,
"Apr 30, 2022 6:00 AM",11,6,5,8,3,5,6,4,2,4,2,2,0,0,0,1,7,6,1,2,2,0,6,,3,2,1,5,0,2,0,0,0,,,
"Apr 30, 2022 7:00 AM",24,8,16,27,15,12,22,12,10,20,14,6,6,3,3,1,6,5,1,7,6,1,5,,7,3,4,9,0,4,2,0,2,,,
"Apr 30, 2022 8:00 AM",50,25,25,48,25,23,38,26,12,37,25,12,16,9,7,4,16,15,1,6,5,1,15,,7,4,3,15,3,2,4,2,2,,,
"Apr 30, 2022 9:00 AM",30,15,15,67,44,23,66,41,25,58,37,21,3,3,0,3,10,10,0,13,10,3,9,,21,11,10,17,3,3,3,3,0,,,
"Apr 30, 2022 10:00 AM",37,24,13,45,21,24,52,32,20,45,28,17,17,10,7,8,12,12,0,12,11,1,11,,18,11,7,12,2,3,1,1,0,,,
"Apr 30, 2022 11:00 AM",37,23,14,62,24,38,64,29,35,43,18,25,10,7,3,12,12,11,1,9,6,3,11,,17,16,1,19,4,2,2,2,0,,,
"Apr 30, 2022 12:00 PM",35,21,14,66,22,44,67,49,18,56,41,15,21,11,10,15,10,10,0,4,4,0,11,,17,11,6,23,7,3,7,3,4,,,
"Apr 30, 2022 1:00 PM",46,26,20,48,25,23,57,28,29,46,27,19,24,12,12,9,20,20,0,12,10,2,17,,10,6,4,19,3,4,5,2,3,,,
"Apr 30, 2022 2:00 PM",36,16,20,32,13,19,32,22,10,27,13,14,11,3,8,4,17,15,2,12,12,0,17,,16,8,8,14,2,2,6,6,0,,,
"Apr 30, 2022 3:00 PM",36,17,19,52,28,24,43,16,27,37,20,17,13,7,6,19,12,10,2,8,7,1,11,,6,2,4,24,3,1,4,1,3,,,
"Apr 30, 2022 4:00 PM",41,22,19,35,19,16,48,19,29,49,25,24,4,2,2,8,14,14,0,5,5,0,12,,16,7,9,25,5,2,4,2,2,,,
"Apr 30, 2022 5:00 PM",34,16,18,35,26,9,41,15,26,31,12,19,16,3,13,7,7,7,0,3,3,0,7,,13,5,8,12,1,2,3,2,1,,,
"Apr 30, 2022 6:00 PM",28,12,16,22,14,8,14,5,9,22,9,13,10,7,3,5,10,8,2,12,11,1,7,,8,5,3,13,2,0,7,3,4,,,
"Apr 30, 2022 7:00 PM",28,11,17,12,8,4,4,3,1,2,0,2,4,1,3,2,7,6,1,6,5,1,7,,2,2,0,8,0,1,7,3,4,,,
"Apr 30, 2022 8:00 PM",35,13,22,8,8,0,16,7,9,7,6,1,4,2,2,1,15,8,7,8,8,0,7,,2,1,1,7,1,1,6,2,4,,,
"Apr 30, 2022 9:00 PM",30,12,18,8,7,1,15,8,7,11,3,8,3,1,2,2,5,4,1,2,2,0,4,,4,2,2,6,0,0,2,2,0,,,
"Apr 30, 2022 10:00 PM",11,4,7,4,4,0,1,0,1,2,2,0,5,3,2,0,3,2,1,0,0,0,2,,0,0,0,4,0,1,2,1,1,,,
"Apr 30, 2022 11:00 PM",13,4,9,0,0,0,4,3,1,3,1,2,1,0,1,2,2,1,1,7,7,0,1,,0,0,0,0,0,1,0,0,0,,,
"May 1, 2022 12:00 AM",5,1,4,1,1,0,3,1,2,3,0,3,3,2,1,3,1,1,0,3,3,0,1,,3,2,1,4,0,0,0,0,0,,,
"May 1, 2022 1:00 AM",8,3,5,2,1,1,1,0,1,0,0,0,0,0,0,0,1,1,0,2,2,0,1,,0,0,0,2,0,0,0,0,0,,,
"May 1, 2022 2:00 AM",5,4,1,0,0,0,1,0,1,2,1,1,0,0,0,1,1,1,0,3,3,0,1,,1,0,1,0,0,0,1,1,0,,,
"May 1, 2022 3:00 AM",4,1,3,3,2,1,1,0,1,1,1,0,0,0,0,0,0,0,0,2,2,0,0,,0,0,0,1,0,0,0,0,0,,,
"May 1, 2022 4:00 AM",0,0,0,0,0,0,0,0,0,0,0,0,0,0,0,0,1,1,0,0,0,0,1,,0,0,0,0,0,1,0,0,0,,,
"May 1, 2022 5:00 AM",0,0,0,0,0,0,1,1,0,1,0,1,0,0,0,0,1,1,0,1,1,0,1,,0,0,0,0,0,0,2,1,1,,,
"May 1, 2022 6:00 AM",7,4,3,2,0,2,4,2,2,2,1,1,0,0,0,0,5,4,1,1,1,0,4,,1,1,0,3,1,2,1,0,1,,,
"May 1, 2022 7:00 AM",14,7,7,12,7,5,14,8,6,14,8,6,0,0,0,2,9,8,1,7,6,1,8,,2,1,1,5,1,0,1,0,1,,,
"May 1, 2022 8:00 AM",21,7,14,19,11,8,22,12,10,20,12,8,6,4,2,4,8,8,0,5,3,2,7,,12,3,9,103,1,3,0,0,0,,,
"May 1, 2022 9:00 AM",17,7,10,53,37,16,44,30,14,39,26,13,10,4,6,2,12,10,2,13,9,4,11,,16,11,5,13,2,7,2,1,1,,,
"May 1, 2022 10:00 AM",34,20,14,75,41,34,75,37,38,61,36,25,4,4,0,6,17,16,1,9,5,4,17,,31,20,11,18,1,0,3,3,0,,,
"May 1, 2022 11:00 AM",30,19,11,37,15,22,52,24,28,37,21,16,8,4,4,3,6,6,0,6,5,1,3,,10,5,5,20,2,1,9,4,5,,,
"May 1, 2022 12:00 PM",33,16,17,37,9,28,35,6,29,31,6,25,6,4,2,2,6,6,0,6,3,3,4,,12,7,5,16,4,1,8,7,1,,,
"May 1, 2022 1:00 PM",28,13,15,34,13,21,29,14,15,24,11,13,4,3,1,6,4,3,1,3,3,0,2,,6,1,5,5,1,0,1,1,0,,,
"May 1, 2022 2:00 PM",25,12,13,18,7,11,19,9,10,14,7,7,8,2,6,3,8,7,1,8,7,1,6,,6,3,3,9,0,3,1,1,0,,,
"May 1, 2022 3:00 PM",35,21,14,29,18,11,24,14,10,31,18,13,10,5,5,9,11,10,1,7,7,0,10,,10,6,4,10,1,3,2,1,1,,,
"May 1, 2022 4:00 PM",42,20,22,45,18,27,37,21,16,27,19,8,6,0,6,6,12,12,0,10,7,3,10,,14,9,5,16,1,3,2,2,0,,,
"May 1, 2022 5:00 PM",43,23,20,55,30,25,35,18,17,43,21,22,4,2,2,11,16,16,0,9,9,0,16,,11,6,5,15,4,2,4,3,1,,,
"May 1, 2022 6:00 PM",38,21,17,31,18,13,32,14,18,28,15,13,11,8,3,7,7,6,1,8,7,1,6,,9,4,5,16,3,2,4,2,2,,,
"May 1, 2022 7:00 PM",33,14,19,30,20,10,22,10,12,18,8,10,10,5,5,4,14,12,2,7,5,2,10,,9,5,4,7,1,0,1,0,1,,,
"May 1, 2022 8:00 PM",37,8,29,19,12,7,27,13,14,27,11,16,5,2,3,5,8,8,0,6,6,0,6,,5,4,1,23,1,1,5,3,2,,,
"May 1, 2022 9:00 PM",16,6,10,10,5,5,15,6,9,12,5,7,3,2,1,4,7,5,2,5,4,1,5,,8,6,2,7,0,1,0,0,0,,,
"May 1, 2022 10:00 PM",21,7,14,6,1,5,12,5,7,12,6,6,5,4,1,0,6,4,2,5,5,0,3,,6,3,3,5,0,1,2,2,0,,,
"May 1, 2022 11:00 PM",13,3,10,5,4,1,5,3,2,4,1,3,1,1,0,0,3,3,0,2,2,0,1,,0,0,0,2,0,0,0,0,0,,,
"May 2, 2022 12:00 AM",5,1,4,0,0,0,2,0,2,4,1,3,1,0,1,2,2,1,1,3,3,0,1,,2,1,1,3,0,0,0,0,0,,,
"May 2, 2022 1:00 AM",3,0,3,0,0,0,4,1,3,1,0,1,0,0,0,0,0,0,0,1,1,0,0,,0,0,0,5,0,0,1,1,0,,,
"May 2, 2022 2:00 AM",6,3,3,0,0,0,1,1,0,0,0,0,0,0,0,0,2,1,1,1,1,0,1,,1,1,0,1,0,0,1,1,0,,,
"May 2, 2022 3:00 AM",1,0,1,0,0,0,0,0,0,1,1,0,0,0,0,0,0,0,0,2,2,0,1,,0,0,0,0,0,0,2,2,0,,,
"May 2, 2022 4:00 AM",7,1,6,0,0,0,1,1,0,1,1,0,0,0,0,1,1,1,0,0,0,0,1,0,0,0,0,0,0,0,0,0,0,,,
"May 2, 2022 5:00 AM",0,0,0,0,0,0,2,1,1,2,1,1,0,0,0,1,0,0,0,0,0,0,1,0,1,1,0,4,0,0,0,0,0,,,
"May 2, 2022 6:00 AM",14,10,4,5,1,4,8,2,6,2,1,1,0,0,0,1,6,5,1,2,2,0,5,4,4,1,3,6,2,1,0,0,0,,,
"May 2, 2022 7:00 AM",19,9,10,21,15,6,23,16,7,21,13,8,2,0,2,6,10,9,1,11,11,0,9,10,5,4,1,14,3,2,1,1,0,,,
"May 2, 2022 8:00 AM",47,21,26,55,31,24,47,25,22,45,26,19,5,3,2,13,13,12,1,5,5,0,14,13,15,5,10,24,2,6,2,2,0,,,
"May 2, 2022 9:00 AM",65,32,33,82,42,40,74,43,31,70,41,29,11,2,9,5,27,27,0,10,8,2,31,23,37,21,16,24,6,9,1,1,0,,,
"May 2, 2022 10:00 AM",58,34,24,143,87,56,142,84,58,147,86,61,23,17,6,11,27,27,0,17,17,0,22,27,40,29,11,31,4,9,3,2,1,,,
"May 2, 2022 11:00 AM",60,39,21,164,88,76,175,83,92,133,68,65,17,13,4,17,23,22,1,11,10,1,22,45,58,35,23,58,15,7,9,8,1,,,
"May 2, 2022 12:00 PM",74,43,31,181,97,84,179,94,85,149,87,62,37,16,21,20,28,26,2,14,12,2,22,45,79,53,26,51,16,6,10,8,2,,,
"May 2, 2022 1:00 PM",66,30,36,199,100,99,167,92,75,141,81,60,43,20,23,18,20,16,4,15,12,3,16,43,72,39,33,43,8,5,8,5,3,,,
"May 2, 2022 2:00 PM",80,45,35,143,63,80,173,76,97,105,52,53,23,15,8,29,23,23,0,18,17,1,21,17,77,43,34,55,8,5,7,4,3,,,
"May 2, 2022 3:00 PM",67,30,37,152,74,78,148,72,76,134,62,72,27,14,13,22,25,24,1,18,16,2,21,31,67,34,33,30,8,3,2,1,1,,,
"May 2, 2022 4:00 PM",63,25,38,102,57,45,116,46,70,83,41,42,39,12,27,43,29,27,2,23,21,2,25,20,60,24,36,36,4,6,9,4,5,,,
"May 2, 2022 5:00 PM",83,35,48,72,27,45,78,38,40,55,28,27,29,7,22,18,19,17,2,10,10,0,18,26,43,15,28,31,4,1,8,4,4,,,
"May 2, 2022 6:00 PM",59,27,32,80,32,48,87,30,57,85,32,53,35,20,15,9,18,16,2,18,14,4,14,14,28,11,17,28,5,3,4,3,1,,,
"May 2, 2022 7:00 PM",56,20,36,46,32,14,44,29,15,46,28,18,11,8,3,9,16,13,3,15,14,1,15,20,26,11,15,14,2,0,3,1,2,,,
"May 2, 2022 8:00 PM",48,20,28,26,8,18,25,8,17,29,13,16,7,2,5,5,17,15,2,12,12,0,15,7,10,5,5,12,2,3,2,1,1,,,
"May 2, 2022 9:00 PM",29,11,18,16,11,5,15,7,8,16,4,12,6,3,3,3,8,7,1,12,12,0,6,5,13,5,8,5,1,2,3,1,2,,,
"May 2, 2022 10:00 PM",16,7,9,8,8,0,10,4,6,8,4,4,2,1,1,0,6,3,3,3,3,0,4,8,2,1,1,9,1,0,1,1,0,,,
"May 2, 2022 11:00 PM",16,3,13,1,1,0,5,3,2,3,2,1,1,1,0,0,7,1,6,2,2,0,2,3,3,2,1,3,1,2,2,2,0,,,
"May 3, 2022 12:00 AM",7,1,6,0,0,0,0,0,0,1,1,0,1,0,1,0,2,1,1,3,3,0,1,,0,0,0,1,1,0,0,0,0,,,
"May 3, 2022 1:00 AM",0,0,0,2,0,2,2,1,1,3,0,3,1,1,0,1,1,0,1,0,0,0,0,,1,1,0,1,0,0,1,0,1,,,
"May 3, 2022 2:00 AM",5,3,2,0,0,0,1,0,1,0,0,0,0,0,0,0,0,0,0,1,1,0,0,,0,0,0,0,0,0,1,1,0,,,
"May 3, 2022 3:00 AM",0,0,0,0,0,0,1,0,1,0,0,0,0,0,0,0,0,0,0,1,1,0,0,,1,1,0,0,0,0,0,0,0,,,
"May 3, 2022 4:00 AM",2,1,1,0,0,0,0,0,0,0,0,0,0,0,0,0,1,1,0,0,0,0,1,,0,0,0,3,0,0,0,0,0,,,
"May 3, 2022 5:00 AM",5,2,3,1,0,1,1,1,0,2,1,1,0,0,0,2,8,8,0,0,0,0,5,,1,1,0,8,1,0,0,0,0,,,
"May 3, 2022 6:00 AM",37,24,13,22,5,17,18,4,14,17,5,12,3,3,0,3,17,17,0,8,6,2,16,,6,2,4,38,2,4,2,1,1,,,
"May 3, 2022 7:00 AM",134,97,37,33,7,26,71,21,50,38,16,22,5,4,1,19,59,59,0,16,13,3,60,,33,15,18,82,2,4,8,6,2,,,
"May 3, 2022 8:00 AM",273,208,65,93,28,65,130,47,83,103,41,62,44,27,17,28,155,152,3,34,26,8,150,,83,33,50,210,6,5,9,8,1,,,
"May 3, 2022 9:00 AM",142,116,26,48,17,31,81,35,46,64,34,30,21,13,8,9,81,81,0,17,13,4,74,,41,23,18,82,3,3,8,4,4,,,
"May 3, 2022 10:00 AM",70,54,16,44,22,22,63,32,31,53,30,23,10,6,4,5,33,32,1,8,5,3,27,,17,7,10,24,1,3,4,4,0,,,
"May 3, 2022 11:00 AM",44,23,21,49,17,32,70,32,38,38,19,19,16,7,9,11,20,19,1,9,6,3,18,,27,8,19,22,4,3,7,5,2,,,
"May 3, 2022 12:00 PM",67,36,31,68,31,37,55,30,25,45,22,23,14,10,4,7,20,18,2,14,10,4,14,,22,10,12,27,5,1,3,3,0,,,
"May 3, 2022 1:00 PM",85,45,40,53,31,22,55,35,20,44,24,20,22,8,14,22,25,21,4,13,10,3,19,,32,19,13,25,6,0,4,1,3,,,
"May 3, 2022 2:00 PM",64,21,43,43,20,23,65,24,41,48,27,21,17,14,3,9,21,21,0,11,10,1,18,,26,14,12,23,3,5,5,5,0,,,
"May 3, 2022 3:00 PM",68,31,37,46,20,26,67,38,29,40,24,16,21,6,15,18,26,24,2,23,21,2,21,,30,18,12,34,4,3,11,7,4,,,
"May 3, 2022 4:00 PM",134,48,86,60,34,26,95,61,34,64,43,21,17,7,10,17,29,22,7,38,36,2,23,,34,26,8,50,8,1,4,1,3,,,
"May 3, 2022 5:00 PM",226,57,169,86,49,37,124,64,60,87,49,38,36,16,20,29,45,42,3,97,93,4,42,,66,46,20,58,8,3,15,9,6,,,
"May 3, 2022 6:00 PM",174,38,136,88,61,27,136,99,37,93,64,29,21,5,16,23,41,37,4,88,86,2,40,,67,47,20,54,5,4,9,6,3,,,
"May 3, 2022 7:00 PM",144,52,92,65,43,22,87,57,30,69,38,31,11,4,7,18,28,23,5,45,44,1,21,,53,43,10,37,2,6,9,5,4,,,
"May 3, 2022 8:00 PM",79,29,50,44,20,24,56,23,33,46,14,32,10,5,5,6,19,14,5,28,27,1,15,,16,10,6,22,6,2,4,1,3,,,
"May 3, 2022 9:00 PM",61,14,47,24,15,9,33,23,10,26,15,11,2,0,2,6,13,11,2,17,17,0,12,,10,8,2,18,3,0,4,3,1,,,
"May 3, 2022 10:00 PM",32,9,23,9,7,2,11,4,7,7,1,6,4,1,3,1,13,7,6,20,19,1,6,,3,1,2,6,1,1,3,1,2,,,
"May 3, 2022 11:00 PM",14,3,11,0,0,0,5,4,1,3,1,2,0,0,0,2,4,2,2,6,6,0,1,,1,1,0,4,0,0,3,3,0,,,
"May 4, 2022 12:00 AM",10,1,9,0,0,0,0,0,0,1,0,1,0,0,0,1,3,2,1,3,3,0,2,,0,0,0,3,1,0,0,0,0,,,
"May 4, 2022 1:00 AM",1,0,1,0,0,0,1,0,1,0,0,0,0,0,0,0,1,1,0,0,0,0,1,,0,0,0,0,1,0,0,0,0,,,
"May 4, 2022 2:00 AM",5,3,2,0,0,0,0,0,0,0,0,0,0,0,0,0,1,1,0,0,0,0,0,,0,0,0,0,0,0,0,0,0,,,
"May 4, 2022 3:00 AM",0,0,0,1,1,0,1,1,0,1,1,0,0,0,0,0,0,0,0,0,0,0,1,,1,1,0,0,0,0,0,0,0,,,
"May 4, 2022 4:00 AM",2,1,1,1,0,1,2,1,1,2,1,1,0,0,0,0,2,2,0,0,0,0,2,1,0,0,0,3,0,0,0,0,0,,,
"May 4, 2022 5:00 AM",12,6,6,5,3,2,4,2,2,3,2,1,1,1,0,3,6,6,0,0,0,0,6,1,0,0,0,14,0,0,0,0,0,,,
"May 4, 2022 6:00 AM",47,32,15,23,8,15,28,11,17,25,9,16,3,3,0,4,24,24,0,10,8,2,23,12,18,9,9,40,1,5,3,2,1,,,
"May 4, 2022 7:00 AM",158,110,48,81,27,54,119,35,84,79,30,49,13,10,3,17,87,87,0,30,23,7,88,41,45,15,30,145,6,8,10,9,1,,,
"May 4, 2022 8:00 AM",308,238,70,121,34,87,173,54,119,135,50,85,37,24,13,29,185,184,1,53,39,14,184,57,82,22,60,236,9,6,17,16,1,,,
"May 4, 2022 9:00 AM",127,110,17,66,23,43,77,34,43,69,36,33,6,5,1,11,86,86,0,27,19,8,79,20,41,16,25,71,3,9,6,4,2,,,
"May 4, 2022 10:00 AM",86,54,32,35,13,22,44,22,22,39,21,18,14,11,3,32,29,29,0,11,9,2,24,13,23,14,9,32,0,1,2,2,0,,,
"May 4, 2022 11:00 AM",61,39,22,30,16,14,50,22,28,28,16,12,7,3,4,7,28,28,0,7,7,0,25,14,23,8,15,15,3,1,5,4,1,,,
"May 4, 2022 12:00 PM",77,33,44,57,26,31,63,33,30,45,24,21,9,5,4,20,27,26,1,28,25,3,21,28,29,20,9,21,6,1,6,3,3,,,
"May 4, 2022 1:00 PM",97,40,57,55,30,25,82,54,28,74,47,27,20,14,6,18,34,31,3,34,29,5,30,39,36,23,13,36,4,5,11,5,6,,,
"May 4, 2022 2:00 PM",60,30,30,57,33,24,89,47,42,57,35,22,17,11,6,13,21,20,1,23,17,6,15,33,37,22,15,32,5,3,7,4,3,,,
"May 4, 2022 3:00 PM",85,31,54,68,45,23,86,56,30,67,47,20,15,6,9,28,39,35,4,28,25,3,31,45,47,35,12,32,1,3,8,2,6,,,
"May 4, 2022 4:00 PM",145,54,91,69,36,33,107,66,41,75,38,37,16,9,7,19,32,29,3,52,51,1,36,56,64,40,24,47,15,2,11,4,7,,,
"May 4, 2022 5:00 PM",242,55,187,104,66,38,161,94,67,121,81,40,23,10,13,34,54,51,3,99,93,6,48,131,86,66,20,73,10,10,13,7,6,,,
"May 4, 2022 6:00 PM",228,64,164,146,102,44,206,146,60,148,102,46,13,5,8,28,54,47,7,99,97,2,45,151,97,79,18,59,5,3,14,10,4,,,
"May 4, 2022 7:00 PM",131,46,85,108,67,41,147,86,61,99,57,42,19,12,7,14,17,15,2,51,51,0,12,78,66,45,21,36,5,1,9,5,4,,,
"May 4, 2022 8:00 PM",89,38,51,95,51,44,111,45,66,82,38,44,11,6,5,9,16,14,2,27,26,1,13,32,39,14,25,40,8,2,10,7,3,,,
"May 4, 2022 9:00 PM",67,18,49,28,17,11,33,19,14,26,11,15,6,1,5,5,23,19,4,28,27,1,18,15,21,16,5,17,1,4,5,2,3,,,
"May 4, 2022 10:00 PM",42,7,35,10,7,3,16,7,9,13,3,10,4,3,1,4,6,2,4,10,10,0,3,11,11,6,5,6,1,1,5,2,3,,,
"May 4, 2022 11:00 PM",28,7,21,6,4,2,9,4,5,5,0,5,3,1,2,1,3,2,1,13,13,0,2,8,4,2,2,5,2,2,0,0,0,,,
"May 5, 2022 12:00 AM",15,2,13,0,0,0,3,0,3,7,2,5,2,2,0,1,4,3,1,7,7,0,2,4,0,0,0,0,0,0,0,0,0,,,
"May 5, 2022 1:00 AM",3,1,2,0,0,0,1,1,0,1,1,0,0,0,0,0,0,0,0,3,3,0,0,1,0,0,0,3,1,0,1,1,0,,,
"May 5, 2022 2:00 AM",3,1,2,2,2,0,2,2,0,2,2,0,0,0,0,0,1,1,0,0,0,0,1,1,1,1,0,0,0,0,0,0,0,,,
"May 5, 2022 3:00 AM",2,0,2,0,0,0,0,0,0,0,0,0,0,0,0,0,0,0,0,0,0,0,0,0,0,0,0,1,0,0,0,0,0,,,
"May 5, 2022 4:00 AM",3,2,1,0,0,0,2,2,0,1,1,0,0,0,0,0,1,1,0,0,0,0,1,1,0,0,0,1,0,0,0,0,0,,,
"May 5, 2022 5:00 AM",6,5,1,0,0,0,4,1,3,1,1,0,0,0,0,3,5,5,0,1,1,0,6,1,1,1,0,9,0,1,1,1,0,,,
"May 5, 2022 6:00 AM",39,29,10,27,9,18,33,14,19,32,13,19,1,1,0,8,20,20,0,12,10,2,18,17,12,2,10,35,2,5,1,1,0,,,
"May 5, 2022 7:00 AM",146,102,44,73,20,53,84,26,58,67,23,44,17,15,2,14,94,94,0,22,19,3,89,47,45,18,27,117,3,5,6,4,2,,,
"May 5, 2022 8:00 AM",315,225,90,99,29,70,161,53,108,120,45,75,46,27,19,37,186,182,4,46,35,11,172,49,84,16,68,211,7,8,19,16,3,,,
"May 5, 2022 9:00 AM",128,103,25,65,25,40,99,45,54,72,40,32,24,17,7,12,75,75,0,19,15,4,69,29,49,15,34,94,4,7,4,4,0,,,
"May 5, 2022 10:00 AM",84,53,31,68,31,37,61,28,33,53,29,24,17,11,6,10,43,43,0,9,7,2,32,9,23,14,9,28,6,6,2,1,1,,,
"May 5, 2022 11:00 AM",58,34,24,53,22,31,62,27,35,35,13,22,19,13,6,15,22,19,3,14,13,1,21,18,29,12,17,18,1,0,2,2,0,,,
"May 5, 2022 12:00 PM",64,34,30,67,39,28,84,50,34,61,35,26,19,7,12,18,31,28,3,24,22,2,25,24,49,32,17,21,4,6,1,0,1,,,
"May 5, 2022 1:00 PM",84,44,40,52,32,20,82,45,37,58,34,24,21,15,6,6,21,18,3,17,14,3,20,32,61,40,21,34,5,3,4,3,1,,,
"May 5, 2022 2:00 PM",70,31,39,45,29,16,86,45,41,50,28,22,18,14,4,11,22,20,2,30,29,1,15,34,48,29,19,27,5,4,6,4,2,,,
"May 5, 2022 3:00 PM",100,35,65,59,30,29,83,49,34,63,39,24,16,8,8,15,34,31,3,36,25,11,25,39,42,22,20,40,4,3,8,1,7,,,
"May 5, 2022 4:00 PM",142,57,85,71,36,35,99,65,34,82,52,30,10,4,6,31,29,27,2,50,45,5,27,70,49,33,16,55,9,8,14,10,4,,,
"May 5, 2022 5:00 PM",208,66,142,140,64,76,169,115,54,150,110,40,33,11,22,21,41,34,7,97,93,4,36,108,83,67,16,76,9,5,12,8,4,,,
"May 5, 2022 6:00 PM",216,68,148,82,52,30,135,99,36,100,65,35,13,4,9,27,48,40,8,95,92,3,40,111,84,65,19,54,8,6,6,6,0,,,
"May 5, 2022 7:00 PM",134,43,91,55,41,14,102,74,28,76,52,24,23,7,16,13,24,19,5,55,52,3,20,66,41,37,4,31,5,2,11,7,4,,,
"May 5, 2022 8:00 PM",81,18,63,76,32,44,68,33,35,73,29,44,13,4,9,10,17,16,1,39,37,2,15,33,22,13,9,28,4,0,9,3,6,,,
"May 5, 2022 9:00 PM",53,12,41,36,29,7,37,15,22,37,12,25,5,2,3,7,19,18,1,16,16,0,18,16,11,5,6,15,1,0,6,1,5,,,
"May 5, 2022 10:00 PM",32,9,23,35,34,1,36,7,29,34,11,23,8,2,6,2,5,3,2,18,17,1,4,12,9,5,4,16,1,2,3,2,1,,,
"May 5, 2022 11:00 PM",33,6,27,12,11,1,15,4,11,10,0,10,2,0,2,4,7,2,5,8,8,0,1,11,3,2,1,6,1,1,0,0,0,,,
"May 6, 2022 12:00 AM",7,2,5,0,0,0,4,3,1,2,1,1,0,0,0,2,2,2,0,9,9,0,3,4,6,1,5,2,0,0,1,0,1,,,
"May 6, 2022 1:00 AM",3,0,3,1,1,0,2,1,1,1,0,1,0,0,0,0,1,0,1,3,3,0,0,1,0,0,0,3,0,0,0,0,0,,,
"May 6, 2022 2:00 AM",1,1,0,0,0,0,1,1,0,0,0,0,0,0,0,0,1,1,0,0,0,0,1,0,0,0,0,0,0,0,0,0,0,,,
"May 6, 2022 3:00 AM",0,0,0,0,0,0,1,1,0,1,1,0,0,0,0,0,0,0,0,0,0,0,0,0,1,1,0,0,0,0,0,0,0,,,
"May 6, 2022 4:00 AM",5,1,4,2,0,2,1,0,1,2,1,1,2,0,2,1,2,2,0,1,1,0,2,1,0,0,0,1,0,0,1,1,0,,,
"May 6, 2022 5:00 AM",8,6,2,5,3,2,2,2,0,3,2,1,1,1,0,3,6,6,0,0,0,0,6,1,1,1,0,8,0,0,1,0,1,,,
"May 6, 2022 6:00 AM",49,31,18,25,13,12,29,16,13,22,11,11,1,1,0,3,25,25,0,8,7,1,22,18,9,7,2,30,1,5,2,1,1,,,
"May 6, 2022 7:00 AM",113,85,28,71,33,38,87,33,54,61,32,29,12,8,4,9,52,52,0,12,9,3,56,33,36,20,16,84,4,3,4,4,0,,,
"May 6, 2022 8:00 AM",216,163,53,95,29,66,131,44,87,108,45,63,28,19,9,31,115,113,2,49,40,9,111,42,66,20,46,143,8,7,14,10,4,,,
"May 6, 2022 9:00 AM",115,83,32,78,32,46,80,42,38,73,41,32,14,10,4,7,56,55,1,24,18,6,52,22,8,1,7,58,3,5,7,2,5,,,
"May 6, 2022 10:00 AM",67,50,17,39,15,24,48,17,31,41,22,19,17,9,8,15,25,24,1,15,12,3,18,11,0,0,0,25,0,2,2,1,1,,,
"May 6, 2022 11:00 AM",45,20,25,37,23,14,42,19,23,31,18,13,7,5,2,6,18,17,1,12,9,3,16,12,0,0,0,23,5,2,2,1,1,,,
"May 6, 2022 12:00 PM",50,21,29,22,12,10,22,12,10,14,7,7,8,3,5,7,17,14,3,21,14,7,15,19,0,0,0,13,0,0,1,0,1,,,
"May 6, 2022 1:00 PM",88,44,44,17,10,7,54,27,27,27,12,15,8,3,5,6,21,19,2,18,14,4,22,18,0,0,0,19,2,0,3,2,1,,,
"May 6, 2022 2:00 PM",62,32,30,24,15,9,31,20,11,27,20,7,7,5,2,7,21,20,1,19,18,1,18,17,0,0,0,16,9,1,13,8,5,,,
"May 6, 2022 3:00 PM",60,28,32,23,10,13,27,14,13,20,10,10,3,1,2,12,16,11,5,21,20,1,10,29,0,0,0,33,1,2,6,4,2,,,
"May 6, 2022 4:00 PM",109,33,76,26,15,11,52,32,20,45,27,18,13,6,7,10,30,28,2,39,34,5,32,36,0,0,0,29,3,2,7,3,4,,,
"May 6, 2022 5:00 PM",130,36,94,56,32,24,71,45,26,41,24,17,12,3,9,17,23,21,2,61,56,5,22,68,0,0,0,52,2,2,3,0,3,,,
"May 6, 2022 6:00 PM",126,37,89,45,23,22,76,54,22,45,26,19,12,1,11,17,18,16,2,57,53,4,14,79,0,0,0,35,3,4,8,3,5,,,
"May 6, 2022 7:00 PM",105,35,70,46,35,11,65,35,30,45,28,17,15,3,12,12,26,21,5,33,30,3,19,37,0,0,0,33,5,2,8,5,3,,,
"May 6, 2022 8:00 PM",54,22,32,31,19,12,44,32,12,31,18,13,6,5,1,19,13,13,0,14,14,0,12,16,0,0,0,20,2,2,4,3,1,,,
"May 6, 2022 9:00 PM",39,9,30,25,18,7,22,11,11,21,13,8,1,1,0,3,18,16,2,12,11,1,17,18,0,0,0,12,2,2,1,1,0,,,
"May 6, 2022 10:00 PM",43,15,28,7,7,0,20,9,11,12,9,3,1,0,1,6,11,6,5,9,8,1,6,13,0,0,0,13,0,1,2,0,2,,,
"May 6, 2022 11:00 PM",24,2,22,2,2,0,9,6,3,2,0,2,3,2,1,1,6,4,2,4,4,0,4,9,0,0,0,3,1,1,1,1,0,,,
"May 7, 2022 12:00 AM",13,4,9,0,0,0,4,3,1,5,2,3,1,0,1,4,5,5,0,3,3,0,5,5,0,0,0,5,0,0,0,0,0,,,
"May 7, 2022 1:00 AM",8,0,8,0,0,0,3,2,1,1,0,1,0,0,0,0,2,2,0,4,4,0,3,4,0,0,0,1,0,1,1,1,0,,,
"May 7, 2022 2:00 AM",6,2,4,0,0,0,2,2,0,0,0,0,0,0,0,0,1,1,0,3,3,0,1,1,0,0,0,0,0,0,0,0,0,,,
"May 7, 2022 3:00 AM",4,2,2,2,2,0,0,0,0,1,1,0,0,0,0,0,1,0,1,2,2,0,2,1,0,0,0,3,0,0,0,0,0,,,
"May 7, 2022 4:00 AM",3,2,1,11,1,10,6,5,1,2,2,0,0,0,0,1,1,1,0,1,1,0,0,1,0,0,0,5,0,0,0,0,0,,,
"May 7, 2022 5:00 AM",2,1,1,47,35,12,45,38,7,46,36,10,1,1,0,0,0,0,0,0,0,0,0,9,0,0,0,3,0,0,0,0,0,,,
"May 7, 2022 6:00 AM",13,6,7,23,7,16,30,9,21,22,6,16,0,0,0,1,7,7,0,2,2,0,8,7,0,0,0,9,1,0,2,2,0,,,
"May 7, 2022 7:00 AM",28,11,17,34,20,14,34,15,19,25,15,10,4,1,3,3,11,10,1,5,4,1,9,6,0,0,0,23,0,4,2,1,1,,,
"May 7, 2022 8:00 AM",53,32,21,53,35,18,58,34,24,51,37,14,7,4,3,18,15,15,0,11,7,4,17,30,0,0,0,23,5,9,3,1,2,,,
"May 7, 2022 9:00 AM",46,27,19,104,66,38,95,62,33,92,65,27,15,9,6,7,24,23,1,10,10,0,19,31,0,0,0,25,2,5,4,3,1,,,
"May 7, 2022 10:00 AM",74,42,32,121,68,53,97,69,28,105,69,36,21,13,8,18,23,23,0,14,13,1,24,36,0,0,0,38,11,10,11,6,5,,,
"May 7, 2022 11:00 AM",59,30,29,167,69,98,147,77,70,152,76,76,29,19,10,8,23,21,2,15,11,4,23,38,0,0,0,43,9,16,6,3,3,,,
"May 7, 2022 12:00 PM",79,38,41,144,57,87,137,83,54,137,85,52,23,15,8,24,34,32,2,29,25,4,31,38,0,0,0,45,10,7,5,3,2,,,
"May 7, 2022 1:00 PM",65,40,25,120,52,68,115,62,53,109,57,52,36,17,19,25,23,21,2,13,13,0,21,37,0,0,0,46,9,8,6,2,4,,,
"May 7, 2022 2:00 PM",69,34,35,94,52,42,111,65,46,76,42,34,25,15,10,16,33,32,1,24,22,2,27,42,0,0,0,44,13,2,7,5,2,,,
"May 7, 2022 3:00 PM",71,32,39,114,57,57,144,76,68,101,57,44,20,7,13,23,24,24,0,21,16,5,23,38,0,0,0,31,2,4,10,5,5,,,
"May 7, 2022 4:00 PM",64,35,29,114,58,56,172,102,70,105,59,46,30,15,15,12,20,20,0,16,13,3,26,47,0,0,0,37,6,2,12,10,2,,,
"May 7, 2022 5:00 PM",64,31,33,136,72,64,169,47,122,120,43,77,35,14,21,15,19,15,4,16,15,1,14,25,0,0,0,52,9,2,6,4,2,,,
"May 7, 2022 6:00 PM",67,22,45,88,61,27,92,44,48,73,44,29,17,10,7,19,22,21,1,21,20,1,20,35,0,0,0,42,2,2,4,2,2,,,
"May 7, 2022 7:00 PM",58,20,38,59,28,31,59,27,32,49,25,24,12,4,8,11,12,11,1,17,14,3,10,21,0,0,0,29,5,0,5,1,4,,,
"May 7, 2022 8:00 PM",43,16,27,39,21,18,39,18,21,31,13,18,13,8,5,3,12,7,5,11,8,3,7,10,0,0,0,22,4,0,7,3,4,,,
"May 7, 2022 9:00 PM",32,10,22,17,6,11,23,8,15,25,8,17,9,8,1,3,9,8,1,10,10,0,9,7,0,0,0,19,1,0,5,3,2,,,
"May 7, 2022 10:00 PM",26,9,17,11,7,4,19,5,14,13,6,7,4,4,0,0,11,10,1,6,6,0,8,5,0,0,0,9,1,1,3,1,2,,,
"May 7, 2022 11:00 PM",15,7,8,11,5,6,11,3,8,11,0,11,2,1,1,3,5,5,0,10,10,0,5,3,0,0,0,8,0,1,6,4,2,,,
"May 8, 2022 12:00 AM",5,3,2,0,0,0,1,1,0,6,0,6,1,1,0,2,4,4,0,4,4,0,3,5,0,0,0,5,1,1,1,1,0,,,
"May 8, 2022 1:00 AM",7,0,7,2,2,0,6,2,4,2,2,0,5,1,4,1,2,2,0,5,5,0,3,0,0,0,0,2,0,1,2,1,1,,,
"May 8, 2022 2:00 AM",9,4,5,2,2,0,4,3,1,1,1,0,1,0,1,0,0,0,0,5,5,0,0,7,0,0,0,1,0,0,0,0,0,,,
"May 8, 2022 3:00 AM",1,1,0,0,0,0,1,1,0,2,1,1,0,0,0,0,0,0,0,1,1,0,0,3,0,0,0,1,0,0,1,1,0,,,
"May 8, 2022 4:00 AM",4,2,2,0,0,0,1,1,0,1,1,0,0,0,0,1,2,2,0,0,0,0,2,0,0,0,0,2,0,1,0,0,0,,,
"May 8, 2022 5:00 AM",4,1,3,2,1,1,1,1,0,2,1,1,1,0,1,0,0,0,0,0,0,0,0,1,0,0,0,0,0,0,1,1,0,,,
"May 8, 2022 6:00 AM",13,8,5,7,4,3,13,8,5,7,4,3,0,0,0,0,5,4,1,4,4,0,5,7,0,0,0,4,2,3,2,1,1,,,
"May 8, 2022 7:00 AM",17,10,7,29,15,14,42,21,21,26,12,14,1,1,0,5,13,12,1,8,7,1,12,14,0,0,0,19,0,6,0,0,0,,,
"May 8, 2022 8:00 AM",49,19,30,85,59,26,76,51,25,75,56,19,1,1,0,6,21,21,0,11,9,2,22,18,0,0,0,52,2,19,2,1,1,,,
"May 8, 2022 9:00 AM",50,15,35,134,88,46,135,77,58,133,85,48,10,6,4,14,25,25,0,20,17,3,23,46,0,0,0,35,5,5,3,3,0,,,
"May 8, 2022 10:00 AM",81,47,34,226,123,103,198,127,71,172,113,59,16,6,10,20,31,30,1,12,12,0,31,55,0,0,0,31,14,9,13,10,3,,,
"May 8, 2022 11:00 AM",76,45,31,304,158,146,270,148,122,281,160,121,32,19,13,25,32,31,1,20,19,1,29,63,0,0,0,59,11,12,6,2,4,,,
"May 8, 2022 12:00 PM",88,36,52,282,151,131,315,189,126,273,167,106,38,20,18,23,24,23,1,20,17,3,27,74,0,0,0,58,14,9,6,4,2,,,
"May 8, 2022 1:00 PM",69,42,27,284,149,135,277,161,116,267,157,110,44,24,20,19,38,38,0,22,15,7,36,69,0,0,0,38,19,11,8,8,0,,,
"May 8, 2022 2:00 PM",76,39,37,276,131,145,324,160,164,239,116,123,49,31,18,22,27,27,0,18,14,4,24,47,0,0,0,62,11,5,8,5,3,,,
"May 8, 2022 3:00 PM",70,38,32,223,119,104,284,126,158,209,98,111,50,24,26,16,30,27,3,23,21,2,23,45,0,0,0,66,14,7,2,2,0,,,
"May 8, 2022 4:00 PM",75,34,41,223,115,108,310,139,171,222,107,115,45,21,24,31,24,24,0,22,19,3,22,38,0,0,0,60,3,9,5,4,1,,,
"May 8, 2022 5:00 PM",71,35,36,162,97,65,214,98,116,129,61,68,33,21,12,20,18,18,0,20,19,1,17,36,0,0,0,52,2,1,6,3,3,,,
"May 8, 2022 6:00 PM",63,23,40,107,46,61,192,83,109,130,52,78,20,11,9,19,28,25,3,14,11,3,20,35,0,0,0,62,3,2,10,7,3,,,
"May 8, 2022 7:00 PM",51,23,28,67,33,34,116,30,86,80,24,56,24,15,9,14,26,23,3,15,14,1,16,24,0,0,0,48,2,1,5,3,2,,,
"May 8, 2022 8:00 PM",54,21,33,34,19,15,54,21,33,41,18,23,8,6,2,4,23,15,8,18,18,0,15,10,0,0,0,25,1,1,2,1,1,,,
"May 8, 2022 9:00 PM",35,9,26,20,2,18,42,8,34,29,8,21,4,2,2,4,14,13,1,9,9,0,13,10,0,0,0,13,2,2,2,2,0,,,
"May 8, 2022 10:00 PM",15,5,10,14,6,8,14,5,9,17,4,13,2,2,0,1,7,2,5,4,4,0,4,6,0,0,0,2,1,2,1,0,1,,,
"May 8, 2022 11:00 PM",17,5,12,2,1,1,17,9,8,10,6,4,5,2,3,5,3,2,1,4,4,0,3,7,0,0,0,8,1,1,1,1,0,,,
"May 9, 2022 12:00 AM",5,1,4,0,0,0,3,2,1,0,0,0,1,0,1,1,2,2,0,3,3,0,2,6,0,0,0,4,0,1,0,0,0,,,
"May 9, 2022 1:00 AM",3,2,1,0,0,0,3,1,2,2,0,2,0,0,0,1,2,1,1,2,2,0,1,2,0,0,0,1,0,0,0,0,0,,,
"May 9, 2022 2:00 AM",2,1,1,1,1,0,0,0,0,1,1,0,0,0,0,0,0,0,0,0,0,0,0,2,0,0,0,1,0,0,0,0,0,,,
"May 9, 2022 3:00 AM",1,0,1,0,0,0,0,0,0,0,0,0,0,0,0,0,1,1,0,1,1,0,1,0,0,0,0,0,0,0,0,0,0,,,
"May 9, 2022 4:00 AM",0,0,0,1,0,1,2,1,1,2,1,1,0,0,0,0,2,2,0,0,0,0,2,1,0,0,0,3,0,0,0,0,0,,,
"May 9, 2022 5:00 AM",9,4,5,2,2,0,5,3,2,3,2,1,0,0,0,2,9,8,1,3,3,0,9,0,0,0,0,8,0,1,0,0,0,,,
"May 9, 2022 6:00 AM",37,22,15,16,6,10,20,8,12,19,8,11,1,1,0,6,21,21,0,8,8,0,21,9,0,0,0,29,1,5,3,2,1,,,
"May 9, 2022 7:00 AM",96,65,31,61,23,38,89,34,55,68,26,42,12,7,5,19,84,84,0,19,16,3,82,38,0,0,0,83,2,5,5,4,1,,,
"May 9, 2022 8:00 AM",235,184,51,82,24,58,133,45,88,100,38,62,37,25,12,32,137,135,2,43,30,13,129,52,0,0,0,184,7,5,16,13,3,,,
"May 9, 2022 9:00 AM",124,92,32,43,16,27,49,22,27,42,21,21,23,16,7,44,79,79,0,25,20,5,70,24,0,0,0,54,1,2,9,6,3,,,
"May 9, 2022 10:00 AM",54,35,19,26,13,13,42,20,22,36,17,19,10,5,5,52,25,25,0,7,6,1,26,11,0,0,0,22,2,1,4,3,1,,,
"May 9, 2022 11:00 AM",42,25,17,50,28,22,40,22,18,41,27,14,14,8,6,59,18,16,2,8,7,1,14,13,0,0,0,18,1,1,5,3,2,,,
"May 9, 2022 12:00 PM",50,26,24,34,10,24,33,11,22,32,11,21,12,7,5,29,18,18,0,15,15,0,15,10,0,0,0,26,1,1,2,1,1,,,
"May 9, 2022 1:00 PM",52,23,29,16,9,7,29,16,13,24,14,10,17,4,13,3,26,25,1,10,8,2,20,12,0,0,0,12,3,1,1,1,0,,,
"May 9, 2022 2:00 PM",46,19,27,9,6,3,28,12,16,22,13,9,8,7,1,12,11,11,0,18,17,1,10,20,0,0,0,11,1,3,4,3,1,,,
"May 9, 2022 3:00 PM",74,33,41,26,18,8,30,21,9,28,17,11,11,6,5,14,22,21,1,20,17,3,13,29,0,0,0,27,2,0,5,0,5,,,
"May 9, 2022 4:00 PM",114,31,83,23,19,4,52,35,17,43,32,11,10,6,4,10,32,29,3,41,36,5,26,42,0,0,0,29,5,2,12,9,3,,,
"May 9, 2022 5:00 PM",183,50,133,70,45,25,81,52,29,63,44,19,13,3,10,15,39,32,7,86,83,3,34,113,0,0,0,57,4,6,5,3,2,,,
"May 9, 2022 6:00 PM",167,42,125,62,45,17,99,75,24,75,47,28,19,4,15,26,27,25,2,96,92,4,25,98,0,0,0,42,6,2,10,7,3,,,
"May 9, 2022 7:00 PM",92,17,75,60,35,25,87,56,31,53,34,19,10,4,6,13,16,10,6,45,39,6,8,54,0,0,0,19,4,2,6,4,2,,,
"May 9, 2022 8:00 PM",73,17,56,44,27,17,47,24,23,43,22,21,9,5,4,12,20,15,5,26,23,3,16,19,0,0,0,21,3,2,8,3,5,,,
"May 9, 2022 9:00 PM",37,12,25,23,13,10,24,15,9,22,11,11,1,0,1,8,12,10,2,11,11,0,8,11,0,0,0,11,4,1,8,7,1,,,
"May 9, 2022 10:00 PM",24,5,19,1,0,1,7,2,5,2,2,0,0,0,0,9,6,3,3,10,9,1,4,6,0,0,0,6,0,2,4,1,3,,,
"May 9, 2022 11:00 PM",13,1,12,3,3,0,3,3,0,1,1,0,1,1,0,0,5,1,4,11,10,1,2,6,0,0,0,0,0,0,1,1,0,,,
"May 10, 2022 12:00 AM",8,0,8,1,1,0,1,1,0,2,1,1,1,0,1,1,5,4,1,6,6,0,3,2,0,0,0,0,0,0,0,0,0,,,
"May 10, 2022 1:00 AM",3,1,2,0,0,0,0,0,0,0,0,0,0,0,0,0,1,1,0,2,2,0,1,1,0,0,0,0,0,0,0,0,0,,,
"May 10, 2022 2:00 AM",3,3,0,1,0,1,0,0,0,1,0,1,0,0,0,0,0,0,0,0,0,0,0,3,0,0,0,0,0,0,1,1,0,,,
"May 10, 2022 3:00 AM",1,0,1,0,0,0,0,0,0,1,1,0,0,0,0,0,2,1,1,0,0,0,1,0,0,0,0,0,0,0,0,0,0,,,
"May 10, 2022 4:00 AM",2,1,1,0,0,0,0,0,0,0,0,0,0,0,0,0,2,2,0,0,0,0,2,1,0,0,0,2,0,0,0,0,0,,,
"May 10, 2022 5:00 AM",14,10,4,5,1,4,6,2,4,6,2,4,1,1,0,3,9,9,0,1,1,0,9,2,0,0,0,8,1,0,1,1,0,,,
"May 10, 2022 6:00 AM",48,33,15,20,4,16,27,13,14,19,7,12,3,3,0,11,29,29,0,12,11,1,29,12,0,0,0,36,1,6,2,1,1,,,
"May 10, 2022 7:00 AM",144,105,39,70,20,50,104,36,68,73,25,48,10,10,0,16,93,92,1,20,16,4,82,44,0,0,0,136,4,7,9,8,1,,,
"May 10, 2022 8:00 AM",309,240,69,110,33,77,196,68,128,136,62,74,51,29,22,40,192,189,3,52,34,18,184,51,0,0,0,233,7,11,19,14,5,,,
"May 10, 2022 9:00 AM",154,122,32,56,23,33,103,46,57,77,36,41,18,13,5,13,82,82,0,19,15,4,75,35,0,0,0,78,4,3,8,7,1,,,
"May 10, 2022 10:00 AM",55,30,25,52,24,28,59,32,27,52,30,22,10,8,2,7,22,21,1,10,5,5,16,14,0,0,0,37,1,2,0,0,0,,,
"May 10, 2022 11:00 AM",46,27,19,37,17,20,50,21,29,41,17,24,22,9,13,14,30,27,3,11,10,1,27,19,0,0,0,26,2,1,2,2,0,,,
"May 10, 2022 12:00 PM",68,39,29,49,27,22,58,29,29,41,27,14,10,8,2,10,25,25,0,9,7,2,23,20,0,0,0,30,1,3,4,4,0,,,
"May 10, 2022 1:00 PM",65,27,38,65,42,23,67,40,27,61,35,26,16,7,9,11,28,26,2,24,20,4,23,29,0,0,0,28,5,6,6,4,2,,,
"May 10, 2022 2:00 PM",58,23,35,42,22,20,49,21,28,49,22,27,23,17,6,19,19,18,1,31,27,4,14,25,0,0,0,29,3,4,4,3,1,,,
"May 10, 2022 3:00 PM",94,38,56,58,34,24,75,45,30,58,37,21,15,7,8,23,32,31,1,30,24,6,22,40,0,0,0,35,4,2,8,4,4,,,
"May 10, 2022 4:00 PM",162,57,105,79,54,25,109,71,38,94,59,35,22,12,10,35,36,32,4,62,57,5,34,81,0,0,0,56,9,5,7,4,3,,,
"May 10, 2022 5:00 PM",248,59,189,118,68,50,195,115,80,131,86,45,32,15,17,33,47,44,3,109,103,6,44,142,0,0,0,67,6,3,12,7,5,,,
"May 10, 2022 6:00 PM",217,59,158,155,103,52,204,144,60,148,96,52,27,9,18,27,51,46,5,102,99,3,45,133,0,0,0,55,7,8,7,3,4,,,
"May 10, 2022 7:00 PM",131,43,88,86,49,37,113,73,40,73,44,29,18,11,7,12,30,28,2,62,61,1,26,58,0,0,0,28,6,7,13,8,5,,,
"May 10, 2022 8:00 PM",93,32,61,39,26,13,98,47,51,50,28,22,10,5,5,16,26,23,3,35,32,3,23,42,0,0,0,38,4,5,8,3,5,,,
"May 10, 2022 9:00 PM",61,16,45,36,24,12,46,21,25,33,17,16,9,2,7,16,14,12,2,21,21,0,11,16,0,0,0,21,2,1,4,3,1,,,
"May 10, 2022 10:00 PM",35,6,29,15,9,6,18,8,10,12,6,6,2,0,2,0,12,9,3,20,18,2,9,9,0,0,0,8,0,0,4,3,1,,,
"May 10, 2022 11:00 PM",24,5,19,0,0,0,9,4,5,3,0,3,0,0,0,1,7,3,4,10,10,0,3,3,0,0,0,6,0,1,4,1,3,,,
"May 11, 2022 12:00 AM",4,0,4,0,0,0,0,0,0,0,0,0,1,0,1,3,2,1,1,5,5,0,1,3,0,0,0,2,0,0,0,0,0,,,
"May 11, 2022 1:00 AM",5,3,2,0,0,0,3,2,1,0,0,0,0,0,0,3,0,0,0,1,1,0,0,1,0,0,0,1,0,1,0,0,0,,,
"May 11, 2022 2:00 AM",4,2,2,0,0,0,0,0,0,0,0,0,0,0,0,0,0,0,0,1,1,0,0,0,0,0,0,1,0,0,1,1,0,,,
"May 11, 2022 3:00 AM",2,0,2,0,0,0,1,1,0,1,1,0,0,0,0,0,1,1,0,4,4,0,1,0,0,0,0,0,0,0,0,0,0,,,
"May 11, 2022 4:00 AM",2,1,1,0,0,0,1,1,0,1,1,0,0,0,0,2,2,2,0,0,0,0,2,1,0,0,0,2,0,0,0,0,0,,,
"May 11, 2022 5:00 AM",10,7,3,2,1,1,1,0,1,0,0,0,2,2,0,2,11,11,0,1,1,0,11,1,0,0,0,11,0,1,1,1,0,,,
"May 11, 2022 6:00 AM",50,40,10,17,8,9,29,17,12,18,7,11,4,4,0,3,29,28,1,7,5,2,28,14,0,0,0,34,4,3,8,5,3,,,
"May 11, 2022 7:00 AM",161,111,50,77,34,43,101,33,68,73,36,37,17,13,4,16,101,101,0,27,24,3,103,40,0,0,0,112,7,4,11,10,1,,,
"May 11, 2022 8:00 AM",294,221,73,109,31,78,190,56,134,124,43,81,47,31,16,38,177,176,1,46,32,14,174,52,0,0,0,246,9,11,19,15,4,,,
"May 11, 2022 9:00 AM",128,103,25,66,24,42,82,41,41,65,33,32,15,9,6,6,85,82,3,28,20,8,72,30,0,0,0,76,4,8,6,5,1,,,
"May 11, 2022 10:00 AM",53,37,16,58,23,35,57,25,32,58,26,32,7,3,4,16,33,32,1,15,13,2,31,13,0,0,0,30,1,4,2,1,1,,,
"May 11, 2022 11:00 AM",61,35,26,40,18,22,60,18,42,34,13,21,12,4,8,6,26,25,1,12,11,1,19,16,0,0,0,25,3,1,4,3,1,,,
"May 11, 2022 12:00 PM",78,45,33,62,36,26,67,36,31,52,31,21,17,13,4,13,28,27,1,22,16,6,20,24,0,0,0,30,4,4,3,3,0,,,
"May 11, 2022 1:00 PM",67,30,37,54,32,22,78,51,27,73,48,25,27,10,17,20,39,33,6,31,25,6,26,32,0,0,0,28,11,2,8,3,5,,,
"May 11, 2022 2:00 PM",65,22,43,38,20,18,52,34,18,39,21,18,23,11,12,16,29,24,5,27,25,2,19,27,0,0,0,24,8,7,8,2,6,,,
"May 11, 2022 3:00 PM",84,37,47,59,33,26,57,41,16,39,27,12,13,5,8,17,32,29,3,39,29,10,27,38,0,0,0,30,6,4,6,3,3,,,
"May 11, 2022 4:00 PM",127,44,83,74,44,30,93,63,30,77,42,35,20,7,13,25,31,28,3,55,51,4,26,53,0,0,0,44,4,3,9,4,5,,,
"May 11, 2022 5:00 PM",263,67,196,91,51,40,120,69,51,96,52,44,24,9,15,25,43,35,8,108,103,5,33,113,0,0,0,70,6,3,8,5,3,,,
"May 11, 2022 6:00 PM",223,59,164,85,60,25,136,102,34,98,66,32,20,10,10,28,42,38,4,92,89,3,42,119,0,0,0,35,7,1,5,3,2,,,
"May 11, 2022 7:00 PM",133,34,99,65,45,20,124,85,39,93,61,32,7,5,2,15,25,24,1,44,40,4,22,56,0,0,0,35,4,3,12,7,5,,,
"May 11, 2022 8:00 PM",94,42,52,73,41,32,87,41,46,59,28,31,9,5,4,15,16,13,3,26,25,1,13,39,0,0,0,23,3,4,4,2,2,,,
"May 11, 2022 9:00 PM",65,18,47,31,16,15,33,14,19,29,13,16,7,5,2,5,19,12,7,26,25,1,11,25,0,0,0,14,5,3,4,2,2,,,
"May 11, 2022 10:00 PM",40,11,29,9,8,1,14,1,13,10,2,8,10,1,9,4,10,9,1,18,18,0,10,14,0,0,0,9,0,2,6,3,3,,,
"May 11, 2022 11:00 PM",23,3,20,5,4,1,11,8,3,3,2,1,0,0,0,0,4,2,2,6,6,0,3,5,0,0,0,2,0,0,1,0,1,,,
"May 12, 2022 12:00 AM",12,2,10,1,0,1,0,0,0,3,1,2,3,0,3,3,3,1,2,6,6,0,1,3,0,0,0,3,1,1,0,0,0,,,
"May 12, 2022 1:00 AM",5,2,3,1,1,0,4,3,1,1,1,0,0,0,0,0,1,1,0,0,0,0,1,2,0,0,0,1,0,0,0,0,0,,,
"May 12, 2022 2:00 AM",3,3,0,0,0,0,0,0,0,0,0,0,0,0,0,0,0,0,0,0,0,0,0,0,0,0,0,0,0,0,1,1,0,,,
"May 12, 2022 3:00 AM",1,0,1,0,0,0,1,1,0,0,0,0,0,0,0,0,0,0,0,1,1,0,0,0,0,0,0,1,0,0,0,0,0,,,
"May 12, 2022 4:00 AM",4,1,3,0,0,0,1,1,0,1,1,0,1,1,0,0,1,1,0,1,1,0,1,0,0,0,0,2,0,0,0,0,0,,,
"May 12, 2022 5:00 AM",6,5,1,5,3,2,5,3,2,5,4,1,2,1,1,2,9,9,0,1,1,0,9,2,0,0,0,10,0,0,1,1,0,,,
"May 12, 2022 6:00 AM",41,28,13,31,15,16,35,21,14,25,11,14,2,2,0,4,25,25,0,9,7,2,24,14,0,0,0,27,3,7,3,3,0,,,
"May 12, 2022 7:00 AM",144,95,49,72,30,42,130,35,95,81,30,51,12,10,2,20,97,97,0,24,20,4,93,41,0,0,0,127,1,6,4,3,1,,,
"May 12, 2022 8:00 AM",298,239,59,113,40,73,168,56,112,130,58,72,44,25,19,36,177,174,3,54,42,12,176,46,0,0,0,221,7,9,24,20,4,,,
"May 12, 2022 9:00 AM",130,106,24,51,19,32,82,38,44,56,25,31,28,20,8,13,72,71,1,20,16,4,70,39,0,0,0,77,3,6,3,2,1,,,
"May 12, 2022 10:00 AM",60,41,19,51,18,33,72,39,33,52,31,21,17,7,10,7,23,23,0,10,7,3,27,22,0,0,0,29,3,3,1,1,0,,,
"May 12, 2022 11:00 AM",65,35,30,42,20,22,53,21,32,47,24,23,5,3,2,6,23,22,1,12,8,4,20,14,0,0,0,27,0,5,5,1,4,,,
"May 12, 2022 12:00 PM",74,38,36,70,35,35,63,31,32,47,24,23,18,9,9,22,22,20,2,12,10,2,20,22,0,0,0,31,4,4,6,4,2,,,
"May 12, 2022 1:00 PM",69,32,37,44,23,21,63,30,33,51,24,27,17,7,10,9,23,20,3,19,17,2,15,34,0,0,0,18,6,1,7,6,1,,,
"May 12, 2022 2:00 PM",71,24,47,48,29,19,44,26,18,45,30,15,17,5,12,10,16,15,1,19,16,3,14,24,0,0,0,24,3,0,7,3,4,,,
"May 12, 2022 3:00 PM",102,47,55,37,21,16,55,33,22,48,20,28,13,5,8,17,31,29,2,27,20,7,26,40,0,0,0,33,3,7,11,5,6,,,
"May 12, 2022 4:00 PM",131,50,81,51,30,21,85,61,24,67,45,22,29,10,19,25,27,22,5,59,57,2,23,58,0,0,0,42,7,6,7,1,6,,,
"May 12, 2022 5:00 PM",233,61,172,95,36,59,142,105,37,126,93,33,26,16,10,24,44,39,5,99,93,6,41,122,0,0,0,57,6,1,7,7,0,,,
"May 12, 2022 6:00 PM",196,54,142,83,61,22,134,101,33,102,79,23,16,4,12,23,40,37,3,77,77,0,38,119,0,0,0,45,8,3,9,3,6,,,
"May 12, 2022 7:00 PM",126,33,93,55,33,22,51,39,12,59,34,25,11,4,7,23,23,13,10,54,50,4,15,51,0,0,0,32,3,1,10,8,2,,,
"May 12, 2022 8:00 PM",81,26,55,39,25,14,51,23,28,38,20,18,13,4,9,10,11,10,1,35,35,0,10,17,0,0,0,21,1,5,5,2,3,,,
"May 12, 2022 9:00 PM",56,13,43,40,34,6,38,14,24,38,11,27,6,2,4,7,15,15,0,25,24,1,15,12,0,0,0,14,5,1,4,2,2,,,
"May 12, 2022 10:00 PM",33,8,25,27,25,2,26,5,21,24,5,19,7,2,5,1,5,4,1,7,6,1,4,14,0,0,0,12,2,3,4,2,2,,,
"May 12, 2022 11:00 PM",25,7,18,7,7,0,9,3,6,12,1,11,4,0,4,0,7,3,4,6,6,0,3,10,0,0,0,3,0,0,2,2,0,,,
"May 13, 2022 12:00 AM",7,1,6,0,0,0,2,0,2,4,1,3,2,2,0,0,2,1,1,5,5,0,1,8,0,0,0,3,1,0,1,1,0,,,
"May 13, 2022 1:00 AM",5,0,5,2,2,0,3,3,0,2,2,0,0,0,0,0,0,0,0,0,0,0,0,2,0,0,0,4,0,0,0,0,0,,,
"May 13, 2022 2:00 AM",7,5,2,1,1,0,2,1,1,1,1,0,0,0,0,0,0,0,0,3,3,0,0,1,0,0,0,0,0,0,0,0,0,,,
"May 13, 2022 3:00 AM",1,0,1,0,0,0,0,0,0,0,0,0,0,0,0,0,0,0,0,0,0,0,0,0,0,0,0,1,0,1,0,0,0,,,
"May 13, 2022 4:00 AM",3,0,3,0,0,0,1,1,0,1,1,0,0,0,0,0,2,2,0,1,1,0,1,0,0,0,0,4,0,0,1,1,0,,,
"May 13, 2022 5:00 AM",9,8,1,3,1,2,9,5,4,3,3,0,0,0,0,1,9,9,0,1,1,0,10,1,0,0,0,14,0,0,0,0,0,,,
"May 13, 2022 6:00 AM",37,25,12,31,15,16,31,14,17,28,13,15,4,4,0,4,18,18,0,8,6,2,18,7,0,0,0,33,2,4,4,2,2,,,
"May 13, 2022 7:00 AM",104,71,33,60,26,34,75,31,44,44,16,28,16,11,5,15,46,46,0,14,11,3,45,35,0,0,0,69,3,6,7,5,2,,,
"May 13, 2022 8:00 AM",200,148,52,108,35,73,140,49,91,96,47,49,32,24,8,22,109,108,1,40,28,12,108,34,0,0,0,146,8,8,15,13,2,,,
"May 13, 2022 9:00 AM",100,76,24,59,28,31,77,39,38,64,37,27,16,9,7,4,60,60,0,24,19,5,63,23,0,0,0,71,2,5,9,8,1,,,
"May 13, 2022 10:00 AM",55,27,28,39,20,19,56,23,33,26,13,13,18,8,10,7,33,31,2,13,10,3,26,19,0,0,0,30,0,4,3,1,2,,,
"May 13, 2022 11:00 AM",54,32,22,25,8,17,64,27,37,35,17,18,8,3,5,13,23,19,4,11,10,1,16,5,0,0,0,18,5,4,4,2,2,,,
"May 13, 2022 12:00 PM",73,34,39,47,23,24,59,29,30,43,23,20,16,9,7,13,26,25,1,26,22,4,27,18,0,0,0,29,4,3,9,8,1,,,
"May 13, 2022 1:00 PM",86,30,56,66,38,28,64,36,28,51,35,16,14,6,8,7,30,29,1,25,21,4,27,30,0,0,0,25,7,4,8,2,6,,,
"May 13, 2022 2:00 PM",59,31,28,50,28,22,52,30,22,41,23,18,13,9,4,18,29,26,3,31,26,5,26,21,0,0,0,30,6,4,11,5,6,,,
"May 13, 2022 3:00 PM",74,33,41,45,26,19,62,39,23,45,28,17,33,16,17,22,25,21,4,22,20,2,17,32,0,0,0,29,4,2,13,7,6,,,
"May 13, 2022 4:00 PM",157,58,99,81,52,29,91,67,24,89,56,33,31,14,17,28,28,28,0,42,38,4,28,69,0,0,0,43,5,5,8,8,0,,,
"May 13, 2022 5:00 PM",161,51,110,119,64,55,123,72,51,106,63,43,12,3,9,34,28,26,2,70,65,5,30,69,0,0,0,62,9,1,7,4,3,,,
"May 13, 2022 6:00 PM",138,41,97,98,66,32,137,89,48,102,62,40,18,9,9,24,27,26,1,60,55,5,26,76,0,0,0,40,8,4,10,7,3,,,
"May 13, 2022 7:00 PM",102,45,57,87,44,43,94,43,51,78,40,38,12,4,8,16,19,16,3,40,37,3,16,28,0,0,0,34,3,3,6,2,4,,,
"May 13, 2022 8:00 PM",85,39,46,47,24,23,69,32,37,52,22,30,10,6,4,18,18,16,2,19,18,1,13,32,0,0,0,24,5,2,3,1,2,,,
"May 13, 2022 9:00 PM",59,16,43,27,14,13,49,22,27,34,11,23,3,2,1,12,12,10,2,15,14,1,12,11,0,0,0,15,3,2,8,5,3,,,
"May 13, 2022 10:00 PM",30,11,19,10,6,4,25,10,15,16,9,7,4,2,2,5,10,9,1,16,16,0,10,9,0,0,0,13,0,2,3,2,1,,,
"May 13, 2022 11:00 PM",26,4,22,5,4,1,14,7,7,13,3,10,2,2,0,1,5,5,0,9,9,0,4,6,0,0,0,5,0,2,2,1,1,,,
"May 14, 2022 12:00 AM",25,4,21,0,0,0,2,1,1,2,1,1,2,0,2,0,4,3,1,10,10,0,3,5,0,0,0,2,2,1,1,1,0,,,
"May 14, 2022 1:00 AM",12,1,11,6,2,4,6,4,2,10,5,5,3,3,0,0,0,0,0,12,12,0,0,5,0,0,0,5,0,0,1,0,1,,,
"May 14, 2022 2:00 AM",8,4,4,4,1,3,1,1,0,0,0,0,0,0,0,0,2,2,0,3,3,0,2,3,0,0,0,0,0,1,1,1,0,,,
"May 14, 2022 3:00 AM",3,1,2,0,0,0,3,2,1,1,1,0,0,0,0,2,0,0,0,2,2,0,0,0,0,0,0,1,0,0,0,0,0,,,
"May 14, 2022 4:00 AM",2,1,1,0,0,0,2,1,1,1,1,0,0,0,0,1,1,1,0,0,0,0,1,1,0,0,0,0,0,1,0,0,0,,,
"May 14, 2022 5:00 AM",5,3,2,2,2,0,2,1,1,3,2,1,0,0,0,0,1,1,0,2,2,0,2,3,0,0,0,1,1,0,1,1,0,,,
"May 14, 2022 6:00 AM",11,5,6,13,4,9,14,9,5,10,4,6,0,0,0,1,3,2,1,2,2,0,1,9,0,0,0,13,0,2,0,0,0,,,
"May 14, 2022 7:00 AM",43,23,20,46,33,13,48,26,22,32,22,10,2,1,1,4,10,9,1,6,6,0,9,20,0,0,0,28,0,4,1,1,0,,,
"May 14, 2022 8:00 AM",48,33,15,77,40,37,106,66,40,75,46,29,13,7,6,15,14,13,1,16,15,1,15,35,0,0,0,29,1,9,3,3,0,,,
"May 14, 2022 9:00 AM",60,27,33,129,73,56,161,114,47,99,68,31,18,13,5,17,17,16,1,16,15,1,15,52,0,0,0,42,5,7,5,3,2,,,
"May 14, 2022 10:00 AM",79,51,28,167,97,70,221,114,107,144,93,51,18,6,12,19,36,33,3,26,21,5,33,56,0,0,0,44,5,1,5,4,1,,,
"May 14, 2022 11:00 AM",103,55,48,162,78,84,215,132,83,130,71,59,41,27,14,20,34,32,2,19,17,2,26,44,0,0,0,54,9,20,8,3,5,,,
"May 14, 2022 12:00 PM",84,52,32,193,87,106,283,165,118,217,131,86,42,19,23,19,34,33,1,12,11,1,33,71,0,0,0,87,5,6,2,1,1,,,
"May 14, 2022 1:00 PM",87,46,41,146,72,74,207,97,110,145,72,73,42,23,19,12,36,33,3,17,15,2,31,40,0,0,0,69,8,4,5,2,3,,,
"May 14, 2022 2:00 PM",102,59,43,107,48,59,147,71,76,108,57,51,30,20,10,14,39,37,2,22,20,2,36,38,0,0,0,78,8,2,5,4,1,,,
"May 14, 2022 3:00 PM",67,34,33,109,51,58,158,56,102,116,44,72,17,10,7,17,31,30,1,11,10,1,26,39,0,0,0,56,3,3,4,2,2,,,
"May 14, 2022 4:00 PM",69,32,37,89,45,44,130,60,70,94,45,49,22,17,5,12,23,23,0,15,13,2,18,18,0,0,0,32,5,2,8,5,3,,,
"May 14, 2022 5:00 PM",82,16,66,102,54,48,123,49,74,106,42,64,25,8,17,14,21,18,3,18,18,0,22,41,0,0,0,32,7,0,5,3,2,,,
"May 14, 2022 6:00 PM",62,30,32,60,42,18,83,34,49,47,20,27,16,6,10,18,22,19,3,17,17,0,19,22,0,0,0,30,4,2,4,2,2,,,
"May 14, 2022 7:00 PM",67,26,41,39,13,26,60,23,37,41,14,27,12,4,8,6,18,17,1,13,12,1,18,22,0,0,0,25,1,1,5,1,4,,,
"May 14, 2022 8:00 PM",48,19,29,30,22,8,46,29,17,37,22,15,3,1,2,1,10,9,1,8,6,2,12,21,0,0,0,17,1,2,7,5,2,,,
"May 14, 2022 9:00 PM",41,16,25,13,2,11,24,11,13,16,6,10,6,5,1,1,12,11,1,5,5,0,12,9,0,0,0,13,1,0,7,1,6,,,
"May 14, 2022 10:00 PM",27,8,19,5,3,2,13,2,11,8,3,5,8,4,4,2,5,5,0,8,7,1,6,8,0,0,0,6,1,1,5,2,3,,,
"May 14, 2022 11:00 PM",21,7,14,3,2,1,8,4,4,8,3,5,4,4,0,4,7,6,1,7,7,0,5,5,0,0,0,2,0,0,0,0,0,,,
"May 15, 2022 12:00 AM",11,4,7,0,0,0,4,2,2,8,2,6,1,1,0,1,2,1,1,6,6,0,3,4,0,0,0,12,0,1,2,1,1,,,
"May 15, 2022 1:00 AM",11,5,6,2,0,2,8,1,7,4,0,4,1,1,0,0,1,1,0,6,6,0,1,4,0,0,0,4,0,1,1,1,0,,,
"May 15, 2022 2:00 AM",7,5,2,0,0,0,2,2,0,1,1,0,0,0,0,0,0,0,0,6,6,0,0,3,0,0,0,0,0,0,1,1,0,,,
"May 15, 2022 3:00 AM",3,2,1,0,0,0,1,0,1,0,0,0,2,0,2,0,0,0,0,3,3,0,0,2,0,0,0,0,0,0,0,0,0,,,
"May 15, 2022 4:00 AM",2,1,1,0,0,0,0,0,0,0,0,0,0,0,0,1,0,0,0,1,1,0,0,1,0,0,0,1,0,0,0,0,0,,,
"May 15, 2022 5:00 AM",1,1,0,0,0,0,2,2,0,1,0,1,0,0,0,0,0,0,0,1,1,0,0,3,0,0,0,2,0,0,2,2,0,,,
"May 15, 2022 6:00 AM",3,1,2,8,3,5,9,3,6,6,3,3,0,0,0,0,6,5,1,2,1,1,7,5,0,0,0,7,0,2,0,0,0,,,
"May 15, 2022 7:00 AM",19,6,13,32,22,10,29,17,12,34,24,10,2,0,2,2,12,11,1,2,1,1,9,16,0,0,0,19,2,7,1,0,1,,,
"May 15, 2022 8:00 AM",36,13,23,60,40,20,82,55,27,68,48,20,7,4,3,6,9,9,0,10,10,0,14,30,0,0,0,25,3,12,2,1,1,,,
"May 15, 2022 9:00 AM",47,22,25,123,62,61,130,74,56,105,61,44,14,7,7,12,17,17,0,11,11,0,17,31,0,0,0,40,2,7,2,2,0,,,
"May 15, 2022 10:00 AM",70,43,27,208,128,80,258,166,92,192,135,57,30,11,19,16,15,15,0,15,14,1,16,37,0,0,0,52,8,8,2,1,1,,,
"May 15, 2022 11:00 AM",54,34,20,284,163,121,322,202,120,232,164,68,47,33,14,17,27,25,2,18,16,2,22,54,0,0,0,60,10,4,6,4,2,,,
"May 15, 2022 12:00 PM",89,45,44,303,177,126,334,205,129,263,173,90,42,14,28,40,24,21,3,16,15,1,23,69,0,0,0,49,9,1,6,3,3,,,
"May 15, 2022 1:00 PM",67,33,34,270,134,136,277,128,149,238,131,107,27,20,7,27,22,20,2,22,16,6,22,46,0,0,0,54,7,8,4,4,0,,,
"May 15, 2022 2:00 PM",71,37,34,193,99,94,203,103,100,170,102,68,29,17,12,28,23,22,1,19,19,0,17,35,0,0,0,50,7,0,8,8,0,,,
"May 15, 2022 3:00 PM",57,30,27,212,87,125,195,86,109,181,73,108,28,16,12,19,22,21,1,14,12,2,19,31,0,0,0,37,5,3,3,3,0,,,
"May 15, 2022 4:00 PM",90,40,50,146,60,86,162,51,111,155,50,105,24,19,5,24,18,16,2,25,21,4,20,28,0,0,0,54,3,6,7,3,4,,,
"May 15, 2022 5:00 PM",52,23,29,86,50,36,108,36,72,88,30,58,22,6,16,20,21,20,1,18,13,5,18,18,0,0,0,43,3,2,2,2,0,,,
"May 15, 2022 6:00 PM",64,29,35,64,30,34,81,31,50,70,27,43,5,3,2,19,10,10,0,11,11,0,13,22,0,0,0,36,5,2,8,5,3,,,
"May 15, 2022 7:00 PM",54,21,33,48,21,27,44,24,20,39,16,23,14,3,11,18,11,11,0,12,10,2,11,23,0,0,0,13,2,2,2,1,1,,,
"May 15, 2022 8:00 PM",38,15,23,37,19,18,38,16,22,24,15,9,0,0,0,8,19,18,1,17,16,1,18,6,0,0,0,19,2,1,0,0,0,,,
"May 15, 2022 9:00 PM",24,7,17,9,4,5,29,15,14,17,11,6,3,1,2,9,13,12,1,8,8,0,13,8,0,0,0,12,1,0,1,1,0,,,
"May 15, 2022 10:00 PM",24,11,13,4,0,4,7,1,6,3,0,3,4,3,1,0,5,5,0,3,3,0,6,2,0,0,0,4,3,2,1,1,0,,,
"May 15, 2022 11:00 PM",17,6,11,3,1,2,5,1,4,4,1,3,3,1,2,0,7,7,0,2,2,0,8,3,0,0,0,2,0,0,3,2,1,,,
"May 16, 2022 12:00 AM",6,0,6,0,0,0,1,1,0,0,0,0,0,0,0,1,1,1,0,2,2,0,1,4,0,0,0,3,0,0,0,0,0,,,
"May 16, 2022 1:00 AM",3,1,2,0,0,0,4,1,3,0,0,0,0,0,0,0,0,0,0,1,1,0,0,3,0,0,0,2,0,0,0,0,0,,,
"May 16, 2022 2:00 AM",4,2,2,0,0,0,0,0,0,0,0,0,0,0,0,0,0,0,0,0,0,0,0,0,0,0,0,0,0,0,0,0,0,,,
"May 16, 2022 3:00 AM",0,0,0,0,0,0,2,1,1,2,1,1,0,0,0,0,0,0,0,0,0,0,0,1,0,0,0,0,0,0,0,0,0,,,
"May 16, 2022 4:00 AM",1,0,1,1,0,1,0,0,0,0,0,0,1,1,0,1,2,2,0,1,1,0,2,0,0,0,0,0,0,0,0,0,0,,,
"May 16, 2022 5:00 AM",6,4,2,1,1,0,2,0,2,1,0,1,0,0,0,1,8,8,0,1,1,0,7,2,0,0,0,9,2,2,0,0,0,,,
"May 16, 2022 6:00 AM",39,25,14,8,3,5,12,5,7,12,5,7,2,2,0,5,22,22,0,4,2,2,22,6,0,0,0,26,1,6,4,3,1,,,
"May 16, 2022 7:00 AM",117,85,32,49,14,35,67,19,48,44,16,28,10,10,0,10,61,61,0,19,14,5,62,26,0,0,0,100,1,1,7,6,1,,,
"May 16, 2022 8:00 AM",240,187,53,71,15,56,119,33,86,89,31,58,21,9,12,25,130,128,2,37,28,9,124,44,0,0,0,157,8,4,13,10,3,,,
"May 16, 2022 9:00 AM",102,86,16,38,17,21,60,36,24,36,26,10,17,15,2,11,57,57,0,23,19,4,54,23,0,0,0,47,0,2,3,3,0,,,
"May 16, 2022 10:00 AM",58,36,22,45,17,28,47,20,27,43,18,25,5,2,3,13,25,25,0,8,4,4,24,11,0,0,0,23,1,0,0,0,0,,,
"May 16, 2022 11:00 AM",51,33,18,30,11,19,49,27,22,28,17,11,7,6,1,9,13,12,1,10,8,2,12,14,0,0,0,15,2,2,3,1,2,,,
"May 16, 2022 12:00 PM",64,31,33,43,24,19,57,37,20,31,22,9,18,9,9,12,9,8,1,18,17,1,7,17,0,0,0,23,4,7,7,5,2,,,
"May 16, 2022 1:00 PM",74,33,41,24,13,11,60,28,32,33,15,18,13,1,12,14,15,15,0,21,17,4,16,18,0,0,0,25,3,2,4,2,2,,,
"May 16, 2022 2:00 PM",43,21,22,28,15,13,55,29,26,30,16,14,15,13,2,9,17,15,2,19,15,4,13,19,0,0,0,23,3,0,3,3,0,,,
"May 16, 2022 3:00 PM",69,23,46,43,18,25,80,49,31,50,28,22,6,2,4,19,33,31,2,29,20,9,25,35,0,0,0,33,3,2,4,4,0,,,
"May 16, 2022 4:00 PM",118,43,75,75,49,26,95,62,33,77,53,24,24,12,12,20,33,27,6,47,44,3,26,64,0,0,0,45,13,2,13,9,4,,,
"May 16, 2022 5:00 PM",209,56,153,87,51,36,134,72,62,96,52,44,14,6,8,23,30,28,2,92,89,3,29,104,0,0,0,77,3,14,10,3,7,,,
"May 16, 2022 6:00 PM",188,46,142,104,66,38,139,97,42,117,75,42,20,10,10,20,28,23,5,72,70,2,23,130,0,0,0,44,6,2,13,8,5,,,
"May 16, 2022 7:00 PM",106,31,75,117,73,44,138,82,56,106,60,46,11,2,9,28,28,25,3,45,41,4,23,54,0,0,0,37,3,4,9,6,3,,,
"May 16, 2022 8:00 PM",72,26,46,96,43,53,103,40,63,82,40,42,14,9,5,9,17,17,0,18,16,2,13,21,0,0,0,35,4,1,6,1,5,,,
"May 16, 2022 9:00 PM",57,12,45,33,15,18,35,11,24,26,8,18,3,2,1,9,14,14,0,20,18,2,16,15,0,0,0,27,4,1,4,4,0,,,
"May 16, 2022 10:00 PM",35,15,20,10,2,8,21,9,12,9,5,4,3,1,2,4,5,3,2,6,6,0,2,8,0,0,0,7,1,3,6,4,2,,,
"May 16, 2022 11:00 PM",13,5,8,3,2,1,7,6,1,4,3,1,1,0,1,2,3,2,1,6,6,0,2,6,0,0,0,2,0,0,0,0,0,,,
"May 17, 2022 12:00 AM",7,1,6,1,0,1,0,0,0,5,3,2,2,2,0,0,0,0,0,3,3,0,1,4,0,0,0,5,0,0,0,0,0,,,
"May 17, 2022 1:00 AM",2,0,2,1,0,1,2,1,1,1,0,1,0,0,0,0,1,1,0,1,0,1,1,2,0,0,0,2,0,0,0,0,0,,,
"May 17, 2022 2:00 AM",3,3,0,1,0,1,1,0,1,1,0,1,0,0,0,0,0,0,0,0,0,0,0,0,0,0,0,3,0,0,0,0,0,,,
"May 17, 2022 3:00 AM",2,0,2,0,0,0,0,0,0,1,1,0,0,0,0,0,0,0,0,0,0,0,0,1,0,0,0,0,0,0,0,0,0,,,
"May 17, 2022 4:00 AM",4,0,4,0,0,0,0,0,0,0,0,0,0,0,0,0,2,2,0,1,1,0,2,0,0,0,0,2,0,0,0,0,0,,,
"May 17, 2022 5:00 AM",8,5,3,1,0,1,3,2,1,5,3,2,1,1,0,3,11,11,0,1,1,0,11,2,0,0,0,5,0,0,0,0,0,,,
"May 17, 2022 6:00 AM",49,31,18,23,11,12,19,11,8,28,12,16,0,0,0,5,23,22,1,8,7,1,21,10,0,0,0,38,1,6,5,4,1,,,
"May 17, 2022 7:00 AM",145,102,43,57,16,41,85,25,60,57,21,36,10,7,3,15,83,82,1,23,18,5,79,50,0,0,0,100,3,5,7,5,2,,,
"May 17, 2022 8:00 AM",250,185,65,99,32,67,139,40,99,96,35,61,25,18,7,37,159,156,3,48,40,8,154,40,0,0,0,193,8,7,13,13,0,,,
"May 17, 2022 9:00 AM",135,111,24,52,27,25,75,33,42,54,32,22,16,8,8,11,64,64,0,20,13,7,67,30,0,0,0,59,7,4,3,2,1,,,
"May 17, 2022 10:00 AM",60,45,15,39,17,22,48,27,21,24,12,12,7,5,2,5,20,18,2,9,6,3,18,13,0,0,0,20,3,3,2,2,0,,,
"May 17, 2022 11:00 AM",49,30,19,23,16,7,47,27,20,27,17,10,9,2,7,11,13,13,0,14,13,1,12,11,0,0,0,38,1,2,8,5,3,,,
"May 17, 2022 12:00 PM",62,30,32,32,12,20,41,21,20,34,19,15,7,3,4,17,10,9,1,12,11,1,15,8,0,0,0,22,3,1,5,3,2,,,
"May 17, 2022 1:00 PM",50,23,27,27,10,17,35,21,14,31,17,14,15,3,12,7,15,13,2,23,20,3,11,20,0,0,0,16,2,0,5,3,2,,,
"May 17, 2022 2:00 PM",47,12,35,18,10,8,20,7,13,15,5,10,12,11,1,10,14,12,2,23,22,1,9,17,0,0,0,15,2,0,7,3,4,,,
"May 17, 2022 3:00 PM",47,19,28,13,7,6,21,18,3,14,9,5,4,0,4,9,15,14,1,17,12,5,11,18,0,0,0,18,5,1,6,2,4,,,
"May 17, 2022 4:00 PM",89,27,62,22,17,5,28,19,9,27,19,8,2,0,2,7,18,15,3,42,39,3,16,31,0,0,0,20,3,1,9,2,7,,,
"May 17, 2022 5:00 PM",185,35,150,40,26,14,67,44,23,57,37,20,10,3,7,9,35,32,3,64,61,3,32,84,0,0,0,44,1,3,4,3,1,,,
"May 17, 2022 6:00 PM",168,38,130,49,37,12,71,57,14,72,57,15,5,1,4,11,36,34,2,98,93,5,34,98,0,0,0,34,4,3,7,6,1,,,
"May 17, 2022 7:00 PM",93,26,67,44,26,18,52,39,13,44,26,18,6,1,5,21,20,17,3,40,40,0,18,46,0,0,0,10,1,4,8,6,2,,,
"May 17, 2022 8:00 PM",71,26,45,34,13,21,48,27,21,40,19,21,2,0,2,14,16,16,0,21,21,0,16,21,0,0,0,17,2,2,2,0,2,,,
"May 17, 2022 9:00 PM",34,8,26,32,20,12,36,16,20,28,14,14,5,2,3,6,16,14,2,11,11,0,17,12,0,0,0,16,4,2,6,5,1,,,
"May 17, 2022 10:00 PM",32,12,20,11,11,0,19,10,9,9,6,3,5,2,3,4,6,5,1,13,12,1,3,10,0,0,0,5,2,0,6,3,3,,,
"May 17, 2022 11:00 PM",7,1,6,5,5,0,7,5,2,3,2,1,2,1,1,1,1,0,1,3,2,1,1,3,0,0,0,6,0,0,0,0,0,,,
"May 18, 2022 12:00 AM",6,2,4,0,0,0,1,1,0,2,2,0,0,0,0,0,4,3,1,2,2,0,3,1,0,0,0,0,0,0,0,0,0,,,
"May 18, 2022 1:00 AM",4,0,4,0,0,0,1,1,0,0,0,0,1,0,1,0,1,0,1,3,3,0,0,0,0,0,0,1,0,0,0,0,0,,,
"May 18, 2022 2:00 AM",2,2,0,1,0,1,0,0,0,0,0,0,0,0,0,0,0,0,0,0,0,0,0,0,0,0,0,2,0,0,0,0,0,,,
"May 18, 2022 3:00 AM",0,0,0,0,0,0,0,0,0,0,0,0,0,0,0,0,0,0,0,0,0,0,0,1,0,0,0,0,0,0,0,0,0,,,
"May 18, 2022 4:00 AM",4,2,2,1,0,1,2,1,1,1,0,1,0,0,0,0,3,3,0,1,1,0,3,1,0,0,0,3,0,0,1,1,0,,,
"May 18, 2022 5:00 AM",5,2,3,2,1,1,5,2,3,4,2,2,2,2,0,3,10,10,0,2,2,0,10,3,0,0,0,11,0,0,1,1,0,,,
"May 18, 2022 6:00 AM",46,32,14,32,17,15,38,27,11,34,21,13,3,2,1,1,28,28,0,7,7,0,29,12,0,0,0,37,3,4,3,2,1,,,
"May 18, 2022 7:00 AM",136,98,38,87,32,55,100,31,69,80,30,50,14,8,6,18,83,82,1,23,18,5,85,41,0,0,0,118,4,5,6,4,2,,,
"May 18, 2022 8:00 AM",267,197,70,108,26,82,160,40,120,134,44,90,26,11,15,34,140,138,2,53,33,20,143,51,0,0,0,232,5,5,18,13,5,,,
"May 18, 2022 9:00 AM",115,89,26,72,39,33,78,43,35,65,37,28,16,9,7,38,88,88,0,19,17,2,75,24,0,0,0,81,5,4,5,3,2,,,
"May 18, 2022 10:00 AM",63,37,26,51,17,34,65,21,44,49,18,31,14,10,4,41,26,25,1,13,9,4,22,16,0,0,0,34,6,3,3,3,0,,,
"May 18, 2022 11:00 AM",55,36,19,79,35,44,73,40,33,60,32,28,11,3,8,46,20,17,3,10,9,1,17,22,0,0,0,27,4,3,2,1,1,,,
"May 18, 2022 12:00 PM",64,33,31,54,27,27,64,21,43,45,18,27,18,8,10,9,25,24,1,22,19,3,20,24,0,0,0,32,6,2,1,0,1,,,
"May 18, 2022 1:00 PM",71,25,46,47,29,18,68,46,22,56,39,17,22,13,9,8,36,33,3,22,18,4,29,33,0,0,0,23,3,2,6,2,4,,,
"May 18, 2022 2:00 PM",54,25,29,28,16,12,52,34,18,36,24,12,16,11,5,14,23,21,2,27,22,5,21,22,0,0,0,17,7,8,12,8,4,,,
"May 18, 2022 3:00 PM",95,35,60,30,19,11,45,27,18,31,18,13,13,6,7,22,20,19,1,35,26,9,19,37,0,0,0,27,3,6,9,5,4,,,
"May 18, 2022 4:00 PM",130,42,88,49,30,19,77,49,28,70,39,31,9,4,5,31,22,17,5,45,40,5,23,42,0,0,0,39,5,2,6,5,1,,,
"May 18, 2022 5:00 PM",193,53,140,60,40,20,100,63,37,84,52,32,32,13,19,30,40,35,5,107,102,5,35,130,0,0,0,55,3,8,9,5,4,,,
"May 18, 2022 6:00 PM",210,62,148,74,51,23,112,79,33,84,57,27,18,8,10,21,41,40,1,103,97,6,38,113,0,0,0,37,7,6,12,6,6,,,
"May 18, 2022 7:00 PM",81,21,60,47,28,19,79,52,27,59,36,23,9,3,6,15,14,13,1,34,34,0,14,60,0,0,0,31,2,1,5,3,2,,,
"May 18, 2022 8:00 PM",57,12,45,17,11,6,33,20,13,24,11,13,3,0,3,6,8,6,2,20,18,2,9,23,0,0,0,17,6,1,5,5,0,,,
"May 18, 2022 9:00 PM",45,11,34,12,9,3,24,13,11,14,10,4,4,1,3,4,11,9,2,13,11,2,10,7,0,0,0,19,0,1,5,1,4,,,
"May 18, 2022 10:00 PM",25,9,16,7,3,4,8,5,3,9,3,6,3,2,1,2,10,9,1,12,10,2,8,11,0,0,0,7,2,1,2,0,2,,,
"May 18, 2022 11:00 PM",8,1,7,3,3,0,12,6,6,11,5,6,2,1,1,0,3,3,0,7,6,1,3,8,0,0,0,4,0,1,1,1,0,,,
"May 19, 2022 12:00 AM",12,4,8,0,0,0,2,2,0,2,2,0,0,0,0,0,3,2,1,4,3,1,2,3,0,0,0,3,0,0,1,1,0,,,
"May 19, 2022 1:00 AM",0,0,0,0,0,0,0,0,0,0,0,0,0,0,0,0,1,0,1,1,1,0,0,2,0,0,0,0,0,0,0,0,0,,,
"May 19, 2022 2:00 AM",3,3,0,0,0,0,0,0,0,0,0,0,0,0,0,0,0,0,0,1,1,0,0,0,0,0,0,0,0,0,0,0,0,,,
"May 19, 2022 3:00 AM",0,0,0,0,0,0,0,0,0,0,0,0,0,0,0,0,0,0,0,0,0,0,0,0,0,0,0,2,0,0,0,0,0,,,
"May 19, 2022 4:00 AM",3,1,2,0,0,0,1,1,0,3,3,0,0,0,0,0,1,1,0,0,0,0,1,0,0,0,0,2,0,0,1,1,0,,,
"May 19, 2022 5:00 AM",10,8,2,4,3,1,2,1,1,4,1,3,0,0,0,3,9,9,0,1,1,0,9,2,0,0,0,8,0,0,0,0,0,,,
"May 19, 2022 6:00 AM",48,29,19,32,16,16,37,20,17,29,18,11,1,1,0,4,26,26,0,12,11,1,24,16,0,0,0,26,2,4,3,2,1,,,
"May 19, 2022 7:00 AM",135,94,41,70,21,49,100,24,76,76,22,54,9,8,1,17,90,90,0,20,17,3,88,45,0,0,0,117,4,5,4,4,0,,,
"May 19, 2022 8:00 AM",301,215,86,106,38,68,169,51,118,118,46,72,40,25,15,29,176,175,1,53,40,13,183,49,0,0,0,223,3,9,17,14,3,,,
"May 19, 2022 9:00 AM",139,114,25,72,36,36,96,52,44,76,44,32,20,15,5,10,70,69,1,21,16,5,56,36,0,0,0,87,7,8,4,4,0,,,
"May 19, 2022 10:00 AM",74,48,26,87,35,52,93,51,42,80,45,35,12,8,4,10,40,38,2,11,10,1,32,26,0,0,0,33,3,4,1,1,0,,,
"May 19, 2022 11:00 AM",50,29,21,74,41,33,100,47,53,64,35,29,15,4,11,10,27,26,1,11,10,1,30,12,0,0,0,31,1,6,2,2,0,,,
"May 19, 2022 12:00 PM",64,30,34,76,35,41,88,42,46,57,28,29,12,5,7,17,18,16,2,25,24,1,16,23,0,0,0,27,3,2,1,1,0,,,
"May 19, 2022 1:00 PM",117,60,57,68,41,27,115,70,45,69,41,28,14,7,7,11,24,22,2,25,20,5,22,35,0,0,0,30,8,3,5,4,1,,,
"May 19, 2022 2:00 PM",50,21,29,56,29,27,75,40,35,57,32,25,18,10,8,14,18,18,0,22,20,2,14,38,0,0,0,25,5,5,9,3,6,,,
"May 19, 2022 3:00 PM",95,29,66,77,40,37,83,43,40,61,33,28,11,5,6,14,41,35,6,30,24,6,27,43,0,0,0,42,4,0,9,6,3,,,
"May 19, 2022 4:00 PM",144,51,93,86,54,32,113,77,36,107,67,40,16,7,9,25,34,31,3,51,48,3,34,70,0,0,0,60,7,6,11,7,4,,,
"May 19, 2022 5:00 PM",242,67,175,139,61,78,234,150,84,177,126,51,30,12,18,22,39,34,5,121,116,5,34,126,0,0,0,62,3,5,6,4,2,,,
"May 19, 2022 6:00 PM",189,60,129,140,85,55,189,130,59,142,102,40,27,8,19,25,36,32,4,84,81,3,39,108,0,0,0,67,6,9,9,7,2,,,
"May 19, 2022 7:00 PM",125,46,79,102,59,43,139,81,58,107,61,46,16,9,7,18,26,24,2,54,48,6,24,77,0,0,0,46,4,5,13,8,5,,,
"May 19, 2022 8:00 PM",79,25,54,80,36,44,87,35,52,70,27,43,11,5,6,14,15,15,0,30,30,0,14,36,0,0,0,33,2,4,4,2,2,,,
"May 19, 2022 9:00 PM",55,16,39,55,35,20,69,18,51,66,16,50,12,3,9,7,19,16,3,24,24,0,17,17,0,0,0,23,3,3,11,8,3,,,
"May 19, 2022 10:00 PM",39,11,28,32,27,5,38,7,31,22,3,19,9,2,7,4,6,5,1,16,16,0,7,14,0,0,0,16,1,2,4,4,0,,,
"May 19, 2022 11:00 PM",26,8,18,9,7,2,16,7,9,15,6,9,2,0,2,3,5,5,0,7,6,1,5,14,0,0,0,7,0,0,4,2,2,,,
"May 20, 2022 12:00 AM",13,2,11,0,0,0,0,0,0,2,0,2,5,2,3,1,1,1,0,9,9,0,1,5,0,0,0,5,0,0,6,3,3,,,
"May 20, 2022 1:00 AM",7,2,5,2,1,1,2,1,1,1,0,1,0,0,0,0,2,2,0,2,2,0,3,4,0,0,0,4,1,0,2,1,1,,,
"May 20, 2022 2:00 AM",4,3,1,0,0,0,0,0,0,0,0,0,2,0,2,0,0,0,0,3,3,0,0,3,0,0,0,1,0,0,1,1,0,,,
"May 20, 2022 3:00 AM",0,0,0,0,0,0,1,0,1,1,0,1,0,0,0,0,0,0,0,3,3,0,0,0,0,0,0,1,0,0,0,0,0,,,
"May 20, 2022 4:00 AM",5,1,4,1,0,1,3,1,2,1,0,1,0,0,0,0,1,1,0,1,1,0,1,1,0,0,0,1,0,1,0,0,0,,,
"May 20, 2022 5:00 AM",10,8,2,2,2,0,4,3,1,4,4,0,0,0,0,1,8,8,0,1,1,0,9,5,0,0,0,10,0,0,1,1,0,,,
"May 20, 2022 6:00 AM",41,25,16,24,12,12,29,17,12,17,9,8,3,2,1,5,19,19,0,11,9,2,17,7,0,0,0,35,1,1,3,2,1,,,
"May 20, 2022 7:00 AM",88,62,26,58,22,36,85,21,64,53,18,35,5,4,1,14,65,64,1,13,11,2,62,34,0,0,0,77,2,1,4,3,1,,,
"May 20, 2022 8:00 AM",196,138,58,83,35,48,130,43,87,93,49,44,29,17,12,24,93,93,0,30,24,6,98,48,0,0,0,126,2,3,15,13,2,,,
"May 20, 2022 9:00 AM",97,67,30,70,33,37,75,45,30,68,37,31,7,4,3,9,53,53,0,18,15,3,47,19,0,0,0,58,4,5,9,5,4,,,
"May 20, 2022 10:00 AM",61,40,21,54,23,31,43,18,25,40,20,20,12,9,3,9,19,17,2,16,13,3,17,17,0,0,0,30,4,3,3,3,0,,,
"May 20, 2022 11:00 AM",69,39,30,32,13,19,50,22,28,36,20,16,9,5,4,4,24,24,0,9,6,3,24,21,0,0,0,33,3,2,4,4,0,,,
"May 20, 2022 12:00 PM",50,21,29,29,14,15,37,17,20,31,12,19,11,4,7,4,16,15,1,20,17,3,15,13,0,0,0,12,3,2,10,4,6,,,
"May 20, 2022 1:00 PM",66,34,32,26,18,8,31,24,7,31,18,13,9,4,5,9,11,11,0,18,13,5,13,29,0,0,0,13,3,0,6,4,2,,,
"May 20, 2022 2:00 PM",54,33,21,27,15,12,39,25,14,38,27,11,12,8,4,11,18,16,2,13,11,2,13,24,0,0,0,15,2,0,4,3,1,,,
"May 20, 2022 3:00 PM",74,36,38,31,22,9,60,33,27,38,22,16,7,2,5,16,14,12,2,14,12,2,9,30,0,0,0,28,6,3,5,3,2,,,
"May 20, 2022 4:00 PM",114,37,77,56,36,20,77,54,23,61,39,22,20,8,12,14,22,20,2,32,28,4,22,45,0,0,0,33,5,2,12,7,5,,,
"May 20, 2022 5:00 PM",161,56,105,81,50,31,117,73,44,84,57,27,13,6,7,25,28,28,0,64,62,2,28,73,0,0,0,42,4,4,7,4,3,,,
"May 20, 2022 6:00 PM",106,35,71,60,44,16,115,68,47,69,45,24,11,6,5,22,25,23,2,56,51,5,23,65,0,0,0,37,6,3,10,9,1,,,
"May 20, 2022 7:00 PM",81,31,50,54,26,28,64,41,23,56,33,23,15,5,10,10,19,16,3,23,20,3,16,37,0,0,0,23,4,1,5,1,4,,,
"May 20, 2022 8:00 PM",64,25,39,56,28,28,49,24,25,48,23,25,8,6,2,4,19,18,1,18,16,2,18,17,0,0,0,27,2,0,9,5,4,,,
"May 20, 2022 9:00 PM",41,13,28,19,11,8,25,8,17,14,5,9,5,2,3,10,10,9,1,14,13,1,13,12,0,0,0,18,3,2,10,5,5,,,
"May 20, 2022 10:00 PM",25,13,12,7,3,4,12,4,8,8,2,6,0,0,0,0,5,5,0,10,10,0,4,6,0,0,0,7,2,4,2,0,2,,,
"May 20, 2022 11:00 PM",32,5,27,7,5,2,12,5,7,7,2,5,0,0,0,0,5,5,0,10,10,0,4,10,0,0,0,8,0,2,2,2,0,,,
"May 21, 2022 12:00 AM",7,0,7,2,2,0,3,3,0,6,5,1,0,0,0,1,1,1,0,9,9,0,1,6,0,0,0,3,1,1,0,0,0,,,
"May 21, 2022 1:00 AM",7,0,7,2,1,1,3,2,1,3,2,1,0,0,0,0,0,0,0,2,2,0,0,1,0,0,0,1,4,0,0,0,0,,,
"May 21, 2022 2:00 AM",11,2,9,0,0,0,1,1,0,0,0,0,0,0,0,0,0,0,0,3,3,0,0,0,0,0,0,2,0,0,0,0,0,,,
"May 21, 2022 3:00 AM",5,1,4,0,0,0,0,0,0,1,0,1,0,0,0,1,0,0,0,2,2,0,1,2,0,0,0,0,0,0,0,0,0,,,
"May 21, 2022 4:00 AM",3,2,1,0,0,0,1,1,0,0,0,0,0,0,0,0,0,0,0,2,2,0,0,0,0,0,0,1,0,0,0,0,0,,,
"May 21, 2022 5:00 AM",2,2,0,2,1,1,0,0,0,4,2,2,0,0,0,0,3,3,0,2,2,0,3,6,0,0,0,4,1,0,0,0,0,,,
"May 21, 2022 6:00 AM",11,7,4,7,4,3,12,8,4,7,5,2,0,0,0,2,6,5,1,2,2,0,4,7,0,0,0,9,1,4,0,0,0,,,
"May 21, 2022 7:00 AM",21,8,13,28,19,9,32,19,13,25,19,6,4,0,4,2,12,12,0,4,3,1,12,12,0,0,0,16,0,1,0,0,0,,,
"May 21, 2022 8:00 AM",50,30,20,49,24,25,52,32,20,52,38,14,12,7,5,13,14,13,1,4,3,1,13,19,0,0,0,21,2,6,2,1,1,,,
"May 21, 2022 9:00 AM",58,28,30,79,34,45,89,61,28,79,54,25,12,8,4,5,16,15,1,20,16,4,17,24,0,0,0,33,3,17,5,5,0,,,
"May 21, 2022 10:00 AM",56,34,22,100,49,51,102,59,43,85,58,27,24,13,11,19,27,26,1,12,11,1,23,46,0,0,0,39,7,7,7,5,2,,,
"May 21, 2022 11:00 AM",55,31,24,151,76,75,114,67,47,111,67,44,33,25,8,9,31,31,0,12,10,2,31,38,0,0,0,25,9,7,6,4,2,,,
"May 21, 2022 12:00 PM",63,31,32,151,55,96,147,80,67,132,76,56,24,12,12,28,32,30,2,11,10,1,28,55,0,0,0,47,5,4,8,7,1,,,
"May 21, 2022 1:00 PM",54,34,20,115,52,63,100,56,44,112,68,44,23,10,13,15,22,19,3,22,21,1,15,25,0,0,0,52,6,7,11,3,8,,,
"May 21, 2022 2:00 PM",67,28,39,104,62,42,123,71,52,115,62,53,25,19,6,27,21,20,1,10,9,1,19,33,0,0,0,35,4,5,9,5,4,,,
"May 21, 2022 3:00 PM",72,38,34,83,43,40,143,81,62,91,54,37,19,5,14,28,24,20,4,25,21,4,21,28,0,0,0,45,7,2,1,0,1,,,
"May 21, 2022 4:00 PM",68,41,27,123,67,56,135,64,71,100,48,52,18,12,6,29,14,14,0,21,19,2,16,28,0,0,0,39,3,1,2,1,1,,,
"May 21, 2022 5:00 PM",67,35,32,89,41,48,125,37,88,87,28,59,24,11,13,28,18,15,3,15,11,4,14,23,0,0,0,32,6,5,9,5,4,,,
"May 21, 2022 6:00 PM",70,34,36,72,34,38,78,26,52,75,26,49,30,10,20,17,19,19,0,10,10,0,22,13,0,0,0,45,8,1,4,3,1,,,
"May 21, 2022 7:00 PM",59,25,34,25,13,12,42,15,27,49,20,29,6,0,6,5,19,17,2,12,11,1,13,15,0,0,0,30,7,2,4,3,1,,,
"May 21, 2022 8:00 PM",30,18,12,28,12,16,32,14,18,25,10,15,10,4,6,6,8,7,1,11,10,1,10,14,0,0,0,11,1,2,3,1,2,,,
"May 21, 2022 9:00 PM",38,13,25,12,4,8,23,13,10,21,9,12,7,5,2,3,11,11,0,10,10,0,12,12,0,0,0,16,2,1,1,1,0,,,
"May 21, 2022 10:00 PM",36,9,27,9,6,3,16,4,12,19,2,17,2,2,0,0,10,10,0,5,3,2,10,6,0,0,0,6,1,1,3,2,1,,,
"May 21, 2022 11:00 PM",24,9,15,8,5,3,16,7,9,14,6,8,2,0,2,0,4,4,0,1,1,0,4,9,0,0,0,9,0,0,0,0,0,,,
"May 22, 2022 12:00 AM",13,4,9,2,2,0,5,1,4,8,1,7,4,1,3,1,2,2,0,13,12,1,2,4,0,0,0,4,0,0,0,0,0,,,
"May 22, 2022 1:00 AM",8,3,5,1,0,1,3,1,2,4,0,4,3,2,1,1,5,5,0,7,7,0,6,6,0,0,0,5,1,0,0,0,0,,,
"May 22, 2022 2:00 AM",7,1,6,1,1,0,4,2,2,0,0,0,1,0,1,0,1,1,0,4,4,0,1,3,0,0,0,1,0,2,0,0,0,,,
"May 22, 2022 3:00 AM",3,0,3,2,0,2,1,1,0,0,0,0,3,2,1,0,0,0,0,0,0,0,0,3,0,0,0,3,0,0,1,1,0,,,
"May 22, 2022 4:00 AM",5,0,5,0,0,0,3,2,1,1,1,0,0,0,0,0,2,1,1,3,1,2,1,1,0,0,0,2,0,1,0,0,0,,,
"May 22, 2022 5:00 AM",2,2,0,1,0,1,3,0,3,1,0,1,0,0,0,0,1,1,0,0,0,0,0,0,0,0,0,5,0,0,0,0,0,,,
"May 22, 2022 6:00 AM",11,6,5,10,5,5,6,4,2,8,4,4,0,0,0,0,8,7,1,3,2,1,8,4,0,0,0,8,0,3,1,1,0,,,
"May 22, 2022 7:00 AM",14,8,6,24,13,11,42,28,14,29,18,11,4,2,2,1,10,10,0,8,8,0,10,14,0,0,0,19,1,3,1,1,0,,,
"May 22, 2022 8:00 AM",28,9,19,66,42,24,59,37,22,57,34,23,5,5,0,3,13,13,0,4,4,0,15,14,0,0,0,40,3,8,2,2,0,,,
"May 22, 2022 9:00 AM",31,17,14,96,53,43,92,59,33,86,65,21,8,3,5,9,14,14,0,9,9,0,14,30,0,0,0,32,13,9,5,4,1,,,
"May 22, 2022 10:00 AM",57,33,24,167,91,76,124,72,52,132,83,49,16,12,4,12,24,23,1,10,9,1,20,37,0,0,0,31,6,12,6,4,2,,,
"May 22, 2022 11:00 AM",42,27,15,134,69,65,127,72,55,139,74,65,15,11,4,17,10,10,0,19,10,9,13,36,0,0,0,37,4,5,1,1,0,,,
"May 22, 2022 12:00 PM",53,22,31,157,77,80,172,102,70,159,91,68,21,12,9,18,22,21,1,20,18,2,20,46,0,0,0,33,2,4,3,1,2,,,
"May 22, 2022 1:00 PM",49,24,25,116,63,53,118,64,54,97,59,38,16,9,7,29,26,25,1,22,19,3,22,48,0,0,0,35,2,4,4,2,2,,,
"May 22, 2022 2:00 PM",61,30,31,92,48,44,98,58,40,76,45,31,19,12,7,20,16,14,2,12,10,2,15,33,0,0,0,34,5,5,6,4,2,,,
"May 22, 2022 3:00 PM",58,29,29,116,53,63,136,73,63,117,60,57,22,9,13,15,35,33,2,24,19,5,33,20,0,0,0,27,4,3,4,3,1,,,
"May 22, 2022 4:00 PM",66,27,39,117,60,57,144,69,75,103,45,58,29,13,16,15,13,13,0,14,10,4,15,24,0,0,0,37,2,4,3,1,2,,,
"May 22, 2022 5:00 PM",51,26,25,76,38,38,116,37,79,72,23,49,21,9,12,21,11,10,1,7,6,1,10,21,0,0,0,29,1,3,5,3,2,,,
"May 22, 2022 6:00 PM",51,20,31,32,20,12,63,30,33,33,19,14,11,7,4,6,15,14,1,20,20,0,12,15,0,0,0,26,2,2,5,3,2,,,
"May 22, 2022 7:00 PM",58,26,32,31,14,17,53,26,27,33,16,17,2,2,0,10,13,13,0,11,10,1,13,16,0,0,0,16,2,0,3,2,1,,,
"May 22, 2022 8:00 PM",33,15,18,27,12,15,29,10,19,30,10,20,5,3,2,7,14,13,1,12,11,1,11,10,0,0,0,20,0,1,1,1,0,,,
"May 22, 2022 9:00 PM",25,8,17,15,5,10,27,14,13,22,10,12,3,3,0,4,7,7,0,4,3,1,8,2,0,0,0,8,3,0,6,4,2,,,
"May 22, 2022 10:00 PM",17,6,11,5,3,2,14,5,9,11,2,9,1,1,0,0,7,7,0,5,5,0,9,5,0,0,0,10,0,1,1,1,0,,,
"May 22, 2022 11:00 PM",21,2,19,4,1,3,9,4,5,8,4,4,2,1,1,2,2,2,0,1,1,0,3,2,0,0,0,2,0,1,0,0,0,,,
"May 23, 2022 12:00 AM",3,1,2,0,0,0,8,1,7,5,1,4,6,5,1,1,2,2,0,2,2,0,1,6,0,0,0,8,1,0,0,0,0,,,
"May 23, 2022 1:00 AM",5,0,5,0,0,0,1,0,1,2,0,2,0,0,0,0,1,0,1,1,1,0,0,1,0,0,0,1,0,0,0,0,0,,,
"May 23, 2022 2:00 AM",2,1,1,1,1,0,1,1,0,1,1,0,0,0,0,0,1,1,0,2,2,0,1,0,0,0,0,0,0,0,1,1,0,,,
"May 23, 2022 3:00 AM",0,0,0,0,0,0,0,0,0,0,0,0,0,0,0,0,0,0,0,0,0,0,0,0,0,0,0,0,0,0,0,0,0,,,
"May 23, 2022 4:00 AM",2,0,2,1,0,1,2,1,1,1,0,1,0,0,0,0,1,1,0,0,0,0,1,1,0,0,0,0,0,0,0,0,0,,,
"May 23, 2022 5:00 AM",4,3,1,1,0,1,6,2,4,2,0,2,1,1,0,3,5,5,0,1,1,0,5,3,0,0,0,5,0,1,0,0,0,,,
"May 23, 2022 6:00 AM",51,34,17,25,12,13,26,10,16,24,11,13,1,1,0,4,27,27,0,8,7,1,26,13,0,0,0,26,1,3,3,2,1,,,
"May 23, 2022 7:00 AM",108,72,36,60,20,40,89,37,52,63,25,38,15,11,4,13,76,76,0,21,20,1,77,35,0,0,0,101,5,2,7,6,1,,,
"May 23, 2022 8:00 AM",206,154,52,106,28,78,173,55,118,115,41,74,30,12,18,34,138,136,2,47,35,12,136,45,0,0,0,172,6,2,16,14,2,,,
"May 23, 2022 9:00 AM",120,96,24,71,35,36,107,57,50,75,46,29,17,11,6,5,63,63,0,23,20,3,60,32,0,0,0,52,3,3,5,5,0,,,
"May 23, 2022 10:00 AM",47,28,19,58,21,37,54,19,35,40,18,22,18,11,7,10,37,36,1,14,9,5,34,16,0,0,0,25,3,4,1,1,0,,,
"May 23, 2022 11:00 AM",50,27,23,51,25,26,40,15,25,35,21,14,7,6,1,11,16,16,0,13,10,3,16,13,0,0,0,25,2,3,1,0,1,,,
"May 23, 2022 12:00 PM",65,33,32,73,35,38,56,30,26,51,29,22,19,8,11,16,17,17,0,18,18,0,15,22,0,0,0,26,7,3,1,1,0,,,
"May 23, 2022 1:00 PM",64,33,31,55,31,24,54,27,27,46,23,23,18,11,7,10,20,16,4,16,11,5,15,18,0,0,0,27,4,7,5,1,4,,,
"May 23, 2022 2:00 PM",41,15,26,29,19,10,43,27,16,30,17,13,11,7,4,9,16,15,1,20,11,9,11,16,0,0,0,20,3,1,6,4,2,,,
"May 23, 2022 3:00 PM",79,26,53,47,34,13,41,28,13,40,31,9,9,8,1,20,24,22,2,21,21,0,18,30,0,0,0,24,9,1,3,3,0,,,
"May 23, 2022 4:00 PM",118,50,68,49,33,16,78,47,31,59,32,27,21,6,15,25,24,21,3,42,37,5,19,60,0,0,0,44,6,2,11,8,3,,,
"May 23, 2022 5:00 PM",177,58,119,62,36,26,108,69,39,91,45,46,20,12,8,18,28,23,5,94,93,1,22,103,0,0,0,49,1,6,6,5,1,,,
"May 23, 2022 6:00 PM",134,34,100,43,33,10,88,57,31,60,37,23,8,2,6,18,29,26,3,93,88,5,26,88,0,0,0,32,1,0,5,2,3,,,
"May 23, 2022 7:00 PM",83,25,58,27,17,10,55,39,16,34,22,12,7,4,3,8,16,16,0,39,38,1,19,50,0,0,0,18,4,3,7,3,4,,,
"May 23, 2022 8:00 PM",69,12,57,37,28,9,50,32,18,31,22,9,6,4,2,6,9,8,1,20,18,2,9,23,0,0,0,18,8,1,4,3,1,,,
"May 23, 2022 9:00 PM",38,12,26,23,9,14,27,15,12,23,9,14,2,1,1,9,11,11,0,11,9,2,12,7,0,0,0,13,6,0,3,3,0,,,
"May 23, 2022 10:00 PM",17,7,10,9,6,3,17,11,6,18,9,9,1,0,1,3,6,5,1,10,9,1,4,10,0,0,0,7,1,0,0,0,0,,,
"May 23, 2022 11:00 PM",11,3,8,0,0,0,3,3,0,1,1,0,0,0,0,0,3,2,1,8,8,0,2,7,0,0,0,6,0,0,3,3,0,,,
"May 24, 2022 12:00 AM",3,1,2,0,0,0,1,1,0,1,1,0,1,0,1,0,3,3,0,4,4,0,3,1,0,0,0,1,0,0,2,0,2,,,
"May 24, 2022 1:00 AM",4,0,4,1,0,1,1,0,1,1,0,1,2,0,2,0,0,0,0,2,2,0,0,2,0,0,0,0,0,0,0,0,0,,,
"May 24, 2022 2:00 AM",3,2,1,1,1,0,0,0,0,0,0,0,0,0,0,0,0,0,0,0,0,0,0,1,0,0,0,1,0,0,1,1,0,,,
"May 24, 2022 3:00 AM",0,0,0,0,0,0,0,0,0,0,0,0,0,0,0,0,0,0,0,0,0,0,0,0,0,0,0,0,0,0,0,0,0,,,
"May 24, 2022 4:00 AM",3,2,1,0,0,0,2,2,0,1,1,0,0,0,0,1,1,1,0,0,0,0,0,1,0,0,0,3,0,0,0,0,0,,,
"May 24, 2022 5:00 AM",7,4,3,1,0,1,1,0,1,2,0,2,3,2,1,3,11,10,1,0,0,0,10,2,0,0,0,5,0,2,1,1,0,,,
"May 24, 2022 6:00 AM",56,39,17,25,7,18,31,13,18,29,12,17,2,1,1,8,32,32,0,12,11,1,30,24,0,0,0,38,2,8,2,1,1,,,
"May 24, 2022 7:00 AM",143,97,46,54,16,38,102,25,77,70,22,48,12,10,2,17,84,82,2,22,18,4,86,40,0,0,0,130,4,7,5,5,0,,,
"May 24, 2022 8:00 AM",311,223,88,116,37,79,192,56,136,130,48,82,22,15,7,34,168,168,0,44,35,9,155,61,0,0,0,253,5,6,16,13,3,,,
"May 24, 2022 9:00 AM",129,98,31,57,27,30,106,63,43,68,47,21,22,10,12,11,76,75,1,23,15,8,64,24,0,0,0,66,0,2,4,3,1,,,
"May 24, 2022 10:00 AM",63,42,21,58,27,31,71,29,42,55,27,28,17,13,4,10,29,27,2,11,6,5,25,21,0,0,0,28,4,4,2,1,1,,,
"May 24, 2022 11:00 AM",53,32,21,42,20,22,63,26,37,48,26,22,26,8,18,14,22,21,1,9,7,2,18,18,0,0,0,25,1,2,3,2,1,,,
"May 24, 2022 12:00 PM",54,24,30,64,27,37,62,36,26,58,32,26,12,10,2,13,20,17,3,17,11,6,17,17,0,0,0,23,7,6,3,3,0,,,
"May 24, 2022 1:00 PM",97,44,53,65,35,30,64,32,32,55,30,25,21,12,9,12,33,28,5,31,27,4,25,33,0,0,0,30,2,1,4,4,0,,,
"May 24, 2022 2:00 PM",82,37,45,60,32,28,60,33,27,62,31,31,19,8,11,14,22,20,2,38,32,6,18,31,0,0,0,19,2,2,3,2,1,,,
"May 24, 2022 3:00 PM",96,36,60,52,33,19,71,35,36,56,33,23,17,9,8,25,35,32,3,31,26,5,26,36,0,0,0,35,4,5,6,2,4,,,
"May 24, 2022 4:00 PM",133,50,83,77,52,25,87,63,24,75,51,24,15,7,8,22,32,29,3,35,32,3,27,71,0,0,0,42,5,1,7,2,5,,,
"May 24, 2022 5:00 PM",229,54,175,108,48,60,159,97,62,124,79,45,25,11,14,27,38,30,8,100,96,4,29,137,0,0,0,66,9,3,13,9,4,,,
"May 24, 2022 6:00 PM",224,59,165,99,70,29,170,126,44,121,83,38,27,13,14,31,50,45,5,95,87,8,42,127,0,0,0,48,6,5,3,2,1,,,
"May 24, 2022 7:00 PM",134,51,83,90,52,38,122,79,43,74,44,30,25,11,14,31,23,20,3,55,54,1,24,74,0,0,0,36,3,6,11,7,4,,,
"May 24, 2022 8:00 PM",87,24,63,58,35,23,92,39,53,53,33,20,11,2,9,17,21,19,2,39,39,0,20,24,0,0,0,41,4,2,7,3,4,,,
"May 24, 2022 9:00 PM",67,24,43,34,25,9,38,16,22,35,13,22,3,3,0,13,10,10,0,18,15,3,11,9,0,0,0,14,5,1,4,2,2,,,
"May 24, 2022 10:00 PM",41,8,33,22,17,5,19,9,10,16,6,10,6,0,6,6,9,8,1,13,11,2,11,10,0,0,0,12,2,0,1,1,0,,,
"May 24, 2022 11:00 PM",10,0,10,3,2,1,9,4,5,5,2,3,7,2,5,2,3,2,1,10,10,0,2,5,0,0,0,4,0,0,2,0,2,,,
"May 25, 2022 12:00 AM",9,4,5,0,0,0,2,0,2,1,0,1,2,1,1,1,1,1,0,5,5,0,1,5,0,0,0,2,0,0,2,1,1,,,
"May 25, 2022 1:00 AM",6,0,6,3,0,3,3,1,2,2,0,2,0,0,0,0,1,0,1,2,2,0,0,2,0,0,0,3,1,0,0,0,0,,,
"May 25, 2022 2:00 AM",7,6,1,0,0,0,0,0,0,0,0,0,0,0,0,0,0,0,0,1,1,0,0,1,0,0,0,3,0,0,0,0,0,,,
"May 25, 2022 3:00 AM",3,1,2,0,0,0,2,2,0,1,1,0,0,0,0,1,0,0,0,1,1,0,0,1,0,0,0,0,0,0,0,0,0,,,
"May 25, 2022 4:00 AM",1,1,0,2,0,2,3,1,2,4,2,2,1,0,1,0,1,1,0,0,0,0,1,1,0,0,0,1,0,0,1,1,0,,,
"May 25, 2022 5:00 AM",6,3,3,4,2,2,6,4,2,5,3,2,3,2,1,4,9,9,0,0,0,0,8,2,0,0,0,10,0,2,1,1,0,,,
"May 25, 2022 6:00 AM",48,31,17,37,16,21,35,13,22,39,22,17,1,1,0,6,32,32,0,12,10,2,28,18,0,0,0,38,3,8,4,3,1,,,
"May 25, 2022 7:00 AM",125,80,45,57,15,42,85,28,57,54,19,35,10,9,1,18,80,80,0,26,23,3,82,29,0,0,0,122,5,5,9,8,1,,,
"May 25, 2022 8:00 AM",295,216,79,110,32,78,176,53,123,119,40,79,26,17,9,38,146,144,2,46,32,14,142,54,0,0,0,233,5,7,31,26,5,,,
"May 25, 2022 9:00 AM",132,103,29,49,18,31,86,45,41,69,37,32,19,15,4,5,84,84,0,18,13,5,79,29,0,0,0,62,4,3,4,3,1,,,
"May 25, 2022 10:00 AM",55,37,18,54,21,33,63,27,36,49,21,28,8,5,3,10,25,23,2,8,6,2,25,10,0,0,0,29,5,3,7,5,2,,,
"May 25, 2022 11:00 AM",52,31,21,40,20,20,56,29,27,41,26,15,7,5,2,4,15,14,1,12,10,2,15,10,0,0,0,27,1,1,6,2,4,,,
"May 25, 2022 12:00 PM",68,33,35,26,14,12,48,26,22,34,20,14,4,0,4,10,18,17,1,18,16,2,17,19,0,0,0,21,3,1,5,4,1,,,
"May 25, 2022 1:00 PM",78,42,36,40,26,14,65,40,25,62,41,21,17,9,8,13,32,30,2,27,21,6,28,36,0,0,0,29,5,5,8,2,6,,,
"May 25, 2022 2:00 PM",67,38,29,41,22,19,45,19,26,34,17,17,14,7,7,11,20,19,1,26,24,2,17,22,0,0,0,32,2,3,8,2,6,,,
"May 25, 2022 3:00 PM",81,31,50,23,20,3,34,22,12,31,21,10,5,2,3,17,19,18,1,23,15,8,17,37,0,0,0,28,2,3,7,2,5,,,
"May 25, 2022 4:00 PM",138,44,94,52,37,15,64,45,19,64,41,23,23,5,18,20,25,24,1,38,37,1,24,46,0,0,0,43,6,4,11,7,4,,,
"May 25, 2022 5:00 PM",245,69,176,88,49,39,128,79,49,112,61,51,30,9,21,25,51,43,8,95,92,3,42,97,0,0,0,51,9,6,10,6,4,,,
"May 25, 2022 6:00 PM",199,60,139,94,68,26,148,110,38,107,70,37,24,11,13,12,37,34,3,106,100,6,37,128,0,0,0,53,7,6,11,8,3,,,
"May 25, 2022 7:00 PM",128,44,84,95,55,40,124,78,46,110,70,40,18,10,8,30,27,24,3,42,42,0,24,63,0,0,0,28,8,2,7,4,3,,,
"May 25, 2022 8:00 PM",91,36,55,70,39,31,98,43,55,62,26,36,14,5,9,20,21,18,3,33,32,1,19,31,0,0,0,33,10,3,11,9,2,,,
"May 25, 2022 9:00 PM",61,12,49,48,23,25,52,22,30,53,24,29,14,10,4,10,12,11,1,20,20,0,11,14,0,0,0,19,9,1,10,4,6,,,
"May 25, 2022 10:00 PM",34,7,27,13,7,6,24,8,16,18,6,12,4,1,3,7,8,5,3,17,16,1,6,10,0,0,0,16,2,1,2,1,1,,,
"May 25, 2022 11:00 PM",15,4,11,10,7,3,9,5,4,8,5,3,3,3,0,4,4,4,0,10,9,1,5,8,0,0,0,2,1,0,2,1,1,,,
"May 26, 2022 12:00 AM",4,1,3,1,1,0,1,1,0,0,0,0,0,0,0,0,1,0,1,4,4,0,1,4,0,0,0,1,1,1,2,1,1,,,
"May 26, 2022 1:00 AM",3,1,2,1,1,0,3,3,0,1,1,0,1,0,1,0,1,1,0,2,2,0,1,0,0,0,0,1,1,0,0,0,0,,,
"May 26, 2022 2:00 AM",7,4,3,2,0,2,2,1,1,1,0,1,0,0,0,0,1,0,1,1,1,0,0,3,0,0,0,0,0,0,0,0,0,,,
"May 26, 2022 3:00 AM",3,0,3,0,0,0,0,0,0,0,0,0,0,0,0,0,0,0,0,0,0,0,0,0,0,0,0,0,0,0,0,0,0,,,
"May 26, 2022 4:00 AM",2,1,1,1,0,1,3,2,1,3,2,1,0,0,0,1,0,0,0,1,1,0,0,1,0,0,0,1,0,0,0,0,0,,,
"May 26, 2022 5:00 AM",6,6,0,1,0,1,2,0,2,1,0,1,1,1,0,1,4,4,0,1,1,0,6,1,0,0,0,7,0,1,0,0,0,,,
"May 26, 2022 6:00 AM",42,26,16,23,7,16,33,13,20,25,8,17,4,4,0,3,27,26,1,14,13,1,25,18,0,0,0,29,1,6,5,4,1,,,
"May 26, 2022 7:00 AM",129,91,38,44,11,33,88,26,62,43,15,28,11,10,1,18,83,83,0,13,11,2,81,30,0,0,0,95,3,2,8,7,1,,,
"May 26, 2022 8:00 AM",281,200,81,102,29,73,176,61,115,123,47,76,25,17,8,27,164,162,2,40,32,8,157,51,0,0,0,231,8,8,21,17,4,,,
"May 26, 2022 9:00 AM",118,100,18,53,22,31,84,37,47,61,34,27,15,12,3,13,73,73,0,27,20,7,65,24,0,0,0,63,5,3,3,2,1,,,
"May 26, 2022 10:00 AM",60,41,19,49,21,28,63,36,27,50,31,19,12,7,5,8,22,21,1,5,3,2,20,19,0,0,0,30,0,4,1,0,1,,,
"May 26, 2022 11:00 AM",39,22,17,23,11,12,31,12,19,23,10,13,14,8,6,4,10,10,0,10,9,1,9,10,0,0,0,16,0,1,3,0,3,,,
"May 26, 2022 12:00 PM",52,28,24,46,19,27,58,25,33,30,13,17,18,8,10,10,19,17,2,19,16,3,16,17,0,0,0,29,2,3,5,4,1,,,
"May 26, 2022 1:00 PM",67,36,31,35,23,12,31,15,16,31,16,15,8,2,6,10,28,23,5,21,18,3,19,30,0,0,0,15,8,1,4,2,2,,,
"May 26, 2022 2:00 PM",60,27,33,37,24,13,36,24,12,35,23,12,13,8,5,9,20,18,2,20,17,3,19,26,0,0,0,21,0,8,6,4,2,,,
"May 26, 2022 3:00 PM",81,31,50,44,23,21,45,29,16,44,27,17,21,12,9,17,33,31,2,36,32,4,25,32,0,0,0,22,2,3,9,6,3,,,
"May 26, 2022 4:00 PM",125,50,75,68,46,22,93,65,28,72,54,18,17,7,10,18,23,18,5,43,39,4,18,62,0,0,0,44,7,4,9,4,5,,,
"May 26, 2022 5:00 PM",205,58,147,124,55,69,163,113,50,161,111,50,18,8,10,21,42,37,5,87,81,6,41,114,0,0,0,63,15,7,14,10,4,,,
"May 26, 2022 6:00 PM",187,49,138,122,82,40,151,103,48,108,76,32,15,7,8,34,32,32,0,86,83,3,32,99,0,0,0,52,8,7,5,5,0,,,
"May 26, 2022 7:00 PM",137,56,81,89,48,41,126,79,47,87,45,42,21,13,8,15,26,23,3,45,42,3,22,65,0,0,0,40,3,3,8,6,2,,,
"May 26, 2022 8:00 PM",87,30,57,79,39,40,85,39,46,76,32,44,15,7,8,21,15,14,1,23,22,1,11,35,0,0,0,27,4,0,10,4,6,,,
"May 26, 2022 9:00 PM",71,19,52,38,22,16,51,21,30,40,15,25,9,5,4,11,14,12,2,18,17,1,12,23,0,0,0,21,2,3,4,2,2,,,
"May 26, 2022 10:00 PM",41,13,28,32,28,4,52,12,40,30,6,24,5,2,3,0,7,7,0,15,13,2,8,18,0,0,0,16,0,1,3,2,1,,,
"May 26, 2022 11:00 PM",27,5,22,17,14,3,25,10,15,16,5,11,5,1,4,0,5,5,0,13,12,1,5,18,0,0,0,13,0,0,1,1,0,,,
"May 27, 2022 12:00 AM",15,3,12,0,0,0,3,1,2,6,2,4,1,0,1,1,2,2,0,6,6,0,1,16,0,0,0,5,1,0,0,0,0,,,
"May 27, 2022 1:00 AM",7,1,6,4,3,1,0,0,0,1,0,1,0,0,0,2,1,0,1,1,1,0,0,2,0,0,0,2,0,0,1,1,0,,,
"May 27, 2022 2:00 AM",8,7,1,1,1,0,1,0,1,0,0,0,0,0,0,0,0,0,0,4,4,0,0,1,0,0,0,1,0,0,2,0,2,,,
"May 27, 2022 3:00 AM",3,0,3,0,0,0,1,1,0,0,0,0,0,0,0,0,0,0,0,1,1,0,0,0,0,0,0,0,0,0,2,2,0,,,
"May 27, 2022 4:00 AM",0,0,0,2,0,2,4,2,2,3,2,1,0,0,0,0,1,0,1,0,0,0,0,1,0,0,0,2,0,1,0,0,0,,,
"May 27, 2022 5:00 AM",8,5,3,5,5,0,7,4,3,7,6,1,0,0,0,1,5,5,0,0,0,0,5,2,0,0,0,13,0,0,0,0,0,,,
"May 27, 2022 6:00 AM",42,26,16,43,18,25,44,24,20,32,15,17,2,2,0,5,25,24,1,11,9,2,24,12,0,0,0,22,1,3,3,1,2,,,
"May 27, 2022 7:00 AM",113,79,34,68,26,42,80,36,44,58,26,32,9,8,1,7,57,55,2,16,12,4,53,27,0,0,0,84,4,3,9,8,1,,,
"May 27, 2022 8:00 AM",181,133,48,100,34,66,145,45,100,101,42,59,16,12,4,23,97,94,3,41,32,9,89,49,0,0,0,151,8,4,16,14,2,,,
"May 27, 2022 9:00 AM",113,80,33,76,43,33,105,66,39,75,45,30,21,9,12,10,50,50,0,17,12,5,44,31,0,0,0,42,7,6,9,2,7,,,
"May 27, 2022 10:00 AM",79,52,27,61,23,38,97,46,51,63,33,30,17,12,5,14,27,27,0,9,9,0,22,20,0,0,0,31,2,4,0,0,0,,,
"May 27, 2022 11:00 AM",43,20,23,77,40,37,90,49,41,61,36,25,9,2,7,7,24,22,2,10,10,0,19,11,0,0,0,28,8,3,6,3,3,,,
"May 27, 2022 12:00 PM",80,36,44,64,28,36,95,50,45,61,28,33,21,15,6,11,26,26,0,18,13,5,24,30,0,0,0,30,3,7,10,3,7,,,
"May 27, 2022 1:00 PM",107,44,63,44,23,21,75,42,33,60,35,25,19,14,5,19,28,25,3,27,25,2,22,34,0,0,0,46,13,2,10,7,3,,,
"May 27, 2022 2:00 PM",73,37,36,67,35,32,73,37,36,58,38,20,16,5,11,10,27,26,1,18,15,3,26,33,0,0,0,42,6,6,13,5,8,,,
"May 27, 2022 3:00 PM",100,39,61,84,53,31,88,49,39,88,51,37,23,8,15,13,21,20,1,30,24,6,20,35,0,0,0,37,4,6,6,3,3,,,
"May 27, 2022 4:00 PM",122,44,78,100,50,50,105,54,51,84,48,36,29,12,17,30,31,29,2,48,47,1,28,66,0,0,0,58,3,6,12,8,4,,,
"May 27, 2022 5:00 PM",211,72,139,105,64,41,141,84,57,119,80,39,27,13,14,29,28,25,3,72,64,8,24,79,0,0,0,67,8,5,7,2,5,,,
"May 27, 2022 6:00 PM",162,54,108,118,66,52,141,86,55,103,49,54,14,6,8,21,37,35,2,46,44,2,32,74,0,0,0,45,2,8,6,4,2,,,
"May 27, 2022 7:00 PM",100,52,48,107,54,53,133,83,50,103,65,38,20,9,11,24,18,17,1,27,26,1,18,43,0,0,0,49,3,1,6,3,3,,,
"May 27, 2022 8:00 PM",61,24,37,44,29,15,76,43,33,48,33,15,12,5,7,14,16,14,2,18,17,1,16,23,0,0,0,28,6,3,5,3,2,,,
"May 27, 2022 9:00 PM",52,25,27,35,17,18,67,19,48,29,10,19,10,10,0,13,11,10,1,6,5,1,9,12,0,0,0,18,4,0,1,1,0,,,
"May 27, 2022 10:00 PM",59,22,37,22,13,9,29,13,16,25,8,17,6,2,4,2,13,11,2,17,14,3,15,10,0,0,0,11,1,2,3,1,2,,,
"May 27, 2022 11:00 PM",28,12,16,11,9,2,22,11,11,13,5,8,2,0,2,1,6,5,1,12,12,0,4,8,0,0,0,9,0,2,2,2,0,,,
"May 28, 2022 12:00 AM",17,3,14,0,0,0,9,3,6,11,5,6,4,2,2,0,7,7,0,8,7,1,6,9,0,0,0,9,2,0,2,2,0,,,
"May 28, 2022 1:00 AM",9,1,8,1,1,0,6,2,4,3,1,2,0,0,0,0,1,1,0,6,6,0,1,7,0,0,0,3,0,0,0,0,0,,,
"May 28, 2022 2:00 AM",8,5,3,1,1,0,2,2,0,1,1,0,0,0,0,0,2,2,0,5,5,0,3,6,0,0,0,1,0,0,0,0,0,,,
"May 28, 2022 3:00 AM",5,0,5,0,0,0,0,0,0,0,0,0,0,0,0,0,0,0,0,1,1,0,1,2,0,0,0,0,0,0,0,0,0,,,
"May 28, 2022 4:00 AM",3,0,3,3,0,3,1,1,0,0,0,0,1,1,0,0,1,1,0,1,1,0,0,1,0,0,0,0,0,0,0,0,0,,,
"May 28, 2022 5:00 AM",5,2,3,1,1,0,3,1,2,3,2,1,0,0,0,0,0,0,0,2,2,0,0,1,0,0,0,6,0,0,0,0,0,,,
"May 28, 2022 6:00 AM",13,10,3,14,11,3,17,10,7,12,8,4,0,0,0,0,2,1,1,5,5,0,2,8,0,0,0,5,0,0,0,0,0,,,
"May 28, 2022 7:00 AM",24,14,10,35,19,16,46,34,12,39,28,11,2,2,0,2,9,9,0,4,2,2,10,15,0,0,0,16,3,5,1,1,0,,,
"May 28, 2022 8:00 AM",44,20,24,64,34,30,77,45,32,63,38,25,13,7,6,30,17,17,0,15,14,1,17,24,0,0,0,22,2,9,0,0,0,,,
"May 28, 2022 9:00 AM",53,24,29,109,66,43,144,98,46,93,70,23,7,6,1,14,18,18,0,12,9,3,17,35,0,0,0,37,4,7,7,4,3,,,
"May 28, 2022 10:00 AM",72,41,31,129,80,49,206,133,73,154,102,52,26,14,12,13,22,22,0,8,8,0,23,48,0,0,0,33,3,7,2,0,2,,,
"May 28, 2022 11:00 AM",70,44,26,166,93,73,241,142,99,159,98,61,46,31,15,11,31,29,2,20,17,3,28,51,0,0,0,43,13,5,3,1,2,,,
"May 28, 2022 12:00 PM",86,48,38,189,82,107,264,140,124,184,111,73,32,15,17,22,34,30,4,17,13,4,27,73,0,0,0,62,15,8,11,8,3,,,
"May 28, 2022 1:00 PM",67,35,32,146,76,70,177,91,86,142,85,57,43,24,19,22,26,26,0,20,19,1,26,54,0,0,0,47,11,10,13,7,6,,,
"May 28, 2022 2:00 PM",67,35,32,127,61,66,177,106,71,128,76,52,51,28,23,24,28,27,1,16,10,6,25,33,0,0,0,51,8,5,8,6,2,,,
"May 28, 2022 3:00 PM",62,26,36,126,62,64,164,71,93,123,65,58,26,13,13,21,33,31,2,10,9,1,26,30,0,0,0,46,13,6,3,2,1,,,
"May 28, 2022 4:00 PM",77,45,32,125,65,60,153,52,101,125,49,76,19,3,16,29,18,13,5,13,13,0,13,30,0,0,0,51,12,1,12,8,4,,,
"May 28, 2022 5:00 PM",60,25,35,112,59,53,112,42,70,108,41,67,35,19,16,10,21,20,1,18,17,1,25,26,0,0,0,33,3,4,4,4,0,,,
"May 28, 2022 6:00 PM",55,28,27,72,27,45,90,27,63,57,20,37,14,10,4,21,21,21,0,9,9,0,19,17,0,0,0,42,2,2,4,2,2,,,
"May 28, 2022 7:00 PM",65,32,33,68,35,33,57,25,32,45,20,25,22,9,13,14,11,10,1,14,13,1,9,23,0,0,0,21,4,2,7,5,2,,,
"May 28, 2022 8:00 PM",40,18,22,38,24,14,46,21,25,32,12,20,11,6,5,5,18,18,0,5,4,1,16,8,0,0,0,15,2,0,1,1,0,,,
"May 28, 2022 9:00 PM",39,14,25,12,5,7,18,7,11,15,5,10,3,3,0,7,7,5,2,7,6,1,3,11,0,0,0,10,1,0,0,0,0,,,
"May 28, 2022 10:00 PM",31,13,18,14,9,5,9,2,7,5,1,4,9,6,3,2,9,9,0,8,7,1,9,5,0,0,0,8,0,7,1,1,0,,,
"May 28, 2022 11:00 PM",34,11,23,14,12,2,17,9,8,11,6,5,10,1,9,2,8,7,1,9,9,0,7,6,0,0,0,3,1,0,1,1,0,,,
"May 29, 2022 12:00 AM",20,6,14,0,0,0,2,0,2,5,2,3,5,4,1,1,1,0,1,4,4,0,0,5,0,0,0,7,0,1,2,1,1,,,
"May 29, 2022 1:00 AM",12,4,8,3,1,2,3,0,3,3,1,2,0,0,0,1,3,3,0,6,6,0,2,8,0,0,0,2,1,1,4,2,2,,,
"May 29, 2022 2:00 AM",10,4,6,0,0,0,1,1,0,1,1,0,0,0,0,3,1,1,0,1,1,0,1,1,0,0,0,2,0,0,0,0,0,,,
"May 29, 2022 3:00 AM",3,0,3,0,0,0,0,0,0,0,0,0,0,0,0,1,0,0,0,1,1,0,0,2,0,0,0,0,1,0,0,0,0,,,
"May 29, 2022 4:00 AM",6,3,3,0,0,0,1,0,1,1,0,1,0,0,0,0,2,2,0,0,0,0,1,0,0,0,0,1,0,1,0,0,0,,,
"May 29, 2022 5:00 AM",2,1,1,0,0,0,1,0,1,1,0,1,0,0,0,0,1,1,0,1,1,0,1,0,0,0,0,2,0,0,1,1,0,,,
"May 29, 2022 6:00 AM",7,6,1,5,1,4,8,5,3,2,1,1,0,0,0,0,4,3,1,3,2,1,4,4,0,0,0,7,1,0,0,0,0,,,
"May 29, 2022 7:00 AM",19,8,11,24,15,9,27,13,14,28,19,9,1,0,1,3,11,11,0,8,7,1,9,20,0,0,0,13,0,4,1,0,1,,,
"May 29, 2022 8:00 AM",34,19,15,82,52,30,83,61,22,73,56,17,3,1,2,1,10,10,0,12,10,2,10,22,0,0,0,26,4,10,2,1,1,,,
"May 29, 2022 9:00 AM",40,23,17,108,76,32,113,77,36,92,60,32,12,6,6,17,20,20,0,7,7,0,18,34,0,0,0,52,2,8,4,3,1,,,
"May 29, 2022 10:00 AM",39,29,10,162,93,69,175,106,69,124,75,49,16,10,6,9,25,23,2,19,18,1,23,32,0,0,0,39,5,5,3,2,1,,,
"May 29, 2022 11:00 AM",71,36,35,117,72,45,142,86,56,81,55,26,21,9,12,9,25,24,1,23,19,4,24,33,0,0,0,32,5,2,5,4,1,,,
"May 29, 2022 12:00 PM",66,38,28,134,67,67,180,88,92,143,80,63,32,19,13,15,21,19,2,21,18,3,20,44,0,0,0,41,8,6,8,3,5,,,
"May 29, 2022 1:00 PM",62,28,34,119,51,68,135,70,65,85,44,41,37,20,17,11,20,19,1,17,16,1,22,34,0,0,0,39,4,1,3,2,1,,,
"May 29, 2022 2:00 PM",67,35,32,101,54,47,112,62,50,83,49,34,28,16,12,15,15,13,2,13,10,3,13,30,0,0,0,36,4,2,2,0,2,,,
"May 29, 2022 3:00 PM",58,32,26,111,60,51,144,68,76,96,54,42,41,18,23,17,15,15,0,16,14,2,14,29,0,0,0,39,4,5,11,7,4,,,
"May 29, 2022 4:00 PM",68,34,34,125,63,62,114,66,48,100,60,40,11,6,5,32,24,22,2,13,11,2,20,28,0,0,0,27,8,5,7,4,3,,,
"May 29, 2022 5:00 PM",62,32,30,142,74,68,135,54,81,139,63,76,22,13,9,19,19,18,1,11,10,1,15,33,0,0,0,36,4,4,5,5,0,,,
"May 29, 2022 6:00 PM",63,29,34,87,37,50,98,36,62,93,36,57,20,11,9,13,12,10,2,10,10,0,11,19,0,0,0,29,7,0,9,6,3,,,
"May 29, 2022 7:00 PM",46,20,26,65,22,43,74,26,48,49,18,31,20,9,11,9,9,7,2,14,14,0,6,16,0,0,0,22,2,1,10,5,5,,,
"May 29, 2022 8:00 PM",55,27,28,31,14,17,52,25,27,43,16,27,9,5,4,8,9,9,0,9,8,1,10,22,0,0,0,18,3,1,2,2,0,,,
"May 29, 2022 9:00 PM",21,9,12,34,16,18,41,17,24,31,15,16,3,2,1,9,8,8,0,4,4,0,8,4,0,0,0,11,0,0,2,1,1,,,
"May 29, 2022 10:00 PM",21,11,10,16,7,9,20,7,13,9,2,7,3,2,1,1,5,5,0,6,6,0,7,6,0,0,0,9,1,1,3,2,1,,,
"May 29, 2022 11:00 PM",12,2,10,6,3,3,4,0,4,6,2,4,2,1,1,1,4,3,1,3,3,0,3,3,0,0,0,2,0,0,0,0,0,,,
"May 30, 2022 12:00 AM",4,0,4,0,0,0,4,0,4,2,0,2,0,0,0,1,2,2,0,2,2,0,2,4,0,0,0,4,0,0,0,0,0,,,
"May 30, 2022 1:00 AM",3,2,1,0,0,0,0,0,0,1,0,1,1,0,1,0,1,1,0,1,1,0,0,3,0,0,0,2,0,0,0,0,0,,,
"May 30, 2022 2:00 AM",2,1,1,0,0,0,0,0,0,0,0,0,0,0,0,0,0,0,0,0,0,0,0,0,0,0,0,0,0,0,0,0,0,,,
"May 30, 2022 3:00 AM",0,0,0,0,0,0,0,0,0,0,0,0,0,0,0,0,0,0,0,1,1,0,0,0,0,0,0,0,0,0,0,0,0,,,
"May 30, 2022 4:00 AM",4,1,3,0,0,0,2,2,0,1,1,0,0,0,0,1,0,0,0,1,1,0,0,0,0,0,0,2,0,0,0,0,0,,,
"May 30, 2022 5:00 AM",4,3,1,3,2,1,6,3,3,3,2,1,0,0,0,2,8,8,0,2,2,0,8,2,0,0,0,16,0,1,1,1,0,,,
"May 30, 2022 6:00 AM",41,24,17,17,6,11,25,13,12,22,11,11,2,2,0,4,30,30,0,10,9,1,28,13,0,0,0,35,0,4,5,3,2,,,
"May 30, 2022 7:00 AM",108,76,32,57,16,41,81,31,50,54,23,31,7,6,1,20,76,76,0,18,13,5,83,24,0,0,0,92,1,3,3,3,0,,,
"May 30, 2022 8:00 AM",248,173,75,79,22,57,137,47,90,104,38,66,36,17,19,17,121,120,1,42,31,11,123,47,0,0,0,165,5,3,13,11,2,,,
"May 30, 2022 9:00 AM",107,88,19,48,21,27,72,42,30,55,34,21,15,13,2,4,70,68,2,24,18,6,63,30,0,0,0,54,4,2,5,4,1,,,
"May 30, 2022 10:00 AM",47,34,13,41,23,18,59,37,22,50,29,21,14,8,6,12,21,21,0,8,6,2,21,10,0,0,0,31,1,0,2,1,1,,,
"May 30, 2022 11:00 AM",51,33,18,48,29,19,60,30,30,36,21,15,12,4,8,9,21,20,1,18,13,5,18,11,0,0,0,20,1,2,4,1,3,,,
"May 30, 2022 12:00 PM",60,28,32,43,15,28,61,26,35,40,17,23,20,12,8,14,25,24,1,14,11,3,22,19,0,0,0,23,4,4,5,3,2,,,
"May 30, 2022 1:00 PM",97,42,55,45,26,19,65,35,30,48,23,25,24,13,11,22,31,27,4,15,13,2,22,29,0,0,0,31,3,2,5,3,2,,,
"May 30, 2022 2:00 PM",56,27,29,27,18,9,36,18,18,28,20,8,15,9,6,7,12,12,0,15,13,2,11,14,0,0,0,29,5,1,11,8,3,,,
"May 30, 2022 3:00 PM",73,29,44,27,15,12,31,18,13,28,18,10,13,4,9,9,15,12,3,25,22,3,12,32,0,0,0,20,5,3,9,5,4,,,
"May 30, 2022 4:00 PM",102,32,70,23,19,4,35,26,9,33,23,10,10,5,5,14,21,16,5,40,37,3,14,37,0,0,0,35,1,3,5,1,4,,,
"May 30, 2022 5:00 PM",183,65,118,45,30,15,81,49,32,56,36,20,16,8,8,15,36,32,4,89,85,4,31,78,0,0,0,52,2,1,5,3,2,,,
"May 30, 2022 6:00 PM",160,42,118,47,37,10,75,60,15,61,42,19,15,6,9,17,29,25,4,86,84,2,25,93,0,0,0,48,2,4,5,3,2,,,
"May 30, 2022 7:00 PM",74,23,51,29,16,13,48,26,22,27,16,11,6,3,3,3,16,14,2,36,34,2,15,39,0,0,0,19,6,4,8,3,5,,,
"May 30, 2022 8:00 PM",66,15,51,25,18,7,27,18,9,24,18,6,11,5,6,3,6,6,0,18,18,0,7,18,0,0,0,9,2,2,2,2,0,,,
"May 30, 2022 9:00 PM",42,11,31,25,12,13,26,12,14,18,8,10,5,2,3,6,7,7,0,12,9,3,7,10,0,0,0,10,2,0,1,1,0,,,
"May 30, 2022 10:00 PM",20,5,15,3,3,0,5,2,3,2,1,1,2,0,2,4,2,1,1,7,6,1,1,7,0,0,0,4,0,0,1,0,1,,,
"May 30, 2022 11:00 PM",9,2,7,3,2,1,3,3,0,0,0,0,1,1,0,1,4,3,1,4,4,0,3,6,0,0,0,4,0,0,2,1,1,,,
"May 31, 2022 12:00 AM",9,1,8,0,0,0,0,0,0,0,0,0,3,2,1,0,2,2,0,1,1,0,2,1,0,0,0,0,0,0,0,0,0,,,
"May 31, 2022 1:00 AM",0,0,0,0,0,0,0,0,0,0,0,0,0,0,0,0,0,0,0,2,2,0,0,1,0,0,0,0,0,0,0,0,0,,,
"May 31, 2022 2:00 AM",3,3,0,0,0,0,0,0,0,0,0,0,0,0,0,0,0,0,0,0,0,0,0,0,0,0,0,0,0,0,0,0,0,,,
"May 31, 2022 3:00 AM",1,0,1,0,0,0,0,0,0,0,0,0,0,0,0,1,0,0,0,0,0,0,2,2,0,0,0,0,0,0,0,0,0,,,
"May 31, 2022 4:00 AM",1,1,0,1,1,0,1,1,0,2,2,0,1,1,0,0,0,0,0,0,0,0,0,0,0,0,0,1,0,0,1,1,0,,,
"May 31, 2022 5:00 AM",8,6,2,0,0,0,5,1,4,3,1,2,1,0,1,1,11,10,1,1,1,0,11,2,0,0,0,10,0,1,0,0,0,,,
"May 31, 2022 6:00 AM",44,27,17,27,11,16,33,17,16,30,16,14,2,2,0,5,33,33,0,14,11,3,28,17,0,0,0,34,0,5,0,0,0,,,
"May 31, 2022 7:00 AM",129,93,36,66,21,45,81,22,59,64,26,38,11,8,3,22,80,79,1,18,13,5,77,32,0,0,0,117,1,9,8,7,1,,,
"May 31, 2022 8:00 AM",304,228,76,113,29,84,163,42,121,112,39,73,24,14,10,32,168,168,0,57,47,10,160,49,0,0,0,230,4,8,13,9,4,,,
"May 31, 2022 9:00 AM",127,98,29,52,22,30,92,45,47,64,34,30,25,20,5,9,63,63,0,20,16,4,53,32,0,0,0,79,9,4,10,9,1,,,
"May 31, 2022 10:00 AM",63,43,20,54,24,30,68,34,34,51,30,21,16,6,10,7,29,29,0,10,8,2,27,22,0,0,0,33,4,5,4,2,2,,,
"May 31, 2022 11:00 AM",52,36,16,37,22,15,52,28,24,37,21,16,10,4,6,10,18,18,0,17,15,2,20,16,0,0,0,27,6,4,6,4,2,,,
"May 31, 2022 12:00 PM",69,31,38,42,22,20,55,26,29,35,16,19,19,8,11,13,25,24,1,19,16,3,18,16,0,0,0,25,8,6,6,6,0,,,
"May 31, 2022 1:00 PM",85,41,44,50,21,29,72,41,31,62,33,29,13,8,5,19,35,31,4,25,23,2,30,36,0,0,0,34,9,5,8,5,3,,,
"May 31, 2022 2:00 PM",75,28,47,41,26,15,46,18,28,38,22,16,15,8,7,20,18,18,0,22,21,1,16,27,0,0,0,29,4,5,8,5,3,,,
"May 31, 2022 3:00 PM",87,37,50,25,14,11,52,28,24,26,16,10,14,7,7,23,26,24,2,33,26,7,18,23,0,0,0,34,1,1,6,0,6,,,
"May 31, 2022 4:00 PM",127,31,96,60,40,20,67,40,27,58,31,27,14,8,6,21,35,30,5,42,39,3,31,71,0,0,0,46,4,3,11,7,4,,,
"May 31, 2022 5:00 PM",218,51,167,63,42,21,95,65,30,77,53,24,16,9,7,29,40,36,4,75,70,5,32,98,0,0,0,48,6,3,12,7,5,,,
"May 31, 2022 6:00 PM",157,31,126,62,48,14,109,84,25,78,57,21,14,5,9,9,32,26,6,89,84,5,26,108,0,0,0,41,6,2,4,4,0,,,
"May 31, 2022 7:00 PM",100,26,74,43,29,14,73,59,14,51,40,11,7,1,6,13,11,10,1,52,49,3,12,71,0,0,0,17,7,2,7,2,5,,,
"May 31, 2022 8:00 PM",64,13,51,38,25,13,41,22,19,42,23,19,5,2,3,3,14,12,2,22,21,1,12,25,0,0,0,29,2,2,3,2,1,,,
"May 31, 2022 9:00 PM",43,11,32,22,15,7,24,11,13,21,8,13,10,3,7,6,10,9,1,16,16,0,9,4,0,0,0,10,2,1,3,2,1,,,
"May 31, 2022 10:00 PM",26,9,17,16,9,7,17,4,13,16,4,12,2,0,2,1,7,6,1,14,13,1,5,10,0,0,0,8,3,1,2,1,1,,,
"May 31, 2022 11:00 PM",10,0,10,2,2,0,4,2,2,2,1,1,0,0,0,1,3,3,0,6,6,0,3,4,0,0,0,2,0,0,2,1,1,,,
"Jun 1, 2022 12:00 AM",7,2,5,0,0,0,2,0,2,0,0,0,0,0,0,1,0,0,0,4,4,0,0,2,0,0,0,2,0,0,1,1,0,,,
"Jun 1, 2022 1:00 AM",3,0,3,0,0,0,1,1,0,0,0,0,0,0,0,0,1,0,1,2,2,0,0,0,0,0,0,1,0,0,1,0,1,,,
"Jun 1, 2022 2:00 AM",2,2,0,0,0,0,0,0,0,0,0,0,0,0,0,1,0,0,0,1,1,0,0,0,0,0,0,0,0,0,0,0,0,,,
"Jun 1, 2022 3:00 AM",2,1,1,0,0,0,0,0,0,0,0,0,0,0,0,0,0,0,0,0,0,0,0,1,0,0,0,0,0,0,0,0,0,,,
"Jun 1, 2022 4:00 AM",3,1,2,1,0,1,2,1,1,1,0,1,0,0,0,2,1,1,0,0,0,0,1,2,0,0,0,3,0,0,0,0,0,,,
"Jun 1, 2022 5:00 AM",1,1,0,2,1,1,6,1,5,4,2,2,0,0,0,3,9,9,0,1,1,0,9,3,0,0,0,10,0,1,1,1,0,,,
"Jun 1, 2022 6:00 AM",47,30,17,33,16,17,42,18,24,37,17,20,0,0,0,7,36,34,2,10,8,2,33,20,0,0,0,34,1,5,1,0,1,,,
"Jun 1, 2022 7:00 AM",135,97,38,75,28,47,92,32,60,76,36,40,6,6,0,22,79,77,2,23,16,7,76,38,0,0,0,126,2,3,9,8,1,,,
"Jun 1, 2022 8:00 AM",301,222,79,116,29,87,152,46,106,122,38,84,34,25,9,33,154,154,0,62,46,16,159,55,0,0,0,245,7,6,16,13,3,,,
"Jun 1, 2022 9:00 AM",130,101,29,69,24,45,79,45,34,78,48,30,15,10,5,6,84,84,0,21,19,2,71,24,0,0,0,80,6,5,7,5,2,,,
"Jun 1, 2022 10:00 AM",61,37,24,58,24,34,74,36,38,48,30,18,8,2,6,15,28,28,0,7,7,0,30,20,0,0,0,38,4,1,6,3,3,,,
"Jun 1, 2022 11:00 AM",56,41,15,42,24,18,69,45,24,49,26,23,12,8,4,12,20,20,0,18,13,5,21,16,0,0,0,20,5,4,9,5,4,,,
"Jun 1, 2022 12:00 PM",71,24,47,75,37,38,85,51,34,59,35,24,23,12,11,17,20,20,0,24,21,3,20,31,0,0,0,28,4,6,4,2,2,,,
"Jun 1, 2022 1:00 PM",95,45,50,73,32,41,103,52,51,67,29,38,22,13,9,15,26,22,4,36,34,2,18,37,0,0,0,43,5,8,8,4,4,,,
"Jun 1, 2022 2:00 PM",73,32,41,59,29,30,99,54,45,58,28,30,11,4,7,12,25,23,2,32,27,5,23,27,0,0,0,39,4,8,7,6,1,,,
"Jun 1, 2022 3:00 PM",98,36,62,70,41,29,94,63,31,67,41,26,18,5,13,17,17,16,1,16,14,2,19,40,0,0,0,32,5,4,9,6,3,,,
"Jun 1, 2022 4:00 PM",136,44,92,83,51,32,110,59,51,91,53,38,20,6,14,19,30,28,2,33,29,4,27,65,0,0,0,49,5,5,4,2,2,,,
"Jun 1, 2022 5:00 PM",241,81,160,136,73,63,191,126,65,124,76,48,29,9,20,31,34,29,5,122,116,6,26,125,0,0,0,83,7,7,10,7,3,,,
"Jun 1, 2022 6:00 PM",238,69,169,142,92,50,191,123,68,177,100,77,21,9,12,22,52,46,6,104,98,6,46,137,0,0,0,57,8,8,8,4,4,,,
"Jun 1, 2022 7:00 PM",129,45,84,155,91,64,179,120,59,153,94,59,20,10,10,9,25,22,3,48,45,3,25,80,0,0,0,39,10,3,12,4,8,,,
"Jun 1, 2022 8:00 PM",75,36,39,107,53,54,121,46,75,111,45,66,11,8,3,16,21,20,1,33,31,2,17,44,0,0,0,43,4,9,9,4,5,,,
"Jun 1, 2022 9:00 PM",63,23,40,56,31,25,86,31,55,58,26,32,9,1,8,10,15,13,2,20,16,4,12,23,0,0,0,24,9,2,9,4,5,,,
"Jun 1, 2022 10:00 PM",51,16,35,26,17,9,38,12,26,33,7,26,6,3,3,8,9,6,3,16,15,1,6,19,0,0,0,15,0,1,1,0,1,,,
"Jun 1, 2022 11:00 PM",22,3,19,11,7,4,17,7,10,11,4,7,7,1,6,3,6,6,0,8,8,0,8,12,0,0,0,6,1,1,2,1,1,,,
"Jun 2, 2022 12:00 AM",12,3,9,0,0,0,0,0,0,4,1,3,1,0,1,0,5,5,0,3,3,0,5,4,0,0,0,0,0,0,0,0,0,,,
"Jun 2, 2022 1:00 AM",4,0,4,0,0,0,1,0,1,1,0,1,0,0,0,0,2,1,1,5,5,0,1,3,0,0,0,2,0,0,0,0,0,,,
"Jun 2, 2022 2:00 AM",7,6,1,0,0,0,0,0,0,0,0,0,0,0,0,0,0,0,0,0,0,0,0,1,0,0,0,1,0,0,0,0,0,,,
"Jun 2, 2022 3:00 AM",1,1,0,0,0,0,0,0,0,0,0,0,0,0,0,0,0,0,0,0,0,0,1,0,0,0,0,2,0,0,0,0,0,,,
"Jun 2, 2022 4:00 AM",4,2,2,0,0,0,0,0,0,0,0,0,0,0,0,0,2,2,0,1,1,0,1,2,0,0,0,2,0,0,0,0,0,,,
"Jun 2, 2022 5:00 AM",4,2,2,2,1,1,4,2,2,3,2,1,1,1,0,0,6,6,0,0,0,0,6,0,0,0,0,7,0,1,0,0,0,,,
"Jun 2, 2022 6:00 AM",52,35,17,23,12,11,25,13,12,28,15,13,2,1,1,7,29,29,0,16,14,2,27,21,0,0,0,34,3,6,2,2,0,,,
"Jun 2, 2022 7:00 AM",130,93,37,74,28,46,83,26,57,64,27,37,8,8,0,15,80,80,0,13,10,3,76,37,0,0,0,114,4,4,5,4,1,,,
"Jun 2, 2022 8:00 AM",272,197,75,110,36,74,140,51,89,113,47,66,32,19,13,30,148,145,3,41,32,9,147,52,0,0,0,192,5,4,7,5,2,,,
"Jun 2, 2022 9:00 AM",126,96,30,68,29,39,88,38,50,65,38,27,21,14,7,18,81,80,1,25,21,4,72,24,0,0,0,69,8,5,4,3,1,,,
"Jun 2, 2022 10:00 AM",72,47,25,52,19,33,76,50,26,67,34,33,18,14,4,16,27,27,0,8,8,0,26,28,0,0,0,34,1,3,1,1,0,,,
"Jun 2, 2022 11:00 AM",41,22,19,57,38,19,68,42,26,63,41,22,22,14,8,12,19,19,0,12,10,2,21,21,0,0,0,28,3,2,4,1,3,,,
"Jun 2, 2022 12:00 PM",72,37,35,89,48,41,81,42,39,69,31,38,31,13,18,18,26,23,3,16,14,2,20,19,0,0,0,27,2,0,6,4,2,,,
"Jun 2, 2022 1:00 PM",83,39,44,54,30,24,117,59,58,56,24,32,18,5,13,17,29,28,1,17,15,2,26,30,0,0,0,32,5,2,9,5,4,,,
"Jun 2, 2022 2:00 PM",75,27,48,34,16,18,69,35,34,34,17,17,12,7,5,27,21,20,1,24,22,2,19,25,0,0,0,24,3,2,10,8,2,,,
"Jun 2, 2022 3:00 PM",99,38,61,26,17,9,57,36,21,37,23,14,13,6,7,16,19,17,2,25,21,4,14,28,0,0,0,28,4,1,7,4,3,,,
"Jun 2, 2022 4:00 PM",152,40,112,56,34,22,75,39,36,66,41,25,17,8,9,20,35,31,4,48,46,2,32,58,0,0,0,58,8,5,5,2,3,,,
"Jun 2, 2022 5:00 PM",215,61,154,108,46,62,157,114,43,124,88,36,24,10,14,19,34,30,4,101,96,5,28,114,0,0,0,54,5,4,6,4,2,,,
"Jun 2, 2022 6:00 PM",151,49,102,80,60,20,105,70,35,96,67,29,18,3,15,21,30,23,7,77,74,3,27,97,0,0,0,50,3,3,8,4,4,,,
"Jun 2, 2022 7:00 PM",101,35,66,20,13,7,37,25,12,26,13,13,3,2,1,9,14,14,0,35,32,3,13,43,0,0,0,25,3,1,5,3,2,,,
"Jun 2, 2022 8:00 PM",40,7,33,18,13,5,25,12,13,31,8,23,2,0,2,6,7,6,1,14,14,0,7,17,0,0,0,15,3,1,6,2,4,,,
"Jun 2, 2022 9:00 PM",40,14,26,24,22,2,26,8,18,19,7,12,8,5,3,4,8,5,3,15,13,2,7,5,0,0,0,10,2,1,2,1,1,,,
"Jun 2, 2022 10:00 PM",21,10,11,13,12,1,11,2,9,10,4,6,3,0,3,2,3,2,1,6,5,1,3,9,0,0,0,6,0,0,1,1,0,,,
"Jun 2, 2022 11:00 PM",9,3,6,3,2,1,9,0,9,7,0,7,1,1,0,1,5,3,2,3,3,0,3,13,0,0,0,8,1,1,0,0,0,,,
"Jun 3, 2022 12:00 AM",8,4,4,0,0,0,0,0,0,2,1,1,2,2,0,0,1,1,0,3,3,0,2,6,0,0,0,4,1,0,0,0,0,,,
"Jun 3, 2022 1:00 AM",5,1,4,1,1,0,2,1,1,1,0,1,1,0,1,0,0,0,0,1,1,0,0,5,0,0,0,3,0,0,0,0,0,,,
"Jun 3, 2022 2:00 AM",6,5,1,0,0,0,0,0,0,0,0,0,0,0,0,0,0,0,0,2,2,0,0,1,0,0,0,1,0,0,0,0,0,,,
"Jun 3, 2022 3:00 AM",1,0,1,2,1,1,1,1,0,1,1,0,0,0,0,0,1,1,0,1,1,0,1,1,0,0,0,1,0,0,0,0,0,,,
"Jun 3, 2022 4:00 AM",2,1,1,1,0,1,2,0,2,2,0,2,0,0,0,0,0,0,0,1,1,0,0,1,0,0,0,2,0,0,0,0,0,,,
"Jun 3, 2022 5:00 AM",5,5,0,2,2,0,4,2,2,3,2,1,0,0,0,1,6,6,0,1,1,0,6,1,0,,0,8,0,0,1,1,0,,,
"Jun 3, 2022 6:00 AM",36,23,13,20,12,8,23,16,7,18,11,7,2,1,1,7,20,19,1,10,8,2,18,10,0,,0,21,0,2,0,0,0,,,
"Jun 3, 2022 7:00 AM",82,58,24,72,23,49,63,19,44,55,24,31,12,7,5,7,49,49,0,9,7,2,46,39,0,,0,63,2,3,8,6,2,,,
"Jun 3, 2022 8:00 AM",160,105,55,71,29,42,92,30,62,87,42,45,15,9,6,15,78,77,1,19,12,7,78,36,0,,0,101,5,3,7,5,2,,,
"Jun 3, 2022 9:00 AM",89,67,22,63,26,37,77,41,36,62,41,21,21,15,6,13,42,42,0,20,15,5,36,23,0,,0,46,7,5,6,4,2,,,
"Jun 3, 2022 10:00 AM",51,29,22,57,32,25,66,36,30,50,29,21,16,10,6,13,22,22,0,10,7,3,20,14,0,,0,25,1,1,4,1,3,,,
"Jun 3, 2022 11:00 AM",58,32,26,47,18,29,53,25,28,38,15,23,10,6,4,9,17,15,2,16,9,7,13,8,0,,0,26,5,3,4,4,0,,,
"Jun 3, 2022 12:00 PM",60,23,37,49,24,25,63,30,33,41,18,23,14,7,7,13,24,24,0,18,17,1,18,26,0,,0,38,2,1,4,1,3,,,
"Jun 3, 2022 1:00 PM",90,43,47,52,29,23,70,41,29,42,29,13,22,8,14,20,22,20,2,22,19,3,24,30,0,0,0,32,3,3,3,2,1,,,
"Jun 3, 2022 2:00 PM",66,28,38,55,28,27,71,25,46,51,23,28,14,12,2,14,34,32,2,15,12,3,33,22,0,0,0,31,11,6,12,5,7,,,
"Jun 3, 2022 3:00 PM",77,29,48,53,32,21,70,49,21,63,40,23,16,7,9,13,27,26,1,20,18,2,20,37,0,0,0,35,5,3,6,4,2,,,
"Jun 3, 2022 4:00 PM",132,46,86,108,62,46,106,67,39,92,56,36,25,11,14,38,23,19,4,49,48,1,18,52,0,0,0,47,4,5,7,6,1,,,
"Jun 3, 2022 5:00 PM",161,53,108,96,48,48,136,69,67,96,48,48,26,13,13,22,35,31,4,55,48,7,30,69,0,0,0,49,1,11,8,5,3,,,
"Jun 3, 2022 6:00 PM",110,36,74,104,72,32,134,83,51,101,64,37,14,2,12,22,35,27,8,49,48,1,26,58,0,0,0,53,6,2,9,2,7,,,
"Jun 3, 2022 7:00 PM",98,37,61,68,34,34,101,50,51,72,41,31,10,4,6,14,14,12,2,27,24,3,14,28,0,0,0,27,9,3,12,6,6,,,
"Jun 3, 2022 8:00 PM",53,19,34,59,28,31,44,22,22,43,26,17,12,2,10,19,18,17,1,19,19,0,18,23,0,0,0,21,4,3,2,2,0,,,
"Jun 3, 2022 9:00 PM",42,14,28,34,15,19,31,11,20,21,6,15,9,5,4,8,11,10,1,13,12,1,9,8,0,0,0,15,1,1,2,0,2,,,
"Jun 3, 2022 10:00 PM",27,12,15,11,7,4,23,11,12,15,5,10,4,0,4,6,4,3,1,10,9,1,4,9,0,0,0,8,0,2,1,1,0,,,
"Jun 3, 2022 11:00 PM",28,8,20,10,6,4,22,7,15,12,3,9,4,3,1,3,6,5,1,9,8,1,7,11,0,0,0,11,0,1,3,1,2,,,
"Jun 4, 2022 12:00 AM",12,3,9,0,0,0,2,1,1,6,2,4,1,0,1,0,3,3,0,3,3,0,3,9,0,0,0,3,0,0,0,0,0,,,
"Jun 4, 2022 1:00 AM",14,3,11,2,2,0,6,2,4,7,5,2,1,0,1,1,2,2,0,8,8,0,3,2,0,0,0,3,0,0,0,0,0,,,
"Jun 4, 2022 2:00 AM",8,5,3,1,1,0,2,2,0,0,0,0,0,0,0,2,0,0,0,3,3,0,0,2,0,0,0,1,0,0,0,0,0,,,
"Jun 4, 2022 3:00 AM",5,0,5,0,0,0,2,1,1,2,0,2,0,0,0,0,0,0,0,2,2,0,0,3,0,,0,0,0,0,0,0,0,,,
"Jun 4, 2022 4:00 AM",7,2,5,0,0,0,1,1,0,0,0,0,0,0,0,0,1,1,0,0,0,0,1,2,0,,0,1,0,1,0,0,0,,,
"Jun 4, 2022 5:00 AM",5,4,1,1,1,0,3,2,1,2,1,1,0,0,0,1,3,3,0,2,2,0,3,1,0,,0,4,0,0,0,0,0,,,
"Jun 4, 2022 6:00 AM",13,8,5,14,10,4,20,14,6,17,12,5,0,0,0,1,3,2,1,6,6,0,4,6,0,0,0,10,1,0,4,3,1,,,
"Jun 4, 2022 7:00 AM",38,19,19,32,21,11,50,32,18,28,20,8,2,1,1,5,10,10,0,3,2,1,9,17,0,,0,14,1,1,1,0,1,,,
"Jun 4, 2022 8:00 AM",43,21,22,59,37,22,49,35,14,62,47,15,11,8,3,15,19,18,1,5,4,1,20,27,0,,0,25,6,4,4,3,1,,,
"Jun 4, 2022 9:00 AM",66,28,38,100,53,47,99,54,45,72,49,23,8,3,5,7,23,23,0,14,12,2,21,28,0,,0,28,0,10,0,0,0,,,
"Jun 4, 2022 10:00 AM",50,28,22,107,55,52,110,67,43,103,61,42,25,16,9,10,21,21,0,11,8,3,21,20,0,0,0,46,11,9,9,5,4,,,
"Jun 4, 2022 11:00 AM",61,40,21,126,76,50,137,85,52,108,72,36,41,18,23,8,23,21,2,14,8,6,20,29,0,,0,38,9,8,4,2,2,,,
"Jun 4, 2022 12:00 PM",58,29,29,150,66,84,165,83,82,126,61,65,30,16,14,16,23,22,1,21,19,2,19,32,0,,0,31,9,3,6,4,2,,,
"Jun 4, 2022 1:00 PM",60,33,27,101,46,55,117,54,63,89,41,48,43,24,19,12,22,21,1,17,14,3,21,34,0,0,0,35,3,6,2,1,1,,,
"Jun 4, 2022 2:00 PM",69,39,30,105,50,55,135,82,53,95,49,46,22,12,10,9,31,29,2,15,11,4,28,35,0,,0,34,8,6,3,2,1,,,
"Jun 4, 2022 3:00 PM",56,26,30,113,71,42,120,54,66,97,51,46,28,14,14,22,23,23,0,10,10,0,22,25,0,,0,30,4,1,3,2,1,,,
"Jun 4, 2022 4:00 PM",54,26,28,102,54,48,119,65,54,86,42,44,28,17,11,12,12,11,1,15,15,0,11,18,0,0,0,25,2,3,3,3,0,,,
"Jun 4, 2022 5:00 PM",59,29,30,77,31,46,92,29,63,57,20,37,26,18,8,10,16,16,0,20,17,3,13,28,0,,0,34,5,3,5,1,4,,,
"Jun 4, 2022 6:00 PM",48,21,27,42,21,21,74,33,41,53,17,36,15,8,7,9,20,20,0,15,13,2,18,24,0,0,0,24,4,2,10,8,2,,,
"Jun 4, 2022 7:00 PM",48,23,25,28,12,16,41,17,24,35,18,17,10,2,8,11,12,12,0,9,5,4,10,11,0,,0,18,5,2,5,2,3,,,
"Jun 4, 2022 8:00 PM",26,12,14,18,9,9,27,7,20,22,6,16,10,6,4,9,5,5,0,11,7,4,6,9,0,,0,11,2,2,3,2,1,,,
"Jun 4, 2022 9:00 PM",22,12,10,17,9,8,9,5,4,10,4,6,2,0,2,0,6,6,0,4,4,0,6,9,0,0,0,14,1,0,3,1,2,,,
"Jun 4, 2022 10:00 PM",17,6,11,3,2,1,8,0,8,5,2,3,3,2,1,1,7,6,1,6,4,2,7,3,0,,0,4,2,1,2,0,2,,,
"Jun 4, 2022 11:00 PM",13,5,8,2,0,2,17,6,11,8,3,5,2,1,1,1,5,5,0,9,7,2,5,8,0,0,0,4,0,1,0,0,0,,,
"Jun 5, 2022 12:00 AM",11,3,8,1,0,1,3,2,1,6,4,2,1,1,0,0,2,2,0,5,5,0,2,8,0,,0,3,1,0,0,0,0,,,
"Jun 5, 2022 1:00 AM",11,4,7,1,1,0,6,3,3,2,2,0,0,0,0,2,2,1,1,0,0,0,0,1,0,,0,2,0,0,1,1,0,,,
"Jun 5, 2022 2:00 AM",3,1,2,0,0,0,1,0,1,0,0,0,0,0,0,1,3,2,1,1,1,0,1,1,0,,0,2,0,0,0,0,0,,,
"Jun 5, 2022 3:00 AM",6,1,5,0,0,0,1,1,0,0,0,0,0,0,0,0,0,0,0,2,2,0,3,1,0,,0,0,0,0,0,0,0,,,
"Jun 5, 2022 4:00 AM",1,0,1,0,0,0,0,0,0,2,0,2,0,0,0,0,0,0,0,0,0,0,0,1,0,,0,0,0,0,0,0,0,,,
"Jun 5, 2022 5:00 AM",3,3,0,0,0,0,8,3,5,0,0,0,0,0,0,0,0,0,0,3,3,0,0,0,0,,0,2,0,0,1,1,0,,,
"Jun 5, 2022 6:00 AM",6,4,2,4,1,3,7,4,3,5,2,3,0,0,0,0,8,7,1,1,1,0,7,4,0,,0,7,0,0,0,0,0,,,
"Jun 5, 2022 7:00 AM",14,7,7,21,12,9,19,13,6,19,12,7,3,3,0,2,9,9,0,13,13,0,9,9,0,,0,17,1,0,2,0,2,,,
"Jun 5, 2022 8:00 AM",19,9,10,34,19,15,19,11,8,25,18,7,4,2,2,5,5,5,0,4,4,0,5,6,0,,0,9,0,5,1,0,1,,,
"Jun 5, 2022 9:00 AM",33,13,20,37,17,20,34,20,14,29,16,13,3,3,0,3,9,9,0,5,5,0,11,11,0,,0,12,0,1,1,1,0,,,
"Jun 5, 2022 10:00 AM",15,6,9,34,18,16,25,14,11,23,12,11,3,1,2,5,14,13,1,10,8,2,13,8,0,,0,18,1,1,2,1,1,,,
"Jun 5, 2022 11:00 AM",26,13,13,19,11,8,30,15,15,23,13,10,3,3,0,2,15,14,1,3,2,1,13,10,0,,0,8,1,0,2,0,2,,,
"Jun 5, 2022 12:00 PM",42,25,17,34,11,23,23,12,11,28,13,15,3,1,2,7,9,9,0,4,2,2,10,16,0,,0,20,3,3,3,3,0,,,
"Jun 5, 2022 1:00 PM",28,15,13,27,14,13,27,11,16,20,10,10,8,4,4,1,12,12,0,5,4,1,13,14,0,,0,21,1,0,3,1,2,,,
"Jun 5, 2022 2:00 PM",37,20,17,15,6,9,19,9,10,19,8,11,5,3,2,6,9,6,3,6,5,1,7,8,0,,0,17,4,0,4,4,0,,,
"Jun 5, 2022 3:00 PM",28,13,15,9,4,5,19,8,11,16,7,9,3,2,1,10,9,5,4,1,0,1,9,11,0,,0,7,0,1,2,2,0,,,
"Jun 5, 2022 4:00 PM",18,9,9,10,7,3,26,16,10,13,10,3,5,4,1,2,12,7,5,4,4,0,6,8,0,,0,10,0,1,3,1,2,,,
"Jun 5, 2022 5:00 PM",20,8,12,6,6,0,5,4,1,7,5,2,3,1,2,11,6,6,0,5,5,0,7,3,0,,0,3,0,0,3,2,1,,,
"Jun 5, 2022 6:00 PM",29,12,17,6,4,2,9,4,5,5,2,3,0,0,0,5,7,7,0,4,4,0,7,6,0,,0,8,1,1,2,1,1,,,
"Jun 5, 2022 7:00 PM",23,7,16,3,2,1,7,4,3,6,3,3,2,1,1,6,5,5,0,8,5,3,5,7,0,,0,8,0,0,2,1,1,,,
"Jun 5, 2022 8:00 PM",14,7,7,5,3,2,6,3,3,2,0,2,0,0,0,7,7,7,0,5,4,1,6,9,0,,0,2,0,1,0,0,0,,,
"Jun 5, 2022 9:00 PM",15,5,10,4,3,1,10,5,5,4,2,2,0,0,0,1,7,7,0,5,5,0,7,2,0,,0,6,0,0,0,0,0,,,
"Jun 5, 2022 10:00 PM",11,5,6,2,2,0,9,5,4,3,2,1,2,2,0,2,2,2,0,3,3,0,3,3,0,,0,2,0,0,0,0,0,,,
"Jun 5, 2022 11:00 PM",7,1,6,3,2,1,3,2,1,2,1,1,0,0,0,0,0,0,0,1,1,0,0,5,0,,0,2,0,0,0,0,0,,,
"Jun 6, 2022 12:00 AM",8,4,4,0,0,0,2,2,0,6,2,4,0,0,0,0,1,1,0,3,3,0,1,0,0,,0,2,1,0,0,0,0,,,
"Jun 6, 2022 1:00 AM",3,1,2,1,1,0,2,1,1,2,2,0,1,0,1,0,1,1,0,2,2,0,1,3,,,,2,0,0,1,0,1,,,
"Jun 6, 2022 2:00 AM",6,3,3,0,0,0,0,0,0,0,0,0,0,0,0,0,1,0,1,0,0,0,0,2,0,,0,1,0,0,2,1,1,,,
"Jun 6, 2022 3:00 AM",1,1,0,0,0,0,0,0,0,0,0,0,0,0,0,0,0,0,0,0,0,0,0,1,,,,1,0,0,0,0,0,,,
"Jun 6, 2022 4:00 AM",4,1,3,0,0,0,1,1,0,0,0,0,0,0,0,1,0,0,0,1,1,0,0,0,,,,2,0,0,0,0,0,,,
"Jun 6, 2022 5:00 AM",3,1,2,0,0,0,0,0,0,0,0,0,0,0,0,0,3,2,1,1,1,0,1,0,,,,3,0,0,0,0,0,,,
"Jun 6, 2022 6:00 AM",11,6,5,5,3,2,9,4,5,9,4,5,0,0,0,1,6,5,1,2,0,2,6,5,,,,8,1,0,0,0,0,,,
"Jun 6, 2022 7:00 AM",21,9,12,23,14,9,29,18,11,23,14,9,0,0,0,1,7,7,0,6,5,1,6,7,,,,7,2,2,1,1,0,,,
"Jun 6, 2022 8:00 AM",25,10,15,57,37,20,55,39,16,50,40,10,4,1,3,6,12,12,0,4,4,0,12,21,,,,23,2,4,2,2,0,,,
"Jun 6, 2022 9:00 AM",52,31,21,89,45,44,93,52,41,80,45,35,11,9,2,4,11,11,0,8,8,0,11,24,,,,29,2,4,4,3,1,,,
"Jun 6, 2022 10:00 AM",50,32,18,100,52,48,105,56,49,89,49,40,15,8,7,13,16,16,0,6,5,1,16,30,,,,31,3,8,1,1,0,,,
"Jun 6, 2022 11:00 AM",53,29,24,132,77,55,110,60,50,115,68,47,17,7,10,9,21,20,1,8,7,1,24,23,,,,46,5,8,4,3,1,,,
"Jun 6, 2022 12:00 PM",51,29,22,135,74,61,127,69,58,119,71,48,24,11,13,18,41,39,2,19,16,3,30,28,0,,0,34,12,10,7,6,1,,,
"Jun 6, 2022 1:00 PM",46,21,25,127,55,72,135,68,67,123,66,57,25,12,13,15,30,29,1,10,7,3,27,25,0,,0,35,5,3,5,4,1,,,
"Jun 6, 2022 2:00 PM",64,42,22,118,65,53,139,76,63,125,73,52,39,22,17,11,24,22,2,23,19,4,24,42,0,,0,31,8,7,6,5,1,,,
"Jun 6, 2022 3:00 PM",52,25,27,146,62,84,191,112,79,141,73,68,16,9,7,33,31,29,2,14,13,1,27,46,0,,0,47,5,4,5,4,1,,,
"Jun 6, 2022 4:00 PM",66,32,34,160,95,65,220,115,105,152,75,77,26,9,17,20,22,20,2,15,14,1,19,50,0,,0,31,6,9,9,8,1,,,
"Jun 6, 2022 5:00 PM",79,35,44,145,65,80,229,117,112,133,60,73,22,10,12,23,30,27,3,24,21,3,23,47,0,,0,49,4,11,4,3,1,,,
"Jun 6, 2022 6:00 PM",51,22,29,91,49,42,196,77,119,95,42,53,16,7,9,8,15,14,1,20,18,2,10,33,0,,0,49,4,3,8,6,2,,,
"Jun 6, 2022 7:00 PM",43,18,25,71,34,37,127,56,71,72,36,36,21,15,6,14,24,21,3,10,9,1,18,32,0,,0,28,6,3,5,3,2,,,
"Jun 6, 2022 8:00 PM",42,19,23,60,27,33,92,34,58,71,34,37,14,9,5,10,13,11,2,13,13,0,14,19,0,,0,32,6,0,4,4,0,,,
"Jun 6, 2022 9:00 PM",30,15,15,36,15,21,56,16,40,37,11,26,7,7,0,9,8,7,1,5,4,1,10,5,0,,0,17,3,2,6,1,5,,,
"Jun 6, 2022 10:00 PM",15,9,6,15,4,11,17,9,8,16,5,11,0,0,0,3,8,8,0,6,6,0,7,7,0,,0,9,2,2,2,2,0,,,
"Jun 6, 2022 11:00 PM",11,3,8,9,9,0,10,3,7,7,5,2,0,0,0,3,4,4,0,7,7,0,4,7,0,,0,7,0,1,3,1,2,,,
"Jun 7, 2022 12:00 AM",8,1,7,0,0,0,0,0,0,2,1,1,1,0,1,0,2,2,0,2,2,0,2,3,0,,0,2,1,0,0,0,0,,,
"Jun 7, 2022 1:00 AM",2,1,1,0,0,0,1,1,0,1,1,0,0,0,0,0,0,0,0,1,1,0,0,1,0,,0,3,0,0,0,0,0,,,
"Jun 7, 2022 2:00 AM",2,2,0,0,0,0,1,0,1,0,0,0,0,0,0,0,1,1,0,0,0,0,1,0,0,,0,1,0,0,1,1,0,,,
"Jun 7, 2022 3:00 AM",1,1,0,0,0,0,0,0,0,0,0,0,0,0,0,0,0,0,0,0,0,0,0,0,0,,0,0,0,1,1,1,0,,,
"Jun 7, 2022 4:00 AM",5,3,2,1,1,0,1,1,0,0,0,0,0,0,0,2,0,0,0,0,0,0,0,0,0,,0,2,0,0,0,0,0,,,
"Jun 7, 2022 5:00 AM",7,6,1,1,0,1,3,2,1,1,1,0,0,0,0,3,8,8,0,1,1,0,8,4,,,,5,0,0,0,0,0,,,
"Jun 7, 2022 6:00 AM",60,39,21,22,8,14,35,10,25,26,10,16,1,1,0,4,35,35,0,7,6,1,36,16,,,,38,1,5,2,2,0,,,
"Jun 7, 2022 7:00 AM",135,91,44,61,19,42,95,35,60,69,28,41,10,7,3,14,68,68,0,16,12,4,67,29,,,,116,2,3,3,3,0,,,
"Jun 7, 2022 8:00 AM",248,189,59,110,41,69,163,57,106,112,50,62,31,13,18,21,142,141,1,25,17,8,142,50,,,,193,8,10,8,7,1,,,
"Jun 7, 2022 9:00 AM",117,101,16,64,20,44,86,49,37,61,34,27,12,8,4,14,69,68,1,22,17,5,64,29,,,,57,2,5,6,3,3,,,
"Jun 7, 2022 10:00 AM",62,44,18,64,30,34,56,27,29,35,18,17,20,12,8,9,32,32,0,21,16,5,29,13,,,,24,2,3,3,2,1,,,
"Jun 7, 2022 11:00 AM",48,25,23,82,44,38,68,35,33,59,40,19,24,9,15,8,23,22,1,14,10,4,23,22,0,,0,26,3,2,7,5,2,,,
"Jun 7, 2022 12:00 PM",53,27,26,75,35,40,67,30,37,54,26,28,20,11,9,13,25,24,1,19,16,3,20,20,,,,28,3,9,5,4,1,,,
"Jun 7, 2022 1:00 PM",78,39,39,77,36,41,68,36,32,60,29,31,45,19,26,9,23,20,3,21,18,3,17,22,0,,0,25,8,2,7,4,3,,,
"Jun 7, 2022 2:00 PM",45,21,24,68,40,28,62,34,28,67,40,27,35,19,16,18,9,8,1,20,19,1,6,22,0,,0,32,7,5,7,6,1,,,
"Jun 7, 2022 3:00 PM",76,32,44,68,41,27,88,53,35,58,33,25,9,2,7,11,20,17,3,16,14,2,15,46,0,,0,31,4,1,8,7,1,,,
"Jun 7, 2022 4:00 PM",140,48,92,66,39,27,90,57,33,54,36,18,24,9,15,18,26,23,3,54,49,5,21,53,0,,0,45,9,7,9,8,1,,,
"Jun 7, 2022 5:00 PM",226,48,178,112,49,63,177,101,76,124,67,57,32,11,21,23,57,47,10,99,96,3,43,134,0,,0,66,10,9,16,13,3,,,
"Jun 7, 2022 6:00 PM",189,47,142,94,64,30,177,117,60,107,66,41,23,5,18,27,36,33,3,92,91,1,35,110,0,,0,37,8,7,10,6,4,,,
"Jun 7, 2022 7:00 PM",116,32,84,48,31,17,73,42,31,60,32,28,15,9,6,11,25,21,4,41,39,2,24,45,0,,0,25,3,0,6,2,4,,,
"Jun 7, 2022 8:00 PM",53,17,36,36,25,11,41,22,19,35,17,18,5,5,0,9,13,13,0,26,25,1,10,21,0,,0,14,2,2,2,2,0,,,
"Jun 7, 2022 9:00 PM",28,10,18,27,23,4,28,9,19,22,8,14,8,6,2,7,8,4,4,20,19,1,4,8,0,,0,14,4,0,2,2,0,,,
"Jun 7, 2022 10:00 PM",20,2,18,9,9,0,10,5,5,3,3,0,7,1,6,3,4,4,0,10,9,1,5,10,0,,0,4,3,1,2,1,1,,,
"Jun 7, 2022 11:00 PM",8,3,5,3,3,0,5,2,3,2,1,1,1,0,1,1,4,2,2,8,8,0,2,7,0,,0,3,0,1,1,1,0,,,
"Jun 8, 2022 12:00 AM",1,0,1,0,0,0,0,0,0,0,0,0,0,0,0,1,3,3,0,2,2,0,3,3,0,,0,0,0,0,1,1,0,,,
"Jun 8, 2022 1:00 AM",3,0,3,0,0,0,1,1,0,0,0,0,0,0,0,0,1,0,1,0,0,0,0,1,,,,0,0,0,0,0,0,,,
"Jun 8, 2022 2:00 AM",4,4,0,0,0,0,0,0,0,0,0,0,0,0,0,0,1,1,0,0,0,0,1,1,,,,0,0,0,0,0,0,,,
"Jun 8, 2022 3:00 AM",1,0,1,1,1,0,0,0,0,2,1,1,0,0,0,0,0,0,0,0,0,0,2,1,,,,0,0,0,0,0,0,,,
"Jun 8, 2022 4:00 AM",3,2,1,3,1,2,2,1,1,3,1,2,0,0,0,0,0,0,0,0,0,0,0,2,,,,2,0,0,0,0,0,,,
"Jun 8, 2022 5:00 AM",5,1,4,1,0,1,3,3,0,0,0,0,2,1,1,3,10,10,0,1,1,0,10,3,,,,11,0,0,0,0,0,,,
"Jun 8, 2022 6:00 AM",48,29,19,22,10,12,33,14,19,25,9,16,2,2,0,3,29,29,0,14,12,2,27,12,,,,29,0,4,3,3,0,,,
"Jun 8, 2022 7:00 AM",152,107,45,63,22,41,80,32,48,55,23,32,17,11,6,11,79,78,1,22,17,5,75,40,,,,118,3,2,8,6,2,,,
"Jun 8, 2022 8:00 AM",269,206,63,77,21,56,147,61,86,89,43,46,33,17,16,23,160,159,1,39,23,16,155,66,,,,208,8,9,12,11,1,,,
"Jun 8, 2022 9:00 AM",105,88,17,67,32,35,98,46,52,77,43,34,20,16,4,10,72,72,0,21,18,3,64,35,,,,69,5,2,8,5,3,,,
"Jun 8, 2022 10:00 AM",50,37,13,63,27,36,53,23,30,45,24,21,11,6,5,11,32,32,0,12,9,3,26,15,,,,32,2,5,4,3,1,,,
"Jun 8, 2022 11:00 AM",64,40,24,53,28,25,46,25,21,43,27,16,24,18,6,9,25,22,3,9,5,4,19,8,,,,30,2,0,4,4,0,,,
"Jun 8, 2022 12:00 PM",59,33,26,40,19,21,49,26,23,41,25,16,23,9,14,9,31,31,0,17,15,2,30,18,,,,22,2,3,4,3,1,,,
"Jun 8, 2022 1:00 PM",85,31,54,40,23,17,42,20,22,48,28,20,15,4,11,8,21,20,1,22,20,2,18,28,,,,15,2,7,7,3,4,,,
"Jun 8, 2022 2:00 PM",55,24,31,27,13,14,31,15,16,30,11,19,8,3,5,16,15,14,1,20,16,4,17,21,,,,32,2,4,7,5,2,,,
"Jun 8, 2022 3:00 PM",80,28,52,32,18,14,50,30,20,43,21,22,16,6,10,13,18,17,1,23,23,0,16,26,,,,23,2,2,12,5,7,,,
"Jun 8, 2022 4:00 PM",129,43,86,57,35,22,82,46,36,56,28,28,13,10,3,18,19,16,3,40,37,3,16,45,,,,50,4,4,5,5,0,,,
"Jun 8, 2022 5:00 PM",183,52,131,93,62,31,117,77,40,92,55,37,15,5,10,21,42,37,5,107,102,5,37,104,,,,54,7,6,7,4,3,,,
"Jun 8, 2022 6:00 PM",186,55,131,97,61,36,151,93,58,93,47,46,26,7,19,17,44,39,5,90,88,2,37,113,0,,0,45,5,10,6,4,2,,,
"Jun 8, 2022 7:00 PM",114,39,75,78,48,30,100,66,34,86,59,27,18,8,10,22,29,28,1,46,44,2,23,65,,,,33,4,6,8,3,5,,,
"Jun 8, 2022 8:00 PM",80,29,51,49,25,24,73,38,35,44,24,20,5,3,2,12,6,5,1,27,24,3,8,28,0,,0,23,8,6,2,2,0,,,
"Jun 8, 2022 9:00 PM",54,15,39,32,18,14,42,20,22,29,14,15,9,6,3,10,13,12,1,21,19,2,11,18,,,,14,8,0,7,4,3,,,
"Jun 8, 2022 10:00 PM",59,8,51,16,6,10,26,14,12,7,3,4,12,10,2,3,9,7,2,18,18,0,6,15,,,,9,0,1,2,2,0,,,
"Jun 8, 2022 11:00 PM",17,2,15,5,3,2,9,4,5,6,2,4,1,1,0,0,9,6,3,10,10,0,5,17,,,,3,0,0,0,0,0,,,
"Jun 9, 2022 12:00 AM",8,1,7,0,0,0,2,2,0,3,3,0,1,0,1,0,3,2,1,5,5,0,3,7,,,,1,0,0,1,1,0,,,
"Jun 9, 2022 1:00 AM",1,0,1,1,1,0,2,2,0,1,1,0,1,0,1,0,1,1,0,2,2,0,1,2,,,,0,0,0,1,1,0,,,
"Jun 9, 2022 2:00 AM",4,3,1,1,1,0,0,0,0,0,0,0,0,0,0,0,0,0,0,0,0,0,0,2,,,,1,0,0,0,0,0,,,
"Jun 9, 2022 3:00 AM",1,1,0,0,0,0,0,0,0,0,0,0,0,0,0,0,0,0,0,0,0,0,0,1,,,,0,0,0,0,0,0,,,
"Jun 9, 2022 4:00 AM",6,5,1,0,0,0,0,0,0,0,0,0,0,0,0,0,1,1,0,0,0,0,1,0,,,,1,0,0,0,0,0,,,
"Jun 9, 2022 5:00 AM",8,6,2,1,1,0,6,5,1,2,2,0,0,0,0,1,6,6,0,1,1,0,6,3,,,,9,0,0,0,0,0,,,
"Jun 9, 2022 6:00 AM",49,32,17,35,14,21,31,14,17,30,13,17,2,2,0,6,21,21,0,10,7,3,21,18,,,,30,1,3,7,7,0,,,
"Jun 9, 2022 7:00 AM",92,68,24,19,1,18,35,9,26,23,9,14,5,3,2,9,37,37,0,12,11,1,43,20,,,,81,1,0,6,6,0,,,
"Jun 9, 2022 8:00 AM",154,115,39,31,9,22,61,21,40,38,19,19,9,5,4,14,93,93,0,17,13,4,88,25,,,,128,3,2,3,1,2,,,
"Jun 9, 2022 9:00 AM",77,59,18,20,5,15,44,17,27,28,16,12,10,9,1,7,42,42,0,12,7,5,38,24,,,,39,0,4,4,3,1,,,
"Jun 9, 2022 10:00 AM",37,25,12,10,5,5,18,9,9,13,8,5,4,4,0,6,20,20,0,4,3,1,17,6,,,,13,0,1,1,0,1,,,
"Jun 9, 2022 11:00 AM",25,13,12,11,7,4,17,9,8,12,4,8,4,3,1,5,8,8,0,9,6,3,7,8,,,,14,0,0,4,3,1,,,
"Jun 9, 2022 12:00 PM",44,26,18,21,9,12,25,12,13,23,11,12,6,2,4,12,10,10,0,12,11,1,8,8,,,,14,0,1,3,2,1,,,
"Jun 9, 2022 1:00 PM",74,32,42,52,25,27,49,30,19,57,35,22,9,4,5,7,22,18,4,19,17,2,17,17,,,,29,2,0,5,3,2,,,
"Jun 9, 2022 2:00 PM",45,20,25,36,18,18,48,30,18,49,30,19,11,7,4,5,15,12,3,18,18,0,11,18,,,,16,1,1,11,8,3,,,
"Jun 9, 2022 3:00 PM",66,19,47,42,23,19,50,29,21,41,22,19,12,8,4,13,16,15,1,20,16,4,13,25,,,,27,5,1,5,4,1,,,
"Jun 9, 2022 4:00 PM",93,37,56,77,38,39,75,45,30,60,29,31,21,8,13,25,21,19,2,26,24,2,19,45,,,,26,3,5,8,4,4,,,
"Jun 9, 2022 5:00 PM",184,56,128,112,41,71,178,117,61,125,87,38,33,19,14,23,39,35,4,59,56,3,33,100,,,,47,9,2,15,7,8,,,
"Jun 9, 2022 6:00 PM",140,43,97,122,86,36,223,149,74,138,94,44,15,4,11,14,38,33,5,63,62,1,34,103,,,,42,2,4,9,8,1,,,
"Jun 9, 2022 7:00 PM",103,37,66,134,73,61,180,103,77,136,76,60,12,5,7,27,22,20,2,41,39,2,20,47,,,,53,1,2,8,2,6,,,
"Jun 9, 2022 8:00 PM",75,22,53,102,58,44,136,73,63,84,39,45,18,9,9,28,13,12,1,29,27,2,13,29,0,,0,36,6,2,9,6,3,,,
"Jun 9, 2022 9:00 PM",57,15,42,81,43,38,88,30,58,74,21,53,7,5,2,11,19,16,3,22,22,0,18,22,,,,35,2,4,5,3,2,,,
"Jun 9, 2022 10:00 PM",30,7,23,37,29,8,58,7,51,52,9,43,10,5,5,6,12,11,1,14,13,1,13,10,,,,18,3,1,3,3,0,,,
"Jun 9, 2022 11:00 PM",24,8,16,14,11,3,21,5,16,16,4,12,0,0,0,3,1,1,0,11,11,0,2,11,,,,7,0,1,1,0,1,,,
"Jun 10, 2022 12:00 AM",10,1,9,2,2,0,4,2,2,9,4,5,1,1,0,4,1,1,0,4,3,1,2,8,,,,2,0,0,3,2,1,,,
"Jun 10, 2022 1:00 AM",7,2,5,0,0,0,0,0,0,1,0,1,1,0,1,0,2,1,1,5,5,0,1,3,,,,3,0,0,0,0,0,,,
"Jun 10, 2022 2:00 AM",5,5,0,0,0,0,1,1,0,0,0,0,0,0,0,0,0,0,0,3,2,1,0,4,,,,1,0,0,0,0,0,,,
"Jun 10, 2022 3:00 AM",0,0,0,0,0,0,0,0,0,0,0,0,0,0,0,0,0,0,0,1,1,0,0,2,,,,0,0,0,0,0,0,,,
"Jun 10, 2022 4:00 AM",3,1,2,0,0,0,1,1,0,0,0,0,0,0,0,0,0,0,0,2,1,1,0,1,,,,1,1,0,1,1,0,,,
"Jun 10, 2022 5:00 AM",8,6,2,2,2,0,9,5,4,6,4,2,1,1,0,4,7,7,0,3,3,0,7,1,,,,11,0,0,0,0,0,,,
"Jun 10, 2022 6:00 AM",33,19,14,18,8,10,42,28,14,27,14,13,1,1,0,5,20,20,0,12,11,1,19,19,,,,30,0,4,2,2,0,,,
"Jun 10, 2022 7:00 AM",115,78,37,84,36,48,121,53,68,73,31,42,19,12,7,9,64,64,0,11,8,3,63,34,,,,81,2,4,4,3,1,,,
"Jun 10, 2022 8:00 AM",186,135,51,94,30,64,153,59,94,100,48,52,31,17,14,19,83,82,1,25,19,6,84,43,,,,122,4,6,6,5,1,,,
"Jun 10, 2022 9:00 AM",104,78,26,72,31,41,123,76,47,76,48,28,14,8,6,10,69,68,1,23,18,5,61,22,,,,66,1,7,8,5,3,,,
"Jun 10, 2022 10:00 AM",73,40,33,59,20,39,103,49,54,47,22,25,16,7,9,7,27,26,1,17,12,5,24,19,,,,36,1,3,5,3,2,,,
"Jun 10, 2022 11:00 AM",51,30,21,62,28,34,80,34,46,56,28,28,16,5,11,6,15,15,0,13,9,4,15,19,,,,33,4,3,8,4,4,,,
"Jun 10, 2022 12:00 PM",73,30,43,60,28,32,62,28,34,55,24,31,28,14,14,9,27,25,2,21,18,3,19,26,,,,38,2,0,4,2,2,,,
"Jun 10, 2022 1:00 PM",70,32,38,52,27,25,67,39,28,57,32,25,14,7,7,12,20,15,5,19,17,2,18,24,,,,35,3,6,7,5,2,,,
"Jun 10, 2022 2:00 PM",72,24,48,50,36,14,35,21,14,46,26,20,16,8,8,20,19,19,0,19,16,3,17,21,,,,34,5,0,12,8,4,,,
"Jun 10, 2022 3:00 PM",73,28,45,39,21,18,37,24,13,35,20,15,4,2,2,9,18,17,1,18,17,1,21,30,,,,24,2,6,4,1,3,,,
"Jun 10, 2022 4:00 PM",94,22,72,40,26,14,45,23,22,41,18,23,12,4,8,16,16,15,1,30,28,2,12,34,,,,44,5,3,7,5,2,,,
"Jun 10, 2022 5:00 PM",165,53,112,59,36,23,76,42,34,61,28,33,14,5,9,20,23,22,1,58,58,0,25,69,,,,43,7,5,10,6,4,,,
"Jun 10, 2022 6:00 PM",94,31,63,42,30,12,71,48,23,58,35,23,7,1,6,13,31,27,4,46,41,5,24,54,,,,30,2,2,4,3,1,,,
"Jun 10, 2022 7:00 PM",91,36,55,23,18,5,44,30,14,33,21,12,8,0,8,6,15,13,2,18,14,4,14,30,,,,29,3,1,12,9,3,,,
"Jun 10, 2022 8:00 PM",44,15,29,15,10,5,39,25,14,16,8,8,14,4,10,5,11,10,1,20,16,4,11,18,,,,25,3,2,5,2,3,,,
"Jun 10, 2022 9:00 PM",27,5,22,16,8,8,39,23,16,19,15,4,2,2,0,5,8,8,0,13,9,4,7,17,,,,9,1,1,6,3,3,,,
"Jun 10, 2022 10:00 PM",36,12,24,15,7,8,21,6,15,12,2,10,0,0,0,6,10,10,0,15,14,1,10,10,,,,10,1,1,1,0,1,,,
"Jun 10, 2022 11:00 PM",19,8,11,4,3,1,15,6,9,11,7,4,4,4,0,2,2,2,0,7,6,1,3,16,,,,3,0,0,0,0,0,,,
"Jun 11, 2022 12:00 AM",11,0,11,0,0,0,1,0,1,4,2,2,0,0,0,7,1,1,0,7,7,0,1,9,,,,2,0,0,2,2,0,,,
"Jun 11, 2022 1:00 AM",6,2,4,7,5,2,10,7,3,10,8,2,1,1,0,2,1,1,0,5,5,0,1,6,,,,1,0,0,0,0,0,,,
"Jun 11, 2022 2:00 AM",7,5,2,1,0,1,5,4,1,2,1,1,0,0,0,0,1,0,1,3,3,0,0,3,,,,4,0,1,0,0,0,,,
"Jun 11, 2022 3:00 AM",4,2,2,0,0,0,0,0,0,0,0,0,0,0,0,0,0,0,0,0,0,0,0,1,0,,0,0,0,0,0,0,0,,,
"Jun 11, 2022 4:00 AM",3,2,1,1,0,1,2,1,1,1,0,1,0,0,0,0,0,0,0,0,0,0,0,3,,,,2,0,0,0,0,0,,,
"Jun 11, 2022 5:00 AM",1,0,1,1,1,0,2,1,1,2,1,1,0,0,0,0,2,2,0,0,0,0,2,1,,,,4,0,0,1,1,0,,,
"Jun 11, 2022 6:00 AM",13,7,6,12,7,5,14,8,6,14,8,6,1,0,1,1,6,5,1,0,0,0,5,8,,,,6,0,2,2,2,0,,,
"Jun 11, 2022 7:00 AM",17,12,5,28,12,16,34,17,17,31,17,14,4,2,2,5,11,11,0,7,7,0,12,11,0,,0,15,0,6,1,1,0,,,
"Jun 11, 2022 8:00 AM",44,23,21,59,31,28,65,39,26,53,40,13,9,7,2,22,13,12,1,6,5,1,11,21,,,,23,2,2,3,2,1,,,
"Jun 11, 2022 9:00 AM",37,20,17,103,45,58,132,85,47,83,49,34,18,16,2,4,20,20,0,13,12,1,20,39,,,,23,6,6,5,4,1,,,
"Jun 11, 2022 10:00 AM",69,45,24,152,75,77,201,131,70,126,85,41,33,19,14,20,24,24,0,13,13,0,21,33,,,,33,7,5,7,5,2,,,
"Jun 11, 2022 11:00 AM",63,34,29,123,57,66,177,82,95,107,67,40,36,24,12,7,24,22,2,11,10,1,21,45,,,,37,8,8,7,4,3,,,
"Jun 11, 2022 12:00 PM",87,56,31,107,49,58,118,47,71,78,42,36,19,9,10,12,20,20,0,11,8,3,21,19,0,,0,37,6,6,14,7,7,,,
"Jun 11, 2022 1:00 PM",74,47,27,101,53,48,122,64,58,115,68,47,21,13,8,18,35,35,0,18,17,1,26,42,0,,0,34,7,2,10,5,5,,,
"Jun 11, 2022 2:00 PM",71,31,40,103,60,43,93,57,36,84,54,30,21,13,8,19,38,37,1,14,10,4,22,19,0,,0,39,6,4,7,4,3,,,
"Jun 11, 2022 3:00 PM",59,25,34,127,65,62,109,50,59,101,49,52,22,11,11,14,22,19,3,14,14,0,17,16,0,,0,26,4,5,9,4,5,,,
"Jun 11, 2022 4:00 PM",77,42,35,102,62,40,96,46,50,89,40,49,34,8,26,26,19,13,6,20,19,1,14,24,0,,0,28,6,3,7,6,1,,,
"Jun 11, 2022 5:00 PM",75,28,47,69,38,31,81,36,45,71,25,46,23,13,10,20,26,18,8,22,20,2,18,18,,,,30,2,1,4,3,1,,,
"Jun 11, 2022 6:00 PM",65,28,37,55,26,29,53,21,32,42,19,23,21,3,18,14,14,8,6,18,14,4,6,18,,,,24,3,7,5,3,2,,,
"Jun 11, 2022 7:00 PM",57,20,37,44,18,26,61,26,35,36,16,20,9,8,1,7,12,10,2,10,9,1,11,22,,,,18,4,0,5,3,2,,,
"Jun 11, 2022 8:00 PM",50,22,28,42,24,18,34,14,20,30,15,15,4,1,3,2,16,13,3,12,12,0,12,13,,,,16,4,2,5,1,4,,,
"Jun 11, 2022 9:00 PM",32,11,21,17,10,7,20,11,9,19,10,9,6,2,4,2,8,8,0,7,7,0,9,12,0,,0,11,1,0,1,1,0,,,
"Jun 11, 2022 10:00 PM",14,4,10,4,2,2,14,4,10,8,1,7,0,0,0,4,12,11,1,8,6,2,11,6,,,,10,1,2,4,2,2,,,
"Jun 11, 2022 11:00 PM",10,3,7,2,0,2,15,2,13,11,1,10,0,0,0,1,3,2,1,7,7,0,2,9,,,,4,1,1,0,0,0,,,
"Jun 12, 2022 12:00 AM",7,1,6,0,0,0,2,0,2,8,1,7,1,1,0,0,3,2,1,6,6,0,2,4,0,,0,3,0,0,0,0,0,,,
"Jun 12, 2022 1:00 AM",12,0,12,2,0,2,2,0,2,1,0,1,4,1,3,2,2,2,0,4,4,0,2,3,0,,0,8,1,0,2,1,1,,,
"Jun 12, 2022 2:00 AM",6,3,3,1,1,0,1,0,1,1,0,1,0,0,0,0,3,3,0,1,1,0,3,3,,,,2,0,0,0,0,0,,,
"Jun 12, 2022 3:00 AM",3,1,2,2,2,0,1,1,0,1,1,0,1,0,1,0,0,0,0,1,1,0,0,0,0,,0,3,0,0,0,0,0,,,
"Jun 12, 2022 4:00 AM",3,0,3,0,0,0,2,2,0,0,0,0,0,0,0,0,3,2,1,2,2,0,2,1,,,,1,0,1,0,0,0,,,
"Jun 12, 2022 5:00 AM",5,2,3,3,1,2,4,1,3,2,1,1,1,0,1,0,0,0,0,6,4,2,0,4,0,,0,1,0,2,0,0,0,,,
"Jun 12, 2022 6:00 AM",13,8,5,9,4,5,14,9,5,9,2,7,4,3,1,1,8,7,1,4,4,0,6,11,,,,8,2,4,0,0,0,,,
"Jun 12, 2022 7:00 AM",19,10,9,20,12,8,31,18,13,25,18,7,1,0,1,3,10,10,0,8,8,0,10,13,,,,17,1,9,0,0,0,,,
"Jun 12, 2022 8:00 AM",31,13,18,59,42,17,83,55,28,54,38,16,9,5,4,14,9,9,0,3,3,0,10,21,,,,41,1,10,1,0,1,,,
"Jun 12, 2022 9:00 AM",42,24,18,129,79,50,126,83,43,101,67,34,15,5,10,17,21,20,1,14,14,0,19,39,,,,27,2,7,2,2,0,,,
"Jun 12, 2022 10:00 AM",40,22,18,125,64,61,149,88,61,119,71,48,28,11,17,10,20,18,2,16,16,0,18,38,,,,35,9,0,11,6,5,,,
"Jun 12, 2022 11:00 AM",51,27,24,129,63,66,174,93,81,128,79,49,27,14,13,18,29,29,0,9,9,0,30,46,0,,0,40,2,7,6,6,0,,,
"Jun 12, 2022 12:00 PM",52,32,20,117,56,61,124,55,69,100,38,62,50,24,26,11,22,19,3,14,12,2,21,25,0,,0,42,6,6,7,5,2,,,
"Jun 12, 2022 1:00 PM",56,27,29,124,54,70,119,54,65,96,50,46,34,23,11,17,22,18,4,18,16,2,17,32,,,,31,3,6,9,3,6,,,
"Jun 12, 2022 2:00 PM",40,25,15,89,49,40,127,64,63,102,51,51,26,15,11,22,25,24,1,16,15,1,23,28,0,,0,49,4,6,5,3,2,,,
"Jun 12, 2022 3:00 PM",41,23,18,103,63,40,109,50,59,94,50,44,22,13,9,20,23,22,1,19,16,3,21,20,,,,41,3,4,6,6,0,,,
"Jun 12, 2022 4:00 PM",50,24,26,74,28,46,84,34,50,52,23,29,28,20,8,18,20,20,0,13,10,3,13,25,,,,38,6,4,6,5,1,,,
"Jun 12, 2022 5:00 PM",47,22,25,72,37,35,71,35,36,80,36,44,16,8,8,14,17,16,1,15,13,2,18,32,0,,0,23,2,4,9,5,4,,,
"Jun 12, 2022 6:00 PM",42,21,21,41,22,19,64,39,25,60,34,26,22,10,12,10,20,19,1,10,10,0,15,15,,,,19,6,1,8,6,2,,,
"Jun 12, 2022 7:00 PM",50,19,31,29,13,16,28,9,19,19,7,12,6,1,5,8,8,7,1,13,12,1,7,9,,,,13,1,3,9,7,2,,,
"Jun 12, 2022 8:00 PM",41,20,21,19,8,11,25,11,14,11,6,5,5,3,2,4,16,16,0,10,8,2,17,13,,,,15,1,0,3,2,1,,,
"Jun 12, 2022 9:00 PM",23,11,12,10,4,6,28,15,13,19,8,11,2,0,2,8,7,5,2,5,5,0,4,7,,,,15,1,0,4,2,2,,,
"Jun 12, 2022 10:00 PM",21,7,14,9,4,5,8,2,6,6,1,5,6,4,2,3,4,4,0,8,7,1,4,6,0,,0,5,2,2,1,1,0,,,
"Jun 12, 2022 11:00 PM",14,6,8,1,0,1,3,0,3,1,0,1,5,0,5,4,4,4,0,4,4,0,4,7,,,,2,0,0,1,1,0,,,
"Jun 13, 2022 12:00 AM",6,2,4,0,0,0,0,0,0,5,2,3,3,3,0,0,2,2,0,2,2,0,1,2,,,,3,1,1,1,1,0,,,
"Jun 13, 2022 1:00 AM",2,1,1,4,0,4,0,0,0,0,0,0,0,0,0,1,1,0,1,0,0,0,0,2,,,,0,0,0,0,0,0,,,
"Jun 13, 2022 2:00 AM",3,1,2,0,0,0,0,0,0,0,0,0,0,0,0,0,0,0,0,2,2,0,0,0,,,,1,0,0,0,0,0,,,
"Jun 13, 2022 3:00 AM",2,1,1,0,0,0,1,1,0,0,0,0,0,0,0,0,0,0,0,0,0,0,1,0,,,,0,0,0,0,0,0,,,
"Jun 13, 2022 4:00 AM",0,0,0,0,0,0,0,0,0,0,0,0,0,0,0,0,1,1,0,0,0,0,1,0,,,,0,0,0,0,0,0,,,
"Jun 13, 2022 5:00 AM",3,2,1,1,0,1,6,3,3,2,1,1,1,1,0,5,5,5,0,2,2,0,5,4,,,,12,0,0,2,1,1,,,
"Jun 13, 2022 6:00 AM",44,28,16,19,9,10,26,9,17,26,14,12,1,1,0,6,27,26,1,9,6,3,25,7,,,,45,2,6,5,5,0,,,
"Jun 13, 2022 7:00 AM",126,98,28,55,15,40,76,26,50,52,20,32,12,10,2,8,76,76,0,16,12,4,75,34,,,,94,3,4,3,3,0,,,
"Jun 13, 2022 8:00 AM",206,151,55,82,24,58,139,44,95,87,37,50,31,16,15,24,147,146,1,31,20,11,143,50,,,,189,5,7,12,8,4,,,
"Jun 13, 2022 9:00 AM",116,94,22,50,22,28,79,42,37,53,37,16,10,5,5,10,59,59,0,18,16,2,55,32,,,,65,3,4,5,5,0,,,
"Jun 13, 2022 10:00 AM",47,30,17,44,15,29,81,53,28,50,27,23,12,4,8,9,20,20,0,14,13,1,18,17,,,,19,1,2,1,1,0,,,
"Jun 13, 2022 11:00 AM",39,23,16,60,37,23,83,47,36,49,33,16,22,10,12,9,20,17,3,10,8,2,16,25,,,,29,1,4,3,1,2,,,
"Jun 13, 2022 12:00 PM",50,28,22,61,25,36,90,35,55,56,26,30,25,17,8,10,19,18,1,15,12,3,16,16,,,,30,5,2,9,8,1,,,
"Jun 13, 2022 1:00 PM",73,33,40,48,24,24,59,23,36,51,22,29,24,12,12,13,25,22,3,17,16,1,20,23,,,,24,4,2,6,3,3,,,
"Jun 13, 2022 2:00 PM",50,24,26,52,25,27,60,31,29,48,28,20,15,9,6,18,27,23,4,19,18,1,22,16,,,,20,3,4,7,6,1,,,
"Jun 13, 2022 3:00 PM",79,33,46,53,25,28,54,29,25,39,18,21,15,8,7,20,27,22,5,30,26,4,24,29,,,,29,4,6,10,3,7,,,
"Jun 13, 2022 4:00 PM",107,34,73,74,43,31,77,51,26,68,40,28,18,10,8,26,25,22,3,36,34,2,25,50,0,,0,37,14,2,13,11,2,,,
"Jun 13, 2022 5:00 PM",213,51,162,104,64,40,130,65,65,111,61,50,25,11,14,19,37,33,4,96,92,4,31,100,,,,61,9,6,11,7,4,,,
"Jun 13, 2022 6:00 PM",175,56,119,95,60,35,121,93,28,87,59,28,19,3,16,23,50,45,5,100,96,4,45,118,,,,42,4,6,10,5,5,,,
"Jun 13, 2022 7:00 PM",93,34,59,81,42,39,75,41,34,74,42,32,13,3,10,26,19,17,2,48,47,1,13,52,,,,19,4,4,14,11,3,,,
"Jun 13, 2022 8:00 PM",80,30,50,88,55,33,81,37,44,75,43,32,19,13,6,11,8,8,0,25,25,0,10,22,,,,22,5,3,6,3,3,,,
"Jun 13, 2022 9:00 PM",44,13,31,28,11,17,40,15,25,39,11,28,1,0,1,10,16,14,2,14,14,0,10,18,,,,19,7,0,7,6,1,,,
"Jun 13, 2022 10:00 PM",19,4,15,13,8,5,21,10,11,15,8,7,2,0,2,4,2,1,1,14,13,1,2,11,,,,9,1,1,2,1,1,,,
"Jun 13, 2022 11:00 PM",17,3,14,5,5,0,2,0,2,8,5,3,2,0,2,1,4,4,0,5,5,0,4,3,,,,4,0,0,0,0,0,,,
"Jun 14, 2022 12:00 AM",4,1,3,0,0,0,1,1,0,2,1,1,0,0,0,0,0,0,0,0,0,0,0,6,,,,0,0,0,2,1,1,,,
"Jun 14, 2022 1:00 AM",4,0,4,0,0,0,1,1,0,1,1,0,0,0,0,0,1,0,1,0,0,0,0,1,,,,2,0,0,0,0,0,,,
"Jun 14, 2022 2:00 AM",6,4,2,0,0,0,0,0,0,0,0,0,0,0,0,0,1,1,0,0,0,0,1,1,,,,2,0,0,1,1,0,,,
"Jun 14, 2022 3:00 AM",1,0,1,0,0,0,1,1,0,0,0,0,0,0,0,0,2,2,0,0,0,0,2,0,,,,0,0,0,0,0,0,,,
"Jun 14, 2022 4:00 AM",2,2,0,0,0,0,1,1,0,1,1,0,0,0,0,0,1,1,0,0,0,0,1,2,,,,1,0,0,0,0,0,,,
"Jun 14, 2022 5:00 AM",9,5,4,2,2,0,1,0,1,1,1,0,1,1,0,3,7,7,0,1,1,0,7,2,,,,11,0,0,1,1,0,,,
"Jun 14, 2022 6:00 AM",59,39,20,15,4,11,25,9,16,23,9,14,0,0,0,8,25,25,0,12,10,2,24,15,,,,43,3,7,3,3,0,,,
"Jun 14, 2022 7:00 AM",139,97,42,55,18,37,72,23,49,50,19,31,10,9,1,17,78,76,2,21,15,6,81,31,,,,118,4,3,7,7,0,,,
"Jun 14, 2022 8:00 AM",305,233,72,103,26,77,132,47,85,89,37,52,28,15,13,29,167,165,2,38,27,11,163,49,,,,196,6,10,14,10,4,,,
"Jun 14, 2022 9:00 AM",130,107,23,72,25,47,108,49,59,73,39,34,17,11,6,13,76,75,1,25,18,7,63,29,,,,83,5,11,6,4,2,,,
"Jun 14, 2022 10:00 AM",55,32,23,59,25,34,70,33,37,45,25,20,17,12,5,14,21,21,0,14,10,4,20,18,,,,29,5,6,4,4,0,,,
"Jun 14, 2022 11:00 AM",33,23,10,51,28,23,72,39,33,45,21,24,15,7,8,10,21,19,2,11,7,4,18,20,,,,32,4,5,4,0,4,,,
"Jun 14, 2022 12:00 PM",62,30,32,36,12,24,90,49,41,43,20,23,12,7,5,16,33,31,2,25,23,2,28,30,,,,24,6,5,6,5,1,,,
"Jun 14, 2022 1:00 PM",87,41,46,73,30,43,83,41,42,61,33,28,15,9,6,9,35,31,4,25,22,3,32,26,,,,35,5,1,8,8,0,,,
"Jun 14, 2022 2:00 PM",55,23,32,34,22,12,58,38,20,38,29,9,12,8,4,13,19,19,0,16,13,3,19,27,,,,20,4,6,8,5,3,,,
"Jun 14, 2022 3:00 PM",81,33,48,46,33,13,56,39,17,44,31,13,11,3,8,14,23,20,3,29,27,2,18,34,,,,25,6,3,10,5,5,,,
"Jun 14, 2022 4:00 PM",134,42,92,67,36,31,80,43,37,78,42,36,15,4,11,36,40,32,8,48,47,1,31,64,,,,44,10,6,6,3,3,,,
"Jun 14, 2022 5:00 PM",235,58,177,113,75,38,146,90,56,122,82,40,45,15,30,33,41,37,4,104,97,7,33,115,,,,52,11,8,16,11,5,,,
"Jun 14, 2022 6:00 PM",232,58,174,121,80,41,177,115,62,130,88,42,30,10,20,54,57,54,3,100,98,2,53,135,,,,57,6,3,9,4,5,,,
"Jun 14, 2022 7:00 PM",139,55,84,103,58,45,108,73,35,105,58,47,15,7,8,22,32,27,5,48,42,6,24,69,,,,27,5,2,11,6,5,,,
"Jun 14, 2022 8:00 PM",96,35,61,76,34,42,104,48,56,83,45,38,19,11,8,16,23,20,3,34,32,2,21,27,,,,35,5,0,9,7,2,,,
"Jun 14, 2022 9:00 PM",54,17,37,41,27,14,65,30,35,35,15,20,8,2,6,13,8,7,1,24,23,1,4,21,,,,27,4,0,2,1,1,,,
"Jun 14, 2022 10:00 PM",31,7,24,31,21,10,36,12,24,29,8,21,7,3,4,9,4,4,0,17,17,0,2,13,,,,12,2,0,4,1,3,,,
"Jun 14, 2022 11:00 PM",13,3,10,3,3,0,12,4,8,4,2,2,1,1,0,3,5,5,0,6,6,0,5,10,,,,3,0,0,3,2,1,,,
"Jun 15, 2022 12:00 AM",4,1,3,0,0,0,0,0,0,3,1,2,0,0,0,1,3,3,0,7,7,0,3,6,,,,1,0,1,0,0,0,,,
"Jun 15, 2022 1:00 AM",3,1,2,0,0,0,2,2,0,1,1,0,0,0,0,0,4,3,1,1,1,0,3,1,,,,6,1,0,2,1,1,,,
"Jun 15, 2022 2:00 AM",3,2,1,0,0,0,0,0,0,0,0,0,0,0,0,0,1,1,0,1,1,0,1,1,,,,1,0,0,0,0,0,,,
"Jun 15, 2022 3:00 AM",1,0,1,0,0,0,1,1,0,0,0,0,0,0,0,0,0,0,0,0,0,0,2,2,,,,0,0,0,0,0,0,,,
"Jun 15, 2022 4:00 AM",4,2,2,1,0,1,2,1,1,2,1,1,1,0,1,0,1,1,0,1,1,0,1,1,,,,1,0,0,1,1,0,,,
"Jun 15, 2022 5:00 AM",11,8,3,6,4,2,5,4,1,6,5,1,2,1,1,4,8,7,1,0,0,0,8,3,,,,13,0,0,1,1,0,,,
"Jun 15, 2022 6:00 AM",59,36,23,28,10,18,37,12,25,32,13,19,4,4,0,9,35,34,1,17,15,2,34,18,,,,34,4,4,4,4,0,,,
"Jun 15, 2022 7:00 AM",146,92,54,74,29,45,87,28,59,65,26,39,10,8,2,13,79,79,0,22,18,4,84,44,,,,141,0,7,7,7,0,,,
"Jun 15, 2022 8:00 AM",256,197,59,116,38,78,145,51,94,104,49,55,23,13,10,44,171,170,1,33,22,11,159,66,,,,211,9,5,15,12,3,,,
"Jun 15, 2022 9:00 AM",129,106,23,75,25,50,102,56,46,81,47,34,22,14,8,14,75,74,1,25,21,4,67,36,,,,60,4,5,5,3,2,,,
"Jun 15, 2022 10:00 AM",50,36,14,59,27,32,89,47,42,62,32,30,15,7,8,14,21,21,0,12,10,2,21,26,,,,35,0,2,4,2,2,,,
"Jun 15, 2022 11:00 AM",47,24,23,69,28,41,82,40,42,51,25,26,10,4,6,15,15,15,0,10,8,2,14,20,,,,24,1,6,5,2,3,,,
"Jun 15, 2022 12:00 PM",54,27,27,68,21,47,102,48,54,48,25,23,18,9,9,25,18,17,1,24,23,1,17,30,,,,32,5,1,3,0,3,,,
"Jun 15, 2022 1:00 PM",82,39,43,74,41,33,165,69,96,85,38,47,20,11,9,13,24,22,2,10,7,3,19,31,,,,63,1,4,8,5,3,,,
"Jun 15, 2022 2:00 PM",71,28,43,46,25,21,75,43,32,56,34,22,29,15,14,15,15,14,1,29,27,2,14,25,,,,30,6,5,12,7,5,,,
"Jun 15, 2022 3:00 PM",90,33,57,76,38,38,98,54,44,64,31,33,20,5,15,16,22,20,2,25,23,2,21,36,,,,26,4,2,6,4,2,,,
"Jun 15, 2022 4:00 PM",132,36,96,101,61,40,115,68,47,102,63,39,23,12,11,24,33,27,6,51,50,1,29,55,,,,46,6,4,6,5,1,,,
"Jun 15, 2022 5:00 PM",242,66,176,142,88,54,167,103,64,135,85,50,24,12,12,33,57,54,3,98,88,10,54,145,,,,61,8,8,14,11,3,,,
"Jun 15, 2022 6:00 PM",197,69,128,134,98,36,192,131,61,159,107,52,29,5,24,44,48,40,8,100,96,4,38,127,,,,51,5,12,10,6,4,,,
"Jun 15, 2022 7:00 PM",131,45,86,122,68,54,140,91,49,118,75,43,14,6,8,33,40,36,4,43,42,1,34,57,,,,50,3,6,7,5,2,,,
"Jun 15, 2022 8:00 PM",87,25,62,125,56,69,93,39,54,93,34,59,19,19,0,12,25,22,3,38,38,0,23,22,0,,0,34,5,2,11,8,3,,,
"Jun 15, 2022 9:00 PM",50,11,39,66,44,22,75,30,45,56,22,34,15,3,12,10,9,8,1,25,25,0,9,16,,,,35,9,2,3,2,1,,,
"Jun 15, 2022 10:00 PM",45,7,38,31,15,16,31,8,23,33,10,23,7,3,4,3,11,9,2,13,12,1,8,19,,,,20,2,2,5,3,2,,,
"Jun 15, 2022 11:00 PM",18,5,13,11,7,4,17,5,12,8,2,6,3,1,2,1,5,5,0,14,13,1,5,13,,,,5,0,1,1,0,1,,,
"Jun 16, 2022 12:00 AM",12,6,6,0,0,0,5,1,4,4,1,3,2,2,0,0,2,1,1,5,5,0,1,3,,,,3,0,0,0,0,0,,,
"Jun 16, 2022 1:00 AM",7,2,5,1,1,0,6,6,0,2,2,0,0,0,0,0,0,0,0,2,2,0,0,3,,,,0,1,1,1,0,1,,,
"Jun 16, 2022 2:00 AM",3,3,0,0,0,0,0,0,0,0,0,0,0,0,0,0,1,1,0,0,0,0,1,2,,,,2,0,0,0,0,0,,,
"Jun 16, 2022 3:00 AM",0,0,0,0,0,0,0,0,0,0,0,0,0,0,0,0,0,0,0,0,0,0,0,0,,,,0,0,0,0,0,0,,,
"Jun 16, 2022 4:00 AM",3,1,2,0,0,0,1,1,0,1,1,0,0,0,0,0,2,2,0,1,1,0,2,0,,,,0,0,0,0,0,0,,,
"Jun 16, 2022 5:00 AM",7,5,2,2,1,1,5,3,2,1,1,0,1,0,1,4,5,5,0,2,2,0,5,3,,,,11,0,1,0,0,0,,,
"Jun 16, 2022 6:00 AM",52,30,22,33,14,19,28,12,16,29,14,15,1,1,0,13,30,29,1,12,11,1,31,21,,,,27,2,8,3,3,0,,,
"Jun 16, 2022 7:00 AM",120,85,35,61,27,34,85,34,51,65,38,27,13,10,3,9,80,80,0,14,10,4,78,37,,,,117,3,6,5,4,1,,,
"Jun 16, 2022 8:00 AM",258,183,75,113,37,76,146,54,92,109,48,61,37,20,17,36,146,146,0,30,23,7,144,60,,,,190,5,5,9,5,4,,,
"Jun 16, 2022 9:00 AM",133,106,27,63,25,38,90,46,44,67,39,28,19,13,6,19,79,77,2,14,13,1,71,31,,,,93,4,3,8,4,4,,,
"Jun 16, 2022 10:00 AM",66,40,26,70,34,36,77,52,25,61,41,20,11,8,3,10,36,34,2,12,9,3,36,23,,,,27,7,2,3,2,1,,,
"Jun 16, 2022 11:00 AM",47,29,18,71,38,33,75,35,40,71,33,38,21,11,10,18,22,21,1,12,10,2,21,19,,,,34,4,5,2,1,1,,,
"Jun 16, 2022 12:00 PM",53,26,27,66,33,33,83,49,34,61,33,28,18,4,14,19,26,24,2,14,12,2,23,26,,,,34,1,7,4,4,0,,,
"Jun 16, 2022 1:00 PM",97,44,53,82,37,45,130,69,61,72,36,36,21,9,12,18,27,24,3,17,15,2,22,32,,,,22,4,2,3,2,1,,,
"Jun 16, 2022 2:00 PM",62,32,30,87,51,36,99,47,52,72,37,35,11,5,6,9,22,19,3,34,31,3,21,37,,,,35,3,2,6,3,3,,,
"Jun 16, 2022 3:00 PM",97,34,63,63,43,20,137,75,62,76,45,31,14,7,7,16,29,24,5,32,30,2,21,38,,,,39,4,1,9,8,1,,,
"Jun 16, 2022 4:00 PM",128,30,98,82,38,44,144,90,54,78,46,32,42,15,27,32,29,27,2,34,34,0,25,63,,,,61,3,7,3,3,0,,,
"Jun 16, 2022 5:00 PM",215,61,154,169,89,80,237,160,77,181,132,49,30,10,20,31,42,38,4,89,82,7,35,139,,,,77,3,4,10,8,2,,,
"Jun 16, 2022 6:00 PM",175,52,123,158,98,60,184,129,55,170,125,45,53,23,30,26,28,27,1,75,72,3,29,114,0,,0,47,7,2,11,8,3,,,
"Jun 16, 2022 7:00 PM",109,49,60,117,58,59,170,89,81,124,70,54,22,13,9,27,30,26,4,34,33,1,21,64,,,,50,4,5,15,9,6,,,
"Jun 16, 2022 8:00 PM",83,29,54,88,48,40,115,46,69,104,48,56,18,11,7,9,23,23,0,33,32,1,25,31,,,,58,7,5,11,5,6,,,
"Jun 16, 2022 9:00 PM",55,13,42,55,32,23,81,23,58,60,12,48,14,8,6,20,16,13,3,23,22,1,16,14,,,,38,2,3,8,4,4,,,
"Jun 16, 2022 10:00 PM",34,11,23,36,26,10,46,13,33,32,6,26,7,4,3,0,10,8,2,18,18,0,10,17,,,,20,1,1,3,1,2,,,
"Jun 16, 2022 11:00 PM",18,4,14,9,5,4,17,6,11,10,1,9,3,2,1,1,6,5,1,8,6,2,5,19,,,,5,0,0,0,0,0,,,
"Jun 17, 2022 12:00 AM",17,2,15,2,2,0,5,2,3,14,8,6,4,1,3,1,2,1,1,10,10,0,2,11,,,,5,0,0,2,1,1,,,
"Jun 17, 2022 1:00 AM",7,2,5,0,0,0,2,2,0,1,1,0,0,0,0,1,1,1,0,2,1,1,0,4,,,,1,0,0,1,1,0,,,
"Jun 17, 2022 2:00 AM",6,3,3,2,2,0,2,2,0,2,2,0,0,0,0,0,1,1,0,3,2,1,1,3,,,,1,0,0,0,0,0,,,
"Jun 17, 2022 3:00 AM",3,2,1,0,0,0,0,0,0,0,0,0,0,0,0,0,0,0,0,3,3,0,0,2,,,,1,0,0,0,0,0,,,
"Jun 17, 2022 4:00 AM",2,0,2,1,0,1,4,3,1,3,2,1,0,0,0,0,3,3,0,0,0,0,3,4,,,,2,0,0,0,0,0,,,
"Jun 17, 2022 5:00 AM",10,3,7,7,5,2,10,6,4,5,5,0,1,1,0,5,7,7,0,2,2,0,6,6,,,,13,0,0,0,0,0,,,
"Jun 17, 2022 6:00 AM",41,25,16,22,10,12,35,14,21,30,14,16,2,1,1,9,24,24,0,15,13,2,23,23,,,,26,0,4,1,1,0,,,
"Jun 17, 2022 7:00 AM",111,78,33,89,45,44,83,39,44,73,38,35,9,9,0,10,54,54,0,19,13,6,52,38,,,,77,3,3,9,8,1,,,
"Jun 17, 2022 8:00 AM",149,109,40,101,32,69,106,39,67,92,42,50,29,15,14,24,97,97,0,24,12,12,93,40,,,,132,3,11,8,6,2,,,
"Jun 17, 2022 9:00 AM",108,84,24,81,41,40,89,55,34,85,53,32,21,11,10,16,58,58,0,21,15,6,56,34,,,,50,3,5,3,0,3,,,
"Jun 17, 2022 10:00 AM",48,32,16,75,28,47,84,40,44,71,34,37,19,13,6,13,28,27,1,13,12,1,22,23,,,,32,5,2,4,3,1,,,
"Jun 17, 2022 11:00 AM",48,29,19,54,28,26,84,51,33,55,38,17,14,11,3,15,21,20,1,10,9,1,19,19,,,,37,2,7,4,3,1,,,
"Jun 17, 2022 12:00 PM",63,35,28,73,33,40,103,64,39,70,34,36,11,4,7,18,21,21,0,22,19,3,21,21,,,,30,2,2,4,4,0,,,
"Jun 17, 2022 1:00 PM",96,42,54,72,39,33,120,64,56,74,45,29,31,9,22,12,26,22,4,26,24,2,26,37,,,,40,7,6,6,3,3,,,
"Jun 17, 2022 2:00 PM",73,34,39,91,46,45,101,56,45,92,48,44,20,9,11,23,26,26,0,29,28,1,24,47,,,,40,7,4,7,4,3,,,
"Jun 17, 2022 3:00 PM",95,39,56,93,53,40,128,64,64,84,50,34,27,12,15,20,20,19,1,33,31,2,15,37,,,,31,4,3,4,1,3,,,
"Jun 17, 2022 4:00 PM",134,58,76,96,57,39,132,71,61,92,50,42,28,13,15,25,28,26,2,44,41,3,27,49,,,,53,6,5,4,2,2,,,
"Jun 17, 2022 5:00 PM",160,51,109,96,48,48,146,72,74,95,45,50,27,11,16,26,29,26,3,73,69,4,25,76,,,,56,6,7,13,8,5,,,
"Jun 17, 2022 6:00 PM",129,48,81,61,33,28,127,69,58,78,40,38,22,8,14,16,20,16,4,39,38,1,17,59,,,,38,4,2,7,6,1,,,
"Jun 17, 2022 7:00 PM",87,35,52,68,45,23,69,38,31,65,33,32,22,7,15,22,13,11,2,27,25,2,13,40,,,,42,2,2,7,3,4,,,
"Jun 17, 2022 8:00 PM",61,26,35,41,26,15,40,19,21,44,24,20,10,2,8,13,22,22,0,18,17,1,21,10,,,,19,3,2,4,3,1,,,
"Jun 17, 2022 9:00 PM",44,15,29,25,15,10,33,16,17,19,11,8,6,2,4,9,13,12,1,9,8,1,11,11,,,,13,1,6,8,2,6,,,
"Jun 17, 2022 10:00 PM",31,9,22,2,0,2,20,6,14,11,6,5,7,2,5,2,5,3,2,9,8,1,4,10,,,,9,1,3,4,2,2,,,
"Jun 17, 2022 11:00 PM",34,9,25,8,4,4,6,3,3,6,4,2,7,4,3,5,7,6,1,16,16,0,5,11,,,,5,1,2,0,0,0,,,
"Jun 18, 2022 12:00 AM",21,7,14,0,0,0,3,2,1,0,0,0,4,4,0,0,3,3,0,7,7,0,3,11,,,,6,2,0,1,0,1,,,
"Jun 18, 2022 1:00 AM",9,2,7,1,1,0,2,1,1,4,3,1,0,0,0,1,2,2,0,3,1,2,2,8,,,,6,0,0,0,0,0,,,
"Jun 18, 2022 2:00 AM",8,3,5,2,2,0,1,0,1,0,0,0,0,0,0,0,1,1,0,2,2,0,1,5,,,,3,0,0,1,1,0,,,
"Jun 18, 2022 3:00 AM",4,0,4,0,0,0,0,0,0,0,0,0,0,0,0,0,0,0,0,1,1,0,2,3,,,,0,0,0,0,0,0,,,
"Jun 18, 2022 4:00 AM",4,1,3,1,0,1,4,3,1,1,0,1,0,0,0,1,1,1,0,0,0,0,1,0,,,,2,0,0,0,0,0,,,
"Jun 18, 2022 5:00 AM",2,1,1,2,1,1,10,3,7,1,1,0,1,1,0,0,2,2,0,1,1,0,2,2,,,,3,1,0,1,1,0,,,
"Jun 18, 2022 6:00 AM",11,7,4,7,3,4,18,12,6,9,6,3,0,0,0,2,3,3,0,1,1,0,3,6,,,,8,0,0,0,0,0,,,
"Jun 18, 2022 7:00 AM",30,5,25,31,21,10,33,21,12,45,31,14,3,3,0,4,11,10,1,7,7,0,13,15,,,,25,1,5,0,0,0,,,
"Jun 18, 2022 8:00 AM",43,28,15,64,45,19,61,43,18,65,50,15,40,10,30,25,13,13,0,5,4,1,13,29,,,,22,2,7,2,1,1,,,
"Jun 18, 2022 9:00 AM",53,24,29,117,62,55,91,61,30,98,68,30,30,8,22,14,15,14,1,10,8,2,14,33,,,,24,1,2,5,3,2,,,
"Jun 18, 2022 10:00 AM",65,40,25,149,76,73,143,98,45,149,112,37,22,7,15,14,21,21,0,8,8,0,22,31,,,,23,8,6,9,7,2,,,
"Jun 18, 2022 11:00 AM",55,33,22,128,64,64,124,66,58,126,67,59,32,22,10,15,19,18,1,18,16,2,16,41,,,,31,4,4,5,4,1,,,
"Jun 18, 2022 12:00 PM",56,29,27,142,61,81,140,61,79,116,46,70,26,22,4,19,25,25,0,12,11,1,21,39,,,,32,1,4,4,4,0,,,
"Jun 18, 2022 1:00 PM",86,41,45,126,49,77,122,70,52,107,63,44,44,29,15,13,16,16,0,13,12,1,13,34,,,,37,9,5,5,2,3,,,
"Jun 18, 2022 2:00 PM",68,40,28,99,48,51,123,73,50,98,54,44,24,16,8,13,26,25,1,22,18,4,25,36,,,,27,11,7,1,0,1,,,
"Jun 18, 2022 3:00 PM",75,41,34,107,58,49,143,70,73,114,67,47,33,19,14,32,31,30,1,21,17,4,26,26,,,,37,5,1,8,4,4,,,
"Jun 18, 2022 4:00 PM",68,36,32,112,52,60,119,63,56,86,38,48,23,11,12,29,18,18,0,14,14,0,16,25,,,,32,4,5,7,6,1,,,
"Jun 18, 2022 5:00 PM",70,31,39,81,37,44,121,47,74,99,40,59,22,12,10,15,21,21,0,17,15,2,24,23,,,,39,3,3,4,2,2,,,
"Jun 18, 2022 6:00 PM",69,24,45,83,48,35,99,28,71,77,25,52,24,7,17,22,13,13,0,17,16,1,14,18,,,,21,4,3,5,3,2,,,
"Jun 18, 2022 7:00 PM",68,39,29,66,37,29,76,33,43,57,30,27,19,10,9,18,16,14,2,16,14,2,15,21,,,,31,2,1,2,0,2,,,
"Jun 18, 2022 8:00 PM",45,26,19,43,22,21,48,29,19,36,21,15,11,3,8,2,9,8,1,5,5,0,6,22,,,,23,2,0,0,0,0,,,
"Jun 18, 2022 9:00 PM",16,6,10,40,19,21,43,15,28,30,11,19,13,9,4,6,5,5,0,13,12,1,5,14,,,,21,0,1,4,2,2,,,
"Jun 18, 2022 10:00 PM",24,9,15,10,5,5,14,3,11,14,5,9,8,5,3,3,6,6,0,5,5,0,6,6,,,,12,0,2,3,1,2,,,
"Jun 18, 2022 11:00 PM",18,6,12,14,6,8,15,6,9,11,2,9,4,4,0,6,6,5,1,7,7,0,6,5,,,,8,0,1,0,0,0,,,
"Jun 19, 2022 12:00 AM",13,3,10,1,1,0,2,0,2,8,2,6,5,3,2,2,1,1,0,6,6,0,1,9,,,,8,1,1,0,0,0,,,
"Jun 19, 2022 1:00 AM",6,1,5,1,1,0,6,2,4,3,2,1,0,0,0,1,2,2,0,2,2,0,2,4,,,,8,0,1,2,1,1,,,
"Jun 19, 2022 2:00 AM",10,2,8,0,0,0,9,5,4,4,2,2,0,0,0,3,0,0,0,4,4,0,0,1,,,,7,0,0,0,0,0,,,
"Jun 19, 2022 3:00 AM",6,0,6,2,2,0,1,1,0,2,2,0,0,0,0,0,1,1,0,0,0,0,1,3,,,,0,1,0,0,0,0,,,
"Jun 19, 2022 4:00 AM",2,0,2,0,0,0,1,1,0,0,0,0,4,0,4,1,1,1,0,0,0,0,1,0,,,,1,0,1,0,0,0,,,
"Jun 19, 2022 5:00 AM",1,1,0,3,0,3,2,0,2,1,0,1,1,1,0,1,2,2,0,2,2,0,2,1,,,,2,0,0,0,0,0,,,
"Jun 19, 2022 6:00 AM",7,3,4,7,5,2,13,9,4,6,3,3,1,0,1,0,3,2,1,3,3,0,3,7,,,,7,0,1,1,1,0,,,
"Jun 19, 2022 7:00 AM",15,11,4,18,10,8,32,20,12,27,17,10,1,1,0,1,16,16,0,7,7,0,16,5,,,,22,0,5,0,0,0,,,
"Jun 19, 2022 8:00 AM",20,10,10,73,48,25,77,58,19,67,50,17,5,2,3,6,13,13,0,5,5,0,12,27,,,,16,0,10,1,1,0,,,
"Jun 19, 2022 9:00 AM",32,17,15,121,67,54,101,57,44,95,56,39,15,9,6,11,13,13,0,8,4,4,14,31,,,,38,3,9,4,4,0,,,
"Jun 19, 2022 10:00 AM",57,38,19,119,62,57,109,59,50,103,59,44,25,14,11,25,14,14,0,5,5,0,15,20,,,,45,3,4,3,3,0,,,
"Jun 19, 2022 11:00 AM",54,35,19,130,65,65,118,57,61,121,60,61,14,8,6,10,18,18,0,13,12,1,20,40,,,,44,8,7,3,2,1,,,
"Jun 19, 2022 12:00 PM",65,28,37,137,65,72,132,75,57,122,62,60,24,11,13,29,19,19,0,14,9,5,21,54,,,,35,5,4,4,2,2,,,
"Jun 19, 2022 1:00 PM",56,21,35,113,62,51,141,81,60,104,65,39,24,10,14,22,20,19,1,13,9,4,16,38,,,,34,5,3,8,4,4,,,
"Jun 19, 2022 2:00 PM",57,30,27,119,66,53,174,105,69,115,62,53,24,12,12,23,21,21,0,13,12,1,23,33,,,,27,5,1,6,5,1,,,
"Jun 19, 2022 3:00 PM",75,40,35,165,85,80,165,100,65,132,77,55,31,11,20,27,25,23,2,21,17,4,22,43,,,,32,8,3,11,7,4,,,
"Jun 19, 2022 4:00 PM",73,32,41,124,56,68,197,79,118,138,61,77,30,19,11,26,23,22,1,12,7,5,23,39,,,,47,2,2,8,7,1,,,
"Jun 19, 2022 5:00 PM",75,30,45,138,71,67,168,64,104,128,56,72,32,21,11,12,19,18,1,10,8,2,17,31,,,,46,2,0,9,7,2,,,
"Jun 19, 2022 6:00 PM",65,22,43,73,35,38,103,36,67,61,31,30,18,10,8,10,15,14,1,12,12,0,15,22,,,,40,3,0,7,5,2,,,
"Jun 19, 2022 7:00 PM",47,25,22,50,29,21,56,21,35,44,23,21,10,4,6,9,8,8,0,6,5,1,8,14,,,,29,5,2,3,1,2,,,
"Jun 19, 2022 8:00 PM",30,16,14,49,18,31,46,12,34,43,12,31,29,21,8,5,12,11,1,11,7,4,11,11,,,,21,0,0,1,0,1,,,
"Jun 19, 2022 9:00 PM",31,11,20,24,9,15,23,8,15,24,6,18,15,11,4,4,14,13,1,7,6,1,15,7,,,,12,1,1,2,1,1,,,
"Jun 19, 2022 10:00 PM",21,5,16,6,2,4,11,6,5,8,5,3,3,2,1,2,4,4,0,5,4,1,3,9,,,,4,0,3,1,1,0,,,
"Jun 19, 2022 11:00 PM",16,7,9,4,4,0,6,3,3,4,3,1,5,1,4,4,3,3,0,4,4,0,0,8,,,,4,1,0,1,0,1,,,
"Jun 20, 2022 12:00 AM",13,3,10,0,0,0,2,1,1,1,0,1,3,3,0,0,4,4,0,7,6,1,3,5,,,,2,2,0,0,0,0,,,
"Jun 20, 2022 1:00 AM",2,1,1,2,2,0,0,0,0,3,1,2,4,2,2,1,1,0,1,2,2,0,0,2,,,,1,0,0,0,0,0,,,
"Jun 20, 2022 2:00 AM",1,0,1,0,0,0,1,1,0,1,1,0,0,0,0,0,0,0,0,3,3,0,0,1,,,,0,0,0,0,0,0,,,
"Jun 20, 2022 3:00 AM",1,0,1,0,0,0,1,1,0,0,0,0,0,0,0,0,0,0,0,0,0,0,1,1,,,,0,0,0,0,0,0,,,
"Jun 20, 2022 4:00 AM",4,0,4,0,0,0,1,1,0,1,1,0,0,0,0,0,2,2,0,1,1,0,1,0,,,,3,0,0,0,0,0,,,
"Jun 20, 2022 5:00 AM",4,1,3,1,0,1,4,3,1,4,2,2,2,2,0,1,7,7,0,1,1,0,7,1,,,,12,0,1,1,1,0,,,
"Jun 20, 2022 6:00 AM",47,31,16,17,7,10,31,16,15,18,7,11,5,5,0,7,29,28,1,12,10,2,30,16,,,,30,3,3,4,4,0,,,
"Jun 20, 2022 7:00 AM",128,88,40,74,33,41,96,45,51,69,33,36,12,10,2,16,79,78,1,16,10,6,73,31,,,,114,2,3,10,10,0,,,
"Jun 20, 2022 8:00 AM",219,165,54,110,31,79,153,51,102,108,40,68,26,18,8,31,148,147,1,30,20,10,141,50,,,,179,11,4,8,4,4,,,
"Jun 20, 2022 9:00 AM",123,98,25,74,28,46,76,39,37,68,40,28,14,7,7,16,57,57,0,16,12,4,51,33,,,,71,5,2,4,2,2,,,
"Jun 20, 2022 10:00 AM",70,40,30,72,32,40,55,22,33,54,32,22,16,11,5,14,35,33,2,9,7,2,30,16,,,,29,1,2,1,1,0,,,
"Jun 20, 2022 11:00 AM",52,24,28,64,29,35,86,54,32,54,33,21,15,11,4,6,24,24,0,14,13,1,16,27,,,,23,3,7,4,2,2,,,
"Jun 20, 2022 12:00 PM",70,42,28,101,56,45,85,46,39,76,43,33,33,19,14,16,27,24,3,15,13,2,26,25,,,,21,4,0,5,3,2,,,
"Jun 20, 2022 1:00 PM",87,40,47,76,42,34,89,52,37,73,42,31,23,9,14,17,28,25,3,21,18,3,24,27,,,,25,3,3,6,4,2,,,
"Jun 20, 2022 2:00 PM",50,26,24,83,51,32,99,56,43,57,31,26,28,18,10,21,13,12,1,18,15,3,14,24,,,,32,1,5,5,2,3,,,
"Jun 20, 2022 3:00 PM",81,34,47,74,40,34,127,91,36,64,43,21,34,17,17,15,28,26,2,27,24,3,26,48,,,,22,3,3,3,1,2,,,
"Jun 20, 2022 4:00 PM",110,32,78,126,77,49,184,112,72,111,63,48,23,9,14,27,29,24,5,49,45,4,24,70,,,,47,8,6,10,9,1,,,
"Jun 20, 2022 5:00 PM",249,73,176,168,107,61,332,213,119,163,102,61,33,11,22,35,36,35,1,107,105,2,41,138,,,,99,4,6,9,5,4,,,
"Jun 20, 2022 6:00 PM",180,63,117,173,106,67,445,277,168,204,129,75,17,7,10,31,49,45,4,99,92,7,45,183,,,,92,7,6,3,3,0,,,
"Jun 20, 2022 7:00 PM",108,37,71,182,91,91,358,185,173,182,106,76,18,10,8,18,33,28,5,48,47,1,28,75,,,,61,5,8,10,8,2,,,
"Jun 20, 2022 8:00 PM",66,19,47,193,90,103,254,91,163,165,79,86,12,9,3,20,27,24,3,25,24,1,23,27,,,,87,5,4,5,4,1,,,
"Jun 20, 2022 9:00 PM",48,17,31,71,19,52,116,29,87,64,13,51,9,4,5,14,22,18,4,17,17,0,16,20,,,,38,4,8,4,4,0,,,
"Jun 20, 2022 10:00 PM",39,13,26,23,15,8,32,7,25,22,5,17,4,1,3,3,10,8,2,22,22,0,8,14,,,,9,1,1,1,1,0,,,
"Jun 20, 2022 11:00 PM",25,5,20,12,8,4,9,6,3,6,3,3,5,0,5,0,5,3,2,8,8,0,3,9,,,,5,0,0,3,2,1,,,
"Jun 21, 2022 12:00 AM",4,0,4,0,0,0,0,0,0,6,2,4,0,0,0,1,3,3,0,2,2,0,2,4,,,,2,0,1,0,0,0,,,
"Jun 21, 2022 1:00 AM",2,1,1,0,0,0,0,0,0,0,0,0,0,0,0,1,0,0,0,1,1,0,0,3,,,,0,0,0,0,0,0,,,
"Jun 21, 2022 2:00 AM",2,2,0,0,0,0,0,0,0,0,0,0,0,0,0,0,1,1,0,1,1,0,1,1,,,,0,0,0,0,0,0,,,
"Jun 21, 2022 3:00 AM",1,0,1,0,0,0,0,0,0,0,0,0,0,0,0,0,1,1,0,1,0,1,3,1,,,,0,0,0,0,0,0,,,
"Jun 21, 2022 4:00 AM",3,2,1,1,1,0,9,9,0,6,4,2,1,1,0,0,1,1,0,0,0,0,1,3,,,,3,0,0,0,0,0,,,
"Jun 21, 2022 5:00 AM",7,5,2,5,2,3,14,2,12,5,2,3,3,3,0,2,7,7,0,0,0,0,7,1,,,,9,0,0,0,0,0,,,
"Jun 21, 2022 6:00 AM",58,45,13,30,12,18,37,15,22,34,17,17,7,4,3,7,31,31,0,10,8,2,29,27,,,,35,2,5,3,3,0,,,
"Jun 21, 2022 7:00 AM",153,101,52,56,20,36,85,30,55,63,25,38,14,11,3,14,73,72,1,20,17,3,72,39,,,,130,4,8,10,8,2,,,
"Jun 21, 2022 8:00 AM",275,207,68,92,14,78,166,55,111,103,39,64,30,21,9,39,159,159,0,36,27,9,152,62,,,,209,7,12,7,6,1,,,
"Jun 21, 2022 9:00 AM",121,99,22,67,25,42,92,44,48,84,46,38,15,9,6,15,66,64,2,23,14,9,61,32,,,,75,2,4,8,5,3,,,
"Jun 21, 2022 10:00 AM",54,36,18,48,21,27,67,36,31,50,26,24,9,4,5,15,31,30,1,11,10,1,29,19,,,,30,1,4,5,2,3,,,
"Jun 21, 2022 11:00 AM",51,29,22,45,26,19,66,39,27,44,22,22,11,5,6,19,20,18,2,9,7,2,16,11,,,,32,2,0,1,0,1,,,
"Jun 21, 2022 12:00 PM",70,39,31,63,37,26,63,31,32,51,31,20,20,12,8,18,25,24,1,21,21,0,21,27,,,,19,4,5,2,2,0,,,
"Jun 21, 2022 1:00 PM",97,44,53,64,32,32,65,32,33,57,30,27,24,8,16,22,25,25,0,19,17,2,22,28,,,,27,5,0,3,1,2,,,
"Jun 21, 2022 2:00 PM",59,29,30,53,29,24,66,41,25,59,37,22,19,11,8,13,19,18,1,23,20,3,16,24,,,,29,10,6,11,6,5,,,
"Jun 21, 2022 3:00 PM",75,33,42,62,34,28,73,39,34,60,30,30,23,15,8,23,23,22,1,21,20,1,18,27,,,,24,3,5,5,2,3,,,
"Jun 21, 2022 4:00 PM",134,49,85,69,39,30,110,64,46,73,39,34,11,7,4,20,40,37,3,46,44,2,37,60,,,,43,6,4,8,6,2,,,
"Jun 21, 2022 5:00 PM",234,56,178,137,82,55,166,97,69,116,68,48,31,10,21,28,47,40,7,111,104,7,41,117,,,,79,4,7,8,5,3,,,
"Jun 21, 2022 6:00 PM",208,57,151,120,81,39,230,164,66,125,87,38,22,11,11,33,69,66,3,92,91,1,68,147,,,,50,5,6,8,6,2,,,
"Jun 21, 2022 7:00 PM",133,40,93,132,81,51,212,128,84,125,90,35,28,10,18,15,22,19,3,48,45,3,14,76,,,,49,6,3,7,5,2,,,
"Jun 21, 2022 8:00 PM",84,28,56,85,47,38,140,62,78,90,39,51,8,3,5,11,28,26,2,31,29,2,24,34,,,,36,3,3,9,7,2,,,
"Jun 21, 2022 9:00 PM",51,12,39,40,22,18,86,27,59,50,20,30,6,4,2,8,11,11,0,16,16,0,13,20,,,,32,4,4,6,4,2,,,
"Jun 21, 2022 10:00 PM",41,14,27,35,16,19,56,18,38,34,9,25,2,1,1,3,8,7,1,21,20,1,6,8,,,,14,3,2,3,3,0,,,
"Jun 21, 2022 11:00 PM",23,4,19,7,5,2,12,5,7,10,6,4,3,0,3,0,8,6,2,8,8,0,7,6,,,,5,0,0,1,1,0,,,
"Jun 22, 2022 12:00 AM",11,3,8,1,1,0,1,0,1,7,5,2,1,1,0,2,1,1,0,6,6,0,1,7,,,,2,0,0,1,1,0,,,
"Jun 22, 2022 1:00 AM",3,0,3,1,1,0,3,2,1,4,2,2,2,2,0,1,1,0,1,1,1,0,0,5,,,,3,0,0,1,0,1,,,
"Jun 22, 2022 2:00 AM",4,4,0,0,0,0,2,2,0,3,3,0,0,0,0,0,2,2,0,0,0,0,2,2,,,,0,0,0,0,0,0,,,
"Jun 22, 2022 3:00 AM",2,1,1,0,0,0,1,1,0,0,0,0,0,0,0,0,0,0,0,0,0,0,0,0,,,,0,0,0,0,0,0,,,
"Jun 22, 2022 4:00 AM",1,0,1,2,0,2,3,1,2,2,0,2,0,0,0,0,1,1,0,0,0,0,1,1,,,,6,0,0,0,0,0,,,
"Jun 22, 2022 5:00 AM",9,5,4,2,1,1,5,3,2,9,5,4,3,3,0,1,6,6,0,2,2,0,5,2,,,,14,0,0,0,0,0,,,
"Jun 22, 2022 6:00 AM",66,40,26,21,9,12,28,15,13,22,11,11,5,4,1,7,22,22,0,17,13,4,20,25,,,,37,3,2,0,0,0,,,
"Jun 22, 2022 7:00 AM",124,89,35,69,24,45,112,50,62,74,32,42,3,3,0,14,84,84,0,20,14,6,86,44,,,,118,6,6,4,4,0,,,
"Jun 22, 2022 8:00 AM",248,185,63,98,29,69,159,61,98,103,49,54,34,26,8,29,125,125,0,35,26,9,127,57,,,,226,4,6,7,7,0,,,
"Jun 22, 2022 9:00 AM",128,96,32,81,23,58,96,46,50,77,44,33,17,11,6,10,75,75,0,23,19,4,68,25,,,,78,1,4,2,1,1,,,
"Jun 22, 2022 10:00 AM",55,32,23,38,13,25,57,26,31,45,20,25,10,6,4,8,33,33,0,6,4,2,28,22,,,,25,1,4,5,3,2,,,
"Jun 22, 2022 11:00 AM",43,25,18,38,22,16,60,38,22,44,28,16,17,8,9,12,22,20,2,11,8,3,20,9,,,,25,4,6,3,2,1,,,
"Jun 22, 2022 12:00 PM",67,32,35,58,31,27,67,36,31,58,32,26,9,5,4,18,15,14,1,14,12,2,12,28,,,,29,0,4,3,0,3,,,
"Jun 22, 2022 1:00 PM",86,37,49,62,35,27,58,29,29,56,29,27,23,9,14,18,28,25,3,16,15,1,20,31,,,,29,5,4,4,2,2,,,
"Jun 22, 2022 2:00 PM",64,34,30,49,23,26,72,35,37,57,31,26,24,18,6,16,13,13,0,25,21,4,11,30,,,,25,5,5,7,6,1,,,
"Jun 22, 2022 3:00 PM",82,39,43,53,36,17,51,27,24,48,31,17,18,9,9,12,21,19,2,27,27,0,18,19,,,,28,5,2,7,4,3,,,
"Jun 22, 2022 4:00 PM",116,36,80,57,40,17,72,43,29,55,28,27,18,4,14,32,35,32,3,39,38,1,32,50,,,,42,6,6,7,4,3,,,
"Jun 22, 2022 5:00 PM",228,67,161,102,71,31,157,98,59,114,67,47,23,8,15,40,52,46,6,110,104,6,46,134,,,,62,7,6,13,9,4,,,
"Jun 22, 2022 6:00 PM",201,58,143,137,95,42,186,127,59,132,82,50,28,10,18,27,45,38,7,86,81,5,42,147,,,,70,5,9,6,6,0,,,
"Jun 22, 2022 7:00 PM",118,30,88,84,46,38,146,78,68,101,52,49,20,8,12,22,30,28,2,43,42,1,24,68,,,,40,8,3,10,7,3,,,
"Jun 22, 2022 8:00 PM",79,27,52,66,34,32,127,53,74,73,37,36,16,10,6,28,27,18,9,23,22,1,19,32,,,,47,9,1,6,4,2,,,
"Jun 22, 2022 9:00 PM",61,19,42,43,22,21,61,23,38,44,18,26,13,5,8,25,16,16,0,28,27,1,15,23,,,,16,4,0,3,2,1,,,
"Jun 22, 2022 10:00 PM",46,11,35,11,5,6,30,8,22,16,5,11,8,3,5,2,15,14,1,11,11,0,16,19,,,,15,0,3,2,1,1,,,
"Jun 22, 2022 11:00 PM",15,1,14,13,11,2,16,7,9,15,9,6,8,5,3,5,7,5,2,10,10,0,5,25,,,,13,1,0,2,0,2,,,
"Jun 23, 2022 12:00 AM",12,4,8,0,0,0,3,0,3,5,4,1,5,1,4,3,2,2,0,8,8,0,2,3,,,,7,0,0,0,0,0,,,
"Jun 23, 2022 1:00 AM",7,3,4,0,0,0,1,0,1,1,0,1,1,0,1,1,2,2,0,1,1,0,3,0,,,,0,1,0,1,0,1,,,
"Jun 23, 2022 2:00 AM",7,5,2,0,0,0,1,1,0,2,1,1,0,0,0,0,1,1,0,1,1,0,1,2,,,,1,0,0,1,1,0,,,
"Jun 23, 2022 3:00 AM",0,0,0,0,0,0,1,1,0,3,1,2,2,0,2,0,0,0,0,0,0,0,2,0,,,,1,0,0,0,0,0,,,
"Jun 23, 2022 4:00 AM",1,1,0,3,1,2,3,2,1,3,2,1,0,0,0,0,0,0,0,0,0,0,0,2,,,,2,0,0,1,1,0,,,
"Jun 23, 2022 5:00 AM",10,7,3,3,0,3,4,2,2,0,0,0,1,1,0,1,5,5,0,2,2,0,4,1,,,,10,0,2,1,0,1,,,
"Jun 23, 2022 6:00 AM",46,29,17,17,7,10,41,19,22,24,12,12,3,3,0,6,27,27,0,11,9,2,27,23,,,,31,2,4,1,1,0,,,
"Jun 23, 2022 7:00 AM",123,78,45,43,12,31,94,38,56,50,21,29,5,5,0,14,91,91,0,13,10,3,92,43,,,,96,2,4,8,6,2,,,
"Jun 23, 2022 8:00 AM",234,169,65,95,31,64,144,56,88,95,44,51,25,16,9,27,141,141,0,36,26,10,136,62,,,,173,10,8,15,12,3,,,
"Jun 23, 2022 9:00 AM",142,118,24,68,22,46,89,37,52,55,31,24,22,12,10,18,75,75,0,18,15,3,70,32,,,,70,4,5,4,0,4,,,
"Jun 23, 2022 10:00 AM",52,33,19,47,13,34,88,51,37,51,27,24,9,4,5,21,23,23,0,11,6,5,17,31,,,,41,2,5,2,2,0,,,
"Jun 23, 2022 11:00 AM",46,32,14,55,28,27,73,39,34,49,26,23,11,5,6,24,23,20,3,10,8,2,24,22,,,,35,3,2,4,3,1,,,
"Jun 23, 2022 12:00 PM",73,34,39,73,26,47,74,27,47,46,23,23,16,4,12,7,29,26,3,26,24,2,22,24,,,,38,4,2,5,3,2,,,
"Jun 23, 2022 1:00 PM",71,31,40,62,36,26,65,35,30,56,34,22,25,6,19,14,28,21,7,20,19,1,20,23,,,,30,1,3,3,2,1,,,
"Jun 23, 2022 2:00 PM",57,27,30,71,34,37,54,29,25,45,24,21,22,12,10,21,14,14,0,17,15,2,13,26,,,,29,6,3,6,3,3,,,
"Jun 23, 2022 3:00 PM",72,22,50,68,48,20,72,46,26,58,39,19,19,11,8,12,21,17,4,20,16,4,14,42,,,,35,2,5,5,4,1,,,
"Jun 23, 2022 4:00 PM",123,43,80,84,50,34,116,67,49,96,52,44,22,11,11,30,37,34,3,45,45,0,34,59,,,,57,9,5,6,4,2,,,
"Jun 23, 2022 5:00 PM",194,61,133,158,85,73,190,135,55,154,110,44,36,15,21,30,45,42,3,104,96,8,42,120,,,,74,9,8,8,5,3,,,
"Jun 23, 2022 6:00 PM",199,66,133,148,93,55,243,160,83,177,123,54,17,2,15,38,53,50,3,92,88,4,48,129,,,,63,10,7,8,6,2,,,
"Jun 23, 2022 7:00 PM",111,46,65,134,86,48,233,150,83,151,95,56,21,9,12,24,23,20,3,44,41,3,18,77,,,,51,12,2,9,6,3,,,
"Jun 23, 2022 8:00 PM",99,37,62,82,43,39,163,77,86,89,42,47,19,9,10,8,20,19,1,31,31,0,18,46,,,,51,6,3,4,3,1,,,
"Jun 23, 2022 9:00 PM",61,14,47,87,40,47,147,51,96,70,22,48,6,2,4,18,19,18,1,19,19,0,15,30,,,,35,3,7,6,5,1,,,
"Jun 23, 2022 10:00 PM",38,7,31,45,28,17,73,8,65,43,5,38,13,2,11,7,9,6,3,16,15,1,4,14,,,,25,0,8,6,4,2,,,
"Jun 23, 2022 11:00 PM",25,7,18,20,13,7,32,5,27,29,4,25,7,3,4,3,6,3,3,11,11,0,5,13,,,,20,2,3,3,2,1,,,
"Jun 24, 2022 12:00 AM",20,7,13,0,0,0,8,2,6,17,2,15,0,0,0,4,5,5,0,7,6,1,5,10,,,,6,1,0,2,1,1,,,
"Jun 24, 2022 1:00 AM",9,1,8,0,0,0,7,2,5,2,1,1,0,0,0,1,4,3,1,2,2,0,2,2,,,,4,1,0,1,1,0,,,
"Jun 24, 2022 2:00 AM",5,4,1,0,0,0,1,1,0,1,1,0,0,0,0,1,2,2,0,1,1,0,2,2,,,,1,1,0,0,0,0,,,
"Jun 24, 2022 3:00 AM",1,0,1,0,0,0,4,3,1,1,1,0,0,0,0,0,0,0,0,1,1,0,1,1,,,,1,0,0,0,0,0,,,
"Jun 24, 2022 4:00 AM",2,1,1,0,0,0,1,1,0,3,2,1,0,0,0,0,3,3,0,0,0,0,3,1,,,,3,0,0,0,0,0,,,
"Jun 24, 2022 5:00 AM",9,7,2,4,4,0,9,6,3,6,4,2,4,3,1,2,4,4,0,2,1,1,4,3,,,,7,0,0,0,0,0,,,
"Jun 24, 2022 6:00 AM",45,30,15,20,13,7,48,32,16,27,18,9,7,5,2,4,17,17,0,9,7,2,15,25,,,,31,1,1,2,2,0,,,
"Jun 24, 2022 7:00 AM",87,63,24,63,28,35,103,48,55,56,25,31,7,6,1,10,59,58,1,14,8,6,59,42,,,,69,2,2,3,2,1,,,
"Jun 24, 2022 8:00 AM",168,122,46,83,27,56,170,70,100,93,43,50,22,16,6,21,85,85,0,20,15,5,81,52,,,,127,5,5,7,3,4,,,
"Jun 24, 2022 9:00 AM",91,69,22,84,38,46,111,55,56,69,44,25,19,7,12,12,44,44,0,16,12,4,38,28,,,,52,3,4,3,2,1,,,
"Jun 24, 2022 10:00 AM",50,31,19,54,24,30,85,45,40,46,24,22,15,9,6,9,19,19,0,13,12,1,15,23,,,,28,4,3,2,1,1,,,
"Jun 24, 2022 11:00 AM",46,24,22,51,24,27,90,40,50,55,28,27,15,9,6,18,14,11,3,11,9,2,8,24,,,,31,4,6,4,2,2,,,
"Jun 24, 2022 12:00 PM",68,27,41,65,30,35,59,32,27,48,26,22,20,12,8,25,22,22,0,16,14,2,24,22,,,,32,4,4,5,4,1,,,
"Jun 24, 2022 1:00 PM",75,33,42,44,19,25,62,36,26,47,29,18,26,17,9,20,27,25,2,28,26,2,25,28,,,,26,5,0,2,2,0,,,
"Jun 24, 2022 2:00 PM",58,25,33,46,28,18,41,26,15,39,25,14,12,4,8,17,16,16,0,13,12,1,14,28,,,,33,3,2,17,12,5,,,
"Jun 24, 2022 3:00 PM",101,43,58,52,25,27,53,27,26,46,19,27,11,6,5,14,22,21,1,20,19,1,20,31,,,,30,5,5,7,6,1,,,
"Jun 24, 2022 4:00 PM",104,30,74,40,23,17,59,33,26,53,29,24,18,4,14,19,23,21,2,50,49,1,20,36,,,,41,3,6,6,0,6,,,
"Jun 24, 2022 5:00 PM",145,48,97,50,30,20,65,38,27,57,38,19,19,9,10,23,24,24,0,67,64,3,23,65,,,,46,8,3,11,7,4,,,
"Jun 24, 2022 6:00 PM",113,43,70,35,24,11,62,40,22,39,20,19,10,3,7,14,27,25,2,40,37,3,24,57,,,,33,1,3,3,3,0,,,
"Jun 24, 2022 7:00 PM",89,31,58,18,15,3,42,33,9,21,14,7,3,2,1,12,11,11,0,18,16,2,11,33,,,,18,2,2,5,2,3,,,
"Jun 24, 2022 8:00 PM",28,13,15,20,13,7,43,24,19,23,18,5,1,0,1,9,15,12,3,13,13,0,13,24,,,,20,2,1,10,7,3,,,
"Jun 24, 2022 9:00 PM",38,11,27,13,8,5,31,19,12,10,7,3,6,0,6,4,7,6,1,7,7,0,8,12,,,,16,1,2,1,1,0,,,
"Jun 24, 2022 10:00 PM",40,13,27,4,2,2,26,9,17,7,0,7,0,0,0,5,9,8,1,7,7,0,10,13,,,,9,2,1,1,1,0,,,
"Jun 24, 2022 11:00 PM",31,10,21,7,2,5,14,6,8,9,6,3,0,0,0,4,3,3,0,10,10,0,3,8,,,,9,0,1,1,0,1,,,
"Jun 25, 2022 12:00 AM",11,4,7,1,1,0,4,0,4,9,2,7,1,1,0,4,3,3,0,3,2,1,3,8,,,,3,0,0,0,0,0,,,
"Jun 25, 2022 1:00 AM",5,2,3,2,1,1,8,3,5,3,1,2,1,0,1,2,2,2,0,6,6,0,1,8,,,,3,1,0,1,1,0,,,
"Jun 25, 2022 2:00 AM",6,2,4,1,1,0,2,1,1,1,1,0,0,0,0,0,1,1,0,7,7,0,0,5,,,,1,0,0,0,0,0,,,
"Jun 25, 2022 3:00 AM",8,1,7,2,1,1,0,0,0,0,0,0,0,0,0,1,0,0,0,3,2,1,1,1,,,,1,0,0,0,0,0,,,
"Jun 25, 2022 4:00 AM",2,0,2,0,0,0,3,3,0,0,0,0,1,1,0,0,3,3,0,2,2,0,3,0,,,,2,0,1,0,0,0,,,
"Jun 25, 2022 5:00 AM",2,1,1,0,0,0,4,2,2,1,0,1,0,0,0,1,1,1,0,1,1,0,1,2,,,,1,0,0,0,0,0,,,
"Jun 25, 2022 6:00 AM",14,8,6,9,4,5,9,7,2,9,7,2,0,0,0,2,4,4,0,4,4,0,4,5,,,,5,2,2,1,0,1,,,
"Jun 25, 2022 7:00 AM",17,7,10,34,20,14,39,22,17,25,15,10,6,2,4,3,7,7,0,2,2,0,6,10,,,,12,0,3,0,0,0,,,
"Jun 25, 2022 8:00 AM",37,19,18,43,28,15,73,47,26,50,31,19,3,1,2,12,16,16,0,6,6,0,16,23,,,,26,3,4,1,0,1,,,
"Jun 25, 2022 9:00 AM",49,23,26,92,56,36,121,81,40,86,61,25,13,10,3,12,18,16,2,7,6,1,17,40,,,,31,2,3,2,2,0,,,
"Jun 25, 2022 10:00 AM",50,29,21,126,49,77,162,101,61,102,70,32,24,18,6,19,30,27,3,11,10,1,29,41,,,,40,3,4,5,2,3,,,
"Jun 25, 2022 11:00 AM",70,47,23,120,66,54,186,99,87,123,75,48,35,20,15,17,33,31,2,10,7,3,34,30,,,,54,6,6,1,1,0,,,
"Jun 25, 2022 12:00 PM",52,25,27,126,53,73,132,55,77,116,45,71,29,13,16,23,30,26,4,20,19,1,31,20,,,,30,2,5,4,3,1,,,
"Jun 25, 2022 1:00 PM",54,31,23,103,52,51,127,58,69,88,45,43,17,3,14,14,20,19,1,15,13,2,17,38,,,,35,0,2,4,4,0,,,
"Jun 25, 2022 2:00 PM",69,39,30,66,36,30,87,47,40,62,35,27,24,10,14,16,21,20,1,11,11,0,17,31,,,,38,1,0,6,5,1,,,
"Jun 25, 2022 3:00 PM",44,19,25,84,44,40,93,41,52,86,46,40,12,3,9,13,15,13,2,18,18,0,13,25,,,,23,13,0,6,5,1,,,
"Jun 25, 2022 4:00 PM",43,19,24,60,25,35,78,29,49,64,19,45,13,2,11,12,18,18,0,12,11,1,18,16,,,,30,1,3,5,2,3,,,
"Jun 25, 2022 5:00 PM",46,22,24,39,19,20,76,27,49,51,20,31,12,5,7,10,8,8,0,8,6,2,9,18,,,,36,3,2,4,3,1,,,
"Jun 25, 2022 6:00 PM",53,21,32,42,25,17,38,20,18,37,16,21,18,13,5,10,7,6,1,16,13,3,7,18,,,,9,2,0,3,2,1,,,
"Jun 25, 2022 7:00 PM",33,17,16,26,18,8,41,15,26,26,13,13,5,1,4,11,11,10,1,10,8,2,11,17,,,,13,1,2,3,1,2,,,
"Jun 25, 2022 8:00 PM",42,18,24,26,9,17,25,10,15,17,6,11,5,2,3,5,5,5,0,8,7,1,4,7,,,,14,0,2,0,0,0,,,
"Jun 25, 2022 9:00 PM",31,11,20,2,0,2,19,10,9,9,7,2,0,0,0,3,10,9,1,3,3,0,10,9,,,,11,0,0,3,1,2,,,
"Jun 25, 2022 10:00 PM",18,7,11,2,1,1,13,5,8,9,2,7,1,1,0,1,9,6,3,6,5,1,7,4,,,,3,0,1,1,1,0,,,
"Jun 25, 2022 11:00 PM",12,1,11,3,2,1,10,3,7,15,5,10,1,1,0,6,1,1,0,4,4,0,1,8,,,,5,0,1,3,2,1,,,
"Jun 26, 2022 12:00 AM",8,4,4,0,0,0,3,2,1,3,1,2,5,2,3,6,3,3,0,4,3,1,5,2,,,,7,1,0,1,1,0,,,
"Jun 26, 2022 1:00 AM",2,0,2,0,0,0,4,3,1,4,2,2,1,1,0,0,2,2,0,2,1,1,2,3,,,,7,0,0,0,0,0,,,
"Jun 26, 2022 2:00 AM",11,4,7,0,0,0,1,0,1,0,0,0,0,0,0,0,1,1,0,5,3,2,1,1,,,,1,0,0,0,0,0,,,
"Jun 26, 2022 3:00 AM",4,0,4,1,0,1,0,0,0,1,0,1,0,0,0,0,0,0,0,1,1,0,0,3,,,,1,0,0,0,0,0,,,
"Jun 26, 2022 4:00 AM",3,1,2,0,0,0,3,2,1,0,0,0,2,2,0,0,0,0,0,2,2,0,0,2,,,,3,0,0,0,0,0,,,
"Jun 26, 2022 5:00 AM",1,0,1,1,0,1,1,0,1,0,0,0,0,0,0,0,1,1,0,1,1,0,1,0,,,,0,0,0,0,0,0,,,
"Jun 26, 2022 6:00 AM",6,2,4,2,0,2,4,0,4,3,1,2,0,0,0,0,3,2,1,2,2,0,3,5,,,,2,0,0,0,0,0,,,
"Jun 26, 2022 7:00 AM",9,3,6,7,3,4,10,7,3,7,6,1,1,1,0,3,5,5,0,2,2,0,5,1,,,,6,1,1,0,0,0,,,
"Jun 26, 2022 8:00 AM",20,6,14,22,15,7,30,22,8,23,19,4,0,0,0,8,7,7,0,3,2,1,7,10,,,,12,1,3,1,0,1,,,
"Jun 26, 2022 9:00 AM",21,8,13,63,38,25,60,40,20,40,25,15,8,3,5,11,14,13,1,7,7,0,13,21,,,,14,2,5,1,1,0,,,
"Jun 26, 2022 10:00 AM",35,22,13,114,69,45,113,70,43,99,67,32,18,12,6,12,18,18,0,8,8,0,19,20,,,,24,3,4,3,2,1,,,
"Jun 26, 2022 11:00 AM",45,24,21,102,46,56,113,59,54,84,47,37,12,7,5,15,12,11,1,11,9,2,11,13,,,,26,4,5,3,3,0,,,
"Jun 26, 2022 12:00 PM",55,31,24,104,47,57,128,64,64,89,46,43,18,11,7,27,18,16,2,8,7,1,15,30,,,,24,3,6,5,3,2,,,
"Jun 26, 2022 1:00 PM",46,22,24,106,59,47,88,42,46,74,45,29,23,13,10,8,19,18,1,19,18,1,14,19,,,,40,2,4,2,1,1,,,
"Jun 26, 2022 2:00 PM",41,22,19,84,40,44,93,45,48,77,37,40,22,12,10,19,14,10,4,18,17,1,10,18,,,,19,4,1,7,5,2,,,
"Jun 26, 2022 3:00 PM",40,13,27,63,35,28,62,27,35,52,25,27,4,2,2,9,18,17,1,9,9,0,16,18,,,,26,1,0,4,1,3,,,
"Jun 26, 2022 4:00 PM",31,14,17,39,15,24,59,28,31,61,23,38,27,10,17,4,12,11,1,12,11,1,11,12,,,,25,1,1,3,2,1,,,
"Jun 26, 2022 5:00 PM",27,11,16,32,18,14,36,7,29,28,8,20,8,2,6,8,8,8,0,6,5,1,9,11,,,,25,1,0,0,0,0,,,
"Jun 26, 2022 6:00 PM",37,19,18,20,14,6,39,21,18,27,15,12,4,3,1,6,5,4,1,4,4,0,6,15,,,,17,1,2,2,1,1,,,
"Jun 26, 2022 7:00 PM",44,24,20,24,12,12,29,12,17,13,4,9,8,2,6,5,12,11,1,8,5,3,10,11,,,,20,2,3,4,3,1,,,
"Jun 26, 2022 8:00 PM",29,12,17,28,17,11,49,31,18,32,19,13,7,3,4,6,7,7,0,12,12,0,5,15,,,,10,0,0,2,2,0,,,
"Jun 26, 2022 9:00 PM",11,5,6,22,8,14,24,4,20,20,6,14,9,4,5,2,14,11,3,9,7,2,9,6,,,,12,0,0,5,2,3,,,
"Jun 26, 2022 10:00 PM",16,8,8,11,2,9,8,6,2,8,3,5,2,1,1,4,6,5,1,7,6,1,5,5,,,,5,0,1,0,0,0,,,
"Jun 26, 2022 11:00 PM",14,5,9,6,6,0,4,1,3,4,2,2,7,5,2,4,3,3,0,3,3,0,3,6,,,,4,0,0,4,2,2,,,
"Jun 27, 2022 12:00 AM",6,3,3,0,0,0,0,0,0,1,0,1,1,1,0,0,2,2,0,3,3,0,1,3,,,,2,0,0,1,1,0,,,
"Jun 27, 2022 1:00 AM",2,1,1,0,0,0,2,0,2,0,0,0,0,0,0,0,1,0,1,1,1,0,0,1,,,,1,0,0,0,0,0,,,
"Jun 27, 2022 2:00 AM",1,1,0,1,1,0,0,0,0,1,1,0,1,0,1,0,0,0,0,2,2,0,0,0,,,,1,0,0,0,0,0,,,
"Jun 27, 2022 3:00 AM",2,0,2,0,0,0,0,0,0,0,0,0,0,0,0,1,0,0,0,0,0,0,2,0,,,,0,0,0,0,0,0,,,
"Jun 27, 2022 4:00 AM",4,2,2,3,1,2,4,2,2,4,2,2,0,0,0,0,2,2,0,1,1,0,2,0,,,,1,0,0,0,0,0,,,
"Jun 27, 2022 5:00 AM",2,2,0,6,2,4,7,2,5,6,2,4,0,0,0,1,7,7,0,0,0,0,7,0,,,,11,0,1,0,0,0,,,
"Jun 27, 2022 6:00 AM",55,36,19,14,5,9,28,12,16,17,9,8,4,3,1,6,23,22,1,14,12,2,21,11,,,,31,2,2,2,1,1,,,
"Jun 27, 2022 7:00 AM",120,86,34,58,26,32,74,30,44,63,26,37,11,8,3,9,71,71,0,11,7,4,73,36,,,,109,4,6,3,2,1,,,
"Jun 27, 2022 8:00 AM",200,149,51,92,24,68,131,56,75,90,38,52,24,18,6,25,128,127,1,20,14,6,121,53,,,,166,5,7,10,8,2,,,
"Jun 27, 2022 9:00 AM",114,92,22,57,15,42,63,30,33,42,24,18,12,11,1,16,63,63,0,22,16,6,55,30,,,,77,3,8,2,2,0,,,
"Jun 27, 2022 10:00 AM",44,27,17,49,17,32,81,48,33,56,30,26,15,8,7,17,22,21,1,13,10,3,22,16,,,,29,3,2,5,2,3,,,
"Jun 27, 2022 11:00 AM",48,23,25,68,39,29,87,39,48,41,23,18,28,19,9,18,23,21,2,7,7,0,19,16,,,,24,2,3,5,1,4,,,
"Jun 27, 2022 12:00 PM",53,33,20,75,35,40,92,52,40,66,38,28,25,12,13,19,21,20,1,11,9,2,19,27,,,,26,4,4,6,4,2,,,
"Jun 27, 2022 1:00 PM",72,32,40,63,30,33,84,41,43,55,28,27,30,15,15,24,15,14,1,20,19,1,15,33,,,,33,4,3,8,6,2,,,
"Jun 27, 2022 2:00 PM",55,26,29,57,32,25,57,31,26,42,24,18,17,12,5,28,21,19,2,24,22,2,18,23,,,,22,2,0,6,3,3,,,
"Jun 27, 2022 3:00 PM",74,26,48,45,30,15,61,36,25,48,31,17,33,14,19,21,15,13,2,12,10,2,13,26,,,,23,5,2,3,2,1,,,
"Jun 27, 2022 4:00 PM",97,29,68,67,37,30,87,40,47,77,34,43,20,9,11,26,24,20,4,40,38,2,20,52,,,,33,8,0,13,8,5,,,
"Jun 27, 2022 5:00 PM",215,53,162,107,66,41,127,70,57,113,64,49,21,10,11,36,35,31,4,80,76,4,35,104,,,,80,4,7,2,0,2,,,
"Jun 27, 2022 6:00 PM",164,54,110,73,54,19,123,89,34,94,66,28,22,7,15,33,33,29,4,84,81,3,34,111,,,,45,4,5,6,3,3,,,
"Jun 27, 2022 7:00 PM",85,36,49,87,58,29,84,51,33,83,44,39,13,3,10,17,29,29,0,44,43,1,23,60,,,,27,4,3,6,4,2,,,
"Jun 27, 2022 8:00 PM",62,16,46,45,24,21,51,23,28,47,22,25,10,7,3,10,9,8,1,21,21,0,9,19,,,,24,1,3,7,5,2,,,
"Jun 27, 2022 9:00 PM",56,11,45,31,13,18,30,14,16,26,6,20,8,5,3,12,13,11,2,14,14,0,11,13,,,,17,6,2,2,2,0,,,
"Jun 27, 2022 10:00 PM",24,5,19,10,7,3,19,7,12,6,3,3,3,3,0,4,6,6,0,9,8,1,7,13,,,,6,1,0,0,0,0,,,
"Jun 27, 2022 11:00 PM",25,9,16,2,1,1,10,8,2,6,2,4,4,1,3,7,6,5,1,10,9,1,6,9,,,,4,2,0,0,0,0,,,
"Jun 28, 2022 12:00 AM",9,4,5,0,0,0,2,1,1,5,3,2,1,0,1,2,1,0,1,6,6,0,1,1,,,,5,0,0,0,0,0,,,
"Jun 28, 2022 1:00 AM",2,0,2,1,0,1,1,1,0,1,0,1,0,0,0,0,1,1,0,2,2,0,0,2,,,,2,0,0,1,1,0,,,
"Jun 28, 2022 2:00 AM",4,3,1,0,0,0,0,0,0,0,0,0,0,0,0,0,1,1,0,0,0,0,1,0,,,,0,0,0,0,0,0,,,
"Jun 28, 2022 3:00 AM",0,0,0,0,0,0,0,0,0,0,0,0,0,0,0,0,0,0,0,0,0,0,1,0,,,,0,0,0,0,0,0,,,
"Jun 28, 2022 4:00 AM",1,0,1,2,0,2,3,1,2,2,0,2,0,0,0,0,2,2,0,0,0,0,2,1,,,,0,0,0,0,0,0,,,
"Jun 28, 2022 5:00 AM",7,6,1,1,0,1,2,0,2,4,2,2,1,1,0,2,6,6,0,0,0,0,6,1,,,,8,0,0,0,0,0,,,
"Jun 28, 2022 6:00 AM",30,20,10,5,2,3,11,3,8,11,3,8,2,1,1,7,20,20,0,11,10,1,19,9,,,,23,1,5,2,1,1,,,
"Jun 28, 2022 7:00 AM",89,66,23,24,3,21,34,5,29,22,5,17,0,0,0,6,54,54,0,11,10,1,54,27,,,,64,1,1,1,1,0,,,
"Jun 28, 2022 8:00 AM",156,117,39,21,5,16,59,23,36,34,20,14,7,5,2,14,76,76,0,18,10,8,82,39,,,,100,3,4,3,1,2,,,
"Jun 28, 2022 9:00 AM",71,50,21,15,5,10,31,17,14,22,12,10,5,3,2,8,34,33,1,14,8,6,27,14,,,,23,0,1,2,0,2,,,
"Jun 28, 2022 10:00 AM",25,19,6,9,6,3,17,11,6,15,12,3,4,3,1,3,9,8,1,7,7,0,6,5,,,,15,1,2,0,0,0,,,
"Jun 28, 2022 11:00 AM",31,20,11,6,0,6,12,6,6,5,0,5,6,1,5,3,6,6,0,6,2,4,7,4,,,,11,2,0,3,2,1,,,
"Jun 28, 2022 12:00 PM",41,20,21,7,3,4,21,12,9,11,3,8,6,2,4,9,11,11,0,9,9,0,7,7,,,,10,3,2,3,2,1,,,
"Jun 28, 2022 1:00 PM",48,25,23,42,24,18,40,22,18,26,17,9,7,4,3,8,12,12,0,11,10,1,10,16,,,,22,1,2,3,2,1,,,
"Jun 28, 2022 2:00 PM",41,14,27,26,14,12,47,30,17,24,19,5,12,6,6,19,12,12,0,17,17,0,10,14,,,,13,1,0,1,1,0,,,
"Jun 28, 2022 3:00 PM",48,23,25,23,18,5,44,25,19,37,27,10,8,7,1,12,16,13,3,12,9,3,13,23,,,,20,0,4,3,1,2,,,
"Jun 28, 2022 4:00 PM",96,33,63,47,24,23,54,30,24,47,27,20,11,5,6,20,19,17,2,29,27,2,18,33,,,,33,4,0,4,3,1,,,
"Jun 28, 2022 5:00 PM",145,42,103,80,43,37,105,58,47,92,53,39,20,6,14,36,34,33,1,61,56,5,28,80,,,,66,7,6,5,5,0,,,
"Jun 28, 2022 6:00 PM",143,45,98,80,55,25,114,75,39,101,64,37,17,9,8,32,34,30,4,62,60,2,28,89,,,,42,4,6,4,2,2,,,
"Jun 28, 2022 7:00 PM",105,40,65,87,59,28,101,59,42,88,57,31,5,2,3,21,21,17,4,32,28,4,18,62,,,,35,3,2,9,5,4,,,
"Jun 28, 2022 8:00 PM",78,30,48,111,45,66,115,53,62,92,43,49,12,11,1,26,16,12,4,21,21,0,15,24,,,,44,7,2,4,3,1,,,
"Jun 28, 2022 9:00 PM",61,17,44,48,24,24,59,23,36,40,17,23,4,1,3,18,16,13,3,14,14,0,10,13,,,,25,0,0,3,1,2,,,
"Jun 28, 2022 10:00 PM",35,19,16,14,8,6,23,14,9,14,6,8,3,0,3,14,3,2,1,11,11,0,2,9,,,,13,4,1,3,3,0,,,
"Jun 28, 2022 11:00 PM",21,9,12,4,3,1,10,4,6,7,3,4,0,0,0,4,2,1,1,5,5,0,1,10,,,,3,1,0,2,2,0,,,
"Jun 29, 2022 12:00 AM",7,3,4,0,0,0,0,0,0,1,0,1,5,2,3,3,7,5,2,7,6,1,6,5,,,,0,0,0,0,0,0,,,
"Jun 29, 2022 1:00 AM",5,0,5,0,0,0,1,1,0,1,1,0,0,0,0,1,1,1,0,4,1,3,1,3,,,,0,1,0,1,1,0,,,
"Jun 29, 2022 2:00 AM",3,3,0,1,0,1,2,1,1,0,0,0,0,0,0,0,1,1,0,1,1,0,1,0,,,,1,1,0,1,0,1,,,
"Jun 29, 2022 3:00 AM",0,0,0,0,0,0,1,1,0,0,0,0,0,0,0,0,0,0,0,0,0,0,0,0,,,,0,0,0,0,0,0,,,
"Jun 29, 2022 4:00 AM",3,2,1,2,0,2,3,1,2,4,1,3,0,0,0,0,2,2,0,0,0,0,2,1,,,,1,0,0,1,1,0,,,
"Jun 29, 2022 5:00 AM",6,5,1,2,1,1,2,2,0,4,3,1,0,0,0,1,6,6,0,0,0,0,7,1,,,,5,0,0,0,0,0,,,
"Jun 29, 2022 6:00 AM",44,30,14,26,10,16,38,16,22,27,13,14,4,4,0,6,17,17,0,11,8,3,17,22,,,,37,3,2,1,1,0,,,
"Jun 29, 2022 7:00 AM",101,71,30,69,23,46,72,25,47,56,27,29,7,2,5,9,65,64,1,14,12,2,66,28,,,,93,4,4,2,2,0,,,
"Jun 29, 2022 8:00 AM",213,165,48,80,23,57,128,45,83,88,39,49,26,20,6,25,116,115,1,25,18,7,116,50,,,,155,5,7,4,2,2,,,
"Jun 29, 2022 9:00 AM",108,86,22,62,20,42,72,41,31,59,35,24,17,12,5,18,56,55,1,20,16,4,53,20,,,,67,2,4,1,1,0,,,
"Jun 29, 2022 10:00 AM",68,50,18,45,12,33,77,37,40,44,22,22,15,10,5,21,17,15,2,11,8,3,16,11,,,,29,3,9,3,2,1,,,
"Jun 29, 2022 11:00 AM",56,35,21,43,14,29,71,39,32,53,25,28,20,10,10,18,13,12,1,8,6,2,11,9,,,,32,6,6,7,5,2,,,
"Jun 29, 2022 12:00 PM",57,26,31,40,25,15,79,48,31,50,31,19,15,6,9,17,18,17,1,15,13,2,16,32,,,,20,8,1,7,7,0,,,
"Jun 29, 2022 1:00 PM",74,34,40,63,32,31,103,47,56,52,26,26,15,7,8,19,29,27,2,18,16,2,23,27,,,,29,2,4,5,2,3,,,
"Jun 29, 2022 2:00 PM",50,23,27,46,28,18,59,32,27,41,23,18,14,9,5,20,28,24,4,23,22,1,25,19,,,,37,4,1,5,4,1,,,
"Jun 29, 2022 3:00 PM",77,30,47,48,28,20,83,45,38,39,24,15,13,5,8,18,19,16,3,31,30,1,15,16,,,,28,5,2,3,2,1,,,
"Jun 29, 2022 4:00 PM",125,32,93,52,30,22,77,42,35,56,27,29,13,3,10,27,22,17,5,35,31,4,18,47,,,,46,4,0,5,3,2,,,
"Jun 29, 2022 5:00 PM",201,56,145,87,59,28,123,79,44,92,59,33,24,11,13,44,48,44,4,92,88,4,44,90,,,,55,11,2,8,4,4,,,
"Jun 29, 2022 6:00 PM",181,54,127,71,43,28,110,61,49,89,49,40,13,2,11,25,30,28,2,76,73,3,30,101,,,,50,2,7,10,7,3,,,
"Jun 29, 2022 7:00 PM",96,37,59,54,39,15,92,69,23,66,56,10,10,7,3,36,17,16,1,33,33,0,18,50,,,,24,5,3,9,5,4,,,
"Jun 29, 2022 8:00 PM",96,32,64,55,32,23,57,24,33,57,28,29,8,1,7,28,16,11,5,26,25,1,11,29,,,,26,3,2,7,5,2,,,
"Jun 29, 2022 9:00 PM",58,16,42,26,13,13,37,11,26,18,5,13,7,5,2,14,17,16,1,11,11,0,15,14,,,,13,3,0,5,4,1,,,
"Jun 29, 2022 10:00 PM",33,9,24,11,8,3,19,10,9,13,5,8,4,2,2,10,6,5,1,8,7,1,5,10,,,,11,1,1,2,1,1,,,
"Jun 29, 2022 11:00 PM",22,10,12,3,3,0,3,2,1,4,1,3,2,1,1,10,4,4,0,7,7,0,4,5,,,,5,0,0,0,0,0,,,
"Jun 30, 2022 12:00 AM",14,7,7,0,0,0,3,1,2,7,4,3,3,1,2,3,5,5,0,7,6,1,5,7,,,,3,0,0,0,0,0,,,
"Jun 30, 2022 1:00 AM",6,3,3,0,0,0,1,1,0,0,0,0,0,0,0,5,0,0,0,3,2,1,0,0,,,,6,0,0,0,0,0,,,
"Jun 30, 2022 2:00 AM",6,4,2,0,0,0,0,0,0,0,0,0,0,0,0,0,1,1,0,2,2,0,1,0,,,,0,0,0,0,0,0,,,
"Jun 30, 2022 3:00 AM",2,1,1,0,0,0,1,1,0,0,0,0,0,0,0,1,0,0,0,1,0,1,0,0,,,,0,0,0,0,0,0,,,
"Jun 30, 2022 4:00 AM",3,2,1,2,0,2,3,1,2,3,1,2,0,0,0,0,2,2,0,0,0,0,2,0,,,,0,0,0,1,1,0,,,
"Jun 30, 2022 5:00 AM",7,4,3,0,0,0,2,0,2,3,1,2,2,2,0,2,10,10,0,0,0,0,10,0,,,,3,1,0,1,1,0,,,
"Jun 30, 2022 6:00 AM",38,22,16,14,6,8,24,11,13,15,9,6,3,1,2,4,15,15,0,9,8,1,16,19,,,,23,3,3,2,1,1,,,
"Jun 30, 2022 7:00 AM",84,53,31,34,14,20,48,15,33,32,16,16,9,6,3,8,55,55,0,13,8,5,53,29,,,,85,2,4,6,5,1,,,
"Jun 30, 2022 8:00 AM",218,160,58,62,15,47,84,34,50,67,30,37,16,11,5,11,117,117,0,18,14,4,114,47,,,,141,4,4,8,6,2,,,
"Jun 30, 2022 9:00 AM",106,87,19,57,22,35,58,26,32,59,35,24,9,6,3,18,53,52,1,18,12,6,46,25,,,,59,4,0,4,3,1,,,
"Jun 30, 2022 10:00 AM",61,43,18,40,18,22,56,31,25,39,21,18,11,6,5,1,17,17,0,8,6,2,19,15,,,,31,0,3,0,0,0,,,
"Jun 30, 2022 11:00 AM",51,32,19,44,22,22,64,36,28,43,23,20,10,8,2,9,19,15,4,9,8,1,15,8,,,,26,2,0,4,3,1,,,
"Jun 30, 2022 12:00 PM",62,27,35,63,34,29,57,27,30,48,30,18,12,4,8,22,15,14,1,14,12,2,12,17,,,,17,7,1,5,3,2,,,
"Jun 30, 2022 1:00 PM",66,30,36,50,23,27,79,36,43,46,29,17,22,10,12,8,18,15,3,21,15,6,14,21,,,,32,2,2,5,4,1,,,
"Jun 30, 2022 2:00 PM",54,25,29,43,25,18,58,29,29,38,21,17,15,10,5,16,22,18,4,24,21,3,17,23,,,,26,3,1,3,1,2,,,
"Jun 30, 2022 3:00 PM",70,28,42,44,24,20,58,31,27,45,25,20,15,4,11,16,12,12,0,24,22,2,13,28,,,,29,5,5,4,2,2,,,
"Jun 30, 2022 4:00 PM",94,28,66,51,28,23,81,49,32,49,30,19,16,3,13,17,29,25,4,30,27,3,25,42,,,,35,7,2,1,1,0,,,
"Jun 30, 2022 5:00 PM",167,54,113,106,58,48,121,90,31,119,84,35,17,7,10,14,30,28,2,70,66,4,29,92,,,,58,2,4,6,5,1,,,
"Jun 30, 2022 6:00 PM",145,46,99,94,61,33,126,85,41,96,67,29,29,15,14,22,43,39,4,63,62,1,38,98,,,,41,4,5,6,4,2,,,
"Jun 30, 2022 7:00 PM",100,43,57,94,60,34,102,66,36,83,55,28,13,7,6,32,17,17,0,39,37,2,19,52,,,,22,2,2,7,5,2,,,
"Jun 30, 2022 8:00 PM",81,28,53,74,39,35,74,31,43,76,36,40,16,9,7,9,17,16,1,28,27,1,18,18,,,,23,2,2,11,4,7,,,
"Jun 30, 2022 9:00 PM",65,22,43,50,31,19,60,15,45,56,14,42,3,1,2,8,12,11,1,16,14,2,12,15,,,,32,3,1,2,2,0,,,
"Jun 30, 2022 10:00 PM",36,10,26,31,20,11,48,9,39,47,11,36,10,4,6,7,5,4,1,15,13,2,3,16,,,,18,1,2,1,0,1,,,
"Jun 30, 2022 11:00 PM",22,4,18,11,10,1,12,3,9,12,4,8,5,1,4,3,1,0,1,16,15,1,0,7,,,,6,0,2,3,3,0,,,
"Jul 1, 2022 12:00 AM",16,2,14,1,1,0,4,3,1,12,6,6,2,1,1,1,3,3,0,11,11,0,2,9,,,,1,0,0,1,1,0,,,
"Jul 1, 2022 1:00 AM",9,0,9,1,1,0,2,2,0,4,3,1,0,0,0,1,0,0,0,3,3,0,0,3,,,,2,0,0,1,1,0,,,
"Jul 1, 2022 2:00 AM",7,4,3,0,0,0,1,0,1,0,0,0,0,0,0,0,1,1,0,1,1,0,1,2,,,,3,0,0,0,0,0,,,
"Jul 1, 2022 3:00 AM",0,0,0,2,1,1,0,0,0,0,0,0,1,1,0,0,0,0,0,0,0,0,1,2,,,,0,0,0,0,0,0,,,
"Jul 1, 2022 4:00 AM",2,1,1,3,1,2,0,0,0,4,1,3,2,1,1,0,0,0,0,1,1,0,0,0,,,,1,0,0,0,0,0,,,
"Jul 1, 2022 5:00 AM",10,5,5,1,1,0,0,0,0,5,5,0,0,0,0,0,11,11,0,1,1,0,12,3,,,,8,0,0,1,1,0,,,
"Jul 1, 2022 6:00 AM",41,22,19,21,7,14,0,0,0,20,6,14,2,2,0,4,16,16,0,11,10,1,17,15,,,,27,1,0,2,1,1,,,
"Jul 1, 2022 7:00 AM",50,36,14,48,24,24,0,0,0,42,21,21,8,5,3,6,40,40,0,12,8,4,40,26,,,,65,1,3,5,4,1,,,
"Jul 1, 2022 8:00 AM",126,86,40,50,13,37,0,0,0,60,30,30,10,7,3,42,59,58,1,20,15,5,58,43,,,,89,4,2,4,2,2,,,
"Jul 1, 2022 9:00 AM",85,68,17,40,16,24,0,0,0,49,30,19,12,9,3,15,42,40,2,19,13,6,33,29,,,,43,1,3,0,0,0,,,
"Jul 1, 2022 10:00 AM",54,36,18,54,21,33,0,0,0,52,24,28,12,6,6,7,25,25,0,16,13,3,25,16,,,,30,2,2,7,5,2,,,
"Jul 1, 2022 11:00 AM",48,34,14,59,32,27,0,0,0,46,24,22,10,7,3,14,16,16,0,7,6,1,15,15,,,,26,3,2,3,3,0,,,
"Jul 1, 2022 12:00 PM",70,34,36,55,26,29,0,0,0,36,16,20,27,19,8,11,28,27,1,26,26,0,24,24,,,,29,5,5,1,1,0,,,
"Jul 1, 2022 1:00 PM",74,36,38,80,34,46,0,0,0,71,38,33,25,9,16,18,14,11,3,18,14,4,14,22,,,,26,0,0,4,4,0,,,
"Jul 1, 2022 2:00 PM",65,34,31,71,34,37,0,0,0,41,25,16,25,13,12,28,17,16,1,17,16,1,13,26,,,,28,7,4,9,6,3,,,
"Jul 1, 2022 3:00 PM",76,30,46,54,21,33,0,0,0,51,23,28,15,9,6,18,14,12,2,21,18,3,13,24,,,,18,1,4,3,1,2,,,
"Jul 1, 2022 4:00 PM",94,33,61,23,18,5,0,0,0,36,23,13,10,5,5,18,24,20,4,28,28,0,20,29,,,,26,2,4,9,6,3,,,
"Jul 1, 2022 5:00 PM",123,42,81,86,55,31,0,0,0,70,40,30,18,2,16,36,25,23,2,46,43,3,21,54,,,,49,4,0,6,5,1,,,
"Jul 1, 2022 6:00 PM",97,32,65,60,34,26,0,0,0,58,32,26,7,3,4,27,24,23,1,43,42,1,25,43,,,,32,2,1,3,1,2,,,
"Jul 1, 2022 7:00 PM",83,25,58,46,23,23,0,0,0,37,18,19,12,11,1,20,10,10,0,19,19,0,14,24,,,,24,1,3,2,2,0,,,
"Jul 1, 2022 8:00 PM",54,20,34,31,18,13,0,0,0,39,20,19,6,5,1,11,18,18,0,13,13,0,14,20,,,,13,1,1,1,1,0,,,
"Jul 1, 2022 9:00 PM",32,12,20,20,15,5,0,0,0,14,4,10,4,1,3,7,6,4,2,14,12,2,5,7,,,,10,0,1,1,1,0,,,
"Jul 1, 2022 10:00 PM",32,8,24,7,3,4,0,0,0,7,5,2,6,6,0,6,8,8,0,5,5,0,8,6,,,,3,1,1,2,1,1,,,
"Jul 1, 2022 11:00 PM",18,3,15,2,2,0,0,0,0,2,1,1,7,0,7,4,6,6,0,12,11,1,6,6,,,,5,0,1,0,0,0,,,
"Jul 2, 2022 12:00 AM",6,0,6,1,0,1,,,,3,2,1,3,0,3,0,0,0,0,3,3,0,0,3,,,,4,1,0,0,0,0,,,
"Jul 2, 2022 1:00 AM",3,1,2,0,0,0,0,0,,4,2,2,4,2,2,0,1,1,0,4,3,1,1,2,,,,1,0,0,2,1,1,,,
"Jul 2, 2022 2:00 AM",8,3,5,1,1,0,0,0,0,1,1,0,0,0,0,1,1,1,0,1,1,0,1,2,,,,1,0,1,0,0,0,,,
"Jul 2, 2022 3:00 AM",9,1,8,0,0,0,0,0,0,0,0,0,0,0,0,0,0,0,0,2,2,0,1,1,,,,0,0,0,0,0,0,,,
"Jul 2, 2022 4:00 AM",6,1,5,2,0,2,0,0,0,1,0,1,0,0,0,0,1,1,0,1,1,0,1,1,,,,1,0,0,0,0,0,,,
"Jul 2, 2022 5:00 AM",1,1,0,1,1,0,0,0,0,3,2,1,2,1,1,0,1,1,0,0,0,0,0,1,,,,5,0,0,0,0,0,,,
"Jul 2, 2022 6:00 AM",14,6,8,4,3,1,0,0,0,6,2,4,1,1,0,2,7,6,1,3,2,1,8,7,,,,5,1,0,1,1,0,,,
"Jul 2, 2022 7:00 AM",21,10,11,33,18,15,0,0,0,32,20,12,3,3,0,2,15,15,0,3,3,0,14,17,,,,19,1,3,1,1,0,,,
"Jul 2, 2022 8:00 AM",34,18,16,45,20,25,0,0,0,41,24,17,3,3,0,10,9,9,0,4,4,0,9,23,,,,19,3,0,2,1,1,,,
"Jul 2, 2022 9:00 AM",33,12,21,97,43,54,0,0,0,78,55,23,12,9,3,12,23,21,2,14,13,1,21,33,,,,23,6,11,3,3,0,,,
"Jul 2, 2022 10:00 AM",48,31,17,120,48,72,0,0,0,108,78,30,8,5,3,24,17,16,1,7,7,0,15,31,,,,34,5,9,3,1,2,,,
"Jul 2, 2022 11:00 AM",62,33,29,90,39,51,0,0,0,87,48,39,30,23,7,19,16,16,0,15,13,2,17,22,,,,28,6,8,4,1,3,,,
"Jul 2, 2022 12:00 PM",62,26,36,125,68,57,0,0,0,114,70,44,25,10,15,26,11,9,2,14,12,2,9,37,,,,38,12,5,11,9,2,,,
"Jul 2, 2022 1:00 PM",55,28,27,105,53,52,0,0,0,118,74,44,27,14,13,29,25,23,2,16,15,1,25,36,,,,31,1,2,11,9,2,,,
"Jul 2, 2022 2:00 PM",62,37,25,106,57,49,0,0,0,91,51,40,16,3,13,20,17,17,0,15,15,0,15,28,,,,35,5,8,8,3,5,,,
"Jul 2, 2022 3:00 PM",58,26,32,109,56,53,0,0,0,96,43,53,22,9,13,15,14,11,3,9,7,2,10,17,,,,36,6,2,6,4,2,,,
"Jul 2, 2022 4:00 PM",54,21,33,120,54,66,0,0,0,94,44,50,32,12,20,39,14,13,1,13,11,2,12,23,,,,33,4,3,7,2,5,,,
"Jul 2, 2022 5:00 PM",57,24,33,72,45,27,0,0,0,80,30,50,24,10,14,14,18,17,1,13,12,1,17,34,,,,34,7,3,8,6,2,,,
"Jul 2, 2022 6:00 PM",45,16,29,78,43,35,0,0,0,70,33,37,20,11,9,29,20,19,1,9,9,0,17,22,,,,28,4,3,6,4,2,,,
"Jul 2, 2022 7:00 PM",56,29,27,68,36,32,0,0,0,56,23,33,10,5,5,15,16,14,2,13,10,3,12,24,,,,27,1,1,7,5,2,,,
"Jul 2, 2022 8:00 PM",29,18,11,26,13,13,0,0,0,29,13,16,7,1,6,2,13,10,3,16,16,0,8,11,,,,26,2,0,1,1,0,,,
"Jul 2, 2022 9:00 PM",23,8,15,19,13,6,0,0,0,13,5,8,3,2,1,7,13,13,0,6,6,0,12,7,,,,11,1,0,3,3,0,,,
"Jul 2, 2022 10:00 PM",13,9,4,15,2,13,0,0,0,10,2,8,3,2,1,7,9,9,0,2,2,0,10,9,,,,10,0,3,0,0,0,,,
"Jul 2, 2022 11:00 PM",14,3,11,5,5,0,0,0,0,10,1,9,1,0,1,1,6,6,0,3,3,0,6,10,,,,7,0,1,1,1,0,,,
"Jul 3, 2022 12:00 AM",14,6,8,0,0,0,0,0,0,3,1,2,4,3,1,5,2,2,0,3,3,0,1,6,,,,4,0,0,0,0,0,,,
"Jul 3, 2022 1:00 AM",7,4,3,2,1,1,0,0,0,6,0,6,0,0,0,1,4,3,1,3,3,0,2,3,,,,4,0,1,0,0,0,,,
"Jul 3, 2022 2:00 AM",7,4,3,0,0,0,0,0,0,3,0,3,0,0,0,1,0,0,0,4,2,2,0,0,,,,3,0,0,2,1,1,,,
"Jul 3, 2022 3:00 AM",4,0,4,4,2,2,0,0,0,2,2,0,3,0,3,0,0,0,0,4,3,1,1,2,,,,1,0,0,0,0,0,,,
"Jul 3, 2022 4:00 AM",3,0,3,1,0,1,0,0,0,0,0,0,0,0,0,0,2,2,0,2,1,1,2,2,,,,1,0,0,0,0,0,,,
"Jul 3, 2022 5:00 AM",4,2,2,0,0,0,0,0,0,0,0,0,0,0,0,0,2,2,0,0,0,0,3,0,,,,1,0,0,0,0,0,,,
"Jul 3, 2022 6:00 AM",6,4,2,4,4,0,0,0,,8,5,3,2,0,2,0,3,2,1,2,2,0,3,3,,,,6,0,1,0,0,0,,,
"Jul 3, 2022 7:00 AM",9,3,6,19,9,10,0,0,0,21,13,8,2,2,0,5,10,9,1,6,5,1,9,6,,,,12,1,3,1,0,1,,,
"Jul 3, 2022 8:00 AM",19,6,13,65,52,13,0,0,0,63,51,12,8,3,5,2,17,17,0,7,6,1,16,24,,,,16,1,14,2,0,2,,,
"Jul 3, 2022 9:00 AM",36,13,23,104,67,37,0,0,0,93,57,36,10,4,6,8,18,18,0,8,8,0,18,39,,,,35,7,8,1,1,0,,,
"Jul 3, 2022 10:00 AM",34,22,12,107,65,42,0,0,0,108,72,36,12,7,5,14,15,15,0,15,13,2,13,50,,,,41,3,6,0,0,0,,,
"Jul 3, 2022 11:00 AM",45,22,23,135,61,74,0,0,0,122,56,66,10,5,5,15,18,16,2,17,15,2,14,34,,,,42,6,2,8,6,2,,,
"Jul 3, 2022 12:00 PM",41,24,17,134,68,66,0,0,0,114,67,47,24,18,6,15,14,11,3,7,5,2,16,22,,,,43,6,6,7,5,2,,,
"Jul 3, 2022 1:00 PM",51,30,21,121,54,67,0,0,0,93,54,39,15,9,6,19,22,22,0,22,20,2,23,36,,,,33,8,1,5,3,2,,,
"Jul 3, 2022 2:00 PM",56,23,33,131,75,56,0,0,0,124,69,55,40,17,23,14,25,25,0,13,11,2,24,35,,,,37,4,2,3,2,1,,,
"Jul 3, 2022 3:00 PM",67,37,30,131,73,58,0,0,0,125,71,54,23,10,13,22,20,20,0,23,22,1,18,24,,,,36,3,3,2,1,1,,,
"Jul 3, 2022 4:00 PM",38,23,15,125,62,63,0,0,0,102,43,59,22,12,10,24,15,14,1,8,6,2,16,24,,,,33,3,5,5,2,3,,,
"Jul 3, 2022 5:00 PM",61,35,26,118,59,59,0,0,,107,40,67,25,11,14,24,22,19,3,13,13,0,16,28,,,,50,4,2,4,2,2,,,
"Jul 3, 2022 6:00 PM",51,21,30,68,40,28,0,0,0,90,38,52,10,4,6,12,13,12,1,22,18,4,11,18,,,,34,2,2,3,2,1,,,
"Jul 3, 2022 7:00 PM",48,22,26,33,7,26,0,0,0,49,19,30,5,1,4,9,10,10,0,6,6,0,11,11,,,,24,1,0,6,2,4,,,
"Jul 3, 2022 8:00 PM",28,13,15,27,15,12,0,0,0,24,8,16,5,2,3,8,12,11,1,10,9,1,11,12,,,,17,3,1,2,2,0,,,
"Jul 3, 2022 9:00 PM",31,13,18,15,9,6,0,0,0,13,4,9,1,1,0,9,9,9,0,5,4,1,8,5,,,,10,1,2,1,0,1,,,
"Jul 3, 2022 10:00 PM",18,10,8,11,3,8,0,0,0,12,2,10,4,4,0,10,6,5,1,6,4,2,5,5,,,,4,1,2,1,1,0,,,
"Jul 3, 2022 11:00 PM",13,2,11,2,1,1,0,0,0,2,1,1,2,2,0,3,4,4,0,5,5,0,3,8,,,,4,0,1,0,0,0,,,
"Jul 4, 2022 12:00 AM",9,2,7,0,0,0,0,0,0,1,0,1,0,0,0,1,2,2,0,4,4,0,2,2,,,,0,0,0,2,1,1,,,
"Jul 4, 2022 1:00 AM",2,0,2,0,0,0,0,0,0,0,0,0,1,0,1,1,0,0,0,0,0,0,0,0,,,,1,0,0,0,0,0,,,
"Jul 4, 2022 2:00 AM",2,1,1,0,0,0,0,0,0,0,0,0,0,0,0,0,0,0,0,4,4,0,0,1,,,,1,0,0,0,0,0,,,
"Jul 4, 2022 3:00 AM",0,0,0,0,0,0,0,0,0,0,0,0,0,0,0,0,0,0,0,0,0,0,0,0,,,,0,0,0,0,0,0,,,
"Jul 4, 2022 4:00 AM",1,0,1,1,0,1,0,0,0,1,0,1,0,0,0,0,2,2,0,0,0,0,2,0,,,,2,0,0,0,0,0,,,
"Jul 4, 2022 5:00 AM",6,4,2,0,0,0,0,0,0,2,1,1,0,0,0,0,8,8,0,1,1,0,8,1,,,,15,0,2,0,0,0,,,
"Jul 4, 2022 6:00 AM",47,29,18,10,3,7,0,0,0,13,5,8,0,0,0,5,28,27,1,8,8,0,28,14,,,,26,1,2,0,0,0,,,
"Jul 4, 2022 7:00 AM",111,86,25,53,16,37,0,0,0,56,30,26,12,8,4,10,71,69,2,11,10,1,68,27,,,,89,3,4,4,3,1,,,
"Jul 4, 2022 8:00 AM",184,138,46,79,22,57,0,0,0,94,44,50,16,11,5,16,108,107,1,28,23,5,102,48,,,,133,3,2,7,5,2,,,
"Jul 4, 2022 9:00 AM",99,78,21,48,16,32,0,0,0,47,23,24,7,5,2,17,48,48,0,10,3,7,48,26,,,,49,3,3,4,4,0,,,
"Jul 4, 2022 10:00 AM",29,18,11,36,16,20,0,0,0,32,16,16,14,12,2,14,32,31,1,9,7,2,29,12,,,,30,6,2,4,2,2,,,
"Jul 4, 2022 11:00 AM",34,22,12,36,18,18,0,0,0,36,20,16,22,12,10,13,11,10,1,12,10,2,7,11,,,,10,0,1,1,1,0,,,
"Jul 4, 2022 12:00 PM",51,26,25,51,23,28,0,0,,39,20,19,15,10,5,17,14,13,1,10,8,2,14,15,,,,23,2,3,4,4,0,,,
"Jul 4, 2022 1:00 PM",63,33,30,41,25,16,0,0,,40,24,16,11,5,6,17,12,12,0,17,17,0,12,22,,,,26,5,0,6,5,1,,,
"Jul 4, 2022 2:00 PM",48,19,29,39,19,20,0,0,,40,21,19,13,7,6,18,11,10,1,18,18,0,8,19,,,,17,2,1,12,6,6,,,
"Jul 4, 2022 3:00 PM",77,30,47,44,27,17,0,0,0,34,23,11,19,15,4,11,20,19,1,15,14,1,18,35,,,,30,3,3,2,0,2,,,
"Jul 4, 2022 4:00 PM",86,24,62,56,32,24,0,0,0,61,33,28,16,4,12,28,22,21,1,35,34,1,18,59,,,,42,4,1,9,6,3,,,
"Jul 4, 2022 5:00 PM",174,43,131,84,58,26,0,0,0,82,43,39,19,7,12,25,32,30,2,67,66,1,33,89,,,,68,9,5,7,3,4,,,
"Jul 4, 2022 6:00 PM",163,58,105,93,65,28,0,0,0,84,59,25,20,9,11,28,39,34,5,88,86,2,34,107,,,,55,4,5,11,7,4,,,
"Jul 4, 2022 7:00 PM",117,37,80,97,58,39,0,0,0,88,53,35,14,6,8,24,14,13,1,30,28,2,16,50,,,,25,7,4,7,4,3,,,
"Jul 4, 2022 8:00 PM",56,12,44,79,45,34,0,0,0,73,36,37,6,1,5,11,17,15,2,34,31,3,11,20,,,,25,2,0,2,1,1,,,
"Jul 4, 2022 9:00 PM",46,11,35,42,14,28,0,0,0,45,13,32,11,9,2,11,9,8,1,14,13,1,7,17,,,,28,2,1,1,1,0,,,
"Jul 4, 2022 10:00 PM",25,7,18,15,11,4,0,0,0,18,10,8,5,1,4,2,4,3,1,16,16,0,3,4,,,,12,0,2,0,0,0,,,
"Jul 4, 2022 11:00 PM",12,2,10,5,2,3,0,0,0,3,1,2,4,1,3,3,3,3,0,5,5,0,3,9,,,,3,0,1,0,0,0,,,
"Jul 5, 2022 12:00 AM",7,0,7,0,0,0,0,0,0,2,1,1,0,0,0,0,2,2,0,4,4,0,2,4,,,,3,0,0,0,0,0,,,
"Jul 5, 2022 1:00 AM",3,1,2,1,0,1,0,0,0,1,0,1,0,0,0,0,1,1,0,1,1,0,1,0,,,,1,0,0,0,0,0,,,
"Jul 5, 2022 2:00 AM",5,5,0,0,0,0,0,0,0,0,0,0,0,0,0,0,1,1,0,1,1,0,1,0,,,,0,0,0,0,0,0,,,
"Jul 5, 2022 3:00 AM",1,0,1,0,0,0,0,0,0,0,0,0,0,0,0,0,0,0,0,1,1,0,0,0,,,,0,0,0,0,0,0,,,
"Jul 5, 2022 4:00 AM",1,1,0,2,0,2,0,0,0,2,0,2,1,0,1,0,2,2,0,0,0,0,2,0,,,,1,0,0,0,0,0,,,
"Jul 5, 2022 5:00 AM",8,5,3,1,0,1,0,0,0,2,1,1,1,1,0,1,8,8,0,2,1,1,7,1,,,,7,0,0,1,1,0,,,
"Jul 5, 2022 6:00 AM",43,28,15,17,7,10,0,0,0,19,9,10,2,2,0,5,25,25,0,8,7,1,27,14,,,,28,1,7,1,0,1,,,
"Jul 5, 2022 7:00 AM",127,97,30,45,15,30,0,0,0,42,15,27,3,1,2,11,78,77,1,11,8,3,78,27,,,,114,3,4,6,5,1,,,
"Jul 5, 2022 8:00 AM",213,147,66,81,20,61,0,0,0,91,41,50,11,7,4,18,130,130,0,22,14,8,131,51,,,,158,5,5,7,5,2,,,
"Jul 5, 2022 9:00 AM",130,109,21,52,18,34,0,0,0,50,27,23,16,8,8,16,59,57,2,20,15,5,54,34,,,,60,3,6,2,2,0,,,
"Jul 5, 2022 10:00 AM",42,31,11,47,19,28,0,0,0,38,23,15,9,4,5,11,26,26,0,14,12,2,23,15,,,,29,1,3,0,0,0,,,
"Jul 5, 2022 11:00 AM",41,20,21,58,31,27,0,0,0,60,40,20,20,12,8,14,15,14,1,11,8,3,15,17,,,,21,1,3,2,0,2,,,
"Jul 5, 2022 12:00 PM",50,28,22,57,29,28,0,0,0,45,21,24,13,10,3,14,17,16,1,17,15,2,15,23,,,,34,7,2,2,2,0,,,
"Jul 5, 2022 1:00 PM",57,19,38,51,23,28,0,0,0,42,23,19,17,10,7,22,20,19,1,22,22,0,23,25,,,,31,7,3,6,4,2,,,
"Jul 5, 2022 2:00 PM",52,25,27,34,17,17,0,0,0,38,26,12,15,11,4,15,22,22,0,18,16,2,20,24,,,,23,6,2,6,6,0,,,
"Jul 5, 2022 3:00 PM",78,31,47,41,22,19,0,0,0,49,27,22,22,14,8,19,17,15,2,29,26,3,14,32,,,,31,5,1,5,4,1,,,
"Jul 5, 2022 4:00 PM",132,34,98,66,44,22,0,0,0,72,35,37,20,9,11,19,18,16,2,40,39,1,15,59,,,,43,9,3,9,7,2,,,
"Jul 5, 2022 5:00 PM",226,64,162,107,66,41,0,0,0,122,73,49,20,7,13,23,36,29,7,97,96,1,29,121,,,,71,9,9,5,4,1,,,
"Jul 5, 2022 6:00 PM",197,52,145,113,79,34,0,0,0,119,80,39,21,5,16,27,43,40,3,90,84,6,39,118,,,,52,7,5,9,5,4,,,
"Jul 5, 2022 7:00 PM",128,58,70,102,59,43,0,0,0,115,67,48,10,7,3,15,20,19,1,35,32,3,17,78,,,,45,10,5,7,5,2,,,
"Jul 5, 2022 8:00 PM",82,26,56,54,29,25,0,0,0,63,29,34,12,1,11,24,10,8,2,31,30,1,9,28,,,,53,6,4,2,0,2,,,
"Jul 5, 2022 9:00 PM",68,20,48,41,22,19,0,0,0,48,14,34,7,5,2,16,13,12,1,21,20,1,10,13,,,,33,1,4,3,0,3,,,
"Jul 5, 2022 10:00 PM",35,11,24,17,11,6,0,0,0,18,7,11,10,2,8,3,8,8,0,12,10,2,8,9,,,,13,2,0,5,1,4,,,
"Jul 5, 2022 11:00 PM",18,3,15,5,5,0,0,0,0,7,2,5,5,1,4,2,8,8,0,9,7,2,8,14,,,,8,2,1,2,2,0,,,
"Jul 6, 2022 12:00 AM",7,0,7,0,0,0,0,0,0,6,0,6,1,0,1,1,3,3,0,4,4,0,3,4,,,,1,0,0,0,0,0,,,
"Jul 6, 2022 1:00 AM",5,2,3,2,0,2,0,0,0,2,0,2,0,0,0,0,0,0,0,1,1,0,0,2,,,,0,0,0,0,0,0,,,
"Jul 6, 2022 2:00 AM",8,7,1,1,0,1,0,0,0,1,0,1,0,0,0,0,1,1,0,0,0,0,1,0,,,,0,0,0,0,0,0,,,
"Jul 6, 2022 3:00 AM",1,0,1,0,0,0,0,0,0,0,0,0,0,0,0,0,0,0,0,0,0,0,1,1,,,,0,0,0,0,0,0,,,
"Jul 6, 2022 4:00 AM",2,1,1,1,0,1,0,0,0,1,0,1,0,0,0,0,0,0,0,0,0,0,0,0,,,,0,0,0,0,0,0,,,
"Jul 6, 2022 5:00 AM",9,4,5,0,0,0,0,0,0,3,1,2,2,2,0,0,7,7,0,0,0,0,8,1,,,,12,1,0,1,1,0,,,
"Jul 6, 2022 6:00 AM",39,21,18,24,12,12,0,0,0,27,14,13,6,4,2,5,34,34,0,9,8,1,30,15,,,,40,1,4,4,4,0,,,
"Jul 6, 2022 7:00 AM",122,82,40,53,18,35,0,0,0,52,15,37,8,7,1,13,76,75,1,11,8,3,76,39,,,,124,3,4,5,4,1,,,
"Jul 6, 2022 8:00 AM",244,175,69,71,16,55,0,0,0,83,41,42,9,6,3,19,130,130,0,26,19,7,128,57,,,,155,4,9,9,7,2,,,
"Jul 6, 2022 9:00 AM",126,103,23,58,20,38,0,0,0,65,41,24,18,10,8,13,66,64,2,22,14,8,60,30,,,,66,4,4,6,4,2,,,
"Jul 6, 2022 10:00 AM",59,43,16,45,13,32,0,0,,53,24,29,7,7,0,13,30,30,0,9,9,0,30,18,,,,30,2,2,6,4,2,,,
"Jul 6, 2022 11:00 AM",45,30,15,51,24,27,0,0,0,36,21,15,19,6,13,10,14,12,2,10,6,4,11,10,,,,26,3,0,3,1,2,,,
"Jul 6, 2022 12:00 PM",49,24,25,68,31,37,0,0,0,55,28,27,13,4,9,14,22,20,2,12,10,2,18,13,,,,33,3,4,4,2,2,,,
"Jul 6, 2022 1:00 PM",75,38,37,57,29,28,0,0,0,58,26,32,10,5,5,6,21,17,4,17,15,2,18,27,,,,23,3,1,10,3,7,,,
"Jul 6, 2022 2:00 PM",45,20,25,45,27,18,0,0,0,36,21,15,16,8,8,23,12,12,0,16,14,2,11,28,,,,19,5,3,6,4,2,,,
"Jul 6, 2022 3:00 PM",76,25,51,56,32,24,0,0,0,58,44,14,8,5,3,20,15,12,3,22,21,1,15,26,,,,28,6,2,2,2,0,,,
"Jul 6, 2022 4:00 PM",120,36,84,55,34,21,0,0,0,73,39,34,11,3,8,26,26,23,3,45,41,4,21,63,,,,45,3,6,9,5,4,,,
"Jul 6, 2022 5:00 PM",228,57,171,82,55,27,0,0,0,103,62,41,18,4,14,17,48,41,7,81,81,0,39,101,,,,56,8,3,9,5,4,,,
"Jul 6, 2022 6:00 PM",167,58,109,90,61,29,0,0,0,108,69,39,15,5,10,19,31,28,3,80,79,1,31,128,,,,48,6,6,11,8,3,,,
"Jul 6, 2022 7:00 PM",102,31,71,62,38,24,0,0,0,52,33,19,9,4,5,11,24,24,0,41,40,1,28,59,,,,36,6,3,3,2,1,,,
"Jul 6, 2022 8:00 PM",76,36,40,75,40,35,0,0,0,71,35,36,11,6,5,14,17,16,1,31,30,1,16,31,,,,42,5,4,4,4,0,,,
"Jul 6, 2022 9:00 PM",68,20,48,24,10,14,0,0,0,28,8,20,7,3,4,8,15,15,0,24,22,2,17,11,,,,22,1,1,2,2,0,,,
"Jul 6, 2022 10:00 PM",29,6,23,11,6,5,0,0,0,13,4,9,0,0,0,3,8,8,0,13,13,0,7,12,,,,10,3,0,6,4,2,,,
"Jul 6, 2022 11:00 PM",18,6,12,2,1,1,0,0,0,6,4,2,3,0,3,2,4,4,0,6,6,0,4,5,,,,4,0,0,3,2,1,,,
"Jul 7, 2022 12:00 AM",9,3,6,0,0,0,0,0,0,3,1,2,1,1,0,1,4,4,0,3,2,1,4,5,,,,1,0,0,0,0,0,,,
"Jul 7, 2022 1:00 AM",3,1,2,1,1,0,0,0,0,1,1,0,0,0,0,2,2,2,0,3,2,1,2,1,,,,2,0,0,0,0,0,,,
"Jul 7, 2022 2:00 AM",5,3,2,0,0,0,0,0,0,0,0,0,0,0,0,0,0,0,0,3,3,0,0,1,,,,1,0,0,0,0,0,,,
"Jul 7, 2022 3:00 AM",3,0,3,0,0,0,0,0,0,0,0,0,0,0,0,0,0,0,0,0,0,0,1,1,,,,0,0,0,1,1,0,,,
"Jul 7, 2022 4:00 AM",2,1,1,2,0,2,0,0,0,3,0,3,0,0,0,0,0,0,0,0,0,0,0,0,,,,0,0,0,0,0,0,,,
"Jul 7, 2022 5:00 AM",8,5,3,1,1,0,0,0,0,2,0,2,2,2,0,1,7,7,0,2,1,1,6,1,,,,11,0,0,0,0,0,,,
"Jul 7, 2022 6:00 AM",42,28,14,22,10,12,0,0,0,23,14,9,4,4,0,7,26,26,0,9,7,2,26,23,,,,33,3,4,3,2,1,,,
"Jul 7, 2022 7:00 AM",113,74,39,57,19,38,0,0,0,61,23,38,6,5,1,11,66,66,0,12,10,2,66,25,,,,103,4,3,4,4,0,,,
"Jul 7, 2022 8:00 AM",201,139,62,66,14,52,0,0,0,75,32,43,15,9,6,18,125,124,1,20,15,5,124,59,,,,125,5,2,4,3,1,,,
"Jul 7, 2022 9:00 AM",138,104,34,68,24,44,0,0,0,58,33,25,11,6,5,20,61,59,2,17,13,4,52,30,,,,63,1,2,4,2,2,,,
"Jul 7, 2022 10:00 AM",60,42,18,44,19,25,0,0,0,45,30,15,12,7,5,12,31,31,0,9,8,1,28,15,,,,27,2,4,2,2,0,,,
"Jul 7, 2022 11:00 AM",39,20,19,71,42,29,0,0,0,61,33,28,22,13,9,8,16,11,5,19,16,3,13,20,,,,34,7,7,4,1,3,,,
"Jul 7, 2022 12:00 PM",60,30,30,85,32,53,0,0,0,57,23,34,19,11,8,15,16,16,0,20,15,5,17,17,,,,27,9,5,7,4,3,,,
"Jul 7, 2022 1:00 PM",62,32,30,72,36,36,0,0,0,67,38,29,30,14,16,18,27,26,1,16,15,1,28,35,,,,33,10,7,9,7,2,,,
"Jul 7, 2022 2:00 PM",61,35,26,58,28,30,0,0,0,54,38,16,19,9,10,12,16,16,0,20,19,1,18,22,,,,11,4,5,2,2,0,,,
"Jul 7, 2022 3:00 PM",82,40,42,63,39,24,0,0,0,58,40,18,19,9,10,24,17,12,5,21,19,2,12,24,,,,33,3,6,12,9,3,,,
"Jul 7, 2022 4:00 PM",108,33,75,99,41,58,0,0,0,83,38,45,14,6,8,29,20,19,1,40,38,2,20,62,,,,46,6,4,8,6,2,,,
"Jul 7, 2022 5:00 PM",196,55,141,155,66,89,0,0,0,158,101,57,28,17,11,23,41,39,2,83,80,3,37,108,,,,60,7,11,8,4,4,,,
"Jul 7, 2022 6:00 PM",155,45,110,118,79,39,0,0,0,144,114,30,23,8,15,27,44,40,4,82,80,2,43,112,,,,57,9,1,6,5,1,,,
"Jul 7, 2022 7:00 PM",114,52,62,109,60,49,0,0,0,102,61,41,16,10,6,9,20,20,0,39,37,2,18,65,,,,52,7,0,8,7,1,,,
"Jul 7, 2022 8:00 PM",100,38,62,116,59,57,0,0,0,104,49,55,16,7,9,19,16,16,0,27,25,2,15,49,,,,40,3,1,4,1,3,,,
"Jul 7, 2022 9:00 PM",65,20,45,95,42,53,0,0,0,87,26,61,13,5,8,10,16,15,1,24,22,2,15,21,,,,44,6,1,4,2,2,,,
"Jul 7, 2022 10:00 PM",42,8,34,62,50,12,0,0,0,54,12,42,18,2,16,5,24,22,2,18,17,1,21,20,,,,25,0,1,6,2,4,,,
"Jul 7, 2022 11:00 PM",29,11,18,19,15,4,0,0,0,22,4,18,4,2,2,5,5,5,0,9,9,0,6,9,,,,13,1,0,7,3,4,,,
"Jul 8, 2022 12:00 AM",11,2,9,0,0,0,0,0,0,11,4,7,0,0,0,2,4,3,1,13,13,0,3,7,,,,3,0,0,3,1,2,,,
"Jul 8, 2022 1:00 AM",6,1,5,3,3,0,0,0,0,1,1,0,1,0,1,2,1,1,0,3,3,0,1,2,,,,4,1,0,0,0,0,,,
"Jul 8, 2022 2:00 AM",3,2,1,0,0,0,0,0,0,2,1,1,0,0,0,1,2,2,0,1,1,0,1,3,,,,3,0,0,0,0,0,,,
"Jul 8, 2022 3:00 AM",3,0,3,1,1,0,0,0,0,0,0,0,0,0,0,0,0,0,0,0,0,0,1,1,,,,0,0,0,0,0,0,,,
"Jul 8, 2022 4:00 AM",3,1,2,1,0,1,0,0,0,1,0,1,2,1,1,0,0,0,0,0,0,0,0,1,,,,0,0,0,1,1,0,,,
"Jul 8, 2022 5:00 AM",12,7,5,7,5,2,0,0,0,5,3,2,1,1,0,0,7,7,0,0,0,0,7,4,,,,6,0,0,1,1,0,,,
"Jul 8, 2022 6:00 AM",41,24,17,19,8,11,0,0,0,23,10,13,2,2,0,3,17,17,0,12,10,2,16,30,,,,27,0,2,1,1,0,,,
"Jul 8, 2022 7:00 AM",80,61,19,52,18,34,0,0,0,56,27,29,8,6,2,9,39,38,1,12,9,3,38,36,,,,62,1,3,4,3,1,,,
"Jul 8, 2022 8:00 AM",148,105,43,56,16,40,0,0,0,76,34,42,19,8,11,19,83,82,1,17,15,2,82,49,,,,103,3,1,5,3,2,,,
"Jul 8, 2022 9:00 AM",94,74,20,67,24,43,0,0,0,48,34,14,19,12,7,18,45,45,0,14,10,4,44,20,,,,42,4,5,7,5,2,,,
"Jul 8, 2022 10:00 AM",57,40,17,53,23,30,0,0,0,38,23,15,16,11,5,13,18,17,1,10,8,2,18,12,,,,39,3,6,3,2,1,,,
"Jul 8, 2022 11:00 AM",56,33,23,48,23,25,0,0,0,42,24,18,15,5,10,13,22,19,3,15,11,4,18,21,,,,29,4,7,8,4,4,,,
"Jul 8, 2022 12:00 PM",62,30,32,70,32,38,0,0,0,55,28,27,28,23,5,18,18,18,0,16,14,2,16,30,,,,28,7,3,2,2,0,,,
"Jul 8, 2022 1:00 PM",83,31,52,56,26,30,0,0,0,48,24,24,11,3,8,27,24,24,0,22,17,5,24,18,,,,30,4,2,5,2,3,,,
"Jul 8, 2022 2:00 PM",70,35,35,73,48,25,0,0,0,65,43,22,12,7,5,14,17,14,3,28,25,3,15,29,,,,30,3,2,9,4,5,,,
"Jul 8, 2022 3:00 PM",91,36,55,82,45,37,0,0,0,85,45,40,22,9,13,9,26,22,4,33,31,2,23,34,,,,23,3,5,4,0,4,,,
"Jul 8, 2022 4:00 PM",104,34,70,104,67,37,0,0,0,107,67,40,22,8,14,28,29,27,2,36,34,2,26,57,,,,45,13,5,23,13,10,,,
"Jul 8, 2022 5:00 PM",139,41,98,125,63,62,0,0,0,118,59,59,34,18,16,16,25,21,4,63,62,1,23,68,,,,55,5,5,10,5,5,,,
"Jul 8, 2022 6:00 PM",99,44,55,121,68,53,0,0,0,119,69,50,16,3,13,27,25,25,0,42,38,4,23,78,,,,55,2,5,7,5,2,,,
"Jul 8, 2022 7:00 PM",68,31,37,94,52,42,0,0,0,74,39,35,20,11,9,10,13,13,0,18,16,2,13,25,,,,40,6,1,12,11,1,,,
"Jul 8, 2022 8:00 PM",59,27,32,74,43,31,0,0,0,77,49,28,16,11,5,14,15,10,5,13,13,0,11,25,,,,25,5,2,9,6,3,,,
"Jul 8, 2022 9:00 PM",44,10,34,50,22,28,0,0,0,53,16,37,8,3,5,17,15,15,0,13,11,2,13,14,,,,29,3,0,2,2,0,,,
"Jul 8, 2022 10:00 PM",24,11,13,15,9,6,0,0,0,33,10,23,6,6,0,8,7,6,1,13,11,2,6,10,,,,13,3,2,2,1,1,,,
"Jul 8, 2022 11:00 PM",26,6,20,11,5,6,0,0,0,13,7,6,6,1,5,5,3,3,0,9,9,0,3,10,,,,6,1,2,0,0,0,,,
"Jul 9, 2022 12:00 AM",16,4,12,0,0,0,0,0,0,7,4,3,2,1,1,1,4,4,0,4,3,1,5,10,,,,15,0,1,0,0,0,,,
"Jul 9, 2022 1:00 AM",12,4,8,1,0,1,0,0,0,4,0,4,1,0,1,0,2,1,1,8,8,0,1,12,,,,5,0,0,2,1,1,,,
"Jul 9, 2022 2:00 AM",11,7,4,1,1,0,0,0,0,0,0,0,0,0,0,1,1,1,0,4,4,0,1,2,,,,3,0,0,0,0,0,,,
"Jul 9, 2022 3:00 AM",4,1,3,0,0,0,0,0,0,0,0,0,0,0,0,2,0,0,0,1,1,0,1,2,,,,0,0,0,0,0,0,,,
"Jul 9, 2022 4:00 AM",2,0,2,0,0,0,0,0,0,0,0,0,0,0,0,0,0,0,0,1,1,0,0,3,,,,0,0,0,0,0,0,,,
"Jul 9, 2022 5:00 AM",2,0,2,4,2,2,0,0,0,7,3,4,2,2,0,2,2,2,0,1,1,0,2,1,,,,2,0,0,1,0,1,,,
"Jul 9, 2022 6:00 AM",17,7,10,12,6,6,0,0,0,8,4,4,0,0,0,0,4,3,1,5,4,1,4,8,,,,8,0,0,1,1,0,,,
"Jul 9, 2022 7:00 AM",26,11,15,30,20,10,0,0,0,25,15,10,7,4,3,6,8,7,1,2,2,0,5,12,,,,14,3,0,1,1,0,,,
"Jul 9, 2022 8:00 AM",43,11,32,47,28,19,0,0,0,52,35,17,4,2,2,9,14,14,0,4,3,1,16,24,,,,19,1,3,3,1,2,,,
"Jul 9, 2022 9:00 AM",34,18,16,56,23,33,0,0,0,60,32,28,11,6,5,9,9,8,1,11,11,0,10,30,,,,30,5,8,3,3,0,,,
"Jul 9, 2022 10:00 AM",60,36,24,114,63,51,0,0,0,92,64,28,19,10,9,13,22,21,1,11,11,0,21,35,,,,48,4,2,5,4,1,,,
"Jul 9, 2022 11:00 AM",44,27,17,112,59,53,0,0,0,106,70,36,27,12,15,15,11,10,1,16,14,2,12,30,,,,53,5,6,11,8,3,,,
"Jul 9, 2022 12:00 PM",56,29,27,165,73,92,0,0,0,161,96,65,30,13,17,18,18,17,1,19,18,1,17,58,,,,42,6,7,2,1,1,,,
"Jul 9, 2022 1:00 PM",72,29,43,154,65,89,0,0,0,159,98,61,35,15,20,22,18,16,2,12,12,0,14,41,,,,37,6,2,4,3,1,,,
"Jul 9, 2022 2:00 PM",56,36,20,120,56,64,0,0,0,110,48,62,30,21,9,29,36,34,2,15,14,1,31,40,,,,40,6,4,9,5,4,,,
"Jul 9, 2022 3:00 PM",65,34,31,119,73,46,0,0,0,109,67,42,19,4,15,21,22,21,1,14,14,0,20,36,,,,43,4,4,12,9,3,,,
"Jul 9, 2022 4:00 PM",63,26,37,110,57,53,0,0,0,113,61,52,19,8,11,26,22,22,0,9,5,4,20,26,,,,40,7,3,8,2,6,,,
"Jul 9, 2022 5:00 PM",58,29,29,150,88,62,0,0,0,128,48,80,35,14,21,14,9,7,2,17,17,0,7,21,,,,43,3,2,4,4,0,,,
"Jul 9, 2022 6:00 PM",49,23,26,100,56,44,0,0,0,97,46,51,13,3,10,30,7,6,1,10,10,0,6,30,,,,44,3,2,3,1,2,,,
"Jul 9, 2022 7:00 PM",43,20,23,75,32,43,0,0,0,73,40,33,6,3,3,8,9,9,0,5,4,1,11,12,,,,31,2,3,5,3,2,,,
"Jul 9, 2022 8:00 PM",49,19,30,57,25,32,0,0,0,61,23,38,6,2,4,13,7,6,1,12,12,0,6,10,,,,32,0,4,4,3,1,,,
"Jul 9, 2022 9:00 PM",34,10,24,19,8,11,0,0,0,27,9,18,2,2,0,11,5,5,0,7,7,0,5,6,,,,23,2,1,6,1,5,,,
"Jul 9, 2022 10:00 PM",17,6,11,16,4,12,0,0,0,19,6,13,4,3,1,2,5,5,0,4,4,0,4,8,,,,16,1,1,0,0,0,,,
"Jul 9, 2022 11:00 PM",22,2,20,6,3,3,0,0,0,5,1,4,1,1,0,4,7,7,0,6,6,0,8,4,,,,10,0,1,1,0,1,,,
"Jul 10, 2022 12:00 AM",10,3,7,2,0,2,0,0,0,6,1,5,0,0,0,6,6,6,0,6,5,1,6,9,,,,6,0,1,2,2,0,,,
"Jul 10, 2022 1:00 AM",9,2,7,4,0,4,0,0,0,7,4,3,1,1,0,3,3,3,0,1,1,0,2,12,,,,8,0,0,1,1,0,,,
"Jul 10, 2022 2:00 AM",5,2,3,0,0,0,0,0,0,1,1,0,0,0,0,0,1,1,0,3,3,0,1,3,,,,2,0,0,1,0,1,,,
"Jul 10, 2022 3:00 AM",4,1,3,0,0,0,0,0,0,0,0,0,0,0,0,0,0,0,0,3,3,0,0,1,,,,0,0,1,0,0,0,,,
"Jul 10, 2022 4:00 AM",1,0,1,2,1,1,0,0,0,2,1,1,2,1,1,0,2,2,0,3,2,1,1,1,,,,0,1,0,0,0,0,,,
"Jul 10, 2022 5:00 AM",1,1,0,0,0,0,0,0,0,0,0,0,0,0,0,0,0,0,0,1,1,0,1,1,,,,1,0,0,1,1,0,,,
"Jul 10, 2022 6:00 AM",9,5,4,14,10,4,0,0,0,10,4,6,0,0,0,0,6,6,0,1,1,0,5,6,,,,5,0,1,1,1,0,,,
"Jul 10, 2022 7:00 AM",15,11,4,15,7,8,192,192,0,11,8,3,0,0,0,5,9,7,2,6,5,1,6,12,,,,16,1,2,1,1,0,,,
"Jul 10, 2022 8:00 AM",32,12,20,40,22,18,0,0,0,48,31,17,2,2,0,15,11,11,0,4,4,0,11,28,,,,20,2,10,1,1,0,,,
"Jul 10, 2022 9:00 AM",45,22,23,106,67,39,0,0,0,85,67,18,12,6,6,12,17,15,2,12,8,4,15,43,,,,35,3,3,4,3,1,,,
"Jul 10, 2022 10:00 AM",44,22,22,162,95,67,0,0,0,139,95,44,18,10,8,22,17,17,0,14,12,2,16,56,,,,36,6,4,5,3,2,,,
"Jul 10, 2022 11:00 AM",41,27,14,243,136,107,0,0,0,224,139,85,16,12,4,22,18,17,1,11,10,1,18,61,,,,52,11,6,10,10,0,,,
"Jul 10, 2022 12:00 PM",61,23,38,232,129,103,0,0,0,182,116,66,35,17,18,20,22,20,2,18,13,5,19,51,,,,70,7,7,6,4,2,,,
"Jul 10, 2022 1:00 PM",73,34,39,253,135,118,0,0,0,214,135,79,20,10,10,23,26,26,0,20,17,3,29,56,,,,38,12,3,9,5,4,,,
"Jul 10, 2022 2:00 PM",67,40,27,235,142,93,0,0,0,223,144,79,39,20,19,5,33,32,1,12,10,2,32,49,,,,69,6,7,9,3,6,,,
"Jul 10, 2022 3:00 PM",44,18,26,231,114,117,,,,219,106,113,40,24,16,28,21,21,0,20,18,2,16,50,,,,67,9,4,9,3,6,,,
"Jul 10, 2022 4:00 PM",50,29,21,217,125,92,0,0,0,167,84,83,32,11,21,19,22,20,2,9,9,0,23,45,,,,54,7,4,7,3,4,,,
"Jul 10, 2022 5:00 PM",60,26,34,190,85,105,0,0,0,160,66,94,18,11,7,17,20,20,0,10,8,2,20,44,,,,71,7,4,9,7,2,,,
"Jul 10, 2022 6:00 PM",42,17,25,195,86,109,0,0,0,173,72,101,22,11,11,21,25,24,1,22,20,2,24,41,,,,68,2,4,7,5,2,,,
"Jul 10, 2022 7:00 PM",58,28,30,128,56,72,0,0,0,133,52,81,13,9,4,18,24,22,2,10,10,0,23,31,,,,56,1,3,5,4,1,,,
"Jul 10, 2022 8:00 PM",39,13,26,94,29,65,,,,90,31,59,9,3,6,14,13,12,1,14,13,1,10,20,,,,64,5,0,2,1,1,,,
"Jul 10, 2022 9:00 PM",33,14,19,30,10,20,,,,29,11,18,7,5,2,27,13,13,0,7,7,0,14,7,,,,28,0,2,2,2,0,,,
"Jul 10, 2022 10:00 PM",22,9,13,21,9,12,,,,22,7,15,1,0,1,7,7,7,0,6,4,2,6,15,,,,22,1,2,1,1,0,,,
"Jul 10, 2022 11:00 PM",11,2,9,3,1,2,0,0,0,5,2,3,0,0,0,5,2,1,1,1,1,0,2,2,,,,14,2,0,3,2,1,,,
"Jul 11, 2022 12:00 AM",6,2,4,0,0,0,0,0,0,5,0,5,1,1,0,0,2,2,0,4,4,0,2,7,,,,5,0,0,2,1,1,,,
"Jul 11, 2022 1:00 AM",6,1,5,0,0,0,0,0,0,2,1,1,0,0,0,2,0,0,0,2,2,0,0,1,,,,0,1,0,0,0,0,,,
"Jul 11, 2022 2:00 AM",5,2,3,0,0,0,,,,0,0,0,0,0,0,0,0,0,0,3,3,0,0,2,,,,0,0,0,0,0,0,,,
"Jul 11, 2022 3:00 AM",2,0,2,1,0,1,,,,0,0,0,0,0,0,0,0,0,0,0,0,0,3,0,,,,1,0,0,0,0,0,,,
"Jul 11, 2022 4:00 AM",2,1,1,1,0,1,,,,2,0,2,0,0,0,0,2,2,0,1,1,0,2,0,,,,1,0,0,0,0,0,,,
"Jul 11, 2022 5:00 AM",12,6,6,0,0,0,,,,2,1,1,0,0,0,1,11,11,0,0,0,0,11,4,,,,7,1,3,1,1,0,,,
"Jul 11, 2022 6:00 AM",42,25,17,15,4,11,,,,22,8,14,2,2,0,8,31,31,0,5,4,1,30,18,,,,35,2,1,3,3,0,,,
"Jul 11, 2022 7:00 AM",117,76,41,47,18,29,,,,51,22,29,6,6,0,14,68,66,2,16,12,4,61,32,,,,84,3,2,3,1,2,,,
"Jul 11, 2022 8:00 AM",183,138,45,75,17,58,,,,70,37,33,15,13,2,20,111,110,1,23,16,7,110,50,,,,155,5,5,8,5,3,,,
"Jul 11, 2022 9:00 AM",108,72,36,74,24,50,0,0,0,62,34,28,20,5,15,9,56,55,1,19,15,4,51,29,,,,61,2,5,4,3,1,,,
"Jul 11, 2022 10:00 AM",62,40,22,78,40,38,0,0,0,55,27,28,10,3,7,13,35,33,2,18,17,1,32,19,,,,28,3,4,6,3,3,,,
"Jul 11, 2022 11:00 AM",49,26,23,79,44,35,0,0,0,63,36,27,23,19,4,17,19,17,2,10,7,3,18,12,,,,30,5,5,3,3,0,,,
"Jul 11, 2022 12:00 PM",54,26,28,62,30,32,0,0,0,71,44,27,26,14,12,17,27,24,3,17,13,4,24,30,,,,25,2,2,3,1,2,,,
"Jul 11, 2022 1:00 PM",67,38,29,74,43,31,0,0,0,55,29,26,18,8,10,16,19,19,0,9,9,0,16,22,,,,37,3,3,2,2,0,,,
"Jul 11, 2022 2:00 PM",54,28,26,80,45,35,0,0,0,74,41,33,22,16,6,19,22,21,1,26,24,2,18,30,,,,18,4,4,5,5,0,,,
"Jul 11, 2022 3:00 PM",71,26,45,79,37,42,0,0,0,80,45,35,11,5,6,22,17,14,3,21,21,0,14,35,,,,35,3,1,6,6,0,,,
"Jul 11, 2022 4:00 PM",107,29,78,124,77,47,0,0,0,112,70,42,29,15,14,18,30,27,3,32,32,0,23,60,,,,50,6,5,9,6,3,,,
"Jul 11, 2022 5:00 PM",190,51,139,207,130,77,0,0,0,195,117,78,28,8,20,35,46,40,6,95,92,3,37,118,,,,78,8,10,9,5,4,,,
"Jul 11, 2022 6:00 PM",164,52,112,220,133,87,0,0,0,209,135,74,26,8,18,19,32,28,4,75,71,4,30,145,,,,70,1,5,15,6,9,,,
"Jul 11, 2022 7:00 PM",85,26,59,166,88,78,0,0,0,145,76,69,14,12,2,16,30,29,1,41,33,8,25,77,,,,76,7,6,15,10,5,,,
"Jul 11, 2022 8:00 PM",78,29,49,127,57,70,0,0,0,113,44,69,19,12,7,17,21,19,2,29,29,0,17,46,,,,90,5,6,8,6,2,,,
"Jul 11, 2022 9:00 PM",46,12,34,86,35,51,0,0,0,86,29,57,12,5,7,10,16,14,2,15,15,0,13,19,,,,52,4,2,4,2,2,,,
"Jul 11, 2022 10:00 PM",23,5,18,22,11,11,0,0,0,33,13,20,4,2,2,4,7,7,0,10,10,0,6,8,,,,20,0,1,0,0,0,,,
"Jul 11, 2022 11:00 PM",15,2,13,5,3,2,0,0,0,5,1,4,2,0,2,1,8,5,3,3,3,0,5,5,,,,14,0,0,2,1,1,,,
"Jul 12, 2022 12:00 AM",9,4,5,0,0,0,0,0,0,4,3,1,1,0,1,1,3,3,0,9,9,0,3,4,,,,0,0,0,4,4,0,,,
"Jul 12, 2022 1:00 AM",3,0,3,1,0,1,0,0,0,1,0,1,0,0,0,0,1,1,0,0,0,0,1,4,,,,0,0,0,0,0,0,,,
"Jul 12, 2022 2:00 AM",6,6,0,1,1,0,0,0,0,2,2,0,0,0,0,1,0,0,0,0,0,0,0,3,,,,2,0,0,0,0,0,,,
"Jul 12, 2022 3:00 AM",0,0,0,0,0,0,0,0,0,0,0,0,0,0,0,1,0,0,0,0,0,0,1,3,,,,2,0,0,0,0,0,,,
"Jul 12, 2022 4:00 AM",1,1,0,1,0,1,0,0,0,1,0,1,0,0,0,0,2,2,0,0,0,0,2,1,,,,0,0,0,0,0,0,,,
"Jul 12, 2022 5:00 AM",6,3,3,0,0,0,0,0,0,2,1,1,1,1,0,1,6,6,0,4,4,0,6,4,,,,10,0,0,1,1,0,,,
"Jul 12, 2022 6:00 AM",51,31,20,24,9,15,0,0,0,21,11,10,5,5,0,10,25,25,0,8,6,2,24,16,,,,41,1,6,3,2,1,,,
"Jul 12, 2022 7:00 AM",114,73,41,41,14,27,0,0,0,44,14,30,3,1,2,11,60,59,1,10,8,2,61,32,,,,90,2,3,5,5,0,,,
"Jul 12, 2022 8:00 AM",185,127,58,45,9,36,0,0,0,59,27,32,10,8,2,19,92,91,1,26,21,5,92,50,,,,140,3,3,3,2,1,,,
"Jul 12, 2022 9:00 AM",109,88,21,60,21,39,0,0,0,53,29,24,16,13,3,9,49,48,1,16,13,3,44,25,,,,51,1,3,1,1,0,,,
"Jul 12, 2022 10:00 AM",31,22,9,25,7,18,0,0,0,28,20,8,8,4,4,6,21,20,1,9,6,3,19,15,,,,25,5,2,1,0,1,,,
"Jul 12, 2022 11:00 AM",49,30,19,46,20,26,0,0,0,44,11,33,7,5,2,10,6,6,0,12,12,0,4,9,,,,23,2,2,5,3,2,,,
"Jul 12, 2022 12:00 PM",67,35,32,60,35,25,0,0,0,59,39,20,15,6,9,10,12,12,0,9,8,1,14,22,,,,26,1,4,6,4,2,,,
"Jul 12, 2022 1:00 PM",63,31,32,65,30,35,0,0,0,48,19,29,17,9,8,17,20,20,0,15,12,3,23,21,,,,28,3,1,3,3,0,,,
"Jul 12, 2022 2:00 PM",56,24,32,63,29,34,0,0,0,75,50,25,12,8,4,16,16,15,1,22,20,2,13,17,,,,33,1,1,3,3,0,,,
"Jul 12, 2022 3:00 PM",73,28,45,72,41,31,0,0,0,58,37,21,17,5,12,23,17,15,2,23,22,1,14,33,,,,26,3,1,2,1,1,,,
"Jul 12, 2022 4:00 PM",124,37,87,82,40,42,0,0,0,83,48,35,21,11,10,17,28,26,2,21,19,2,27,55,,,,43,8,1,5,3,2,,,
"Jul 12, 2022 5:00 PM",198,49,149,112,65,47,0,0,0,117,73,44,21,9,12,17,43,35,8,70,68,2,33,109,,,,72,9,2,13,8,5,,,
"Jul 12, 2022 6:00 PM",190,55,135,140,95,45,0,0,0,125,85,40,17,7,10,23,38,34,4,75,73,2,34,114,,,,56,4,5,7,4,3,,,
"Jul 12, 2022 7:00 PM",111,40,71,133,89,44,0,0,0,115,81,34,12,7,5,21,27,23,4,39,34,5,25,73,,,,30,1,6,1,0,1,,,
"Jul 12, 2022 8:00 PM",99,30,69,113,41,72,0,0,0,100,42,58,11,7,4,21,22,21,1,34,28,6,21,45,,,,46,8,1,8,5,3,,,
"Jul 12, 2022 9:00 PM",48,13,35,69,35,34,0,0,0,50,18,32,9,1,8,12,12,11,1,27,24,3,10,17,,,,27,1,3,5,3,2,,,
"Jul 12, 2022 10:00 PM",32,10,22,49,29,20,0,0,0,38,9,29,6,2,4,3,8,7,1,14,14,0,7,19,,,,28,2,1,1,1,0,,,
"Jul 12, 2022 11:00 PM",20,2,18,7,2,5,0,0,0,10,5,5,5,3,2,0,9,8,1,9,8,1,7,5,,,,10,0,1,1,1,0,,,
"Jul 13, 2022 12:00 AM",7,1,6,0,0,0,0,0,0,3,1,2,0,0,0,2,1,1,0,7,7,0,2,7,,,,5,1,0,0,0,0,,,
"Jul 13, 2022 1:00 AM",6,2,4,0,0,0,0,0,0,0,0,0,0,0,0,0,1,0,1,3,3,0,0,0,,,,2,0,0,0,0,0,,,
"Jul 13, 2022 2:00 AM",8,8,0,0,0,0,0,0,0,0,0,0,0,0,0,0,0,0,0,0,0,0,0,1,,,,0,0,0,0,0,0,,,
"Jul 13, 2022 3:00 AM",2,1,1,0,0,0,0,0,0,0,0,0,0,0,0,0,0,0,0,3,3,0,1,2,,,,0,0,0,0,0,0,,,
"Jul 13, 2022 4:00 AM",2,0,2,2,0,2,0,0,0,1,0,1,0,0,0,0,3,3,0,0,0,0,2,0,,,,0,0,0,1,1,0,,,
"Jul 13, 2022 5:00 AM",10,7,3,1,0,1,0,0,0,3,2,1,2,0,2,1,9,9,0,1,1,0,8,4,,,,12,0,0,1,1,0,,,
"Jul 13, 2022 6:00 AM",47,29,18,24,12,12,0,0,0,26,13,13,5,5,0,11,24,24,0,8,7,1,25,18,,,,36,0,7,3,3,0,,,
"Jul 13, 2022 7:00 AM",129,91,38,68,22,46,0,0,0,80,31,49,9,6,3,10,75,74,1,23,20,3,77,35,,,,105,4,1,9,8,1,,,
"Jul 13, 2022 8:00 AM",219,159,60,100,20,80,0,0,0,103,48,55,23,20,3,21,133,132,1,34,29,5,136,57,,,,178,5,7,7,6,1,,,
"Jul 13, 2022 9:00 AM",104,77,27,72,25,47,0,0,0,65,32,33,25,15,10,12,72,72,0,23,19,4,68,27,,,,80,9,8,5,3,2,,,
"Jul 13, 2022 10:00 AM",40,24,16,48,24,24,0,0,0,53,28,25,10,4,6,14,27,25,2,13,12,1,22,32,,,,34,2,1,6,5,1,,,
"Jul 13, 2022 11:00 AM",55,31,24,76,48,28,0,0,0,50,36,14,22,9,13,12,20,18,2,9,8,1,18,22,,,,31,3,5,3,2,1,,,
"Jul 13, 2022 12:00 PM",65,43,22,72,34,38,0,0,0,54,34,20,18,9,9,7,21,19,2,15,13,2,17,28,,,,27,1,1,0,0,0,,,
"Jul 13, 2022 1:00 PM",82,42,40,84,44,40,0,0,0,76,38,38,16,8,8,21,23,22,1,24,24,0,23,37,,,,31,3,4,10,6,4,,,
"Jul 13, 2022 2:00 PM",78,38,40,72,36,36,0,0,0,69,42,27,19,10,9,13,24,24,0,26,24,2,22,27,,,,28,2,4,6,5,1,,,
"Jul 13, 2022 3:00 PM",89,43,46,75,43,32,0,0,0,58,35,23,13,7,6,22,19,18,1,26,23,3,18,31,,,,32,8,2,8,3,5,,,
"Jul 13, 2022 4:00 PM",135,35,100,95,58,37,0,0,0,108,67,41,30,5,25,25,27,25,2,42,41,1,31,60,,,,53,4,2,3,1,2,,,
"Jul 13, 2022 5:00 PM",218,61,157,176,96,80,0,0,0,156,84,72,42,20,22,23,48,46,2,76,74,2,44,140,,,,72,7,10,6,3,3,,,
"Jul 13, 2022 6:00 PM",188,56,132,185,123,62,0,0,0,184,134,50,40,12,28,21,37,33,4,81,78,3,32,126,,,,55,4,8,4,1,3,,,
"Jul 13, 2022 7:00 PM",119,46,73,187,99,88,0,0,0,171,100,71,24,11,13,28,27,26,1,49,47,2,20,75,,,,61,3,5,8,5,3,,,
"Jul 13, 2022 8:00 PM",86,33,53,127,54,73,0,0,0,114,45,69,11,2,9,11,19,18,1,41,36,5,17,32,,,,45,9,8,4,3,1,,,
"Jul 13, 2022 9:00 PM",54,19,35,73,37,36,0,0,0,74,24,50,5,1,4,14,15,13,2,21,20,1,15,17,,,,36,4,0,8,6,2,,,
"Jul 13, 2022 10:00 PM",42,12,30,35,22,13,0,0,0,25,9,16,4,2,2,3,9,9,0,22,21,1,10,18,,,,16,0,2,4,2,2,,,
"Jul 13, 2022 11:00 PM",17,2,15,10,8,2,0,0,0,7,1,6,4,3,1,1,11,10,1,5,5,0,10,11,,,,8,0,1,0,0,0,,,
"Jul 14, 2022 12:00 AM",18,3,15,3,1,2,0,0,0,4,1,3,2,1,1,2,8,8,0,5,5,0,7,8,,,,6,0,0,0,0,0,,,
"Jul 14, 2022 1:00 AM",5,0,5,1,1,0,0,0,0,1,0,1,3,0,3,0,0,0,0,1,1,0,0,4,,,,1,0,0,1,0,1,,,
"Jul 14, 2022 2:00 AM",8,7,1,0,0,0,0,0,0,0,0,0,0,0,0,0,0,0,0,2,1,1,0,0,,,,1,0,0,1,1,0,,,
"Jul 14, 2022 3:00 AM",1,0,1,0,0,0,0,0,0,0,0,0,0,0,0,0,0,0,0,0,0,0,0,3,,,,0,0,0,0,0,0,,,
"Jul 14, 2022 4:00 AM",2,1,1,1,0,1,0,0,0,1,0,1,0,0,0,0,0,0,0,2,2,0,0,0,,,,0,0,0,0,0,0,,,
"Jul 14, 2022 5:00 AM",9,6,3,3,0,3,0,0,0,4,1,3,2,2,0,1,6,6,0,3,3,0,5,2,,,,14,0,0,0,0,0,,,
"Jul 14, 2022 6:00 AM",57,30,27,33,15,18,0,0,0,35,16,19,3,3,0,10,30,30,0,8,6,2,34,25,,,,36,1,6,2,2,0,,,
"Jul 14, 2022 7:00 AM",132,95,37,60,23,37,0,0,0,55,17,38,10,8,2,10,63,62,1,13,9,4,62,32,,,,105,5,2,9,9,0,,,
"Jul 14, 2022 8:00 AM",202,152,50,85,23,62,0,0,0,97,44,53,14,9,5,22,138,138,0,22,18,4,130,43,,,,162,3,4,6,3,3,,,
"Jul 14, 2022 9:00 AM",125,98,27,71,20,51,0,0,0,58,33,25,20,7,13,18,61,60,1,13,13,0,56,26,,,,65,1,5,4,1,3,,,
"Jul 14, 2022 10:00 AM",57,41,16,60,28,32,0,0,0,57,34,23,13,8,5,13,25,23,2,14,12,2,23,30,,,,39,5,5,4,2,2,,,
"Jul 14, 2022 11:00 AM",45,25,20,47,28,19,0,0,0,44,22,22,8,4,4,11,24,24,0,12,12,0,23,16,,,,28,2,1,5,3,2,,,
"Jul 14, 2022 12:00 PM",65,32,33,84,42,42,0,0,0,66,41,25,24,16,8,14,23,21,2,10,9,1,16,32,,,,27,3,4,2,0,2,,,
"Jul 14, 2022 1:00 PM",78,34,44,69,36,33,0,0,0,70,27,43,20,13,7,7,23,22,1,20,18,2,25,29,,,,30,5,0,3,3,0,,,
"Jul 14, 2022 2:00 PM",48,22,26,53,26,27,0,0,0,60,39,21,18,7,11,14,21,19,2,22,17,5,16,24,,,,29,3,7,6,5,1,,,
"Jul 14, 2022 3:00 PM",78,33,45,48,25,23,0,0,0,45,26,19,16,7,9,9,21,17,4,18,17,1,15,31,,,,28,7,0,9,7,2,,,
"Jul 14, 2022 4:00 PM",125,40,85,55,31,24,0,0,0,67,38,29,15,7,8,21,31,29,2,44,43,1,28,67,,,,48,8,6,10,6,4,,,
"Jul 14, 2022 5:00 PM",188,56,132,122,64,58,0,0,0,148,103,45,18,8,10,22,35,31,4,80,75,5,32,99,,,,62,6,7,8,4,4,,,
"Jul 14, 2022 6:00 PM",174,50,124,118,79,39,0,0,0,136,93,43,17,8,9,15,49,47,2,74,73,1,46,100,,,,64,9,10,7,4,3,,,
"Jul 14, 2022 7:00 PM",136,49,87,146,87,59,0,0,0,121,74,47,15,6,9,17,15,13,2,56,53,3,12,57,,,,41,8,7,12,8,4,,,
"Jul 14, 2022 8:00 PM",77,23,54,77,40,37,0,0,0,71,30,41,10,4,6,10,17,16,1,33,32,1,17,33,,,,39,7,2,11,7,4,,,
"Jul 14, 2022 9:00 PM",65,24,41,82,40,42,0,0,0,84,18,66,12,6,6,10,22,20,2,18,18,0,18,20,,,,27,4,2,2,2,0,,,
"Jul 14, 2022 10:00 PM",44,13,31,36,27,9,0,0,0,39,13,26,7,2,5,4,7,7,0,20,19,1,7,17,,,,24,2,2,3,2,1,,,
"Jul 14, 2022 11:00 PM",32,7,25,10,7,3,0,0,0,6,3,3,2,0,2,6,2,2,0,6,6,0,2,19,,,,8,0,4,1,0,1,,,
"Jul 15, 2022 12:00 AM",16,5,11,0,0,0,0,0,0,6,3,3,1,0,1,1,3,2,1,11,11,0,2,3,,,,2,0,0,0,0,0,,,
"Jul 15, 2022 1:00 AM",7,2,5,0,0,0,0,0,0,1,0,1,0,0,0,0,1,0,1,4,4,0,1,3,,,,3,0,1,0,0,0,,,
"Jul 15, 2022 2:00 AM",6,4,2,1,0,1,0,0,0,2,1,1,0,0,0,0,0,0,0,1,1,0,0,2,,,,1,0,0,0,0,0,,,
"Jul 15, 2022 3:00 AM",2,1,1,2,2,0,0,0,0,0,0,0,1,0,1,0,0,0,0,1,1,0,0,1,,,,1,0,0,0,0,0,,,
"Jul 15, 2022 4:00 AM",3,1,2,2,0,2,0,0,0,3,1,2,0,0,0,0,1,1,0,0,0,0,1,4,,,,2,0,0,0,0,0,,,
"Jul 15, 2022 5:00 AM",9,5,4,5,4,1,0,0,0,6,3,3,1,1,0,1,5,5,0,0,0,0,6,2,,,,10,0,0,0,0,0,,,
"Jul 15, 2022 6:00 AM",48,30,18,14,8,6,0,0,0,21,11,10,1,0,1,4,26,26,0,9,9,0,27,18,,,,24,0,2,3,2,1,,,
"Jul 15, 2022 7:00 AM",86,59,27,53,20,33,0,0,0,55,21,34,8,7,1,6,46,45,1,9,6,3,45,40,,,,77,3,2,6,3,3,,,
"Jul 15, 2022 8:00 AM",143,103,40,67,21,46,0,0,0,81,41,40,16,9,7,23,68,68,0,20,17,3,72,34,,,,97,1,5,4,3,1,,,
"Jul 15, 2022 9:00 AM",78,58,20,65,30,35,0,0,0,58,38,20,20,11,9,14,62,62,0,15,12,3,55,29,,,,49,5,3,3,0,3,,,
"Jul 15, 2022 10:00 AM",38,28,10,56,35,21,0,0,0,53,32,21,13,8,5,8,23,23,0,6,5,1,21,20,,,,24,3,4,0,0,0,,,
"Jul 15, 2022 11:00 AM",44,22,22,64,32,32,0,0,0,55,26,29,28,14,14,15,15,15,0,14,11,3,13,16,,,,28,6,2,2,1,1,,,
"Jul 15, 2022 12:00 PM",67,32,35,59,27,32,0,0,0,63,30,33,16,9,7,8,20,18,2,17,16,1,18,29,,,,29,8,1,3,3,0,,,
"Jul 15, 2022 1:00 PM",85,32,53,81,40,41,0,0,0,66,36,30,27,11,16,8,24,22,2,21,18,3,20,37,,,,25,7,2,12,8,4,,,
"Jul 15, 2022 2:00 PM",66,32,34,71,36,35,0,0,0,77,43,34,25,13,12,9,20,19,1,18,16,2,22,35,,,,32,2,2,4,2,2,,,
"Jul 15, 2022 3:00 PM",74,33,41,63,38,25,0,0,0,63,39,24,18,12,6,24,16,15,1,22,22,0,16,33,,,,35,3,2,8,5,3,,,
"Jul 15, 2022 4:00 PM",133,44,89,113,62,51,0,0,0,107,69,38,22,11,11,17,38,35,3,51,47,4,30,60,,,,48,11,5,6,2,4,,,
"Jul 15, 2022 5:00 PM",137,43,94,122,69,53,0,0,0,107,54,53,32,12,20,24,37,36,1,52,50,2,32,57,,,,55,8,2,7,3,4,,,
"Jul 15, 2022 6:00 PM",129,45,84,121,69,52,0,0,0,109,59,50,23,9,14,28,30,30,0,43,40,3,29,59,,,,43,6,4,9,5,4,,,
"Jul 15, 2022 7:00 PM",65,30,35,114,68,46,0,0,0,100,59,41,23,15,8,17,17,14,3,29,26,3,13,41,,,,45,4,3,9,4,5,,,
"Jul 15, 2022 8:00 PM",63,23,40,69,25,44,0,0,0,77,31,46,11,5,6,17,14,13,1,17,17,0,14,28,,,,30,2,1,8,4,4,,,
"Jul 15, 2022 9:00 PM",50,18,32,49,22,27,0,0,0,42,12,30,2,1,1,12,9,8,1,10,8,2,8,5,,,,22,2,1,3,1,2,,,
"Jul 15, 2022 10:00 PM",38,8,30,22,8,14,0,0,0,16,4,12,0,0,0,9,5,5,0,6,6,0,7,5,,,,8,2,2,3,2,1,,,
"Jul 15, 2022 11:00 PM",28,4,24,9,6,3,0,0,0,16,7,9,2,2,0,4,4,4,0,8,7,1,4,11,,,,8,1,4,1,1,0,,,
"Jul 16, 2022 12:00 AM",12,4,8,1,1,0,0,0,0,11,4,7,1,1,0,1,5,5,0,5,5,0,5,9,,,,8,0,1,3,3,0,,,
"Jul 16, 2022 1:00 AM",8,1,7,1,0,1,0,0,0,8,5,3,4,1,3,2,4,4,0,6,6,0,3,5,,,,6,1,0,0,0,0,,,
"Jul 16, 2022 2:00 AM",6,4,2,2,2,0,0,0,0,0,0,0,0,0,0,2,2,2,0,4,4,0,2,1,,,,3,0,0,0,0,0,,,
"Jul 16, 2022 3:00 AM",3,2,1,2,2,0,0,0,0,2,2,0,0,0,0,0,0,0,0,1,1,0,2,4,,,,4,0,0,0,0,0,,,
"Jul 16, 2022 4:00 AM",3,1,2,1,1,0,0,0,0,1,1,0,0,0,0,0,0,0,0,2,2,0,0,1,,,,0,0,0,0,0,0,,,
"Jul 16, 2022 5:00 AM",2,1,1,0,0,0,0,0,0,1,0,1,0,0,0,1,0,0,0,1,1,0,0,4,,,,1,0,0,0,0,0,,,
"Jul 16, 2022 6:00 AM",14,8,6,7,6,1,0,0,0,9,6,3,3,2,1,1,5,4,1,3,3,0,4,5,,,,7,0,2,2,1,1,,,
"Jul 16, 2022 7:00 AM",26,12,14,39,18,21,0,0,0,34,22,12,3,2,1,3,15,12,3,8,8,0,11,15,,,,20,0,1,3,2,1,,,
"Jul 16, 2022 8:00 AM",27,12,15,55,31,24,0,0,0,59,39,20,16,8,8,12,11,11,0,12,11,1,15,23,,,,26,3,2,5,4,1,,,
"Jul 16, 2022 9:00 AM",48,24,24,60,37,23,0,0,0,61,46,15,8,5,3,11,23,22,1,12,10,2,21,36,,,,19,6,3,7,5,2,,,
"Jul 16, 2022 10:00 AM",60,41,19,144,87,57,0,0,0,117,80,37,17,10,7,21,16,16,0,10,10,0,17,51,,,,24,6,2,3,2,1,,,
"Jul 16, 2022 11:00 AM",57,31,26,169,99,70,0,0,0,154,94,60,36,15,21,19,31,29,2,19,15,4,26,54,,,,47,8,8,7,4,3,,,
"Jul 16, 2022 12:00 PM",46,26,20,178,76,102,0,0,0,150,104,46,19,10,9,20,27,27,0,31,23,8,27,75,,,,39,5,4,6,5,1,,,
"Jul 16, 2022 1:00 PM",60,30,30,173,100,73,0,0,0,151,96,55,29,8,21,22,15,14,1,25,25,0,12,63,,,,55,7,13,9,6,3,,,
"Jul 16, 2022 2:00 PM",75,40,35,168,101,67,0,0,0,164,106,58,53,20,33,20,13,13,0,22,22,0,12,60,,,,53,10,5,7,5,2,,,
"Jul 16, 2022 3:00 PM",90,41,49,184,98,86,0,0,0,162,99,63,30,12,18,25,24,22,2,20,16,4,22,70,,,,73,8,2,3,3,0,,,
"Jul 16, 2022 4:00 PM",63,34,29,167,77,90,0,0,0,157,72,85,35,14,21,19,28,27,1,18,16,2,27,50,,,,86,5,7,8,6,2,,,
"Jul 16, 2022 5:00 PM",53,25,28,135,61,74,0,0,0,141,56,85,36,16,20,28,25,25,0,11,8,3,27,42,,,,81,6,2,8,5,3,,,
"Jul 16, 2022 6:00 PM",81,45,36,89,51,38,0,0,0,95,28,67,21,12,9,9,21,21,0,14,14,0,21,31,,,,62,4,4,7,3,4,,,
"Jul 16, 2022 7:00 PM",57,32,25,68,42,26,0,0,0,64,31,33,25,15,10,5,25,24,1,12,12,0,23,21,,,,44,4,3,9,4,5,,,
"Jul 16, 2022 8:00 PM",43,20,23,64,27,37,0,0,0,49,15,34,12,1,11,12,11,10,1,12,11,1,9,16,,,,19,2,7,3,1,2,,,
"Jul 16, 2022 9:00 PM",40,13,27,36,15,21,0,0,0,32,11,21,6,2,4,8,14,12,2,4,4,0,10,9,,,,38,6,0,6,6,0,,,
"Jul 16, 2022 10:00 PM",22,8,14,31,9,22,0,0,0,32,9,23,8,3,5,15,4,4,0,6,4,2,6,6,,,,20,0,2,4,3,1,,,
"Jul 16, 2022 11:00 PM",13,5,8,9,8,1,0,0,0,6,6,0,2,2,0,3,5,5,0,4,4,0,5,9,,,,6,0,2,1,1,0,,,
"Jul 17, 2022 12:00 AM",6,1,5,0,0,0,0,0,0,13,2,11,2,2,0,2,0,0,0,7,6,1,0,3,,,,13,1,2,3,3,0,,,
"Jul 17, 2022 1:00 AM",11,1,10,4,1,3,0,0,0,3,0,3,3,0,3,0,0,0,0,6,5,1,0,5,,,,7,0,1,0,0,0,,,
"Jul 17, 2022 2:00 AM",8,5,3,2,1,1,0,0,0,3,3,0,0,0,0,3,1,0,1,4,4,0,0,2,,,,4,0,1,0,0,0,,,
"Jul 17, 2022 3:00 AM",9,0,9,1,0,1,0,0,0,2,1,1,0,0,0,1,0,0,0,2,2,0,1,3,,,,0,0,0,1,0,1,,,
"Jul 17, 2022 4:00 AM",4,0,4,0,0,0,0,0,0,0,0,0,0,0,0,0,1,1,0,1,1,0,1,0,,,,0,0,0,1,1,0,,,
"Jul 17, 2022 5:00 AM",3,2,1,1,1,0,0,0,0,1,1,0,0,0,0,0,3,2,1,1,1,0,3,2,,,,2,0,0,0,0,0,,,
"Jul 17, 2022 6:00 AM",10,7,3,5,2,3,0,0,0,4,3,1,1,0,1,0,4,3,1,1,1,0,3,3,,,,3,0,2,2,2,0,,,
"Jul 17, 2022 7:00 AM",27,12,15,34,24,10,0,0,0,29,21,8,1,0,1,6,11,11,0,9,7,2,10,12,,,,12,1,1,1,1,0,,,
"Jul 17, 2022 8:00 AM",44,8,36,78,47,31,0,0,0,82,61,21,4,3,1,4,22,22,0,4,2,2,21,24,,,,39,4,6,3,2,1,,,
"Jul 17, 2022 9:00 AM",50,25,25,130,91,39,0,0,0,101,76,25,7,3,4,7,17,17,0,13,13,0,16,45,,,,37,4,11,5,4,1,,,
"Jul 17, 2022 10:00 AM",38,27,11,208,116,92,0,0,0,184,109,75,16,6,10,6,29,28,1,12,9,3,23,42,,,,24,8,3,10,4,6,,,
"Jul 17, 2022 11:00 AM",63,29,34,241,104,137,0,0,0,200,97,103,29,24,5,10,18,18,0,15,15,0,21,49,,,,74,4,11,7,5,2,,,
"Jul 17, 2022 12:00 PM",68,33,35,231,112,119,0,0,0,239,145,94,33,13,20,19,30,29,1,17,15,2,23,59,,,,54,12,5,7,4,3,,,
"Jul 17, 2022 1:00 PM",39,17,22,210,116,94,0,0,0,219,118,101,27,13,14,11,16,16,0,25,24,1,21,63,,,,56,6,7,12,8,4,,,
"Jul 17, 2022 2:00 PM",58,26,32,190,105,85,0,0,0,195,117,78,27,19,8,13,34,32,2,17,15,2,28,53,,,,59,4,9,12,7,5,,,
"Jul 17, 2022 3:00 PM",57,25,32,171,91,80,0,0,0,175,86,89,42,19,23,12,17,17,0,18,16,2,14,56,,,,65,8,0,6,3,3,,,
"Jul 17, 2022 4:00 PM",41,26,15,187,93,94,0,0,0,157,73,84,25,10,15,14,19,18,1,11,10,1,15,36,,,,55,5,10,13,9,4,,,
"Jul 17, 2022 5:00 PM",54,28,26,158,70,88,0,0,0,152,54,98,29,14,15,12,29,28,1,18,14,4,33,30,,,,81,3,2,5,4,1,,,
"Jul 17, 2022 6:00 PM",51,19,32,141,67,74,0,0,0,112,47,65,28,14,14,39,16,14,2,10,8,2,15,31,,,,56,0,1,5,4,1,,,
"Jul 17, 2022 7:00 PM",66,33,33,86,44,42,0,0,0,99,37,62,11,7,4,6,13,13,0,14,12,2,16,23,,,,52,3,6,1,1,0,,,
"Jul 17, 2022 8:00 PM",52,22,30,91,28,63,0,0,0,73,36,37,15,9,6,18,19,18,1,9,9,0,19,16,,,,48,1,2,5,4,1,,,
"Jul 17, 2022 9:00 PM",33,16,17,55,30,25,0,0,0,61,17,44,4,2,2,7,12,11,1,10,10,0,14,6,,,,38,1,4,2,1,1,,,
"Jul 17, 2022 10:00 PM",19,7,12,24,9,15,0,0,0,36,11,25,7,6,1,5,11,10,1,3,2,1,9,9,,,,19,1,1,0,0,0,,,
"Jul 17, 2022 11:00 PM",8,4,4,7,2,5,0,0,0,13,7,6,5,1,4,0,0,0,0,7,5,2,0,15,,,,3,1,1,2,1,1,,,
"Jul 18, 2022 12:00 AM",8,0,8,0,0,0,0,0,0,5,1,4,0,0,0,1,2,2,0,6,6,0,2,5,,,,6,1,1,0,0,0,,,
"Jul 18, 2022 1:00 AM",6,2,4,2,2,0,0,0,0,3,2,1,1,0,1,2,0,0,0,0,0,0,0,3,,,,3,0,0,0,0,0,,,
"Jul 18, 2022 2:00 AM",4,3,1,0,0,0,0,0,0,0,0,0,0,0,0,0,1,1,0,5,4,1,0,1,,,,1,0,0,0,0,0,,,
"Jul 18, 2022 3:00 AM",1,0,1,0,0,0,0,0,0,0,0,0,0,0,0,0,0,0,0,0,0,0,2,0,,,,1,0,0,0,0,0,,,
"Jul 18, 2022 4:00 AM",4,1,3,5,3,2,0,0,0,3,1,2,4,2,2,0,3,3,0,0,0,0,3,2,,,,1,0,0,0,0,0,,,
"Jul 18, 2022 5:00 AM",14,9,5,6,3,3,0,0,0,6,3,3,1,1,0,2,5,5,0,0,0,0,6,7,,,,12,0,2,0,0,0,,,
"Jul 18, 2022 6:00 AM",55,29,26,31,9,22,0,0,0,28,10,18,4,3,1,9,27,26,1,12,9,3,27,21,,,,38,2,3,1,1,0,,,
"Jul 18, 2022 7:00 AM",112,69,43,70,28,42,0,0,0,64,32,32,8,8,0,12,69,66,3,16,14,2,70,43,,,,88,2,2,5,3,2,,,
"Jul 18, 2022 8:00 AM",194,141,53,100,38,62,0,0,0,100,44,56,12,8,4,21,106,105,1,25,18,7,102,49,,,,155,4,1,5,4,1,,,
"Jul 18, 2022 9:00 AM",86,67,19,97,43,54,0,0,0,81,43,38,25,13,12,13,69,69,0,16,12,4,57,29,,,,51,4,4,3,2,1,,,
"Jul 18, 2022 10:00 AM",60,36,24,94,52,42,0,0,0,86,55,31,23,14,9,14,26,25,1,6,5,1,25,21,,,,28,6,4,3,2,1,,,
"Jul 18, 2022 11:00 AM",50,29,21,123,69,54,0,0,0,90,63,27,27,16,11,11,19,18,1,9,8,1,16,23,,,,23,4,6,8,5,3,,,
"Jul 18, 2022 12:00 PM",59,35,24,133,73,60,0,0,0,116,63,53,20,10,10,9,14,12,2,9,8,1,12,33,,,,31,7,3,7,3,4,,,
"Jul 18, 2022 1:00 PM",61,23,38,124,50,74,0,0,0,94,46,48,19,5,14,9,19,18,1,19,16,3,18,39,,,,28,7,5,9,5,4,,,
"Jul 18, 2022 2:00 PM",57,17,40,116,67,49,0,0,0,95,51,44,26,13,13,11,9,8,1,16,13,3,5,29,,,,38,6,4,3,2,1,,,
"Jul 18, 2022 3:00 PM",79,41,38,134,81,53,0,0,0,108,60,48,31,11,20,11,25,23,2,23,21,2,22,76,,,,40,4,8,7,5,2,,,
"Jul 18, 2022 4:00 PM",110,34,76,176,99,77,0,0,0,146,95,51,21,10,11,22,24,20,4,40,39,1,17,122,,,,72,1,2,5,1,4,,,
"Jul 18, 2022 5:00 PM",174,45,129,71,44,27,0,0,0,190,113,77,28,16,12,26,49,47,2,88,84,4,45,225,,,,94,9,6,10,6,4,,,
"Jul 18, 2022 6:00 PM",155,48,107,280,169,111,,,,222,143,79,33,15,18,12,37,33,4,75,73,2,32,173,,,,120,7,7,10,6,4,,,
"Jul 18, 2022 7:00 PM",97,36,61,190,105,85,,,,184,105,79,18,11,7,18,29,29,0,37,34,3,27,35,44,17,27,143,10,10,12,6,6,,,
"Jul 18, 2022 8:00 PM",75,21,54,183,92,91,,,,154,79,75,14,9,5,9,28,26,2,31,31,0,25,57,122,51,71,133,6,5,6,3,3,,,
"Jul 18, 2022 9:00 PM",49,22,27,119,46,73,,,,105,33,72,13,4,9,9,17,16,1,16,14,2,20,15,61,11,50,77,6,4,8,6,2,,,
"Jul 18, 2022 10:00 PM",24,8,16,34,8,26,,,,35,7,28,3,1,2,3,9,9,0,8,8,0,9,12,28,15,13,36,3,0,2,1,1,,,
"Jul 18, 2022 11:00 PM",14,1,13,14,8,6,,,,17,3,14,3,0,3,1,6,5,1,6,6,0,6,7,16,12,4,6,0,1,2,1,1,,,
"Jul 19, 2022 12:00 AM",5,1,4,0,0,0,,,,7,2,5,1,0,1,0,1,1,0,3,3,0,1,5,3,1,2,5,0,0,1,0,1,,,
"Jul 19, 2022 1:00 AM",1,0,1,4,3,1,,,,1,1,0,3,2,1,0,0,0,0,1,1,0,0,2,3,0,3,0,0,0,0,0,0,,,
"Jul 19, 2022 2:00 AM",5,3,2,0,0,0,,,,0,0,0,0,0,0,0,0,0,0,0,0,0,0,2,0,0,0,0,0,1,0,0,0,,,
"Jul 19, 2022 3:00 AM",4,1,3,0,0,0,,,,0,0,0,0,0,0,1,0,0,0,2,1,1,0,0,1,0,1,0,0,0,0,0,0,,,
"Jul 19, 2022 4:00 AM",4,2,2,1,0,1,,,,2,1,1,0,0,0,0,2,2,0,1,1,0,2,1,1,1,0,1,0,0,0,0,0,,,
"Jul 19, 2022 5:00 AM",10,5,5,5,1,4,,,,4,1,3,1,0,1,0,7,7,0,0,0,0,7,2,0,0,0,13,0,1,0,0,0,,,
"Jul 19, 2022 6:00 AM",58,38,20,26,11,15,,,,37,17,20,3,3,0,9,21,21,0,10,6,4,21,17,13,7,6,39,0,4,3,2,1,,,
"Jul 19, 2022 7:00 AM",130,86,44,80,32,48,,,,78,31,47,5,4,1,15,83,82,1,18,14,4,81,48,47,17,30,134,3,3,4,4,0,,,
"Jul 19, 2022 8:00 AM",219,160,59,113,34,79,,,,110,51,59,17,14,3,15,136,136,0,22,18,4,135,52,75,21,54,181,4,3,3,3,0,,,
"Jul 19, 2022 9:00 AM",105,84,21,112,58,54,,,,88,61,27,18,7,11,10,74,72,2,14,10,4,58,33,53,29,24,65,3,7,4,3,1,,,
"Jul 19, 2022 10:00 AM",41,27,14,105,52,53,,,,76,39,37,15,11,4,7,25,25,0,18,13,5,22,18,37,23,14,32,6,4,4,2,2,,,
"Jul 19, 2022 11:00 AM",19,13,6,94,51,43,,,,65,40,25,16,9,7,8,13,13,0,14,11,3,15,16,41,27,14,26,1,3,5,2,3,,,
"Jul 19, 2022 12:00 PM",62,36,26,91,41,50,,,,60,31,29,19,8,11,17,25,21,4,15,14,1,20,30,33,21,12,24,4,5,5,2,3,,,
"Jul 19, 2022 1:00 PM",49,21,28,58,26,32,,,,55,28,27,13,5,8,11,15,15,0,18,16,2,13,29,30,14,16,30,5,3,9,7,2,,,
"Jul 19, 2022 2:00 PM",63,36,27,54,24,30,,,,44,25,19,18,15,3,10,16,14,2,15,14,1,12,14,27,17,10,26,7,0,7,3,4,,,
"Jul 19, 2022 3:00 PM",80,35,45,84,62,22,,,,78,50,28,24,11,13,16,23,20,3,26,24,2,17,30,49,37,12,26,7,4,7,6,1,,,
"Jul 19, 2022 4:00 PM",124,32,92,85,52,33,,,,105,54,51,19,5,14,24,29,28,1,49,45,4,29,85,85,68,17,34,6,0,10,6,4,,,
"Jul 19, 2022 5:00 PM",224,55,169,179,95,84,,,,168,98,70,32,18,14,26,48,41,7,88,85,3,41,141,157,108,49,91,6,7,9,6,3,,,
"Jul 19, 2022 6:00 PM",181,59,122,199,120,79,,,,206,127,79,33,12,21,20,52,44,8,85,83,2,40,152,200,139,61,72,7,6,11,8,3,,,
"Jul 19, 2022 7:00 PM",106,31,75,166,85,81,,,,164,91,73,26,15,11,13,33,32,1,47,43,4,26,95,120,66,54,61,6,10,9,4,5,,,
"Jul 19, 2022 8:00 PM",90,30,60,107,61,46,,,,111,48,63,12,4,8,26,23,21,2,34,32,2,21,29,79,30,49,61,8,3,12,7,5,,,
"Jul 19, 2022 9:00 PM",67,20,47,46,26,20,,,,46,14,32,20,10,10,13,14,12,2,27,26,1,12,18,34,8,26,34,7,2,5,3,2,,,
"Jul 19, 2022 10:00 PM",32,11,21,21,18,3,,,,18,9,9,8,7,1,5,12,10,2,11,10,1,11,13,11,6,5,14,2,2,2,0,2,,,
"Jul 19, 2022 11:00 PM",17,3,14,2,1,1,,,,1,0,1,1,0,1,0,4,4,0,5,5,0,5,4,4,2,2,10,0,2,2,0,2,,,
"Jul 20, 2022 12:00 AM",8,1,7,0,0,0,,,,5,2,3,0,0,0,1,2,1,1,2,2,0,2,4,1,1,0,6,1,0,0,0,0,,,
"Jul 20, 2022 1:00 AM",1,0,1,0,0,0,,,,0,0,0,2,1,1,1,1,0,1,2,2,0,0,1,2,1,1,0,0,0,0,0,0,,,
"Jul 20, 2022 2:00 AM",8,6,2,0,0,0,,,,2,1,1,0,0,0,0,0,0,0,0,0,0,0,0,0,0,0,2,0,0,0,0,0,,,
"Jul 20, 2022 3:00 AM",0,0,0,0,0,0,,,,0,0,0,0,0,0,0,0,0,0,0,0,0,0,0,0,0,0,0,0,0,0,0,0,,,
"Jul 20, 2022 4:00 AM",3,3,0,2,1,1,,,,4,2,2,0,0,0,0,0,0,0,0,0,0,0,3,0,0,0,0,0,1,0,0,0,,,
"Jul 20, 2022 5:00 AM",9,5,4,5,2,3,,,,3,1,2,2,2,0,1,8,8,0,2,2,0,8,2,2,1,1,14,2,0,0,0,0,,,
"Jul 20, 2022 6:00 AM",53,29,24,27,14,13,,,,28,18,10,6,5,1,8,25,25,0,16,14,2,25,23,14,8,6,42,1,4,3,3,0,,,
"Jul 20, 2022 7:00 AM",127,81,46,75,34,41,,,,82,39,43,10,8,2,16,81,80,1,18,15,3,79,40,37,12,25,111,3,5,9,8,1,,,
"Jul 20, 2022 8:00 AM",239,182,57,98,22,76,,,,102,48,54,18,15,3,23,129,129,0,34,27,7,128,44,53,15,38,192,7,2,8,6,2,,,
"Jul 20, 2022 9:00 AM",101,79,22,73,29,44,,,,85,48,37,20,12,8,13,69,66,3,21,17,4,56,24,53,25,28,64,3,9,6,5,1,,,
"Jul 20, 2022 10:00 AM",67,51,16,42,20,22,,,,49,28,21,15,9,6,15,28,28,0,15,9,6,21,27,22,12,10,26,4,6,4,2,2,,,
"Jul 20, 2022 11:00 AM",48,29,19,56,30,26,,,,34,17,17,12,7,5,15,18,17,1,10,9,1,18,14,22,14,8,30,5,2,4,2,2,,,
"Jul 20, 2022 12:00 PM",49,18,31,55,27,28,,,,59,32,27,14,3,11,13,24,22,2,13,13,0,18,24,21,5,16,26,3,5,3,3,0,,,
"Jul 20, 2022 1:00 PM",80,40,40,43,24,19,,,,61,32,29,11,8,3,6,30,23,7,15,13,2,23,19,28,19,9,19,3,7,4,2,2,,,
"Jul 20, 2022 2:00 PM",59,28,31,61,34,27,,,,69,37,32,22,16,6,14,10,7,3,30,25,5,7,23,27,15,12,19,4,3,4,4,0,,,
"Jul 20, 2022 3:00 PM",77,32,45,59,33,26,,,,45,23,22,24,3,21,23,21,19,2,27,25,2,17,37,35,25,10,27,4,3,1,0,1,,,
"Jul 20, 2022 4:00 PM",117,31,86,75,40,35,,,,75,46,29,15,3,12,20,37,29,8,34,32,2,25,66,55,38,17,49,6,7,9,3,6,,,
"Jul 20, 2022 5:00 PM",211,53,158,87,55,32,,,,111,60,51,22,9,13,27,47,45,2,102,97,5,43,115,82,54,28,71,4,6,7,5,2,,,
"Jul 20, 2022 6:00 PM",192,63,129,87,57,30,,,,106,69,37,21,5,16,22,48,43,5,85,81,4,40,116,98,63,35,55,5,6,6,2,4,,,
"Jul 20, 2022 7:00 PM",106,36,70,104,56,48,,,,94,47,47,5,1,4,17,30,28,2,53,52,1,21,69,73,38,35,59,11,5,12,6,6,,,
"Jul 20, 2022 8:00 PM",82,25,57,66,32,34,,,,75,36,39,7,4,3,14,22,19,3,38,35,3,18,39,39,20,19,50,9,3,7,7,0,,,
"Jul 20, 2022 9:00 PM",47,18,29,28,16,12,,,,33,15,18,2,1,1,10,15,14,1,27,26,1,13,23,12,7,5,26,4,0,2,0,2,,,
"Jul 20, 2022 10:00 PM",36,8,28,25,11,14,,,,20,4,16,4,3,1,9,9,8,1,9,9,0,7,12,13,8,5,17,2,0,3,1,2,,,
"Jul 20, 2022 11:00 PM",18,6,12,2,2,0,,,,7,4,3,2,0,2,1,6,5,1,9,8,1,5,13,1,1,0,2,1,0,0,0,0,,,
"Jul 21, 2022 12:00 AM",9,2,7,0,0,0,,,,5,5,0,1,0,1,0,2,1,1,3,3,0,3,6,1,1,0,4,1,1,3,2,1,,,
"Jul 21, 2022 1:00 AM",1,1,0,1,0,1,,,,1,0,1,0,0,0,1,3,3,0,4,4,0,1,2,1,1,0,1,0,0,0,0,0,,,
"Jul 21, 2022 2:00 AM",11,6,5,0,0,0,,,,0,0,0,0,0,0,0,0,0,0,0,0,0,2,0,1,1,0,2,0,0,0,0,0,,,
"Jul 21, 2022 3:00 AM",3,1,2,0,0,0,,,,0,0,0,0,0,0,0,0,0,0,0,0,0,1,0,0,0,0,0,0,0,0,0,0,,,
"Jul 21, 2022 4:00 AM",4,1,3,4,0,4,,,,5,1,4,0,0,0,0,0,0,0,0,0,0,0,1,0,0,0,0,0,0,0,0,0,,,
"Jul 21, 2022 5:00 AM",10,6,4,5,3,2,,,,8,4,4,1,1,0,1,10,10,0,1,1,0,9,5,1,0,1,8,1,0,1,1,0,,,
"Jul 21, 2022 6:00 AM",41,28,13,24,8,16,,,,23,9,14,2,2,0,6,23,23,0,15,13,2,22,21,17,9,8,31,3,3,2,1,1,,,
"Jul 21, 2022 7:00 AM",130,82,48,61,28,33,,,,61,29,32,10,7,3,5,74,73,1,24,19,5,69,45,39,18,21,111,2,6,8,7,1,,,
"Jul 21, 2022 8:00 AM",230,177,53,84,18,66,,,,94,39,55,19,14,5,22,131,130,1,34,29,5,130,47,78,32,46,171,1,3,4,3,1,,,
"Jul 21, 2022 9:00 AM",99,79,20,98,40,58,,,,85,51,34,28,15,13,14,71,71,0,14,12,2,62,26,49,18,31,71,3,9,2,2,0,,,
"Jul 21, 2022 10:00 AM",52,39,13,53,22,31,,,,52,32,20,15,10,5,16,37,34,3,14,12,2,29,17,25,16,9,40,7,3,0,0,0,,,
"Jul 21, 2022 11:00 AM",41,25,16,65,26,39,,,,44,25,19,16,13,3,9,21,19,2,8,8,0,19,13,23,14,9,32,3,1,2,1,1,,,
"Jul 21, 2022 12:00 PM",66,35,31,52,23,29,,,,41,16,25,24,14,10,11,18,15,3,16,14,2,15,14,15,6,9,15,2,3,5,5,0,,,
"Jul 21, 2022 1:00 PM",60,30,30,59,26,33,,,,48,23,25,19,9,10,18,24,22,2,15,13,2,22,30,21,14,7,32,5,1,4,4,0,,,
"Jul 21, 2022 2:00 PM",55,25,30,49,29,20,,,,44,25,19,16,9,7,12,16,16,0,21,21,0,15,16,31,14,17,28,6,1,6,6,0,,,
"Jul 21, 2022 3:00 PM",69,27,42,64,36,28,,,,47,31,16,22,11,11,11,26,19,7,17,15,2,17,37,23,11,12,31,4,1,4,2,2,,,
"Jul 21, 2022 4:00 PM",118,35,83,82,43,39,,,,78,43,35,18,7,11,31,33,29,4,46,45,1,28,48,41,31,10,41,4,0,8,6,2,,,
"Jul 21, 2022 5:00 PM",222,57,165,136,69,67,,,,164,118,46,27,15,12,36,35,33,2,76,73,3,30,112,115,88,27,44,14,8,6,5,1,,,
"Jul 21, 2022 6:00 PM",176,58,118,103,67,36,,,,93,58,35,12,3,9,24,46,39,7,81,80,1,39,114,77,51,26,64,10,8,12,10,2,,,
"Jul 21, 2022 7:00 PM",105,38,67,82,54,28,,,,96,57,39,10,5,5,21,30,28,2,49,47,2,27,49,69,47,22,28,3,3,9,6,3,,,
"Jul 21, 2022 8:00 PM",70,23,47,70,28,42,,,,81,35,46,11,6,5,9,16,14,2,32,32,0,14,31,50,28,22,36,6,1,11,6,5,,,
"Jul 21, 2022 9:00 PM",54,17,37,51,39,12,,,,57,19,38,12,3,9,9,14,13,1,18,17,1,12,18,24,16,8,30,2,4,3,2,1,,,
"Jul 21, 2022 10:00 PM",49,12,37,31,26,5,,,,43,11,32,7,3,4,4,10,10,0,19,18,1,11,18,18,9,9,14,1,4,0,0,0,,,
"Jul 21, 2022 11:00 PM",21,4,17,19,15,4,,,,14,1,13,4,4,0,1,4,4,0,12,12,0,3,10,8,5,3,6,0,0,1,0,1,,,
"Jul 22, 2022 12:00 AM",12,1,11,0,0,0,,,,5,1,4,2,2,0,2,5,5,0,7,7,0,6,8,7,5,2,4,0,0,3,2,1,,,
"Jul 22, 2022 1:00 AM",6,0,6,1,1,0,,,,1,1,0,2,0,2,1,3,1,2,5,4,1,1,3,0,0,0,1,0,0,0,0,0,,,
"Jul 22, 2022 2:00 AM",9,5,4,2,1,1,,,,2,1,1,0,0,0,1,0,0,0,0,0,0,0,0,2,0,2,2,0,0,0,0,0,,,
"Jul 22, 2022 3:00 AM",2,0,2,1,0,1,,,,0,0,0,0,0,0,0,0,0,0,1,1,0,0,0,0,0,0,0,0,0,0,0,0,,,
"Jul 22, 2022 4:00 AM",2,1,1,3,1,2,,,,3,1,2,0,0,0,0,1,1,0,1,1,0,2,2,0,0,0,1,0,0,0,0,0,,,
"Jul 22, 2022 5:00 AM",11,9,2,6,2,4,,,,3,2,1,0,0,0,2,6,5,1,2,2,0,6,1,2,1,1,7,1,0,0,0,0,,,
"Jul 22, 2022 6:00 AM",40,24,16,14,7,7,,,,18,8,10,3,2,1,6,18,18,0,12,10,2,22,25,11,8,3,35,0,2,2,1,1,,,
"Jul 22, 2022 7:00 AM",93,63,30,67,32,35,,,,57,31,26,8,5,3,8,38,37,1,11,9,2,37,32,33,16,17,69,1,9,1,0,1,,,
"Jul 22, 2022 8:00 AM",134,93,41,89,25,64,,,,85,38,47,15,10,5,18,83,83,0,19,18,1,79,47,60,25,35,112,5,5,6,5,1,,,
"Jul 22, 2022 9:00 AM",83,66,17,78,40,38,,,,71,49,22,14,8,6,16,55,54,1,12,10,2,37,27,41,18,23,50,5,5,6,4,2,,,
"Jul 22, 2022 10:00 AM",51,32,19,72,43,29,,,,67,45,22,17,12,5,10,22,22,0,9,7,2,18,22,23,13,10,27,6,1,4,4,0,,,
"Jul 22, 2022 11:00 AM",52,30,22,60,31,29,,,,43,25,18,27,19,8,17,28,27,1,9,8,1,25,13,37,19,18,29,2,6,2,2,0,,,
"Jul 22, 2022 12:00 PM",60,31,29,89,48,41,,,,74,48,26,13,6,7,11,27,25,2,13,12,1,21,19,30,20,10,19,5,4,3,2,1,,,
"Jul 22, 2022 1:00 PM",80,44,36,90,48,42,,,,67,33,34,26,14,12,14,21,18,3,13,13,0,17,27,21,14,7,32,12,3,6,5,1,,,
"Jul 22, 2022 2:00 PM",54,43,11,58,31,27,,,,62,36,26,18,15,3,16,35,34,1,23,21,2,30,36,48,33,15,28,4,4,8,8,0,,,
"Jul 22, 2022 3:00 PM",69,29,40,82,52,30,,,,78,51,27,38,20,18,21,35,28,7,29,29,0,28,43,47,30,17,29,7,5,7,3,4,,,
"Jul 22, 2022 4:00 PM",110,43,67,110,66,44,,,,103,64,39,20,9,11,23,35,30,5,38,38,0,25,70,76,49,27,56,10,5,7,6,1,,,
"Jul 22, 2022 5:00 PM",134,38,96,141,78,63,,,,117,54,63,36,19,17,39,43,39,4,56,54,2,34,70,79,43,36,62,7,3,4,2,2,,,
"Jul 22, 2022 6:00 PM",140,51,89,114,57,57,,,,122,73,49,19,2,17,22,30,27,3,53,50,3,24,86,70,52,18,61,4,2,9,8,1,,,
"Jul 22, 2022 7:00 PM",64,21,43,90,45,45,,,,91,47,44,17,5,12,12,15,15,0,32,27,5,13,41,64,35,29,32,5,4,7,5,2,,,
"Jul 22, 2022 8:00 PM",52,22,30,72,38,34,,,,60,32,28,16,8,8,10,17,15,2,18,16,2,17,26,29,20,9,37,5,3,5,5,0,,,
"Jul 22, 2022 9:00 PM",55,16,39,45,14,31,,,,49,13,36,6,6,0,7,11,10,1,11,10,1,13,12,39,18,21,26,1,4,1,0,1,,,
"Jul 22, 2022 10:00 PM",34,13,21,13,5,8,,,,17,3,14,6,3,3,8,10,9,1,13,13,0,12,8,11,6,5,13,1,1,1,1,0,,,
"Jul 22, 2022 11:00 PM",17,2,15,14,6,8,,,,13,6,7,1,0,1,0,5,4,1,10,8,2,5,7,6,4,2,11,0,1,1,1,0,,,
"Jul 23, 2022 12:00 AM",12,4,8,2,0,2,,,,9,1,8,2,0,2,5,4,4,0,15,13,2,3,8,6,5,1,6,0,1,0,0,0,,,
"Jul 23, 2022 1:00 AM",7,1,6,5,4,1,,,,4,1,3,4,2,2,0,2,2,0,4,3,1,2,4,8,3,5,2,0,1,0,0,0,,,
"Jul 23, 2022 2:00 AM",10,6,4,2,2,0,,,,2,2,0,0,0,0,1,6,5,1,2,1,1,3,3,2,0,2,10,0,0,0,0,0,,,
"Jul 23, 2022 3:00 AM",7,0,7,0,0,0,,,,0,0,0,0,0,0,1,0,0,0,2,1,1,0,0,0,0,0,1,1,1,0,0,0,,,
"Jul 23, 2022 4:00 AM",2,0,2,0,0,0,,,,0,0,0,0,0,0,1,0,0,0,1,1,0,1,0,4,3,1,1,0,0,0,0,0,,,
"Jul 23, 2022 5:00 AM",5,2,3,2,2,0,,,,3,2,1,0,0,0,0,1,0,1,1,0,1,0,4,0,0,0,4,0,0,0,0,0,,,
"Jul 23, 2022 6:00 AM",10,4,6,2,0,2,,,,2,1,1,1,0,1,1,3,3,0,5,5,0,2,2,1,1,0,7,0,1,0,0,0,,,
"Jul 23, 2022 7:00 AM",11,5,6,6,4,2,,,,9,6,3,2,2,0,5,9,8,1,7,6,1,7,2,5,2,3,13,0,1,1,1,0,,,
"Jul 23, 2022 8:00 AM",26,11,15,21,10,11,,,,26,17,9,3,2,1,8,14,14,0,4,4,0,12,11,9,8,1,5,0,0,1,1,0,,,
"Jul 23, 2022 9:00 AM",21,11,10,45,18,27,,,,39,22,17,11,6,5,10,15,15,0,7,5,2,16,23,22,15,7,12,2,3,1,1,0,,,
"Jul 23, 2022 10:00 AM",32,20,12,71,41,30,,,,59,41,18,11,4,7,14,12,11,1,15,14,1,15,31,43,29,14,25,3,2,6,4,2,,,
"Jul 23, 2022 11:00 AM",41,20,21,70,31,39,,,,47,28,19,15,11,4,14,27,25,2,13,11,2,22,30,40,19,21,33,3,3,5,3,2,,,
"Jul 23, 2022 12:00 PM",67,38,29,105,44,61,,,,88,60,28,16,10,6,10,23,22,1,11,10,1,19,30,21,10,11,21,4,0,5,4,1,,,
"Jul 23, 2022 1:00 PM",68,32,36,75,41,34,,,,89,56,33,20,10,10,15,14,14,0,8,7,1,10,24,44,32,12,30,4,4,8,7,1,,,
"Jul 23, 2022 2:00 PM",50,25,25,84,50,34,,,,76,43,33,19,9,10,18,21,18,3,16,14,2,15,24,53,30,23,33,6,5,5,3,2,,,
"Jul 23, 2022 3:00 PM",53,35,18,88,53,35,,,,76,50,26,28,9,19,38,21,19,2,18,11,7,20,27,64,45,19,28,7,3,5,1,4,,,
"Jul 23, 2022 4:00 PM",46,30,16,94,48,46,,,,102,54,48,15,7,8,20,20,18,2,16,12,4,16,21,53,32,21,39,3,4,4,1,3,,,
"Jul 23, 2022 5:00 PM",60,24,36,94,54,40,,,,99,52,47,17,9,8,13,16,15,1,23,20,3,15,20,41,23,18,40,2,0,6,5,1,,,
"Jul 23, 2022 6:00 PM",62,26,36,78,42,36,,,,64,21,43,8,2,6,15,17,17,0,12,9,3,10,19,45,17,28,22,4,2,5,2,3,,,
"Jul 23, 2022 7:00 PM",39,24,15,32,13,19,,,,27,10,17,9,4,5,15,12,11,1,12,11,1,11,10,23,10,13,18,3,4,5,4,1,,,
"Jul 23, 2022 8:00 PM",31,19,12,44,23,21,,,,38,23,15,11,2,9,6,11,9,2,5,4,1,10,11,20,4,16,13,0,2,5,4,1,,,
"Jul 23, 2022 9:00 PM",32,11,21,18,10,8,,,,23,11,12,3,3,0,9,17,15,2,7,6,1,14,4,13,1,12,12,0,1,1,0,1,,,
"Jul 23, 2022 10:00 PM",18,5,13,29,13,16,,,,22,9,13,3,2,1,0,9,9,0,5,5,0,8,5,5,4,1,5,0,1,0,0,0,,,
"Jul 23, 2022 11:00 PM",9,5,4,10,5,5,,,,10,3,7,3,2,1,6,7,6,1,6,5,1,5,9,7,4,3,10,2,2,0,0,0,,,
"Jul 24, 2022 12:00 AM",6,0,6,2,2,0,,,,3,1,2,2,2,0,5,4,4,0,7,7,0,5,3,5,3,2,7,0,1,0,0,0,,,
"Jul 24, 2022 1:00 AM",6,3,3,1,0,1,,,,2,0,2,0,0,0,1,3,2,1,6,5,1,1,8,3,2,1,6,2,0,1,1,0,,,
"Jul 24, 2022 2:00 AM",3,1,2,1,1,0,,,,1,1,0,0,0,0,1,3,2,1,2,2,0,2,2,0,0,0,2,0,0,0,0,0,,,
"Jul 24, 2022 3:00 AM",1,1,0,0,0,0,,,,0,0,0,0,0,0,0,0,0,0,0,0,0,1,4,1,1,0,3,0,0,0,0,0,,,
"Jul 24, 2022 4:00 AM",3,0,3,0,0,0,,,,1,1,0,2,0,2,0,0,0,0,0,0,0,0,3,3,3,0,1,0,0,0,0,0,,,
"Jul 24, 2022 5:00 AM",2,0,2,3,0,3,,,,1,1,0,2,1,1,0,2,1,1,1,0,1,2,0,5,5,0,2,0,1,0,0,0,,,
"Jul 24, 2022 6:00 AM",10,3,7,6,3,3,,,,13,7,6,3,3,0,0,1,1,0,4,3,1,1,7,7,2,5,11,0,1,0,0,0,,,
"Jul 24, 2022 7:00 AM",23,13,10,25,17,8,,,,31,18,13,1,1,0,5,10,8,2,11,9,2,11,7,17,15,2,23,0,0,0,0,0,,,
"Jul 24, 2022 8:00 AM",33,7,26,69,39,30,,,,58,38,20,5,2,3,5,16,15,1,9,7,2,14,22,28,21,7,23,2,7,2,0,2,,,
"Jul 24, 2022 9:00 AM",40,15,25,126,75,51,,,,125,78,47,9,5,4,6,29,28,1,12,11,1,25,33,69,52,17,39,4,7,5,4,1,,,
"Jul 24, 2022 10:00 AM",46,23,23,192,91,101,,,,171,101,70,15,6,9,13,16,14,2,9,8,1,15,48,91,67,24,62,4,5,10,8,2,,,
"Jul 24, 2022 11:00 AM",67,34,33,216,122,94,,,,161,99,62,31,17,14,11,23,21,2,21,18,3,19,57,135,82,53,42,1,11,8,6,2,,,
"Jul 24, 2022 12:00 PM",64,34,30,247,111,136,,,,217,108,109,23,8,15,19,29,27,2,26,23,3,26,48,103,39,64,66,5,5,4,2,2,,,
"Jul 24, 2022 1:00 PM",69,28,41,166,108,58,,,,161,102,59,12,3,9,21,31,28,3,27,25,2,22,50,83,46,37,60,5,17,5,5,0,,,
"Jul 24, 2022 2:00 PM",56,32,24,137,81,56,,,,134,82,52,44,14,30,9,17,16,1,17,12,5,18,27,65,31,34,36,4,8,6,4,2,,,
"Jul 24, 2022 3:00 PM",48,26,22,116,51,65,,,,114,45,69,21,8,13,14,16,16,0,15,13,2,15,36,71,46,25,30,3,6,6,4,2,,,
"Jul 24, 2022 4:00 PM",50,25,25,96,50,46,,,,104,51,53,15,9,6,13,18,15,3,12,11,1,12,28,72,42,30,33,13,5,11,7,4,,,
"Jul 24, 2022 5:00 PM",59,20,39,98,37,61,,,,107,24,83,24,13,11,13,23,23,0,12,12,0,25,14,49,11,38,37,13,5,4,3,1,,,
"Jul 24, 2022 6:00 PM",58,26,32,76,36,40,,,,76,32,44,17,15,2,8,29,24,5,15,14,1,20,18,41,18,23,43,20,2,15,11,4,,,
"Jul 24, 2022 7:00 PM",56,19,37,59,17,42,,,,53,15,38,10,1,9,16,15,14,1,12,10,2,18,10,36,15,21,38,6,4,2,1,1,,,
"Jul 24, 2022 8:00 PM",34,22,12,50,25,25,,,,54,30,24,6,2,4,9,13,11,2,4,2,2,10,22,33,13,20,32,1,1,3,2,1,,,
"Jul 24, 2022 9:00 PM",33,11,22,44,20,24,,,,43,15,28,9,7,2,7,14,13,1,9,9,0,12,6,13,2,11,19,1,5,9,3,6,,,
"Jul 24, 2022 10:00 PM",17,8,9,10,6,4,,,,11,4,7,3,2,1,8,8,8,0,8,5,3,7,7,5,3,2,10,0,1,2,2,0,,,
"Jul 24, 2022 11:00 PM",8,2,6,7,3,4,,,,9,2,7,1,1,0,3,5,5,0,7,6,1,4,6,5,4,1,7,0,1,0,0,0,,,
"Jul 25, 2022 12:00 AM",5,2,3,0,0,0,,,,2,1,1,1,1,0,0,2,2,0,3,3,0,1,6,0,0,0,5,0,0,0,0,0,,,
"Jul 25, 2022 1:00 AM",4,1,3,1,0,1,,,,1,0,1,1,0,1,0,0,0,0,4,4,0,1,2,1,1,0,0,0,0,0,0,0,,,
"Jul 25, 2022 2:00 AM",2,0,2,3,0,3,,,,1,0,1,0,0,0,0,0,0,0,1,1,0,0,0,2,1,1,2,0,0,0,0,0,,,
"Jul 25, 2022 3:00 AM",1,0,1,0,0,0,,,,0,0,0,0,0,0,0,0,0,0,0,0,0,0,0,0,0,0,0,0,0,0,0,0,,,
"Jul 25, 2022 4:00 AM",1,1,0,2,0,2,,,,5,3,2,0,0,0,0,0,0,0,0,0,0,0,2,2,0,2,0,0,0,0,0,0,,,
"Jul 25, 2022 5:00 AM",7,5,2,0,0,0,,,,3,2,1,0,0,0,1,5,5,0,2,2,0,5,1,0,0,0,15,0,0,0,0,0,,,
"Jul 25, 2022 6:00 AM",45,26,19,15,4,11,,,,18,9,9,0,0,0,6,19,19,0,12,7,5,21,13,8,4,4,30,2,6,5,5,0,,,
"Jul 25, 2022 7:00 AM",95,62,33,37,17,20,,,,45,22,23,11,8,3,6,62,61,1,13,10,3,60,32,23,9,14,91,3,2,4,4,0,,,
"Jul 25, 2022 8:00 AM",189,135,54,66,20,46,,,,63,26,37,14,8,6,17,90,89,1,31,24,7,92,48,49,21,28,134,6,2,2,1,1,,,
"Jul 25, 2022 9:00 AM",89,68,21,56,15,41,,,,65,37,28,23,12,11,10,65,64,1,21,16,5,50,26,39,21,18,59,5,3,2,1,1,,,
"Jul 25, 2022 10:00 AM",55,40,15,27,17,10,,,,26,18,8,11,8,3,6,24,24,0,10,8,2,19,19,21,14,7,24,2,2,2,2,0,,,
"Jul 25, 2022 11:00 AM",40,24,16,44,24,20,,,,31,24,7,18,9,9,14,14,14,0,7,5,2,11,13,28,16,12,13,7,2,10,8,2,,,
"Jul 25, 2022 12:00 PM",67,32,35,26,10,16,,,,33,10,23,17,8,9,9,16,15,1,3,3,0,13,19,23,10,13,13,5,2,5,4,1,,,
"Jul 25, 2022 1:00 PM",64,28,36,42,26,16,,,,29,14,15,22,14,8,15,20,15,5,15,14,1,13,17,24,15,9,29,3,2,2,2,0,,,
"Jul 25, 2022 2:00 PM",69,37,32,33,19,14,,,,36,17,19,8,4,4,16,17,16,1,13,13,0,14,9,18,14,4,21,3,3,4,1,3,,,
"Jul 25, 2022 3:00 PM",68,24,44,33,23,10,,,,49,36,13,18,11,7,14,13,13,0,17,16,1,15,19,25,10,15,20,3,4,0,0,0,,,
"Jul 25, 2022 4:00 PM",103,36,67,67,35,32,,,,66,31,35,27,12,15,16,29,21,8,33,32,1,19,56,37,23,14,36,4,3,1,1,0,,,
"Jul 25, 2022 5:00 PM",185,46,139,84,50,34,,,,88,43,45,30,13,17,20,36,32,4,74,72,2,27,92,52,34,18,66,5,7,4,3,1,,,
"Jul 25, 2022 6:00 PM",155,63,92,82,55,27,,,,97,63,34,20,7,13,21,36,30,6,80,79,1,28,111,61,46,15,43,4,3,5,4,1,,,
"Jul 25, 2022 7:00 PM",88,42,46,48,26,22,,,,56,27,29,12,8,4,17,25,23,2,41,37,4,17,35,45,30,15,36,8,3,8,6,2,,,
"Jul 25, 2022 8:00 PM",53,19,34,44,25,19,,,,58,30,28,9,3,6,9,17,11,6,24,23,1,10,32,21,10,11,32,3,4,3,1,2,,,
"Jul 25, 2022 9:00 PM",51,11,40,20,6,14,,,,23,9,14,12,8,4,6,7,6,1,18,18,0,8,16,14,8,6,20,5,1,3,3,0,,,
"Jul 25, 2022 10:00 PM",30,6,24,4,3,1,,,,7,4,3,1,0,1,5,5,4,1,6,5,1,2,11,3,3,0,9,1,3,1,1,0,,,
"Jul 25, 2022 11:00 PM",11,3,8,5,2,3,,,,5,1,4,4,2,2,3,4,4,0,4,4,0,4,4,1,1,0,3,0,1,1,1,0,,,
"Jul 26, 2022 12:00 AM",9,1,8,0,0,0,,,,4,2,2,0,0,0,0,2,2,0,3,3,0,2,2,0,0,0,6,1,1,1,1,0,,,
"Jul 26, 2022 1:00 AM",1,0,1,1,1,0,,,,0,0,0,0,0,0,0,0,0,0,1,1,0,0,0,0,0,0,0,0,0,0,0,0,,,
"Jul 26, 2022 2:00 AM",4,4,0,0,0,0,,,,1,0,1,0,0,0,0,2,2,0,2,2,0,2,0,0,0,0,0,0,0,0,0,0,,,
"Jul 26, 2022 3:00 AM",2,1,1,0,0,0,,,,0,0,0,0,0,0,0,0,0,0,0,0,0,1,1,0,0,0,2,0,0,0,0,0,,,
"Jul 26, 2022 4:00 AM",2,2,0,1,0,1,,,,2,1,1,0,0,0,5,1,1,0,2,2,0,1,0,1,0,1,1,0,1,0,0,0,,,
"Jul 26, 2022 5:00 AM",7,4,3,1,1,0,,,,2,0,2,0,0,0,2,6,6,0,2,2,0,6,3,0,0,0,10,1,2,0,0,0,,,
"Jul 26, 2022 6:00 AM",57,37,20,22,8,14,,,,28,15,13,4,3,1,8,25,25,0,15,11,4,24,13,8,4,4,43,1,4,3,2,1,,,
"Jul 26, 2022 7:00 AM",124,85,39,54,17,37,,,,58,27,31,10,5,5,10,93,92,1,13,10,3,83,37,31,5,26,122,4,3,3,2,1,,,
"Jul 26, 2022 8:00 AM",241,175,66,78,19,59,,,,86,40,46,14,12,2,17,131,131,0,35,24,11,127,57,66,23,43,187,3,5,9,7,2,,,
"Jul 26, 2022 9:00 AM",126,96,30,52,24,28,,,,61,37,24,30,15,15,5,76,76,0,23,20,3,58,31,44,22,22,78,3,7,3,2,1,,,
"Jul 26, 2022 10:00 AM",54,43,11,51,24,27,,,,37,23,14,17,11,6,9,23,22,1,14,11,3,22,20,28,15,13,29,5,5,4,3,1,,,
"Jul 26, 2022 11:00 AM",39,24,15,52,20,32,,,,50,19,31,9,5,4,14,36,34,2,15,10,5,30,16,27,14,13,33,2,4,1,0,1,,,
"Jul 26, 2022 12:00 PM",50,21,29,44,21,23,,,,39,20,19,17,9,8,18,18,15,3,19,17,2,14,20,32,19,13,33,10,3,7,6,1,,,
"Jul 26, 2022 1:00 PM",69,31,38,76,40,36,,,,48,27,21,27,15,12,14,25,23,2,22,20,2,21,18,40,22,18,30,6,2,10,7,3,,,
"Jul 26, 2022 2:00 PM",75,40,35,58,32,26,,,,47,27,20,21,14,7,18,16,16,0,22,20,2,15,26,27,21,6,24,10,5,10,7,3,,,
"Jul 26, 2022 3:00 PM",80,31,49,56,22,34,,,,51,26,25,29,12,17,25,23,19,4,25,21,4,18,33,31,19,12,32,2,3,8,7,1,,,
"Jul 26, 2022 4:00 PM",126,46,80,58,39,19,,,,73,33,40,26,10,16,19,34,31,3,34,31,3,28,49,44,31,13,44,9,5,5,3,2,,,
"Jul 26, 2022 5:00 PM",241,62,179,105,55,50,,,,109,71,38,33,18,15,19,46,39,7,98,97,1,31,113,83,53,30,64,9,8,9,6,3,,,
"Jul 26, 2022 6:00 PM",205,67,138,114,73,41,,,,113,83,30,18,10,8,26,52,44,8,92,88,4,45,123,83,66,17,50,9,8,16,9,7,,,
"Jul 26, 2022 7:00 PM",111,36,75,115,64,51,,,,108,60,48,10,3,7,31,23,22,1,62,59,3,21,47,69,45,24,29,4,2,5,5,0,,,
"Jul 26, 2022 8:00 PM",75,17,58,75,39,36,,,,84,34,50,6,4,2,10,22,20,2,31,29,2,17,41,48,23,25,31,7,4,3,2,1,,,
"Jul 26, 2022 9:00 PM",46,13,33,66,35,31,,,,56,23,33,15,6,9,26,10,7,3,23,22,1,7,16,27,18,9,22,7,0,3,2,1,,,
"Jul 26, 2022 10:00 PM",37,10,27,26,14,12,,,,23,8,15,5,0,5,10,3,3,0,12,11,1,3,11,13,6,7,18,3,1,1,1,0,,,
"Jul 26, 2022 11:00 PM",8,2,6,6,5,1,,,,11,2,9,1,0,1,1,4,4,0,8,8,0,4,5,2,2,0,4,1,1,1,1,0,,,
"Jul 27, 2022 12:00 AM",5,1,4,1,0,1,,,,4,0,4,0,0,0,1,7,5,2,6,6,0,5,4,2,2,0,3,0,1,0,0,0,,,
"Jul 27, 2022 1:00 AM",3,1,2,1,1,0,,,,1,1,0,0,0,0,1,1,0,1,4,4,0,0,3,1,1,0,3,0,0,0,0,0,,,
"Jul 27, 2022 2:00 AM",5,3,2,1,1,0,,,,1,0,1,0,0,0,0,0,0,0,2,2,0,0,1,2,1,1,0,0,0,1,0,1,,,
"Jul 27, 2022 3:00 AM",0,0,0,1,1,0,,,,0,0,0,0,0,0,0,0,0,0,0,0,0,0,1,0,0,0,0,0,0,0,0,0,,,
"Jul 27, 2022 4:00 AM",2,1,1,3,0,3,,,,3,1,2,0,0,0,0,1,1,0,0,0,0,1,1,1,0,1,3,0,0,0,0,0,,,
"Jul 27, 2022 5:00 AM",11,8,3,5,2,3,,,,5,3,2,1,1,0,1,9,9,0,0,0,0,8,2,1,0,1,12,0,0,1,1,0,,,
"Jul 27, 2022 6:00 AM",48,28,20,22,11,11,,,,24,11,13,3,2,1,5,24,24,0,12,10,2,20,21,7,3,4,40,2,4,1,1,0,,,
"Jul 27, 2022 7:00 AM",124,78,46,68,28,40,,,,66,30,36,8,8,0,11,76,75,1,14,10,4,66,44,35,11,24,116,1,3,6,6,0,,,
"Jul 27, 2022 8:00 AM",231,177,54,77,18,59,,,,85,32,53,18,13,5,17,146,143,3,32,27,5,143,49,55,20,35,186,4,5,6,5,1,,,
"Jul 27, 2022 9:00 AM",123,89,34,71,26,45,,,,77,47,30,25,8,17,14,68,68,0,19,15,4,53,31,67,41,26,64,4,5,5,4,1,,,
"Jul 27, 2022 10:00 AM",61,40,21,58,30,28,,,,60,36,24,13,10,3,16,31,29,2,13,11,2,26,23,36,19,17,34,3,2,5,3,2,,,
"Jul 27, 2022 11:00 AM",31,18,13,70,38,32,,,,69,40,29,20,12,8,12,10,10,0,8,6,2,12,23,31,14,17,22,4,8,3,0,3,,,
"Jul 27, 2022 12:00 PM",48,17,31,84,42,42,,,,73,38,35,21,13,8,22,23,19,4,8,7,1,19,24,48,25,23,30,6,3,8,6,2,,,
"Jul 27, 2022 1:00 PM",82,28,54,77,30,47,,,,57,21,36,22,13,9,16,18,17,1,18,16,2,17,25,45,23,22,39,5,5,6,6,0,,,
"Jul 27, 2022 2:00 PM",68,30,38,57,35,22,,,,64,31,33,28,19,9,19,28,26,2,18,16,2,24,20,31,18,13,21,8,2,7,6,1,,,
"Jul 27, 2022 3:00 PM",82,40,42,55,30,25,,,,49,28,21,23,8,15,23,15,13,2,23,19,4,10,32,29,16,13,24,7,4,9,6,3,,,
"Jul 27, 2022 4:00 PM",110,39,71,61,42,19,,,,87,41,46,26,9,17,14,25,21,4,45,43,2,20,42,43,27,16,61,5,1,8,6,2,,,
"Jul 27, 2022 5:00 PM",230,66,164,88,52,36,,,,91,52,39,36,16,20,27,44,39,5,66,65,1,39,110,64,42,22,52,10,3,6,3,3,,,
"Jul 27, 2022 6:00 PM",188,58,130,93,61,32,,,,122,80,42,28,14,14,17,37,35,2,76,76,0,34,107,77,60,17,42,4,13,3,2,1,,,
"Jul 27, 2022 7:00 PM",93,32,61,91,56,35,,,,75,47,28,17,8,9,18,20,16,4,48,47,1,19,57,54,41,13,32,6,9,10,6,4,,,
"Jul 27, 2022 8:00 PM",78,26,52,69,31,38,,,,89,34,55,7,3,4,10,16,14,2,43,37,6,15,47,37,23,14,30,8,6,4,4,0,,,
"Jul 27, 2022 9:00 PM",49,16,33,40,22,18,,,,40,14,26,8,2,6,13,15,14,1,19,18,1,13,17,26,13,13,30,8,0,6,4,2,,,
"Jul 27, 2022 10:00 PM",38,12,26,20,12,8,,,,30,14,16,4,1,3,5,8,6,2,20,20,0,6,12,12,8,4,15,2,0,3,2,1,,,
"Jul 27, 2022 11:00 PM",18,5,13,3,2,1,,,,11,5,6,7,4,3,2,2,2,0,7,7,0,1,9,3,1,2,5,1,0,4,4,0,,,
"Jul 28, 2022 12:00 AM",10,1,9,0,0,0,,,,5,0,5,3,3,0,1,0,0,0,3,3,0,0,4,0,0,0,0,1,1,0,0,0,,,
"Jul 28, 2022 1:00 AM",5,1,4,0,0,0,,,,0,0,0,1,0,1,1,0,0,0,4,4,0,0,2,0,0,0,2,0,0,0,0,0,,,
"Jul 28, 2022 2:00 AM",6,4,2,1,0,1,,,,1,0,1,0,0,0,0,1,1,0,0,0,0,1,1,1,0,1,0,0,0,0,0,0,,,
"Jul 28, 2022 3:00 AM",0,0,0,0,0,0,,,,0,0,0,1,1,0,0,0,0,0,0,0,0,1,1,0,0,0,0,0,0,0,0,0,,,
"Jul 28, 2022 4:00 AM",2,1,1,2,0,2,,,,3,1,2,2,1,1,0,0,0,0,0,0,0,0,1,2,0,2,2,0,0,0,0,0,,,
"Jul 28, 2022 5:00 AM",8,5,3,2,0,2,,,,1,1,0,1,1,0,0,7,7,0,2,2,0,7,2,0,0,0,12,0,0,0,0,0,,,
"Jul 28, 2022 6:00 AM",47,29,18,25,13,12,,,,23,11,12,0,0,0,8,21,21,0,9,6,3,23,20,8,4,4,32,2,4,3,3,0,,,
"Jul 28, 2022 7:00 AM",122,82,40,38,13,25,,,,58,25,33,5,5,0,12,65,65,0,10,8,2,64,35,34,11,23,100,3,5,5,3,2,,,
"Jul 28, 2022 8:00 AM",205,153,52,78,24,54,,,,79,29,50,24,18,6,15,120,119,1,35,27,8,124,41,68,32,36,141,8,2,8,4,4,,,
"Jul 28, 2022 9:00 AM",120,82,38,61,24,37,,,,60,35,25,17,11,6,21,71,70,1,20,15,5,59,16,44,23,21,54,3,5,2,2,0,,,
"Jul 28, 2022 10:00 AM",53,43,10,40,17,23,,,,52,32,20,15,10,5,19,37,35,2,14,12,2,31,19,28,15,13,37,0,5,4,4,0,,,
"Jul 28, 2022 11:00 AM",42,29,13,54,27,27,,,,41,23,18,29,17,12,17,18,17,1,7,7,0,14,14,16,12,4,21,1,4,4,3,1,,,
"Jul 28, 2022 12:00 PM",47,19,28,55,28,27,,,,46,22,24,25,9,16,9,22,20,2,11,8,3,15,23,36,23,13,20,4,0,3,3,0,,,
"Jul 28, 2022 1:00 PM",73,38,35,75,43,32,,,,63,42,21,34,14,20,9,20,19,1,17,16,1,19,19,43,21,22,28,5,1,5,5,0,,,
"Jul 28, 2022 2:00 PM",58,28,30,61,29,32,,,,54,32,22,28,14,14,23,13,12,1,18,17,1,11,15,39,24,15,30,3,5,7,6,1,,,
"Jul 28, 2022 3:00 PM",85,30,55,68,32,36,,,,51,25,26,26,12,14,12,21,19,2,21,19,2,13,34,33,18,15,28,3,2,6,2,4,,,
"Jul 28, 2022 4:00 PM",112,30,82,92,57,35,,,,100,66,34,26,14,12,13,33,30,3,39,38,1,29,46,47,32,15,44,2,4,5,4,1,,,
"Jul 28, 2022 5:00 PM",183,49,134,131,50,81,,,,139,90,49,22,12,10,18,39,34,5,93,87,6,30,95,68,42,26,57,8,4,10,6,4,,,
"Jul 28, 2022 6:00 PM",149,48,101,78,55,23,,,,95,67,28,28,9,19,23,34,26,8,82,80,2,26,83,67,51,16,48,6,6,7,5,2,,,
"Jul 28, 2022 7:00 PM",98,32,66,66,52,14,,,,66,39,27,10,2,8,33,22,19,3,39,39,0,21,57,40,31,9,33,8,3,8,4,4,,,
"Jul 28, 2022 8:00 PM",71,21,50,72,30,42,,,,68,33,35,3,1,2,9,16,16,0,24,22,2,12,35,33,15,18,26,6,2,2,0,2,,,
"Jul 28, 2022 9:00 PM",43,12,31,52,36,16,,,,63,20,43,6,3,3,9,10,8,2,19,18,1,11,25,24,15,9,27,1,5,3,2,1,,,
"Jul 28, 2022 10:00 PM",32,9,23,31,25,6,,,,35,9,26,11,5,6,4,4,4,0,18,17,1,4,20,19,11,8,18,3,2,2,0,2,,,
"Jul 28, 2022 11:00 PM",20,6,14,13,10,3,,,,14,5,9,8,3,5,2,4,3,1,7,7,0,4,12,3,3,0,7,0,3,2,2,0,,,
"Jul 29, 2022 12:00 AM",9,1,8,0,0,0,,,,3,1,2,3,3,0,2,1,1,0,3,3,0,1,7,2,0,2,5,0,0,1,1,0,,,
"Jul 29, 2022 1:00 AM",9,1,8,3,2,1,,,,3,0,3,1,0,1,0,0,0,0,3,3,0,0,2,1,1,0,7,0,0,2,2,0,,,
"Jul 29, 2022 2:00 AM",5,4,1,1,0,1,,,,1,0,1,0,0,0,1,1,1,0,4,2,2,1,0,2,2,0,0,0,0,0,0,0,,,
"Jul 29, 2022 3:00 AM",1,1,0,4,4,0,,,,3,3,0,0,0,0,1,0,0,0,1,1,0,0,1,0,0,0,1,0,0,0,0,0,,,
"Jul 29, 2022 4:00 AM",3,1,2,5,1,4,,,,5,2,3,0,0,0,0,0,0,0,0,0,0,0,1,1,0,1,2,0,1,2,2,0,,,
"Jul 29, 2022 5:00 AM",8,6,2,2,2,0,,,,5,3,2,0,0,0,1,4,4,0,1,1,0,4,4,2,1,1,16,0,0,1,1,0,,,
"Jul 29, 2022 6:00 AM",36,23,13,23,11,12,,,,34,21,13,3,2,1,6,13,13,0,9,6,3,12,16,12,6,6,36,0,2,2,2,0,,,
"Jul 29, 2022 7:00 AM",98,60,38,79,28,51,,,,58,29,29,7,6,1,10,38,38,0,10,8,2,34,30,26,5,21,52,0,4,3,2,1,,,
"Jul 29, 2022 8:00 AM",116,83,33,59,19,40,,,,64,30,34,8,4,4,20,83,81,2,21,16,5,74,43,37,16,21,90,5,2,5,4,1,,,
"Jul 29, 2022 9:00 AM",74,57,17,54,29,25,,,,62,42,20,20,9,11,9,43,42,1,15,14,1,39,22,24,12,12,46,4,5,3,3,0,,,
"Jul 29, 2022 10:00 AM",46,32,14,59,26,33,,,,48,26,22,18,13,5,13,28,28,0,9,9,0,24,17,17,6,11,38,4,2,2,2,0,,,
"Jul 29, 2022 11:00 AM",38,19,19,62,31,31,,,,52,25,27,12,6,6,20,14,12,2,16,15,1,13,15,31,18,13,21,0,2,3,3,0,,,
"Jul 29, 2022 12:00 PM",70,37,33,76,37,39,,,,85,47,38,19,12,7,17,17,17,0,17,14,3,16,26,45,26,19,40,8,5,6,4,2,,,
"Jul 29, 2022 1:00 PM",80,33,47,64,32,32,,,,65,38,27,21,13,8,20,30,29,1,19,15,4,27,23,45,29,16,28,8,3,6,3,3,,,
"Jul 29, 2022 2:00 PM",71,47,24,58,26,32,,,,55,28,27,19,12,7,18,18,17,1,18,17,1,18,20,41,19,22,28,6,7,6,3,3,,,
"Jul 29, 2022 3:00 PM",103,40,63,74,44,30,,,,69,43,26,17,5,12,18,16,14,2,23,22,1,14,35,27,18,9,28,6,1,1,1,0,,,
"Jul 29, 2022 4:00 PM",77,28,49,85,40,45,,,,57,29,28,28,15,13,19,27,24,3,25,24,1,23,49,49,33,16,32,4,4,5,2,3,,,
"Jul 29, 2022 5:00 PM",136,41,95,109,64,45,,,,123,64,59,28,12,16,24,30,28,2,59,54,5,26,59,61,30,31,50,6,5,9,6,3,,,
"Jul 29, 2022 6:00 PM",97,42,55,76,41,35,,,,80,43,37,10,4,6,14,26,23,3,39,37,2,23,47,42,29,13,41,11,2,4,2,2,,,
"Jul 29, 2022 7:00 PM",80,30,50,59,35,24,,,,60,30,30,17,5,12,10,23,20,3,29,27,2,21,31,21,17,4,26,2,1,7,5,2,,,
"Jul 29, 2022 8:00 PM",59,21,38,41,24,17,,,,35,16,19,3,0,3,5,11,9,2,19,16,3,10,30,14,6,8,15,4,0,10,6,4,,,
"Jul 29, 2022 9:00 PM",38,11,27,20,13,7,,,,16,6,10,6,4,2,8,11,10,1,12,12,0,9,10,11,9,2,10,2,2,3,2,1,,,
"Jul 29, 2022 10:00 PM",22,5,17,10,3,7,,,,10,4,6,0,0,0,11,7,6,1,7,6,1,5,3,5,4,1,4,2,4,0,0,0,,,
"Jul 29, 2022 11:00 PM",18,4,14,4,4,0,,,,11,5,6,1,1,0,1,2,2,0,12,11,1,1,12,1,1,0,4,0,1,0,0,0,,,
"Jul 30, 2022 12:00 AM",8,1,7,0,0,0,,,,7,1,6,0,0,0,3,2,2,0,7,7,0,2,6,3,2,1,3,0,0,0,0,0,,,
"Jul 30, 2022 1:00 AM",13,4,9,4,2,2,,,,3,2,1,2,2,0,2,0,0,0,5,5,0,0,3,1,1,0,6,0,0,1,1,0,,,
"Jul 30, 2022 2:00 AM",7,3,4,2,0,2,,,,3,0,3,1,0,1,0,2,2,0,1,1,0,2,2,1,0,1,2,0,2,0,0,0,,,
"Jul 30, 2022 3:00 AM",1,0,1,0,0,0,,,,1,0,1,1,0,1,0,0,0,0,4,4,0,1,3,0,0,0,4,0,0,0,0,0,,,
"Jul 30, 2022 4:00 AM",1,0,1,3,2,1,,,,3,2,1,2,2,0,0,0,0,0,1,1,0,0,1,3,2,1,2,0,0,0,0,0,,,
"Jul 30, 2022 5:00 AM",7,2,5,2,2,0,,,,3,2,1,0,0,0,0,0,0,0,1,1,0,0,1,0,0,0,1,0,0,0,0,0,,,
"Jul 30, 2022 6:00 AM",10,7,3,3,3,0,,,,5,5,0,0,0,0,2,1,1,0,2,2,0,1,4,3,3,0,11,0,1,4,4,0,,,
"Jul 30, 2022 7:00 AM",20,10,10,20,10,10,,,,15,8,7,1,0,1,1,4,4,0,2,1,1,3,9,9,7,2,21,0,2,0,0,0,,,
"Jul 30, 2022 8:00 AM",32,20,12,31,22,9,,,,26,20,6,2,1,1,8,14,14,0,9,8,1,14,13,6,2,4,10,0,3,2,1,1,,,
"Jul 30, 2022 9:00 AM",24,11,13,21,8,13,,,,23,13,10,5,5,0,5,13,13,0,3,3,0,13,10,10,7,3,16,4,0,3,3,0,,,
"Jul 30, 2022 10:00 AM",34,18,16,28,16,12,,,,23,15,8,5,1,4,9,5,4,1,9,7,2,3,16,6,4,2,8,3,4,3,2,1,,,
"Jul 30, 2022 11:00 AM",19,12,7,49,19,30,,,,33,21,12,3,3,0,9,13,12,1,12,11,1,14,12,18,12,6,14,0,1,4,2,2,,,
"Jul 30, 2022 12:00 PM",52,25,27,67,25,42,,,,61,37,24,14,8,6,7,16,16,0,11,9,2,15,21,28,21,7,23,3,3,9,5,4,,,
"Jul 30, 2022 1:00 PM",52,27,25,69,36,33,,,,61,39,22,12,3,9,15,15,15,0,11,10,1,15,23,25,12,13,33,5,3,9,5,4,,,
"Jul 30, 2022 2:00 PM",53,28,25,76,44,32,,,,72,47,25,33,23,10,24,15,15,0,13,10,3,11,21,37,24,13,18,5,1,3,3,0,,,
"Jul 30, 2022 3:00 PM",49,24,25,78,37,41,,,,72,39,33,14,12,2,21,19,18,1,11,11,0,15,22,61,36,25,30,6,4,2,0,2,,,
"Jul 30, 2022 4:00 PM",43,23,20,84,46,38,,,,83,43,40,26,9,17,11,15,14,1,12,11,1,15,23,44,20,24,25,4,3,5,4,1,,,
"Jul 30, 2022 5:00 PM",46,15,31,58,25,33,,,,53,16,37,26,11,15,8,8,8,0,13,11,2,8,8,28,11,17,19,3,2,7,4,3,,,
"Jul 30, 2022 6:00 PM",34,16,18,28,9,19,,,,24,6,18,7,3,4,8,4,4,0,6,5,1,4,8,12,3,9,14,4,2,7,4,3,,,
"Jul 30, 2022 7:00 PM",22,12,10,12,8,4,,,,12,6,6,6,4,2,6,8,7,1,3,3,0,7,3,7,2,5,10,1,1,1,0,1,,,
"Jul 30, 2022 8:00 PM",13,9,4,10,6,4,,,,10,3,7,7,5,2,5,3,3,0,4,4,0,2,5,4,2,2,4,0,0,1,1,0,,,
"Jul 30, 2022 9:00 PM",8,0,8,11,7,4,,,,3,1,2,1,1,0,0,3,3,0,1,1,0,4,0,2,1,1,5,1,0,0,0,0,,,
"Jul 30, 2022 10:00 PM",15,6,9,6,5,1,,,,6,3,3,3,0,3,0,4,4,0,1,1,0,4,3,1,1,0,3,0,1,2,1,1,,,
"Jul 30, 2022 11:00 PM",8,1,7,2,2,0,,,,4,1,3,0,0,0,3,2,2,0,4,4,0,1,4,1,1,0,5,0,0,0,0,0,,,
"Jul 31, 2022 12:00 AM",7,2,5,0,0,0,,,,2,0,2,1,1,0,3,0,0,0,3,3,0,0,3,0,0,0,5,0,0,0,0,0,,,
"Jul 31, 2022 1:00 AM",2,1,1,0,0,0,,,,5,4,1,0,0,0,0,1,1,0,2,2,0,1,0,4,2,2,4,0,0,1,1,0,,,
"Jul 31, 2022 2:00 AM",6,3,3,2,0,2,,,,0,0,0,0,0,0,3,1,0,1,2,2,0,0,1,0,0,0,4,0,0,0,0,0,,,
"Jul 31, 2022 3:00 AM",1,0,1,0,0,0,,,,4,0,4,0,0,0,0,0,0,0,1,1,0,0,0,0,0,0,0,0,0,0,0,0,,,
"Jul 31, 2022 4:00 AM",2,0,2,1,0,1,,,,1,0,1,0,0,0,0,0,0,0,0,0,0,0,1,0,0,0,0,0,0,0,0,0,,,
"Jul 31, 2022 5:00 AM",0,0,0,0,0,0,,,,2,2,0,1,0,1,0,2,2,0,0,0,0,2,0,0,0,0,0,0,0,0,0,0,,,
"Jul 31, 2022 6:00 AM",5,2,3,5,1,4,,,,2,1,1,0,0,0,0,2,2,0,1,1,0,2,1,0,0,0,4,0,0,0,0,0,,,
"Jul 31, 2022 7:00 AM",10,3,7,2,2,0,,,,4,3,1,0,0,0,5,6,6,0,2,2,0,7,3,1,0,1,14,1,0,1,1,0,,,
"Jul 31, 2022 8:00 AM",22,11,11,16,7,9,,,,12,6,6,1,1,0,5,8,8,0,7,7,0,7,6,10,5,5,9,1,6,3,3,0,,,
"Jul 31, 2022 9:00 AM",19,5,14,39,29,10,,,,41,34,7,3,2,1,4,4,4,0,5,4,1,4,22,11,8,3,10,3,1,2,2,0,,,
"Jul 31, 2022 10:00 AM",21,12,9,53,25,28,,,,50,32,18,7,4,3,16,9,9,0,6,6,0,7,10,14,12,2,26,9,8,9,4,5,,,
"Jul 31, 2022 11:00 AM",29,20,9,62,24,38,,,,53,35,18,9,7,2,7,16,15,1,11,9,2,12,27,24,17,7,18,5,1,5,5,0,,,
"Jul 31, 2022 12:00 PM",32,19,13,83,40,43,,,,67,44,23,9,5,4,17,18,15,3,6,4,2,12,22,24,15,9,35,7,2,6,6,0,,,
"Jul 31, 2022 1:00 PM",37,19,18,89,40,49,,,,77,46,31,23,16,7,12,11,11,0,14,11,3,9,35,58,38,20,25,3,2,1,1,0,,,
"Jul 31, 2022 2:00 PM",39,21,18,118,56,62,,,,101,50,51,15,7,8,4,10,10,0,10,8,2,13,31,64,40,24,44,4,8,4,3,1,,,
"Jul 31, 2022 3:00 PM",45,21,24,136,85,51,,,,119,71,48,51,27,24,9,13,10,3,14,12,2,9,45,65,39,26,37,4,3,3,3,0,,,
"Jul 31, 2022 4:00 PM",53,27,26,130,70,60,,,,103,44,59,24,8,16,16,18,17,1,11,10,1,16,22,52,19,33,54,6,5,2,1,1,,,
"Jul 31, 2022 5:00 PM",36,15,21,107,50,57,,,,73,24,49,25,14,11,8,18,18,0,12,10,2,17,21,44,11,33,31,8,6,6,5,1,,,
"Jul 31, 2022 6:00 PM",52,25,27,68,31,37,,,,64,29,35,7,2,5,5,9,9,0,8,8,0,10,11,25,17,8,23,3,5,4,2,2,,,
"Jul 31, 2022 7:00 PM",41,16,25,56,32,24,,,,54,28,26,17,11,6,12,5,4,1,4,4,0,6,13,19,9,10,18,1,4,3,2,1,,,
"Jul 31, 2022 8:00 PM",25,10,15,36,14,22,,,,31,11,20,14,8,6,7,10,9,1,8,8,0,10,9,22,11,11,16,3,3,3,3,0,,,
"Jul 31, 2022 9:00 PM",29,15,14,23,9,14,,,,26,8,18,1,0,1,3,8,7,1,8,7,1,8,5,14,4,10,6,1,1,1,0,1,,,
"Jul 31, 2022 10:00 PM",15,7,8,12,8,4,,,,5,4,1,4,2,2,3,7,7,0,4,4,0,6,7,5,4,1,11,1,1,0,0,0,,,
"Jul 31, 2022 11:00 PM",8,3,5,3,1,2,,,,7,3,4,0,0,0,2,3,3,0,1,1,0,3,6,4,3,1,6,1,1,2,2,0,,,
"Aug 1, 2022 12:00 AM",12,5,7,0,0,0,,,,5,1,4,2,1,1,0,2,2,0,6,6,0,2,2,1,1,0,4,1,1,1,1,0,,,
"Aug 1, 2022 1:00 AM",5,3,2,2,1,1,,,,2,1,1,1,1,0,0,2,2,0,3,3,0,2,0,1,1,0,3,0,0,0,0,0,,,
"Aug 1, 2022 2:00 AM",7,3,4,1,1,0,,,,1,1,0,1,0,1,3,1,1,0,3,3,0,1,3,0,0,0,2,0,0,0,0,0,,,
"Aug 1, 2022 3:00 AM",5,0,5,2,2,0,,,,3,2,1,0,0,0,1,0,0,0,3,3,0,0,2,1,1,0,0,0,0,0,0,0,,,
"Aug 1, 2022 4:00 AM",1,0,1,1,0,1,,,,1,1,0,0,0,0,0,0,0,0,1,1,0,0,1,0,0,0,0,0,1,0,0,0,,,
"Aug 1, 2022 5:00 AM",3,0,3,0,0,0,,,,1,0,1,2,0,2,1,0,0,0,1,1,0,0,1,0,0,0,7,0,0,0,0,0,,,
"Aug 1, 2022 6:00 AM",16,8,8,8,2,6,,,,6,2,4,3,3,0,2,4,4,0,3,3,0,2,7,5,3,2,11,0,0,0,0,0,,,
"Aug 1, 2022 7:00 AM",20,11,9,33,19,14,,,,32,21,11,3,3,0,3,10,10,0,4,3,1,11,11,5,3,2,24,0,3,2,0,2,,,
"Aug 1, 2022 8:00 AM",23,13,10,82,42,40,,,,61,39,22,4,1,3,13,13,12,1,11,11,0,11,15,15,9,6,33,1,2,2,1,1,,,
"Aug 1, 2022 9:00 AM",37,12,25,117,70,47,,,,106,65,41,7,1,6,10,23,21,2,13,9,4,19,24,41,25,16,35,4,5,6,4,2,,,
"Aug 1, 2022 10:00 AM",40,25,15,174,101,73,,,,148,97,51,27,8,19,8,12,11,1,14,13,1,12,41,75,54,21,32,6,3,7,4,3,,,
"Aug 1, 2022 11:00 AM",50,25,25,197,107,90,,,,187,122,65,30,14,16,22,19,18,1,18,16,2,16,38,96,65,31,32,4,6,10,6,4,,,
"Aug 1, 2022 12:00 PM",57,27,30,191,87,104,,,,144,76,68,34,14,20,10,28,27,1,19,11,8,26,45,99,66,33,45,3,7,9,9,0,,,
"Aug 1, 2022 1:00 PM",55,27,28,114,43,71,,,,135,54,81,31,24,7,18,17,14,3,17,16,1,14,29,94,44,50,48,2,3,2,1,1,,,
"Aug 1, 2022 2:00 PM",37,19,18,106,46,60,,,,71,37,34,15,7,8,20,19,18,1,17,16,1,16,25,88,45,43,41,3,4,11,6,5,,,
"Aug 1, 2022 3:00 PM",46,26,20,84,37,47,,,,89,35,54,13,4,9,13,30,25,5,16,16,0,24,23,47,19,28,35,3,2,8,4,4,,,
"Aug 1, 2022 4:00 PM",33,12,21,48,16,32,,,,41,11,30,19,4,15,9,16,16,0,7,6,1,15,12,30,4,26,32,6,0,4,4,0,,,
"Aug 1, 2022 5:00 PM",44,12,32,22,14,8,,,,22,10,12,13,8,5,10,10,10,0,15,13,2,8,15,15,5,10,27,3,1,4,4,0,,,
"Aug 1, 2022 6:00 PM",26,13,13,15,9,6,,,,26,16,10,6,3,3,4,14,12,2,13,13,0,12,17,18,10,8,18,0,1,4,2,2,,,
"Aug 1, 2022 7:00 PM",30,14,16,33,19,14,,,,20,10,10,4,2,2,6,13,12,1,8,7,1,12,10,7,5,2,16,3,3,3,2,1,,,
"Aug 1, 2022 8:00 PM",31,11,20,21,9,12,,,,20,9,11,1,1,0,8,8,8,0,7,7,0,11,10,10,5,5,14,1,0,1,0,1,,,
"Aug 1, 2022 9:00 PM",21,8,13,15,7,8,,,,13,6,7,6,6,0,4,15,12,3,5,5,0,11,9,8,2,6,4,2,1,2,1,1,,,
"Aug 1, 2022 10:00 PM",13,6,7,2,0,2,,,,4,2,2,0,0,0,3,7,7,0,6,3,3,8,1,4,2,2,1,0,0,3,1,2,,,
"Aug 1, 2022 11:00 PM",4,1,3,3,2,1,,,,1,1,0,1,0,1,0,2,2,0,5,3,2,1,4,0,0,0,6,0,2,4,2,2,,,
"Aug 2, 2022 12:00 AM",3,1,2,0,0,0,,,,2,1,1,0,0,0,0,1,1,0,2,2,0,2,5,0,0,0,2,1,0,1,1,0,,,
"Aug 2, 2022 1:00 AM",5,2,3,0,0,0,,,,1,1,0,0,0,0,0,0,0,0,4,2,2,0,1,0,0,0,0,0,0,0,0,0,,,
"Aug 2, 2022 2:00 AM",3,2,1,2,1,1,,,,1,1,0,0,0,0,0,0,0,0,1,1,0,0,1,0,0,0,0,0,0,0,0,0,,,
"Aug 2, 2022 3:00 AM",1,0,1,0,0,0,,,,0,0,0,0,0,0,0,0,0,0,1,1,0,0,0,1,1,0,0,0,0,0,0,0,,,
"Aug 2, 2022 4:00 AM",1,1,0,1,0,1,,,,2,1,1,0,0,0,0,1,1,0,0,0,0,1,1,0,0,0,1,0,0,0,0,0,,,
"Aug 2, 2022 5:00 AM",8,4,4,3,1,2,,,,3,1,2,0,0,0,3,5,5,0,1,1,0,6,0,2,1,1,8,0,0,0,0,0,,,
"Aug 2, 2022 6:00 AM",46,33,13,15,7,8,,,,17,8,9,3,2,1,7,16,16,0,11,8,3,17,9,3,1,2,30,0,3,2,2,0,,,
"Aug 2, 2022 7:00 AM",93,62,31,42,13,29,,,,39,17,22,5,4,1,14,71,70,1,10,5,5,59,28,19,5,14,81,3,6,3,3,0,,,
"Aug 2, 2022 8:00 AM",168,128,40,44,5,39,,,,62,31,31,11,9,2,16,117,117,0,19,17,2,116,47,43,13,30,130,6,2,6,5,1,,,
"Aug 2, 2022 9:00 AM",95,70,25,44,12,32,,,,47,25,22,8,7,1,16,44,43,1,19,15,4,37,24,36,18,18,58,3,7,1,1,0,,,
"Aug 2, 2022 10:00 AM",43,35,8,28,11,17,,,,26,17,9,7,5,2,4,23,23,0,8,6,2,19,13,17,11,6,21,4,3,6,2,4,,,
"Aug 2, 2022 11:00 AM",36,28,8,39,24,15,,,,46,28,18,18,8,10,9,14,14,0,11,8,3,14,9,24,14,10,25,1,1,2,1,1,,,
"Aug 2, 2022 12:00 PM",45,26,19,52,30,22,,,,56,29,27,14,7,7,5,17,15,2,11,7,4,13,15,26,13,13,17,2,0,6,4,2,,,
"Aug 2, 2022 1:00 PM",58,30,28,52,30,22,,,,50,26,24,17,13,4,18,12,11,1,13,9,4,14,23,30,16,14,19,3,2,8,3,5,,,
"Aug 2, 2022 2:00 PM",49,23,26,65,34,31,,,,57,28,29,12,6,6,20,15,12,3,18,15,3,11,31,32,19,13,29,0,3,4,3,1,,,
"Aug 2, 2022 3:00 PM",56,25,31,95,50,45,,,,57,36,21,16,5,11,30,19,11,8,26,22,4,13,28,56,33,23,19,12,3,5,3,2,,,
"Aug 2, 2022 4:00 PM",120,40,80,96,56,40,,,,102,58,44,24,6,18,17,21,17,4,40,39,1,20,59,71,46,25,53,4,3,9,2,7,,,
"Aug 2, 2022 5:00 PM",178,46,132,132,61,71,,,,137,75,62,33,16,17,30,25,22,3,86,83,3,21,93,100,60,40,61,7,4,5,3,2,,,
"Aug 2, 2022 6:00 PM",187,47,140,145,112,33,,,,161,117,44,38,17,21,35,42,34,8,74,69,5,27,95,103,79,24,63,8,12,5,5,0,,,
"Aug 2, 2022 7:00 PM",105,35,70,158,85,73,,,,155,87,68,13,7,6,17,23,23,0,27,27,0,25,87,75,53,22,52,3,5,9,4,5,,,
"Aug 2, 2022 8:00 PM",85,33,52,117,47,70,,,,116,44,72,13,6,7,8,17,15,2,29,26,3,16,26,66,29,37,41,4,4,7,5,2,,,
"Aug 2, 2022 9:00 PM",47,17,30,65,28,37,,,,66,22,44,9,6,3,26,21,18,3,23,23,0,16,21,50,14,36,35,5,4,5,3,2,,,
"Aug 2, 2022 10:00 PM",28,5,23,27,15,12,,,,16,7,9,5,0,5,9,3,3,0,17,14,3,4,12,10,7,3,14,1,1,0,0,0,,,
"Aug 2, 2022 11:00 PM",7,2,5,12,10,2,,,,6,3,3,0,0,0,3,2,2,0,1,1,0,2,7,5,4,1,4,0,0,1,0,1,,,
"Aug 3, 2022 12:00 AM",1,0,1,0,0,0,,,,0,0,0,2,0,2,4,1,1,0,7,7,0,1,2,0,0,0,2,0,1,2,2,0,,,
"Aug 3, 2022 1:00 AM",4,0,4,1,1,0,,,,2,2,0,0,0,0,0,1,1,0,1,1,0,1,5,0,0,0,0,0,0,0,0,0,,,
"Aug 3, 2022 2:00 AM",6,4,2,0,0,0,,,,0,0,0,0,0,0,0,0,0,0,1,1,0,0,0,0,0,0,1,0,0,0,0,0,,,
"Aug 3, 2022 3:00 AM",1,1,0,1,1,0,,,,1,1,0,0,0,0,1,0,0,0,0,0,0,0,1,0,0,0,1,0,0,0,0,0,,,
"Aug 3, 2022 4:00 AM",1,0,1,1,0,1,,,,2,1,1,0,0,0,0,0,0,0,0,0,0,0,0,0,0,0,0,0,1,0,0,0,,,
"Aug 3, 2022 5:00 AM",5,4,1,0,0,0,,,,3,1,2,0,0,0,2,10,10,0,1,1,0,10,3,0,0,0,8,0,0,1,1,0,,,
"Aug 3, 2022 6:00 AM",37,20,17,30,12,18,,,,29,13,16,3,3,0,9,25,25,0,8,6,2,27,18,13,13,0,44,3,4,3,3,0,,,
"Aug 3, 2022 7:00 AM",119,77,42,86,38,48,,,,75,36,39,8,3,5,12,71,69,2,19,16,3,65,28,27,27,0,109,2,7,7,7,0,,,
"Aug 3, 2022 8:00 AM",210,159,51,81,26,55,,,,83,31,52,11,9,2,22,139,139,0,30,25,5,134,56,55,54,1,177,6,5,10,8,2,,,
"Aug 3, 2022 9:00 AM",121,97,24,63,22,41,,,,65,41,24,13,10,3,19,57,57,0,26,24,2,50,30,39,39,0,61,5,11,5,3,2,,,
"Aug 3, 2022 10:00 AM",51,36,15,49,20,29,,,,44,25,19,15,7,8,9,32,31,1,14,13,1,25,24,29,27,2,25,2,2,1,0,1,,,
"Aug 3, 2022 11:00 AM",39,25,14,49,21,28,,,,46,24,22,9,6,3,19,22,21,1,10,8,2,21,15,31,31,0,27,4,8,8,5,3,,,
"Aug 3, 2022 12:00 PM",55,29,26,70,33,37,,,,55,35,20,16,9,7,14,20,19,1,12,11,1,13,23,40,40,0,28,1,6,4,2,2,,,
"Aug 3, 2022 1:00 PM",62,32,30,70,40,30,,,,55,24,31,18,7,11,28,25,23,2,19,17,2,22,25,45,45,0,21,4,3,7,5,2,,,
"Aug 3, 2022 2:00 PM",42,14,28,51,29,22,,,,56,35,21,17,10,7,17,17,16,1,21,18,3,14,25,21,21,0,30,5,1,2,1,1,,,
"Aug 3, 2022 3:00 PM",65,25,40,59,32,27,,,,55,26,29,16,9,7,25,15,12,3,19,18,1,12,37,47,47,0,36,12,2,11,4,7,,,
"Aug 3, 2022 4:00 PM",117,31,86,90,52,38,,,,97,54,43,27,5,22,22,25,22,3,44,44,0,20,64,87,85,2,40,11,1,5,3,2,,,
"Aug 3, 2022 5:00 PM",195,54,141,97,59,38,,,,128,79,49,24,9,15,30,47,45,2,89,85,4,43,111,101,101,0,68,7,9,6,1,5,,,
"Aug 3, 2022 6:00 PM",178,52,126,118,83,35,,,,125,87,38,25,15,10,25,44,40,4,88,85,3,42,107,90,90,0,46,1,11,11,8,3,,,
"Aug 3, 2022 7:00 PM",106,31,75,107,60,47,,,,99,61,38,20,12,8,17,30,29,1,56,54,2,28,59,74,74,0,45,7,5,7,1,6,,,
"Aug 3, 2022 8:00 PM",55,17,38,70,34,36,,,,70,27,43,4,3,1,16,11,10,1,28,26,2,11,30,24,24,0,32,6,5,10,7,3,,,
"Aug 3, 2022 9:00 PM",42,18,24,29,19,10,,,,22,6,16,4,2,2,10,6,4,2,23,21,2,6,12,25,23,2,19,4,2,5,4,1,,,
"Aug 3, 2022 10:00 PM",30,6,24,14,10,4,,,,15,5,10,8,0,8,5,6,6,0,9,9,0,5,6,8,5,3,9,0,0,0,0,0,,,
"Aug 3, 2022 11:00 PM",12,3,9,2,1,1,,,,6,1,5,1,0,1,2,4,3,1,4,4,0,4,5,0,0,0,4,0,0,0,0,0,,,
"Aug 4, 2022 12:00 AM",8,1,7,0,0,0,,,,1,1,0,2,2,0,1,0,0,0,3,3,0,0,3,1,1,0,5,0,1,0,0,0,,,
"Aug 4, 2022 1:00 AM",4,0,4,0,0,0,,,,0,0,0,2,0,2,0,4,4,0,2,2,0,4,1,0,0,0,0,0,0,1,1,0,,,
"Aug 4, 2022 2:00 AM",7,5,2,0,0,0,,,,0,0,0,0,0,0,0,0,0,0,0,0,0,0,0,0,0,0,1,0,0,0,0,0,,,
"Aug 4, 2022 3:00 AM",3,2,1,0,0,0,,,,1,0,1,0,0,0,0,0,0,0,1,1,0,0,0,0,0,0,1,0,0,0,0,0,,,
"Aug 4, 2022 4:00 AM",2,2,0,2,0,2,,,,3,1,2,0,0,0,0,1,1,0,0,0,0,1,0,0,0,0,4,0,0,0,0,0,,,
"Aug 4, 2022 5:00 AM",6,4,2,5,2,3,,,,4,3,1,1,1,0,2,5,5,0,2,2,0,5,6,2,2,0,9,1,0,0,0,0,,,
"Aug 4, 2022 6:00 AM",44,27,17,28,11,17,,,,29,15,14,2,2,0,6,24,24,0,6,4,2,22,19,13,5,8,33,1,2,2,2,0,,,
"Aug 4, 2022 7:00 AM",135,84,51,49,20,29,,,,47,23,24,10,8,2,10,66,65,1,16,14,2,63,35,22,7,15,95,1,6,4,3,1,,,
"Aug 4, 2022 8:00 AM",225,167,58,88,26,62,,,,92,40,52,22,16,6,22,109,109,0,26,21,5,110,43,51,24,27,156,5,1,10,10,0,,,
"Aug 4, 2022 9:00 AM",108,87,21,64,34,30,,,,70,47,23,21,16,5,13,59,59,0,20,16,4,50,23,38,20,18,77,6,4,12,10,2,,,
"Aug 4, 2022 10:00 AM",46,38,8,54,21,33,,,,53,31,22,12,7,5,10,27,27,0,14,9,5,23,20,19,15,4,29,5,4,4,1,3,,,
"Aug 4, 2022 11:00 AM",44,26,18,69,39,30,,,,66,37,29,16,8,8,22,17,17,0,9,8,1,15,21,24,14,10,31,6,3,2,0,2,,,
"Aug 4, 2022 12:00 PM",66,36,30,66,39,27,,,,59,31,28,24,8,16,10,17,16,1,14,12,2,10,19,46,26,20,25,8,8,5,4,1,,,
"Aug 4, 2022 1:00 PM",67,30,37,75,35,40,,,,60,26,34,23,13,10,23,28,24,4,11,10,1,21,31,34,18,16,21,2,1,3,2,1,,,
"Aug 4, 2022 2:00 PM",55,26,29,65,40,25,,,,44,28,16,15,4,11,11,20,20,0,20,17,3,16,22,33,18,15,21,8,3,4,3,1,,,
"Aug 4, 2022 3:00 PM",78,35,43,69,33,36,,,,56,30,26,21,12,9,17,12,11,1,19,17,2,10,34,36,23,13,33,4,3,10,6,4,,,
"Aug 4, 2022 4:00 PM",111,34,77,78,44,34,,,,85,47,38,19,3,16,15,22,21,1,39,39,0,18,64,43,27,16,46,7,5,4,3,1,,,
"Aug 4, 2022 5:00 PM",195,52,143,131,67,64,,,,133,80,53,26,11,15,24,38,33,5,79,78,1,31,90,98,70,28,70,8,3,10,2,8,,,
"Aug 4, 2022 6:00 PM",184,54,130,105,69,36,,,,108,84,24,12,4,8,31,44,38,6,76,73,3,38,110,73,54,19,50,5,7,6,3,3,,,
"Aug 4, 2022 7:00 PM",118,49,69,98,44,54,,,,86,45,41,13,9,4,24,20,18,2,50,48,2,19,47,59,41,18,49,10,2,10,6,4,,,
"Aug 4, 2022 8:00 PM",83,22,61,41,23,18,,,,56,31,25,17,3,14,17,19,19,0,24,23,1,17,32,37,21,16,36,6,2,3,2,1,,,
"Aug 4, 2022 9:00 PM",59,22,37,59,41,18,,,,50,16,34,8,2,6,14,16,12,4,12,11,1,10,21,21,8,13,19,2,1,3,2,1,,,
"Aug 4, 2022 10:00 PM",25,7,18,26,21,5,,,,28,5,23,8,4,4,5,3,3,0,11,10,1,3,13,13,7,6,14,0,2,0,0,0,,,
"Aug 4, 2022 11:00 PM",17,4,13,11,9,2,,,,8,3,5,6,3,3,3,2,1,1,15,15,0,1,9,6,4,2,7,0,1,0,0,0,,,
"Aug 5, 2022 12:00 AM",5,2,3,0,0,0,,,,11,2,9,2,2,0,4,2,2,0,6,6,0,3,11,0,0,0,9,0,0,0,0,0,,,
"Aug 5, 2022 1:00 AM",4,0,4,5,4,1,,,,7,5,2,1,1,0,0,1,0,1,2,1,1,0,5,1,1,0,3,1,0,1,0,1,,,
"Aug 5, 2022 2:00 AM",2,2,0,0,0,0,,,,1,1,0,0,0,0,0,2,2,0,3,3,0,2,1,1,1,0,0,0,0,0,0,0,,,
"Aug 5, 2022 3:00 AM",0,0,0,0,0,0,,,,2,1,1,0,0,0,0,0,0,0,0,0,0,0,1,0,0,0,1,0,0,0,0,0,,,
"Aug 5, 2022 4:00 AM",2,2,0,1,0,1,,,,2,1,1,0,0,0,0,1,1,0,0,0,0,1,1,0,0,0,1,0,0,0,0,0,,,
"Aug 5, 2022 5:00 AM",11,6,5,1,0,1,,,,5,2,3,1,0,1,4,5,5,0,2,2,0,5,2,4,3,1,7,0,0,0,0,0,,,
"Aug 5, 2022 6:00 AM",37,22,15,17,9,8,,,,19,11,8,3,3,0,6,13,13,0,7,5,2,13,10,9,3,6,33,0,2,1,1,0,,,
"Aug 5, 2022 7:00 AM",91,60,31,52,20,32,,,,48,22,26,9,8,1,9,40,40,0,10,8,2,39,36,33,17,16,71,2,3,4,3,1,,,
"Aug 5, 2022 8:00 AM",146,95,51,71,22,49,,,,69,36,33,14,10,4,17,64,63,1,21,16,5,67,37,40,15,25,111,8,3,3,2,1,,,
"Aug 5, 2022 9:00 AM",86,66,20,51,23,28,,,,61,36,25,19,15,4,11,39,38,1,11,7,4,33,15,25,17,8,54,6,10,4,4,0,,,
"Aug 5, 2022 10:00 AM",43,26,17,56,25,31,,,,42,18,24,12,9,3,17,31,31,0,7,6,1,26,17,20,12,8,32,4,3,3,1,2,,,
"Aug 5, 2022 11:00 AM",52,36,16,50,27,23,,,,47,24,23,14,5,9,15,20,17,3,12,10,2,16,22,20,9,11,21,7,2,9,8,1,,,
"Aug 5, 2022 12:00 PM",49,23,26,45,27,18,,,,42,30,12,23,8,15,16,17,14,3,16,15,1,9,19,18,8,10,20,5,4,3,1,2,,,
"Aug 5, 2022 1:00 PM",76,33,43,59,35,24,,,,47,32,15,15,11,4,23,19,18,1,14,14,0,15,28,28,18,10,24,5,1,9,6,3,,,
"Aug 5, 2022 2:00 PM",77,45,32,43,18,25,,,,54,31,23,15,7,8,9,18,17,1,19,18,1,14,18,21,16,5,25,7,4,8,5,3,,,
"Aug 5, 2022 3:00 PM",95,37,58,71,30,41,,,,50,27,23,27,11,16,25,27,23,4,29,26,3,19,32,26,14,12,32,7,4,9,4,5,,,
"Aug 5, 2022 4:00 PM",104,41,63,82,54,28,,,,76,46,30,21,10,11,28,29,25,4,31,29,2,26,56,52,35,17,43,6,2,6,2,4,,,
"Aug 5, 2022 5:00 PM",135,45,90,136,88,48,,,,112,61,51,26,12,14,26,36,33,3,63,59,4,27,72,72,47,25,59,4,6,2,1,1,,,
"Aug 5, 2022 6:00 PM",121,44,77,104,58,46,,,,97,58,39,19,7,12,14,29,25,4,39,37,2,30,69,81,50,31,44,11,5,5,3,2,,,
"Aug 5, 2022 7:00 PM",71,31,40,72,46,26,,,,64,43,21,20,8,12,15,16,16,0,22,19,3,16,44,61,43,18,29,5,4,11,8,3,,,
"Aug 5, 2022 8:00 PM",71,22,49,60,27,33,,,,62,20,42,8,5,3,20,21,17,4,14,13,1,15,24,36,17,19,42,2,2,7,4,3,,,
"Aug 5, 2022 9:00 PM",39,15,24,18,9,9,,,,23,11,12,5,0,5,11,9,8,1,14,13,1,8,19,24,9,15,17,1,1,5,2,3,,,
"Aug 5, 2022 10:00 PM",36,13,23,5,1,4,,,,15,5,10,2,2,0,8,5,5,0,7,6,1,6,12,9,5,4,12,1,1,8,6,2,,,
"Aug 5, 2022 11:00 PM",20,7,13,14,8,6,,,,10,1,9,0,0,0,3,4,3,1,11,11,0,3,9,3,2,1,10,0,3,0,0,0,,,
"Aug 6, 2022 12:00 AM",10,4,6,0,0,0,,,,6,2,4,6,4,2,6,2,2,0,8,8,0,2,2,2,2,0,8,1,0,1,1,0,,,
"Aug 6, 2022 1:00 AM",12,2,10,6,4,2,,,,8,5,3,0,0,0,1,4,4,0,3,3,0,4,5,1,0,1,4,0,1,0,0,0,,,
"Aug 6, 2022 2:00 AM",7,4,3,0,0,0,,,,0,0,0,0,0,0,0,0,0,0,3,2,1,0,4,0,0,0,3,0,0,0,0,0,,,
"Aug 6, 2022 3:00 AM",6,1,5,0,0,0,,,,0,0,0,0,0,0,0,0,0,0,3,3,0,0,1,0,0,0,0,0,1,0,0,0,,,
"Aug 6, 2022 4:00 AM",1,0,1,1,0,1,,,,2,1,1,1,1,0,0,1,1,0,1,1,0,1,0,3,3,0,2,0,1,0,0,0,,,
"Aug 6, 2022 5:00 AM",5,1,4,2,0,2,,,,4,2,2,0,0,0,1,1,1,0,2,2,0,1,1,4,3,1,6,1,0,0,0,0,,,
"Aug 6, 2022 6:00 AM",10,4,6,4,1,3,,,,7,4,3,0,0,0,1,3,3,0,3,3,0,3,5,2,1,1,6,0,0,1,0,1,,,
"Aug 6, 2022 7:00 AM",22,11,11,15,7,8,,,,20,16,4,1,0,1,9,13,13,0,6,4,2,13,15,4,3,1,15,0,2,2,2,0,,,
"Aug 6, 2022 8:00 AM",36,15,21,65,45,20,,,,55,42,13,8,6,2,6,13,12,1,11,10,1,11,27,25,17,8,31,6,3,2,1,1,,,
"Aug 6, 2022 9:00 AM",50,29,21,87,43,44,,,,92,57,35,8,7,1,14,19,18,1,11,9,2,14,43,31,21,10,39,9,5,3,3,0,,,
"Aug 6, 2022 10:00 AM",60,34,26,120,67,53,,,,113,73,40,24,12,12,14,11,10,1,5,5,0,15,31,53,31,22,41,7,14,6,4,2,,,
"Aug 6, 2022 11:00 AM",72,37,35,200,94,106,,,,154,92,62,34,20,14,26,18,16,2,26,23,3,13,29,71,41,30,36,19,3,5,1,4,,,
"Aug 6, 2022 12:00 PM",71,32,39,175,78,97,,,,156,99,57,41,20,21,11,21,20,1,12,11,1,16,53,69,47,22,37,5,7,6,3,3,,,
"Aug 6, 2022 1:00 PM",63,35,28,145,65,80,,,,152,80,72,27,18,9,16,26,23,3,18,16,2,17,56,94,57,37,43,3,5,6,4,2,,,
"Aug 6, 2022 2:00 PM",72,39,33,124,63,61,,,,129,73,56,20,7,13,17,22,21,1,17,15,2,22,22,47,26,21,38,5,2,7,5,2,,,
"Aug 6, 2022 3:00 PM",67,41,26,149,79,70,,,,150,73,77,19,9,10,11,13,13,0,11,11,0,11,31,88,40,48,42,6,2,4,4,0,,,
"Aug 6, 2022 4:00 PM",58,35,23,129,51,78,,,,139,58,81,20,13,7,20,16,15,1,16,12,4,15,29,61,31,30,38,6,1,2,1,1,,,
"Aug 6, 2022 5:00 PM",51,28,23,127,76,51,,,,102,39,63,23,11,12,29,20,18,2,20,18,2,17,29,56,28,28,51,5,5,1,1,0,,,
"Aug 6, 2022 6:00 PM",56,30,26,70,44,26,,,,70,33,37,12,5,7,10,12,12,0,13,12,1,11,27,36,19,17,24,1,3,11,6,5,,,
"Aug 6, 2022 7:00 PM",50,20,30,49,22,27,,,,53,19,34,13,4,9,12,15,15,0,13,13,0,18,7,36,13,23,20,4,1,6,5,1,,,
"Aug 6, 2022 8:00 PM",40,18,22,42,18,24,,,,39,13,26,6,4,2,7,14,13,1,8,8,0,9,6,21,6,15,22,1,1,2,1,1,,,
"Aug 6, 2022 9:00 PM",31,14,17,36,14,22,,,,18,7,11,6,4,2,5,9,7,2,5,3,2,6,9,10,3,7,20,4,1,0,0,0,,,
"Aug 6, 2022 10:00 PM",14,3,11,7,5,2,,,,14,5,9,4,3,1,5,5,5,0,4,4,0,5,7,10,6,4,12,0,1,1,0,1,,,
"Aug 6, 2022 11:00 PM",15,8,7,2,1,1,,,,10,5,5,2,2,0,2,5,5,0,4,2,2,6,12,7,5,2,9,0,0,0,0,0,,,
"Aug 7, 2022 12:00 AM",9,3,6,0,0,0,,,,2,0,2,2,2,0,4,1,1,0,7,7,0,0,2,1,1,0,4,0,1,0,0,0,,,
"Aug 7, 2022 1:00 AM",16,3,13,3,1,2,,,,4,2,2,2,0,2,1,2,2,0,3,3,0,2,2,5,4,1,2,0,0,0,0,0,,,
"Aug 7, 2022 2:00 AM",6,1,5,2,0,2,,,,3,1,2,0,0,0,0,1,1,0,4,4,0,0,2,3,2,1,3,0,0,0,0,0,,,
"Aug 7, 2022 3:00 AM",7,0,7,0,0,0,,,,0,0,0,1,1,0,0,0,0,0,2,2,0,0,0,3,2,1,1,0,0,0,0,0,,,
"Aug 7, 2022 4:00 AM",2,1,1,3,1,2,,,,6,4,2,1,1,0,0,0,0,0,1,1,0,0,4,0,0,0,0,0,0,0,0,0,,,
"Aug 7, 2022 5:00 AM",0,0,0,5,2,3,,,,2,0,2,0,0,0,1,1,1,0,0,0,0,1,0,3,2,1,2,1,0,2,2,0,,,
"Aug 7, 2022 6:00 AM",2,2,0,12,5,7,,,,7,4,3,1,0,1,0,6,6,0,1,1,0,6,2,4,3,1,9,0,1,2,2,0,,,
"Aug 7, 2022 7:00 AM",24,9,15,17,8,9,,,,20,13,7,2,0,2,4,12,11,1,4,4,0,12,12,13,8,5,20,0,2,0,0,0,,,
"Aug 7, 2022 8:00 AM",30,12,18,79,55,24,,,,73,60,13,13,7,6,13,18,18,0,9,8,1,19,27,27,20,7,16,2,11,3,2,1,,,
"Aug 7, 2022 9:00 AM",37,19,18,123,78,45,,,,105,70,35,8,5,3,11,9,9,0,7,6,1,9,45,48,34,14,42,7,12,6,4,2,,,
"Aug 7, 2022 10:00 AM",50,29,21,177,94,83,,,,151,92,59,17,7,10,7,25,25,0,11,9,2,25,50,57,40,17,43,1,11,6,0,6,,,
"Aug 7, 2022 11:00 AM",52,37,15,165,77,88,,,,151,78,73,23,17,6,11,12,12,0,21,17,4,14,55,72,44,28,47,11,3,10,5,5,,,
"Aug 7, 2022 12:00 PM",68,35,33,230,131,99,,,,201,125,76,31,19,12,19,37,35,2,17,16,1,30,46,75,46,29,48,14,4,11,5,6,,,
"Aug 7, 2022 1:00 PM",63,36,27,186,105,81,,,,174,115,59,21,8,13,39,33,23,10,11,9,2,22,55,96,66,30,48,5,4,8,3,5,,,
"Aug 7, 2022 2:00 PM",64,26,38,211,126,85,,,,204,116,88,41,24,17,21,18,14,4,16,13,3,14,44,70,50,20,40,17,8,13,8,5,,,
"Aug 7, 2022 3:00 PM",50,24,26,206,101,105,,,,177,89,88,35,19,16,17,15,14,1,13,13,0,11,40,100,66,34,38,8,4,6,6,0,,,
"Aug 7, 2022 4:00 PM",54,27,27,237,119,118,,,,219,98,121,29,14,15,19,18,18,0,15,13,2,21,40,81,46,35,54,9,3,8,5,3,,,
"Aug 7, 2022 5:00 PM",58,25,33,190,81,109,,,,165,62,103,34,17,17,18,30,26,4,16,15,1,26,34,96,44,52,70,3,8,6,3,3,,,
"Aug 7, 2022 6:00 PM",57,22,35,123,50,73,,,,123,55,68,15,8,7,11,14,12,2,12,11,1,11,37,98,45,53,50,3,5,7,7,0,,,
"Aug 7, 2022 7:00 PM",46,21,25,93,42,51,,,,79,30,49,8,6,2,16,10,8,2,10,10,0,7,23,58,20,38,42,2,3,7,2,5,,,
"Aug 7, 2022 8:00 PM",40,20,20,69,33,36,,,,57,28,29,12,5,7,16,13,12,1,5,5,0,12,13,54,25,29,40,3,1,3,1,2,,,
"Aug 7, 2022 9:00 PM",37,14,23,38,13,25,,,,29,8,21,8,6,2,7,13,11,2,4,4,0,13,8,33,14,19,23,1,1,2,0,2,,,
"Aug 7, 2022 10:00 PM",17,9,8,7,3,4,,,,6,1,5,5,3,2,3,7,7,0,5,5,0,8,13,4,3,1,10,2,1,0,0,0,,,
"Aug 7, 2022 11:00 PM",12,3,9,3,2,1,,,,4,1,3,2,1,1,2,1,1,0,2,2,0,2,7,0,0,0,5,1,3,1,1,0,,,
"Aug 8, 2022 12:00 AM",8,3,5,0,0,0,3,1,2,8,1,7,1,1,0,1,4,4,0,5,5,0,2,2,5,4,1,4,0,0,1,1,0,,,
"Aug 8, 2022 1:00 AM",9,2,7,0,0,0,1,0,1,1,0,1,0,0,0,2,1,0,1,3,3,0,1,2,0,0,0,2,1,0,0,0,0,,,
"Aug 8, 2022 2:00 AM",4,1,3,1,0,1,0,0,0,0,0,0,0,0,0,0,1,1,0,0,0,0,1,0,0,0,0,1,0,0,0,0,0,,,
"Aug 8, 2022 3:00 AM",2,0,2,0,0,0,0,0,0,0,0,0,0,0,0,0,0,0,0,1,1,0,0,0,0,0,0,0,0,0,0,0,0,,,
"Aug 8, 2022 4:00 AM",1,0,1,1,0,1,1,1,0,1,1,0,1,1,0,0,0,0,0,0,0,0,0,1,0,0,0,0,0,0,0,0,0,,,
"Aug 8, 2022 5:00 AM",8,6,2,2,1,1,4,2,2,3,1,2,0,0,0,4,7,7,0,2,2,0,8,3,0,0,0,11,0,2,0,0,0,,,
"Aug 8, 2022 6:00 AM",54,28,26,17,8,9,35,20,15,24,14,10,3,2,1,11,16,16,0,4,2,2,17,13,12,8,4,29,1,2,2,2,0,,,
"Aug 8, 2022 7:00 AM",110,76,34,56,23,33,86,41,45,54,26,28,14,12,2,13,80,79,1,20,14,6,71,35,33,18,15,96,0,2,4,4,0,,,
"Aug 8, 2022 8:00 AM",185,135,50,89,17,72,146,54,92,96,43,53,15,11,4,26,117,117,0,25,18,7,110,55,57,28,29,143,5,5,5,3,2,,,
"Aug 8, 2022 9:00 AM",89,71,18,55,21,34,108,56,52,71,39,32,18,13,5,17,50,48,2,23,19,4,38,27,54,30,24,60,2,5,2,1,1,,,
"Aug 8, 2022 10:00 AM",53,34,19,54,30,24,106,64,42,57,41,16,20,11,9,13,27,26,1,20,12,8,18,26,36,26,10,25,5,4,4,2,2,,,
"Aug 8, 2022 11:00 AM",41,21,20,58,37,21,105,61,44,64,40,24,16,11,5,10,20,18,2,11,11,0,21,26,56,36,20,29,1,3,5,2,3,,,
"Aug 8, 2022 12:00 PM",45,25,20,102,52,50,93,49,44,89,54,35,30,19,11,27,27,25,2,15,15,0,19,22,36,23,13,33,10,2,8,6,2,,,
"Aug 8, 2022 1:00 PM",76,33,43,121,61,60,96,49,47,102,56,46,20,10,10,6,23,21,2,18,15,3,21,27,61,34,27,28,6,1,5,4,1,,,
"Aug 8, 2022 2:00 PM",80,42,38,96,44,52,80,51,29,82,50,32,30,17,13,18,26,24,2,14,13,1,20,33,43,30,13,38,7,2,5,4,1,,,
"Aug 8, 2022 3:00 PM",85,36,49,104,51,53,112,69,43,100,59,41,26,20,6,16,21,20,1,26,23,3,17,38,48,33,15,34,10,4,10,7,3,,,
"Aug 8, 2022 4:00 PM",127,51,76,124,72,52,124,58,66,107,50,57,24,8,16,19,20,18,2,39,39,0,17,56,69,46,23,41,9,2,10,7,3,,,
"Aug 8, 2022 5:00 PM",221,56,165,136,83,53,201,119,82,147,67,80,37,15,22,34,47,42,5,80,76,4,34,113,142,97,45,78,9,11,9,8,1,,,
"Aug 8, 2022 6:00 PM",174,59,115,195,121,74,309,196,113,188,124,64,27,11,16,23,36,29,7,78,77,1,30,130,127,93,34,52,8,6,10,3,7,,,
"Aug 8, 2022 7:00 PM",89,35,54,171,98,73,327,200,127,161,95,66,30,18,12,20,29,25,4,43,40,3,20,73,145,98,47,60,5,6,8,6,2,,,
"Aug 8, 2022 8:00 PM",89,29,60,148,68,80,257,110,147,134,61,73,13,5,8,13,17,17,0,19,17,2,17,38,120,51,69,56,6,4,4,1,3,,,
"Aug 8, 2022 9:00 PM",67,18,49,50,20,30,111,29,82,49,17,32,11,5,6,21,17,16,1,19,19,0,14,26,67,17,50,46,9,2,8,3,5,,,
"Aug 8, 2022 10:00 PM",21,4,17,15,11,4,23,9,14,20,8,12,5,5,0,2,6,4,2,10,10,0,8,8,15,13,2,23,0,1,2,1,1,,,
"Aug 8, 2022 11:00 PM",13,4,9,3,1,2,7,5,2,5,1,4,0,0,0,0,2,2,0,4,4,0,2,8,4,3,1,3,0,0,5,5,0,,,
"Aug 9, 2022 12:00 AM",9,3,6,0,0,0,3,0,3,5,3,2,2,0,2,1,0,0,0,4,4,0,1,4,2,1,1,7,0,1,1,0,1,,,
"Aug 9, 2022 1:00 AM",2,0,2,1,0,1,3,1,2,3,1,2,0,0,0,1,0,0,0,3,2,1,0,0,0,0,0,3,0,0,0,0,0,,,
"Aug 9, 2022 2:00 AM",4,3,1,0,0,0,0,0,0,0,0,0,0,0,0,0,0,0,0,0,0,0,0,0,0,0,0,1,0,0,0,0,0,,,
"Aug 9, 2022 3:00 AM",2,1,1,0,0,0,0,0,0,0,0,0,0,0,0,0,0,0,0,0,0,0,0,0,0,0,0,0,0,0,0,0,0,,,
"Aug 9, 2022 4:00 AM",1,0,1,1,0,1,1,1,0,1,1,0,0,0,0,0,1,0,1,1,1,0,1,0,0,0,0,1,0,1,0,0,0,,,
"Aug 9, 2022 5:00 AM",5,2,3,4,0,4,4,1,3,4,1,3,2,2,0,0,8,8,0,2,2,0,7,4,0,0,0,11,0,0,0,0,0,,,
"Aug 9, 2022 6:00 AM",53,32,21,24,12,12,46,24,22,28,12,16,4,4,0,9,23,23,0,11,7,4,21,23,12,8,4,42,1,5,0,0,0,,,
"Aug 9, 2022 7:00 AM",132,86,46,67,25,42,131,54,77,79,39,40,12,9,3,19,100,99,1,29,23,6,93,48,42,12,30,137,4,4,10,8,2,,,
"Aug 9, 2022 8:00 AM",243,187,56,77,18,59,162,58,104,89,38,51,24,21,3,24,127,126,1,26,18,8,124,58,79,29,50,203,6,5,4,3,1,,,
"Aug 9, 2022 9:00 AM",117,95,22,85,36,49,135,78,57,96,62,34,21,10,11,20,60,59,1,28,22,6,51,43,63,40,23,70,2,10,11,6,5,,,
"Aug 9, 2022 10:00 AM",52,37,15,67,34,33,132,85,47,68,44,24,9,8,1,8,29,28,1,16,13,3,23,25,67,36,31,41,7,4,4,3,1,,,
"Aug 9, 2022 11:00 AM",39,21,18,64,29,35,112,57,55,67,35,32,15,5,10,16,25,23,2,11,7,4,19,20,40,20,20,28,3,5,2,2,0,,,
"Aug 9, 2022 12:00 PM",61,33,28,117,62,55,157,81,76,104,61,43,24,13,11,17,21,18,3,11,11,0,18,34,56,28,28,36,6,3,6,5,1,,,
"Aug 9, 2022 1:00 PM",73,28,45,110,59,51,140,72,68,106,55,51,18,8,10,20,25,22,3,30,25,5,20,46,62,35,27,39,5,7,9,7,2,,,
"Aug 9, 2022 2:00 PM",66,31,35,91,51,40,109,68,41,87,56,31,17,8,9,21,17,16,1,19,17,2,15,26,46,32,14,41,4,2,7,5,2,,,
"Aug 9, 2022 3:00 PM",64,33,31,127,73,54,114,66,48,113,59,54,23,10,13,17,19,15,4,19,17,2,18,54,51,34,17,34,4,3,7,2,5,,,
"Aug 9, 2022 4:00 PM",141,28,113,130,77,53,140,88,52,149,95,54,31,10,21,28,21,17,4,59,58,1,18,80,72,48,24,55,11,3,8,3,5,,,
"Aug 9, 2022 5:00 PM",228,70,158,232,133,99,301,188,113,230,130,100,34,14,20,27,46,42,4,93,85,8,38,163,129,95,34,97,19,8,9,5,4,,,
"Aug 9, 2022 6:00 PM",211,59,152,255,148,107,359,256,103,230,139,91,31,13,18,29,51,47,4,106,103,3,39,192,153,116,37,81,12,6,13,10,3,,,
"Aug 9, 2022 7:00 PM",117,55,62,249,130,119,380,206,174,222,122,100,14,10,4,16,4,4,0,43,41,2,32,100,144,90,54,68,7,9,9,7,2,,,
"Aug 9, 2022 8:00 PM",119,46,73,171,80,91,302,142,160,149,69,80,12,5,7,15,22,18,4,31,30,1,17,45,110,56,54,76,7,4,4,2,2,,,
"Aug 9, 2022 9:00 PM",61,15,46,91,35,56,179,55,124,81,25,56,17,11,6,13,19,16,3,23,20,3,15,26,90,35,55,52,3,4,2,1,1,,,
"Aug 9, 2022 10:00 PM",38,12,26,28,18,10,47,16,31,34,8,26,5,1,4,7,10,8,2,12,11,1,8,11,17,8,9,24,2,2,1,1,0,,,
"Aug 9, 2022 11:00 PM",13,3,10,5,4,1,17,5,12,12,3,9,8,1,7,3,3,2,1,7,7,0,2,5,13,8,5,10,0,0,2,2,0,,,
"Aug 10, 2022 12:00 AM",10,0,10,0,0,0,7,4,3,4,1,3,0,0,0,0,4,4,0,4,3,1,4,7,6,4,2,5,1,0,0,0,0,,,
"Aug 10, 2022 1:00 AM",1,0,1,2,0,2,3,3,0,3,3,0,1,1,0,3,3,1,2,1,1,0,2,3,1,1,0,0,0,0,0,0,0,,,
"Aug 10, 2022 2:00 AM",6,3,3,0,0,0,0,0,0,0,0,0,0,0,0,0,0,0,0,1,1,0,0,1,0,0,0,1,0,0,0,0,0,,,
"Aug 10, 2022 3:00 AM",0,0,0,0,0,0,0,0,0,0,0,0,0,0,0,0,0,0,0,2,2,0,1,1,0,0,0,0,0,0,0,0,0,,,
"Aug 10, 2022 4:00 AM",2,2,0,1,0,1,2,1,1,2,1,1,0,0,0,0,0,0,0,0,0,0,0,0,0,0,0,0,0,0,1,1,0,,,
"Aug 10, 2022 5:00 AM",8,5,3,1,1,0,3,3,0,1,1,0,0,0,0,0,4,4,0,2,2,0,4,7,2,2,0,7,0,0,0,0,0,,,
"Aug 10, 2022 6:00 AM",61,36,25,34,19,15,46,24,22,34,17,17,3,3,0,9,23,23,0,13,9,4,22,21,11,6,5,44,3,2,1,1,0,,,
"Aug 10, 2022 7:00 AM",140,91,49,82,34,48,119,54,65,79,34,45,8,5,3,20,86,86,0,22,18,4,82,32,38,20,18,135,4,4,9,3,6,,,
"Aug 10, 2022 8:00 AM",228,174,54,96,23,73,188,78,110,123,55,68,20,16,4,20,136,135,1,30,22,8,126,65,79,33,46,203,4,6,4,2,2,,,
"Aug 10, 2022 9:00 AM",111,71,40,75,31,44,131,71,60,84,56,28,16,11,5,11,42,42,0,15,12,3,40,31,62,35,27,74,4,6,7,6,1,,,
"Aug 10, 2022 10:00 AM",78,57,21,93,50,43,131,82,49,73,45,28,14,5,9,16,27,26,1,10,9,1,18,33,48,32,16,28,3,3,0,0,0,,,
"Aug 10, 2022 11:00 AM",44,23,21,85,45,40,154,95,59,85,51,34,19,4,15,17,18,17,1,8,6,2,17,30,69,42,27,36,3,4,5,4,1,,,
"Aug 10, 2022 12:00 PM",42,24,18,87,49,38,186,110,76,92,55,37,28,13,15,13,20,19,1,15,14,1,18,48,74,47,27,31,2,5,6,6,0,,,
"Aug 10, 2022 1:00 PM",86,37,49,129,72,57,197,92,105,116,60,56,28,11,17,15,22,19,3,28,25,3,20,34,84,46,38,35,8,1,5,3,2,,,
"Aug 10, 2022 2:00 PM",60,32,28,109,44,65,145,80,65,92,48,44,22,15,7,12,21,21,0,27,27,0,20,33,72,46,26,39,3,8,8,5,3,,,
"Aug 10, 2022 3:00 PM",84,41,43,129,77,52,151,85,66,114,81,33,28,13,15,25,19,16,3,26,25,1,13,54,79,58,21,41,11,5,4,0,4,,,
"Aug 10, 2022 4:00 PM",112,33,79,150,76,74,179,94,85,141,76,65,26,6,20,26,27,23,4,56,53,3,23,71,65,37,28,60,6,6,11,8,3,,,
"Aug 10, 2022 5:00 PM",232,56,176,206,112,94,266,164,102,195,118,77,31,9,22,23,46,44,2,100,92,8,43,160,140,99,41,85,7,7,7,2,5,,,
"Aug 10, 2022 6:00 PM",213,67,146,259,166,93,374,254,120,285,194,91,30,13,17,22,39,32,7,89,88,1,30,191,165,123,42,75,7,8,12,8,4,,,
"Aug 10, 2022 7:00 PM",84,33,51,258,130,128,314,188,126,214,123,91,14,6,8,20,35,33,2,36,34,2,28,96,122,89,33,63,12,7,12,8,4,,,
"Aug 10, 2022 8:00 PM",82,28,54,216,86,130,315,131,184,201,79,122,19,15,4,20,25,23,2,21,20,1,20,59,151,53,98,94,7,8,9,3,6,,,
"Aug 10, 2022 9:00 PM",75,18,57,88,35,53,213,64,149,105,26,79,13,10,3,6,20,15,5,29,29,0,16,26,85,28,57,100,8,3,11,7,4,,,
"Aug 10, 2022 10:00 PM",28,8,20,41,18,23,51,11,40,39,12,27,6,3,3,10,14,14,0,16,15,1,14,20,30,17,13,28,1,0,1,1,0,,,
"Aug 10, 2022 11:00 PM",16,2,14,14,6,8,26,11,15,19,3,16,3,1,2,2,5,5,0,5,5,0,5,12,8,6,2,10,1,0,2,0,2,,,
"Aug 11, 2022 12:00 AM",12,3,9,0,0,0,5,3,2,5,1,4,3,2,1,1,6,5,1,11,11,0,5,6,5,3,2,4,1,0,0,0,0,,,
"Aug 11, 2022 1:00 AM",3,1,2,3,3,0,3,1,2,3,1,2,0,0,0,0,1,1,0,1,1,0,1,2,3,2,1,5,0,0,0,0,0,,,
"Aug 11, 2022 2:00 AM",8,5,3,0,0,0,1,0,1,1,0,1,0,0,0,0,1,1,0,1,1,0,1,0,0,0,0,0,0,0,0,0,0,,,
"Aug 11, 2022 3:00 AM",0,0,0,0,0,0,0,0,0,0,0,0,1,0,1,0,0,0,0,0,0,0,1,1,0,0,0,1,0,0,0,0,0,,,
"Aug 11, 2022 4:00 AM",1,1,0,1,0,1,2,1,1,2,1,1,0,0,0,1,1,1,0,0,0,0,1,1,0,0,0,1,1,0,0,0,0,,,
"Aug 11, 2022 5:00 AM",7,4,3,4,2,2,8,3,5,5,2,3,2,2,0,3,11,11,0,3,3,0,10,6,1,0,1,14,0,1,0,0,0,,,
"Aug 11, 2022 6:00 AM",43,23,20,34,16,18,41,20,21,37,18,19,5,4,1,11,18,18,0,9,6,3,21,31,18,10,8,48,1,3,3,3,0,,,
"Aug 11, 2022 7:00 AM",126,80,46,84,34,50,106,42,64,77,37,40,7,5,2,14,80,80,0,16,12,4,74,39,50,17,33,102,6,4,7,7,0,,,
"Aug 11, 2022 8:00 AM",239,169,70,109,29,80,122,57,65,97,48,49,21,14,7,17,132,132,0,21,18,3,121,54,63,28,35,158,9,7,5,3,2,,,
"Aug 11, 2022 9:00 AM",115,83,32,85,33,52,124,71,53,90,58,32,21,15,6,15,65,64,1,22,15,7,55,44,50,38,12,72,6,5,12,7,5,,,
"Aug 11, 2022 10:00 AM",56,38,18,90,51,39,123,79,44,77,56,21,13,8,5,11,20,19,1,12,9,3,16,33,52,39,13,34,1,5,5,4,1,,,
"Aug 11, 2022 11:00 AM",46,20,26,109,59,50,156,99,57,86,44,42,34,16,18,12,23,21,2,14,12,2,23,18,76,50,26,42,3,4,2,2,0,,,
"Aug 11, 2022 12:00 PM",66,36,30,114,52,62,223,142,81,91,50,41,20,10,10,13,15,13,2,19,17,2,10,48,92,48,44,36,6,3,4,4,0,,,
"Aug 11, 2022 1:00 PM",74,36,38,100,51,49,209,95,114,81,50,31,22,6,16,10,27,22,5,20,20,0,23,33,75,47,28,37,4,1,8,5,3,,,
"Aug 11, 2022 2:00 PM",69,32,37,93,53,40,148,87,61,84,52,32,11,5,6,8,17,13,4,19,16,3,13,41,69,43,26,45,2,2,5,3,2,,,
"Aug 11, 2022 3:00 PM",95,42,53,120,69,51,142,67,75,89,55,34,30,13,17,19,24,21,3,39,34,5,15,43,68,46,22,43,8,6,10,8,2,,,
"Aug 11, 2022 4:00 PM",122,35,87,154,75,79,175,110,65,150,92,58,24,9,15,25,30,28,2,48,48,0,29,87,96,62,34,54,9,5,6,3,3,,,
"Aug 11, 2022 5:00 PM",187,53,134,254,135,119,276,178,98,251,171,80,42,13,29,31,42,34,8,72,69,3,33,151,149,103,46,90,9,5,9,6,3,,,
"Aug 11, 2022 6:00 PM",168,54,114,271,176,95,316,199,117,250,163,87,33,14,19,19,36,32,4,66,62,4,31,152,131,98,33,79,6,7,12,8,4,,,
"Aug 11, 2022 7:00 PM",94,42,52,257,142,115,328,175,153,242,134,108,27,21,6,14,25,24,1,38,37,1,25,87,166,102,64,70,6,8,13,7,6,,,
"Aug 11, 2022 8:00 PM",82,29,53,210,82,128,279,117,162,209,65,144,15,7,8,17,26,25,1,24,24,0,22,40,106,42,64,88,3,4,10,6,4,,,
"Aug 11, 2022 9:00 PM",59,17,42,103,42,61,147,48,99,83,21,62,15,3,12,18,16,14,2,18,15,3,18,20,66,23,43,63,3,2,5,3,2,,,
"Aug 11, 2022 10:00 PM",52,15,37,39,23,16,64,20,44,30,4,26,11,5,6,6,9,8,1,15,14,1,11,16,26,18,8,43,0,2,5,3,2,,,
"Aug 11, 2022 11:00 PM",29,5,24,17,8,9,24,8,16,21,7,14,5,2,3,2,8,6,2,8,8,0,5,22,8,3,5,10,1,0,0,0,0,,,
"Aug 12, 2022 12:00 AM",13,2,11,1,1,0,12,5,7,18,4,14,2,1,1,4,2,2,0,13,12,1,2,9,4,2,2,11,0,0,0,0,0,,,
"Aug 12, 2022 1:00 AM",2,1,1,2,0,2,3,0,3,3,1,2,2,1,1,0,0,0,0,4,3,1,0,2,2,0,2,4,0,1,0,0,0,,,
"Aug 12, 2022 2:00 AM",9,5,4,2,1,1,0,0,0,1,1,0,0,0,0,0,0,0,0,4,3,1,0,2,0,0,0,0,0,0,0,0,0,,,
"Aug 12, 2022 3:00 AM",1,0,1,0,0,0,0,0,0,3,1,2,0,0,0,0,0,0,0,1,1,0,0,3,2,1,1,1,0,0,0,0,0,,,
"Aug 12, 2022 4:00 AM",2,2,0,3,1,2,3,3,0,3,1,2,0,0,0,0,1,1,0,0,0,0,2,2,1,1,0,2,0,0,0,0,0,,,
"Aug 12, 2022 5:00 AM",5,1,4,3,2,1,6,3,3,5,2,3,0,0,0,1,9,9,0,2,1,1,9,3,4,4,0,10,1,0,0,0,0,,,
"Aug 12, 2022 6:00 AM",48,26,22,43,26,17,41,19,22,41,27,14,2,1,1,4,16,15,1,10,7,3,15,17,9,7,2,26,1,2,6,6,0,,,
"Aug 12, 2022 7:00 AM",85,55,30,89,43,46,83,35,48,72,39,33,6,4,2,11,59,59,0,16,13,3,46,42,28,10,18,67,1,8,5,2,3,,,
"Aug 12, 2022 8:00 AM",142,97,45,119,34,85,136,51,85,118,51,67,11,10,1,11,83,80,3,20,16,4,76,44,52,23,29,115,2,6,4,0,4,,,
"Aug 12, 2022 9:00 AM",85,57,28,108,41,67,125,64,61,106,63,43,27,19,8,17,41,41,0,15,12,3,34,40,54,37,17,61,4,2,3,1,2,,,
"Aug 12, 2022 10:00 AM",48,30,18,75,41,34,123,82,41,67,39,28,24,15,9,8,24,24,0,10,8,2,21,25,53,36,17,27,0,5,1,1,0,,,
"Aug 12, 2022 11:00 AM",54,31,23,92,54,38,144,100,44,75,47,28,17,4,13,14,20,18,2,11,10,1,16,37,63,46,17,32,1,5,2,1,1,,,
"Aug 12, 2022 12:00 PM",68,28,40,135,65,70,241,148,93,108,60,48,23,11,12,18,22,20,2,16,14,2,19,64,94,58,36,47,2,0,8,6,2,,,
"Aug 12, 2022 1:00 PM",72,37,35,115,61,54,260,152,108,126,67,59,24,15,9,24,21,19,2,18,17,1,19,63,94,57,37,36,8,6,11,6,5,,,
"Aug 12, 2022 2:00 PM",69,36,33,150,77,73,265,146,119,120,71,49,20,12,8,16,22,21,1,29,27,2,19,59,100,80,20,54,8,1,14,11,3,,,
"Aug 12, 2022 3:00 PM",92,38,54,139,80,59,206,121,85,126,69,57,19,5,14,15,22,16,6,18,16,2,11,49,103,77,26,67,3,2,8,2,6,,,
"Aug 12, 2022 4:00 PM",129,54,75,167,89,78,254,130,124,164,89,75,26,7,19,27,27,25,2,55,50,5,23,81,114,70,44,91,7,3,9,4,5,,,
"Aug 12, 2022 5:00 PM",157,57,100,201,128,73,250,130,120,194,113,81,27,11,16,16,23,19,4,47,43,4,17,89,151,94,57,74,8,6,13,6,7,,,
"Aug 12, 2022 6:00 PM",89,35,54,195,118,77,257,128,129,194,119,75,38,17,21,14,31,28,3,30,28,2,31,89,95,49,46,76,9,5,15,6,9,,,
"Aug 12, 2022 7:00 PM",77,30,47,190,77,113,182,89,93,141,61,80,16,5,11,15,21,17,4,30,27,3,18,45,68,39,29,61,6,4,15,5,10,,,
"Aug 12, 2022 8:00 PM",56,24,32,128,56,72,129,62,67,112,50,62,24,13,11,10,21,19,2,20,19,1,18,24,73,35,38,60,1,3,8,4,4,,,
"Aug 12, 2022 9:00 PM",50,11,39,40,24,16,110,34,76,47,12,35,16,12,4,9,11,9,2,18,17,1,8,16,34,15,19,50,3,1,5,2,3,,,
"Aug 12, 2022 10:00 PM",27,7,20,38,9,29,36,12,24,42,9,33,19,12,7,2,16,14,2,7,5,2,11,13,14,9,5,23,0,2,3,1,2,,,
"Aug 12, 2022 11:00 PM",18,6,12,9,3,6,27,7,20,13,4,9,3,1,2,3,8,8,0,9,8,1,6,10,7,6,1,14,0,2,2,1,1,,,
"Aug 13, 2022 12:00 AM",19,3,16,1,1,0,11,5,6,11,8,3,1,0,1,1,4,4,0,7,7,0,4,6,5,5,0,14,0,1,2,1,1,,,
"Aug 13, 2022 1:00 AM",8,3,5,4,1,3,8,4,4,7,3,4,1,0,1,5,1,0,1,6,5,1,0,8,1,1,0,6,0,0,0,0,0,,,
"Aug 13, 2022 2:00 AM",9,2,7,1,1,0,2,1,1,2,2,0,0,0,0,0,4,4,0,4,3,1,2,1,0,0,0,6,0,0,0,0,0,,,
"Aug 13, 2022 3:00 AM",6,1,5,0,0,0,2,1,1,1,0,1,0,0,0,0,0,0,0,0,0,0,0,2,0,0,0,2,0,0,1,1,0,,,
"Aug 13, 2022 4:00 AM",3,1,2,1,0,1,2,1,1,1,0,1,1,0,1,0,1,1,0,0,0,0,1,3,2,2,0,1,0,0,0,0,0,,,
"Aug 13, 2022 5:00 AM",3,0,3,0,0,0,4,1,3,2,0,2,0,0,0,1,2,2,0,2,1,1,2,1,3,3,0,3,2,1,1,1,0,,,
"Aug 13, 2022 6:00 AM",17,10,7,8,3,5,8,3,5,8,4,4,0,0,0,0,8,8,0,5,5,0,8,2,1,0,1,8,2,2,0,0,0,,,
"Aug 13, 2022 7:00 AM",21,8,13,50,34,16,47,30,17,49,34,15,2,1,1,6,17,17,0,9,5,4,17,26,14,6,8,27,3,2,4,4,0,,,
"Aug 13, 2022 8:00 AM",41,21,20,126,73,53,97,64,33,98,71,27,11,4,7,13,15,15,0,11,11,0,14,36,25,17,8,32,5,3,1,0,1,,,
"Aug 13, 2022 9:00 AM",52,26,26,123,63,60,128,76,52,126,83,43,17,7,10,9,20,20,0,15,11,4,17,51,60,45,15,37,5,5,3,2,1,,,
"Aug 13, 2022 10:00 AM",58,34,24,154,99,55,185,120,65,152,102,50,25,15,10,10,22,22,0,12,10,2,21,69,86,52,34,39,6,2,3,1,2,,,
"Aug 13, 2022 11:00 AM",54,30,24,218,107,111,240,126,114,164,96,68,31,20,11,19,16,16,0,27,25,2,14,75,112,78,34,50,11,4,7,4,3,,,
"Aug 13, 2022 12:00 PM",82,38,44,221,99,122,334,218,116,238,166,72,28,18,10,17,23,22,1,14,14,0,21,90,172,115,57,68,10,3,14,11,3,,,
"Aug 13, 2022 1:00 PM",74,43,31,216,120,96,350,214,136,215,140,75,32,12,20,9,30,29,1,16,14,2,28,75,192,126,66,74,9,9,16,13,3,,,
"Aug 13, 2022 2:00 PM",65,27,38,224,124,100,353,201,152,159,86,73,22,13,9,15,19,19,0,13,11,2,17,84,178,124,54,66,9,4,14,9,5,,,
"Aug 13, 2022 3:00 PM",68,40,28,196,112,84,325,168,157,226,139,87,37,13,24,13,28,26,2,18,17,1,24,52,128,74,54,69,9,15,12,9,3,,,
"Aug 13, 2022 4:00 PM",55,19,36,212,97,115,295,127,168,201,98,103,19,8,11,26,36,35,1,15,12,3,34,46,130,67,63,82,4,5,5,2,3,,,
"Aug 13, 2022 5:00 PM",54,19,35,181,91,90,230,80,150,193,76,117,30,22,8,20,20,20,0,17,16,1,21,27,124,45,79,75,4,5,7,3,4,,,
"Aug 13, 2022 6:00 PM",51,27,24,152,70,82,188,69,119,156,62,94,23,15,8,21,17,17,0,13,13,0,17,24,91,33,58,65,4,4,5,2,3,,,
"Aug 13, 2022 7:00 PM",60,22,38,102,51,51,136,54,82,110,43,67,15,9,6,12,8,8,0,7,6,1,12,28,62,28,34,44,4,9,6,4,2,,,
"Aug 13, 2022 8:00 PM",31,15,16,72,44,28,74,27,47,62,29,33,16,8,8,6,24,23,1,11,11,0,19,11,60,12,48,31,2,3,10,3,7,,,
"Aug 13, 2022 9:00 PM",29,12,17,40,18,22,43,10,33,54,19,35,9,6,3,11,15,13,2,7,6,1,16,10,18,12,6,22,1,0,2,0,2,,,
"Aug 13, 2022 10:00 PM",35,11,24,8,3,5,26,8,18,28,3,25,5,3,2,5,9,9,0,8,8,0,8,6,11,7,4,11,0,2,4,3,1,,,
"Aug 13, 2022 11:00 PM",14,7,7,12,4,8,12,7,5,14,3,11,5,4,1,4,3,3,0,8,8,0,3,6,5,4,1,4,0,0,0,0,0,,,
"Aug 14, 2022 12:00 AM",19,6,13,0,0,0,23,10,13,14,1,13,0,0,0,7,2,2,0,6,6,0,2,6,13,7,6,13,0,0,2,1,1,,,
"Aug 14, 2022 1:00 AM",13,3,10,4,2,2,7,3,4,3,0,3,2,2,0,2,1,1,0,7,7,0,1,7,3,1,2,3,0,2,0,0,0,,,
"Aug 14, 2022 2:00 AM",4,1,3,2,2,0,5,3,2,7,4,3,0,0,0,1,1,1,0,3,3,0,1,2,1,1,0,2,0,0,0,0,0,,,
"Aug 14, 2022 3:00 AM",3,1,2,0,0,0,1,1,0,1,0,1,0,0,0,0,0,0,0,5,5,0,1,2,6,4,2,2,0,0,0,0,0,,,
"Aug 14, 2022 4:00 AM",2,0,2,1,0,1,4,3,1,2,1,1,0,0,0,0,1,0,1,0,0,0,0,1,1,1,0,0,0,0,0,0,0,,,
"Aug 14, 2022 5:00 AM",0,0,0,1,0,1,1,0,1,3,1,2,0,0,0,1,1,1,0,0,0,0,1,0,0,0,0,2,2,0,1,1,0,,,
"Aug 14, 2022 6:00 AM",3,2,1,5,3,2,7,6,1,4,4,0,1,0,1,0,5,5,0,2,2,0,4,4,1,1,0,7,0,0,0,0,0,,,
"Aug 14, 2022 7:00 AM",20,8,12,21,14,7,21,12,9,25,15,10,0,0,0,4,8,7,1,7,6,1,6,12,6,3,3,19,1,1,2,0,2,,,
"Aug 14, 2022 8:00 AM",38,15,23,127,81,46,91,55,36,106,77,29,4,2,2,18,19,19,0,8,8,0,17,39,29,22,7,22,5,9,1,1,0,,,
"Aug 14, 2022 9:00 AM",46,27,19,137,67,70,123,83,40,127,83,44,14,11,3,15,16,16,0,17,12,5,15,31,39,28,11,24,7,10,3,2,1,,,
"Aug 14, 2022 10:00 AM",53,30,23,173,95,78,188,109,79,159,96,63,20,10,10,18,28,28,0,9,6,3,29,47,95,58,37,38,27,13,9,5,4,,,
"Aug 14, 2022 11:00 AM",55,32,23,254,116,138,250,128,122,223,121,102,27,11,16,14,14,14,0,18,14,4,12,46,86,62,24,50,9,10,5,3,2,,,
"Aug 14, 2022 12:00 PM",57,27,30,204,93,111,217,112,105,201,103,98,40,21,19,14,27,25,2,18,15,3,23,66,138,91,47,59,6,1,9,3,6,,,
"Aug 14, 2022 1:00 PM",78,49,29,238,120,118,301,172,129,217,119,98,28,11,17,21,42,41,1,15,12,3,39,64,162,98,64,66,5,4,10,4,6,,,
"Aug 14, 2022 2:00 PM",62,30,32,217,104,113,313,167,146,194,103,91,41,23,18,16,22,21,1,11,10,1,18,54,156,103,53,62,8,7,8,4,4,,,
"Aug 14, 2022 3:00 PM",55,34,21,197,102,95,278,134,144,182,77,105,40,28,12,22,24,22,2,16,14,2,24,43,128,64,64,65,3,4,9,5,4,,,
"Aug 14, 2022 4:00 PM",71,36,35,162,71,91,280,109,171,173,75,98,25,15,10,19,30,25,5,21,18,3,22,44,141,73,68,105,9,2,19,10,9,,,
"Aug 14, 2022 5:00 PM",64,22,42,105,59,46,167,60,107,137,66,71,21,12,9,28,11,11,0,24,22,2,11,50,83,30,53,64,0,4,7,5,2,,,
"Aug 14, 2022 6:00 PM",49,20,29,132,60,72,118,50,68,105,46,59,22,7,15,18,13,12,1,10,9,1,12,41,53,24,29,46,5,4,6,3,3,,,
"Aug 14, 2022 7:00 PM",47,18,29,90,56,34,104,49,55,80,42,38,13,10,3,12,17,17,0,15,14,1,12,27,42,21,21,36,5,2,8,6,2,,,
"Aug 14, 2022 8:00 PM",40,15,25,51,21,30,63,23,40,57,15,42,11,3,8,9,33,30,3,8,8,0,30,12,29,13,16,31,3,3,6,3,3,,,
"Aug 14, 2022 9:00 PM",35,10,25,27,13,14,28,9,19,19,9,10,9,7,2,8,9,7,2,9,9,0,9,11,9,6,3,17,2,0,1,0,1,,,
"Aug 14, 2022 10:00 PM",18,7,11,9,5,4,19,10,9,19,9,10,5,3,2,2,6,6,0,5,5,0,8,8,6,5,1,6,0,1,0,0,0,,,
"Aug 14, 2022 11:00 PM",9,1,8,6,2,4,9,3,6,4,1,3,1,1,0,0,3,3,0,8,7,1,2,2,1,1,0,4,0,0,2,1,1,,,
"Aug 15, 2022 12:00 AM",3,0,3,2,0,2,1,0,1,3,2,1,0,0,0,0,1,1,0,4,4,0,1,5,0,0,0,4,0,1,0,0,0,,,
"Aug 15, 2022 1:00 AM",2,0,2,0,0,0,1,0,1,0,0,0,0,0,0,0,0,0,0,3,3,0,0,3,0,0,0,0,0,0,0,0,0,,,
"Aug 15, 2022 2:00 AM",2,0,2,0,0,0,2,1,1,0,0,0,0,0,0,1,0,0,0,0,0,0,0,0,0,0,0,0,0,0,0,0,0,,,
"Aug 15, 2022 3:00 AM",0,0,0,0,0,0,2,1,1,0,0,0,0,0,0,0,0,0,0,0,0,0,0,0,0,0,0,0,0,0,0,0,0,,,
"Aug 15, 2022 4:00 AM",2,0,2,1,0,1,2,1,1,2,1,1,0,0,0,0,1,1,0,0,0,0,1,0,0,0,0,1,0,0,0,0,0,,,
"Aug 15, 2022 5:00 AM",6,3,3,3,1,2,4,2,2,4,2,2,0,0,0,2,7,6,1,1,0,1,6,5,1,0,1,4,0,1,1,1,0,,,
"Aug 15, 2022 6:00 AM",39,23,16,10,4,6,16,9,7,10,4,6,2,1,1,7,27,27,0,9,7,2,25,12,6,3,3,25,1,2,1,0,1,,,
"Aug 15, 2022 7:00 AM",75,47,28,44,11,33,61,21,40,50,17,33,5,3,2,8,46,44,2,12,9,3,35,19,19,7,12,67,2,1,3,3,0,,,
"Aug 15, 2022 8:00 AM",120,94,26,36,17,19,64,28,36,37,22,15,12,9,3,13,74,72,2,19,12,7,73,40,30,12,18,98,4,1,1,1,0,,,
"Aug 15, 2022 9:00 AM",75,58,17,41,12,29,49,23,26,41,24,17,13,11,2,14,44,43,1,13,10,3,38,13,21,11,10,49,3,0,0,0,0,,,
"Aug 15, 2022 10:00 AM",44,30,14,33,18,15,33,19,14,34,19,15,19,12,7,14,20,20,0,6,5,1,17,14,16,7,9,22,0,4,2,1,1,,,
"Aug 15, 2022 11:00 AM",40,27,13,46,27,19,44,24,20,31,18,13,14,6,8,11,9,8,1,7,7,0,8,17,17,7,10,15,5,3,2,1,1,,,
"Aug 15, 2022 12:00 PM",41,22,19,50,26,24,38,25,13,37,20,17,12,7,5,10,8,6,2,3,3,0,8,19,10,10,0,17,4,0,7,3,4,,,
"Aug 15, 2022 1:00 PM",48,20,28,38,15,23,59,26,33,27,12,15,16,9,7,12,9,8,1,10,10,0,7,12,16,12,4,19,3,3,3,2,1,,,
"Aug 15, 2022 2:00 PM",36,21,15,35,17,18,42,25,17,26,14,12,18,11,7,16,21,19,2,13,10,3,14,16,23,12,11,12,4,3,3,1,2,,,
"Aug 15, 2022 3:00 PM",68,36,32,48,35,13,75,45,30,42,24,18,29,14,15,16,12,10,2,18,16,2,12,30,30,21,9,20,6,0,4,3,1,,,
"Aug 15, 2022 4:00 PM",115,30,85,75,40,35,84,46,38,62,38,24,23,11,12,16,22,19,3,27,26,1,20,38,44,27,17,31,8,1,3,2,1,,,
"Aug 15, 2022 5:00 PM",127,41,86,99,54,45,113,66,47,86,53,33,30,13,17,24,34,30,4,57,53,4,30,74,58,36,22,47,3,9,3,2,1,,,
"Aug 15, 2022 6:00 PM",105,26,79,58,31,27,79,40,39,55,25,30,20,5,15,8,22,17,5,50,48,2,15,63,37,22,15,33,1,2,6,4,2,,,
"Aug 15, 2022 7:00 PM",68,17,51,31,20,11,28,19,9,22,8,14,11,7,4,5,16,13,3,30,28,2,13,33,23,17,6,16,3,3,8,5,3,,,
"Aug 15, 2022 8:00 PM",53,18,35,23,14,9,23,16,7,26,14,12,3,1,2,8,12,12,0,11,11,0,9,20,6,6,0,16,2,2,2,2,0,,,
"Aug 15, 2022 9:00 PM",31,6,25,20,15,5,20,11,9,13,9,4,5,3,2,10,9,6,3,11,9,2,8,11,5,3,2,13,6,0,3,2,1,,,
"Aug 15, 2022 10:00 PM",16,8,8,3,3,0,6,4,2,6,6,0,4,3,1,2,5,4,1,13,11,2,4,5,1,1,0,3,2,0,3,1,2,,,
"Aug 15, 2022 11:00 PM",14,6,8,1,1,0,3,2,1,2,1,1,1,1,0,0,2,2,0,2,2,0,2,3,1,0,1,2,0,0,0,0,0,,,
"Aug 16, 2022 12:00 AM",4,2,2,0,0,0,2,1,1,2,1,1,0,0,0,0,0,0,0,3,3,0,0,5,4,3,1,4,1,1,0,0,0,,,
"Aug 16, 2022 1:00 AM",1,0,1,3,3,0,1,1,0,10,7,3,1,1,0,0,0,0,0,0,0,0,0,0,1,1,0,0,0,0,0,0,0,,,
"Aug 16, 2022 2:00 AM",7,5,2,2,2,0,0,0,0,0,0,0,0,0,0,0,1,1,0,1,1,0,1,0,0,0,0,0,0,0,0,0,0,,,
"Aug 16, 2022 3:00 AM",0,0,0,0,0,0,0,0,0,0,0,0,0,0,0,0,0,0,0,1,1,0,0,0,0,0,0,0,0,0,0,0,0,,,
"Aug 16, 2022 4:00 AM",1,1,0,0,0,0,1,1,0,1,1,0,0,0,0,1,2,2,0,0,0,0,2,1,0,0,0,0,0,0,0,0,0,,,
"Aug 16, 2022 5:00 AM",6,5,1,3,2,1,1,0,1,2,2,0,1,1,0,0,9,9,0,2,1,1,7,1,1,1,0,9,0,1,0,0,0,,,
"Aug 16, 2022 6:00 AM",59,36,23,19,8,11,26,11,15,22,11,11,2,2,0,11,17,17,0,9,6,3,21,19,7,2,5,39,1,2,2,2,0,,,
"Aug 16, 2022 7:00 AM",119,77,42,42,12,30,85,33,52,60,21,39,11,9,2,13,75,74,1,22,17,5,68,37,40,16,24,102,7,4,7,7,0,,,
"Aug 16, 2022 8:00 AM",223,171,52,83,16,67,119,35,84,93,39,54,13,10,3,30,133,130,3,18,15,3,129,48,54,14,40,188,2,5,4,2,2,,,
"Aug 16, 2022 9:00 AM",111,93,18,57,25,32,71,38,33,66,40,26,7,6,1,15,66,66,0,20,15,5,53,31,35,22,13,87,2,7,5,2,3,,,
"Aug 16, 2022 10:00 AM",60,49,11,44,19,25,45,26,19,45,24,21,9,9,0,15,26,26,0,15,12,3,18,19,20,11,9,35,4,4,2,2,0,,,
"Aug 16, 2022 11:00 AM",34,21,13,41,19,22,53,23,30,49,25,24,13,8,5,23,18,16,2,9,8,1,17,11,26,10,16,24,2,2,1,0,1,,,
"Aug 16, 2022 12:00 PM",60,37,23,39,21,18,46,27,19,33,20,13,13,7,6,4,20,18,2,13,11,2,16,17,23,14,9,26,1,3,8,6,2,,,
"Aug 16, 2022 1:00 PM",76,30,46,51,32,19,79,42,37,55,24,31,17,2,15,20,21,18,3,24,24,0,15,28,32,20,12,26,4,5,8,6,2,,,
"Aug 16, 2022 2:00 PM",73,39,34,49,27,22,56,31,25,35,23,12,14,11,3,27,16,14,2,17,14,3,13,21,35,19,16,24,6,5,5,3,2,,,
"Aug 16, 2022 3:00 PM",78,31,47,70,33,37,68,37,31,61,33,28,18,9,9,18,18,17,1,21,19,2,20,31,43,26,17,26,2,4,2,1,1,,,
"Aug 16, 2022 4:00 PM",137,32,105,42,20,22,83,47,36,56,34,22,29,13,16,27,21,19,2,51,48,3,18,58,42,27,15,56,11,3,5,4,1,,,
"Aug 16, 2022 5:00 PM",205,51,154,95,55,40,121,74,47,94,53,41,23,4,19,25,35,25,10,93,86,7,22,131,75,51,24,57,8,3,13,10,3,,,
"Aug 16, 2022 6:00 PM",215,55,160,83,59,24,139,99,40,101,70,31,22,14,8,23,53,48,5,68,68,0,41,118,72,52,20,47,3,9,12,10,2,,,
"Aug 16, 2022 7:00 PM",108,41,67,76,43,33,100,57,43,71,43,28,18,9,9,22,28,26,2,33,29,4,22,58,37,28,9,33,10,4,13,4,9,,,
"Aug 16, 2022 8:00 PM",88,27,61,56,35,21,58,29,29,53,29,24,8,4,4,23,14,13,1,35,33,2,14,22,36,16,20,21,6,5,6,2,4,,,
"Aug 16, 2022 9:00 PM",58,20,38,29,21,8,38,18,20,29,15,14,8,4,4,18,15,11,4,17,17,0,12,13,7,5,2,24,2,1,4,3,1,,,
"Aug 16, 2022 10:00 PM",29,7,22,18,12,6,20,12,8,12,5,7,4,0,4,3,7,7,0,10,8,2,8,7,5,5,0,14,3,1,1,0,1,,,
"Aug 16, 2022 11:00 PM",13,5,8,2,1,1,11,6,5,10,8,2,0,0,0,2,2,2,0,10,9,1,1,7,2,2,0,5,0,1,1,0,1,,,
"Aug 17, 2022 12:00 AM",7,2,5,0,0,0,8,5,3,4,1,3,4,2,2,6,1,1,0,4,4,0,1,6,2,2,0,4,1,3,1,1,0,,,
"Aug 17, 2022 1:00 AM",5,0,5,1,1,0,0,0,0,0,0,0,2,0,2,0,1,0,1,2,2,0,0,2,0,0,0,0,0,0,0,0,0,,,
"Aug 17, 2022 2:00 AM",5,4,1,0,0,0,0,0,0,0,0,0,0,0,0,0,1,1,0,0,0,0,1,1,0,0,0,0,0,0,0,0,0,,,
"Aug 17, 2022 3:00 AM",3,1,2,0,0,0,1,1,0,1,1,0,2,2,0,0,0,0,0,1,1,0,1,1,0,0,0,0,0,0,0,0,0,,,
"Aug 17, 2022 4:00 AM",1,0,1,2,0,2,4,2,2,4,2,2,1,1,0,0,2,2,0,0,0,0,3,1,0,0,0,1,0,0,0,0,0,,,
"Aug 17, 2022 5:00 AM",4,2,2,2,2,0,5,3,2,5,4,1,2,0,2,2,7,7,0,1,0,1,7,3,1,1,0,9,0,0,2,2,0,,,
"Aug 17, 2022 6:00 AM",49,29,20,19,10,9,19,7,12,15,7,8,2,2,0,7,19,19,0,8,6,2,17,21,3,3,0,33,2,2,6,4,2,,,
"Aug 17, 2022 7:00 AM",123,80,43,60,23,37,73,24,49,69,30,39,8,5,3,10,87,86,1,17,15,2,79,40,26,24,2,104,7,4,9,9,0,,,
"Aug 17, 2022 8:00 AM",221,158,63,63,11,52,87,31,56,70,28,42,20,16,4,34,136,136,0,32,23,9,128,58,66,52,14,177,6,3,5,5,0,,,
"Aug 17, 2022 9:00 AM",107,80,27,51,16,35,52,28,24,46,28,18,18,14,4,20,51,51,0,18,17,1,50,19,23,13,10,60,2,5,4,3,1,,,
"Aug 17, 2022 10:00 AM",59,42,17,40,16,24,45,18,27,42,25,17,14,6,8,10,27,27,0,9,8,1,24,12,29,27,2,22,4,2,3,2,1,,,
"Aug 17, 2022 11:00 AM",50,28,22,25,14,11,31,15,16,24,12,12,4,1,3,4,19,17,2,10,8,2,10,4,11,11,0,24,10,2,6,6,0,,,
"Aug 17, 2022 12:00 PM",41,26,15,24,9,15,28,17,11,22,10,12,5,1,4,14,17,15,2,7,6,1,12,10,20,16,4,18,7,0,10,8,2,,,
"Aug 17, 2022 1:00 PM",75,32,43,20,12,8,45,29,16,25,15,10,7,3,4,7,18,16,2,16,15,1,13,21,21,18,3,16,1,3,1,1,0,,,
"Aug 17, 2022 2:00 PM",68,33,35,30,16,14,49,27,22,35,24,11,22,13,9,16,17,13,4,17,16,1,12,24,26,22,4,26,2,2,3,2,1,,,
"Aug 17, 2022 3:00 PM",60,24,36,52,35,17,54,37,17,51,32,19,18,6,12,16,18,15,3,21,20,1,13,25,20,16,4,17,2,1,6,4,2,,,
"Aug 17, 2022 4:00 PM",112,42,70,71,40,31,102,63,39,74,45,29,20,8,12,21,26,20,6,29,28,1,17,53,46,42,4,35,9,6,6,2,4,,,
"Aug 17, 2022 5:00 PM",224,63,161,98,60,38,142,79,63,101,64,37,30,14,16,25,37,31,6,90,88,2,27,105,88,78,10,62,6,7,8,3,5,,,
"Aug 17, 2022 6:00 PM",202,74,128,117,68,49,195,126,69,134,80,54,25,9,16,30,34,31,3,75,74,1,32,133,85,77,8,45,10,9,7,6,1,,,
"Aug 17, 2022 7:00 PM",111,44,67,82,44,38,108,59,49,69,37,32,29,14,15,18,23,21,2,34,34,0,17,45,41,36,5,40,6,8,5,2,3,,,
"Aug 17, 2022 8:00 PM",83,35,48,64,35,29,90,46,44,66,33,33,22,7,15,27,11,9,2,23,22,1,12,28,29,22,7,29,9,2,8,6,2,,,
"Aug 17, 2022 9:00 PM",59,15,44,29,17,12,34,16,18,30,14,16,5,4,1,4,13,12,1,25,24,1,12,16,21,16,5,24,8,2,3,3,0,,,
"Aug 17, 2022 10:00 PM",29,4,25,17,15,2,11,8,3,8,6,2,5,3,2,2,8,8,0,15,13,2,10,11,7,4,3,7,0,0,1,0,1,,,
"Aug 17, 2022 11:00 PM",19,8,11,4,3,1,12,4,8,11,4,7,2,0,2,5,2,2,0,5,5,0,3,16,5,4,1,4,0,0,0,0,0,,,
"Aug 18, 2022 12:00 AM",8,2,6,0,0,0,8,5,3,1,1,0,2,2,0,2,3,3,0,6,5,1,3,9,3,2,1,2,0,1,0,0,0,,,
"Aug 18, 2022 1:00 AM",7,2,5,2,0,2,2,0,2,2,0,2,0,0,0,2,2,1,1,2,2,0,1,1,1,0,1,5,1,0,1,1,0,,,
"Aug 18, 2022 2:00 AM",4,3,1,2,1,1,1,1,0,0,0,0,0,0,0,1,0,0,0,0,0,0,0,2,0,0,0,1,0,1,0,0,0,,,
"Aug 18, 2022 3:00 AM",0,0,0,0,0,0,0,0,0,0,0,0,0,0,0,0,0,0,0,0,0,0,0,1,2,2,0,0,0,0,0,0,0,,,
"Aug 18, 2022 4:00 AM",3,2,1,3,1,2,2,1,1,3,2,1,0,0,0,0,0,0,0,0,0,0,0,0,0,0,0,0,0,1,1,1,0,,,
"Aug 18, 2022 5:00 AM",6,3,3,2,1,1,1,1,0,2,1,1,1,0,1,2,11,11,0,1,0,1,10,2,2,2,0,8,1,1,0,0,0,,,
"Aug 18, 2022 6:00 AM",47,28,19,23,10,13,30,15,15,23,11,12,2,1,1,6,20,20,0,7,3,4,21,25,12,2,10,29,0,2,3,3,0,,,
"Aug 18, 2022 7:00 AM",108,78,30,51,20,31,71,23,48,61,25,36,10,9,1,8,66,65,1,21,15,6,62,36,25,8,17,93,5,6,4,3,1,,,
"Aug 18, 2022 8:00 AM",235,169,66,62,17,45,88,35,53,66,23,43,12,8,4,30,131,131,0,23,20,3,129,47,45,15,30,160,4,3,5,5,0,,,
"Aug 18, 2022 9:00 AM",124,99,25,42,15,27,72,32,40,56,34,22,8,8,0,10,52,52,0,13,11,2,46,21,48,29,19,68,4,6,2,1,1,,,
"Aug 18, 2022 10:00 AM",61,37,24,26,10,16,38,23,15,32,19,13,9,6,3,13,29,29,0,13,10,3,24,15,18,9,9,28,7,2,6,6,0,,,
"Aug 18, 2022 11:00 AM",35,23,12,46,26,20,56,28,28,51,25,26,23,13,10,13,20,18,2,11,9,2,17,10,20,9,11,25,3,3,9,5,4,,,
"Aug 18, 2022 12:00 PM",68,32,36,67,27,40,50,29,21,40,23,17,16,9,7,9,22,21,1,8,8,0,18,17,29,20,9,18,2,2,4,3,1,,,
"Aug 18, 2022 1:00 PM",85,36,49,37,18,19,42,25,17,32,22,10,8,5,3,14,17,13,4,19,17,2,12,21,27,19,8,18,2,4,6,5,1,,,
"Aug 18, 2022 2:00 PM",52,21,31,26,13,13,40,23,17,32,17,15,7,5,2,20,25,22,3,15,14,1,17,20,16,9,7,26,6,3,5,3,2,,,
"Aug 18, 2022 3:00 PM",72,34,38,42,23,19,56,35,21,42,31,11,14,6,8,13,16,15,1,19,18,1,15,26,127,70,57,24,4,4,3,3,0,,,
"Aug 18, 2022 4:00 PM",115,38,77,57,29,28,85,47,38,59,34,25,28,10,18,18,20,19,1,35,35,0,19,52,47,28,19,37,1,2,8,3,5,,,
"Aug 18, 2022 5:00 PM",229,70,159,131,53,78,182,119,63,133,91,42,19,8,11,33,38,30,8,84,83,1,32,127,91,63,28,56,2,6,13,10,3,,,
"Aug 18, 2022 6:00 PM",207,63,144,94,65,29,175,99,76,115,70,45,28,10,18,44,34,28,6,85,82,3,27,107,67,45,22,52,6,6,4,1,3,,,
"Aug 18, 2022 7:00 PM",99,38,61,73,43,30,132,71,61,75,49,26,13,6,7,19,28,26,2,40,38,2,21,48,58,34,24,42,4,0,11,6,5,,,
"Aug 18, 2022 8:00 PM",79,26,53,91,48,43,87,34,53,67,25,42,18,4,14,32,9,8,1,26,21,5,7,33,42,21,21,29,8,6,8,1,7,,,
"Aug 18, 2022 9:00 PM",60,14,46,49,38,11,46,19,27,44,15,29,7,5,2,13,14,13,1,15,14,1,12,19,16,11,5,36,1,1,7,4,3,,,
"Aug 18, 2022 10:00 PM",38,9,29,24,18,6,28,14,14,28,9,19,6,3,3,7,6,5,1,13,10,3,6,13,5,3,2,14,1,1,2,1,1,,,
"Aug 18, 2022 11:00 PM",25,7,18,13,13,0,9,3,6,14,4,10,5,1,4,6,3,3,0,10,9,1,3,10,5,4,1,7,0,0,3,2,1,,,
"Aug 19, 2022 12:00 AM",16,3,13,0,0,0,5,3,2,3,1,2,0,0,0,1,1,1,0,5,5,0,1,13,3,2,1,11,1,0,0,0,0,,,
"Aug 19, 2022 1:00 AM",4,0,4,0,0,0,0,0,0,5,5,0,0,0,0,0,1,1,0,3,3,0,1,3,1,1,0,2,0,0,1,1,0,,,
"Aug 19, 2022 2:00 AM",8,7,1,2,1,1,2,1,1,2,1,1,0,0,0,0,2,2,0,2,2,0,1,1,0,0,0,0,0,0,0,0,0,,,
"Aug 19, 2022 3:00 AM",3,0,3,5,1,4,0,0,0,4,0,4,0,0,0,0,0,0,0,2,2,0,0,2,2,1,1,0,0,0,0,0,0,,,
"Aug 19, 2022 4:00 AM",2,0,2,2,1,1,3,3,0,2,2,0,0,0,0,0,0,0,0,1,1,0,0,0,0,0,0,0,0,0,2,2,0,,,
"Aug 19, 2022 5:00 AM",10,6,4,2,1,1,2,1,1,1,1,0,0,0,0,2,9,9,0,1,0,1,9,2,1,1,0,9,0,0,1,1,0,,,
"Aug 19, 2022 6:00 AM",43,27,16,18,7,11,30,19,11,15,6,9,3,3,0,3,20,20,0,7,5,2,19,22,5,3,2,31,0,2,3,3,0,,,
"Aug 19, 2022 7:00 AM",92,59,33,53,22,31,76,28,48,56,22,34,5,4,1,12,46,45,1,15,11,4,39,29,27,10,17,66,2,2,4,3,1,,,
"Aug 19, 2022 8:00 AM",118,81,37,75,28,47,98,36,62,66,35,31,11,7,4,18,82,82,0,24,18,6,75,49,43,16,27,116,2,2,6,5,1,,,
"Aug 19, 2022 9:00 AM",110,82,28,64,30,34,80,42,38,68,38,30,13,12,1,10,38,37,1,14,10,4,32,25,39,20,19,52,5,6,3,1,2,,,
"Aug 19, 2022 10:00 AM",61,35,26,61,24,37,62,36,26,55,32,23,13,10,3,12,31,31,0,7,5,2,28,20,37,24,13,39,2,2,5,1,4,,,
"Aug 19, 2022 11:00 AM",63,41,22,63,31,32,47,24,23,58,33,25,22,12,10,13,9,8,1,13,12,1,4,18,27,17,10,26,5,6,8,5,3,,,
"Aug 19, 2022 12:00 PM",61,36,25,93,41,52,82,43,39,86,48,38,25,13,12,13,33,27,6,19,18,1,25,24,40,19,21,31,4,5,8,6,2,,,
"Aug 19, 2022 1:00 PM",69,35,34,78,46,32,73,39,34,64,39,25,18,11,7,13,20,20,0,19,17,2,20,29,28,14,14,25,5,2,8,7,1,,,
"Aug 19, 2022 2:00 PM",66,28,38,62,30,32,64,31,33,65,30,35,15,5,10,19,15,14,1,21,19,2,11,32,33,23,10,25,6,9,9,7,2,,,
"Aug 19, 2022 3:00 PM",82,38,44,103,58,45,83,54,29,59,39,20,24,15,9,20,24,24,0,18,17,1,22,37,34,22,12,34,13,2,9,6,3,,,
"Aug 19, 2022 4:00 PM",116,51,65,89,45,44,103,55,48,88,45,43,11,1,10,21,32,27,5,38,37,1,21,47,54,34,20,38,9,3,7,4,3,,,
"Aug 19, 2022 5:00 PM",154,42,112,107,69,38,148,91,57,104,71,33,15,9,6,23,29,23,6,59,57,2,17,81,63,42,21,48,4,3,1,0,1,,,
"Aug 19, 2022 6:00 PM",123,42,81,108,62,46,146,75,71,111,60,51,15,9,6,15,29,25,4,39,35,4,24,66,82,47,35,49,3,6,7,3,4,,,
"Aug 19, 2022 7:00 PM",86,34,52,73,39,34,110,57,53,65,33,32,27,12,15,23,16,16,0,26,24,2,16,32,52,34,18,42,4,6,7,2,5,,,
"Aug 19, 2022 8:00 PM",53,20,33,51,26,25,63,27,36,41,21,20,10,2,8,7,11,10,1,9,9,0,11,13,26,12,14,18,5,1,8,7,1,,,
"Aug 19, 2022 9:00 PM",40,17,23,22,12,10,34,14,20,22,6,16,8,6,2,4,11,9,2,13,13,0,9,17,20,11,9,19,1,2,2,0,2,,,
"Aug 19, 2022 10:00 PM",35,12,23,7,4,3,20,9,11,23,8,15,4,1,3,4,2,1,1,17,16,1,2,11,1,1,0,18,1,2,1,1,0,,,
"Aug 19, 2022 11:00 PM",26,12,14,3,1,2,9,5,4,8,2,6,2,1,1,4,4,4,0,6,6,0,3,7,4,2,2,6,0,1,0,0,0,,,
"Aug 20, 2022 12:00 AM",13,3,10,0,0,0,4,2,2,5,1,4,1,1,0,2,2,2,0,14,14,0,1,12,3,2,1,10,1,1,1,0,1,,,
"Aug 20, 2022 1:00 AM",8,1,7,5,3,2,9,5,4,7,3,4,0,0,0,2,0,0,0,4,3,1,0,6,4,3,1,8,0,1,0,0,0,,,
"Aug 20, 2022 2:00 AM",9,5,4,1,1,0,2,1,1,1,1,0,0,0,0,1,2,2,0,2,1,1,2,5,0,0,0,3,0,0,0,0,0,,,
"Aug 20, 2022 3:00 AM",5,0,5,3,3,0,1,1,0,0,0,0,0,0,0,0,0,0,0,2,2,0,0,1,2,1,1,2,0,0,0,0,0,,,
"Aug 20, 2022 4:00 AM",3,0,3,1,1,0,1,1,0,1,1,0,0,0,0,0,0,0,0,1,1,0,0,2,0,0,0,2,0,0,0,0,0,,,
"Aug 20, 2022 5:00 AM",5,2,3,1,0,1,5,2,3,3,2,1,0,0,0,1,5,5,0,1,1,0,4,4,0,0,0,1,0,0,0,0,0,,,
"Aug 20, 2022 6:00 AM",10,4,6,5,2,3,11,6,5,6,4,2,1,0,1,2,6,6,0,2,2,0,5,10,2,2,0,8,0,1,0,0,0,,,
"Aug 20, 2022 7:00 AM",26,12,14,18,9,9,34,22,12,24,17,7,3,1,2,2,10,9,1,6,3,3,10,15,5,4,1,15,1,3,1,0,1,,,
"Aug 20, 2022 8:00 AM",56,35,21,52,29,23,57,38,19,44,28,16,8,7,1,10,17,16,1,4,4,0,19,17,17,12,5,18,3,3,2,0,2,,,
"Aug 20, 2022 9:00 AM",58,33,25,68,44,24,96,65,31,76,62,14,8,3,5,19,11,10,1,10,7,3,12,32,24,15,9,20,6,7,11,7,4,,,
"Aug 20, 2022 10:00 AM",49,23,26,89,46,43,108,54,54,74,43,31,13,10,3,16,18,18,0,16,12,4,17,27,28,14,14,41,1,13,1,1,0,,,
"Aug 20, 2022 11:00 AM",47,19,28,115,55,60,100,54,46,106,56,50,24,12,12,25,19,18,1,18,17,1,16,31,42,22,20,47,7,3,6,4,2,,,
"Aug 20, 2022 12:00 PM",42,17,25,119,39,80,106,57,49,110,51,59,32,22,10,24,26,26,0,18,17,1,24,19,47,31,16,34,11,5,4,3,1,,,
"Aug 20, 2022 1:00 PM",77,34,43,106,48,58,95,57,38,111,62,49,30,17,13,23,23,23,0,17,16,1,19,37,40,25,15,36,10,2,12,8,4,,,
"Aug 20, 2022 2:00 PM",61,35,26,98,51,47,96,41,55,80,47,33,29,16,13,16,43,41,2,20,16,4,34,17,48,22,26,28,2,2,9,9,0,,,
"Aug 20, 2022 3:00 PM",59,28,31,93,44,49,96,51,45,91,41,50,19,7,12,21,17,16,1,8,8,0,18,28,34,18,16,31,6,1,6,4,2,,,
"Aug 20, 2022 4:00 PM",65,29,36,84,45,39,90,54,36,65,33,32,17,7,10,18,21,19,2,12,9,3,14,23,51,30,21,27,3,3,6,4,2,,,
"Aug 20, 2022 5:00 PM",59,31,28,119,80,39,125,58,67,101,55,46,21,12,9,14,15,14,1,14,12,2,12,28,56,24,32,32,3,1,7,3,4,,,
"Aug 20, 2022 6:00 PM",66,26,40,79,31,48,91,35,56,72,33,39,12,6,6,20,24,22,2,17,16,1,19,24,51,29,22,35,6,7,15,8,7,,,
"Aug 20, 2022 7:00 PM",46,17,29,45,31,14,59,22,37,54,19,35,8,3,5,12,13,11,2,10,8,2,10,9,30,16,14,15,3,1,3,1,2,,,
"Aug 20, 2022 8:00 PM",44,19,25,22,10,12,31,15,16,19,9,10,8,2,6,4,10,9,1,7,7,0,9,5,11,6,5,19,0,0,2,2,0,,,
"Aug 20, 2022 9:00 PM",29,17,12,15,13,2,20,6,14,17,2,15,4,1,3,9,6,5,1,4,3,1,6,3,6,2,4,13,3,0,2,1,1,,,
"Aug 20, 2022 10:00 PM",16,8,8,8,3,5,5,1,4,7,2,5,1,1,0,3,5,4,1,6,6,0,4,3,2,2,0,3,0,1,0,0,0,,,
"Aug 20, 2022 11:00 PM",18,7,11,6,1,5,10,5,5,9,5,4,4,4,0,1,2,2,0,5,5,0,5,10,5,3,2,6,0,1,1,0,1,,,
"Aug 21, 2022 12:00 AM",4,2,2,0,0,0,5,3,2,1,0,1,1,0,1,3,1,1,0,6,6,0,1,4,5,3,2,5,1,0,0,0,0,,,
"Aug 21, 2022 1:00 AM",12,6,6,2,1,1,5,4,1,5,5,0,1,1,0,0,2,1,1,3,3,0,1,4,1,1,0,3,0,0,1,0,1,,,
"Aug 21, 2022 2:00 AM",11,5,6,4,2,2,6,4,2,4,2,2,0,0,0,3,0,0,0,7,7,0,0,4,2,1,1,7,0,0,0,0,0,,,
"Aug 21, 2022 3:00 AM",9,1,8,1,1,0,0,0,0,2,0,2,0,0,0,0,0,0,0,1,1,0,0,3,0,0,0,3,0,0,0,0,0,,,
"Aug 21, 2022 4:00 AM",2,0,2,0,0,0,1,1,0,2,2,0,1,0,1,0,1,1,0,2,2,0,1,0,0,0,0,1,0,1,0,0,0,,,
"Aug 21, 2022 5:00 AM",1,0,1,2,2,0,6,2,4,4,3,1,0,0,0,2,2,2,0,1,1,0,2,0,2,1,1,3,1,1,2,2,0,,,
"Aug 21, 2022 6:00 AM",7,4,3,6,3,3,11,8,3,6,2,4,1,1,0,3,3,3,0,2,2,0,3,8,2,2,0,6,1,1,2,2,0,,,
"Aug 21, 2022 7:00 AM",21,9,12,33,19,14,44,29,15,33,21,12,2,1,1,7,8,7,1,3,2,1,7,16,18,12,6,21,1,3,2,2,0,,,
"Aug 21, 2022 8:00 AM",46,18,28,67,37,30,99,59,40,65,38,27,5,2,3,7,14,14,0,9,8,1,14,23,29,19,10,25,2,10,5,3,2,,,
"Aug 21, 2022 9:00 AM",56,27,29,143,86,57,170,110,60,127,93,34,4,4,0,12,13,12,1,14,12,2,13,42,60,47,13,36,3,8,5,1,4,,,
"Aug 21, 2022 10:00 AM",50,33,17,209,114,95,202,108,94,181,113,68,20,8,12,16,32,32,0,9,8,1,29,33,63,42,21,54,4,8,6,1,5,,,
"Aug 21, 2022 11:00 AM",71,37,34,252,114,138,243,126,117,211,99,112,23,11,12,10,19,16,3,16,14,2,17,52,94,53,41,63,9,10,7,3,4,,,
"Aug 21, 2022 12:00 PM",84,47,37,262,142,120,195,104,91,180,100,80,11,5,6,19,30,30,0,20,20,0,25,43,89,52,37,68,4,3,6,4,2,,,
"Aug 21, 2022 1:00 PM",67,39,28,272,138,134,212,127,85,227,135,92,51,31,20,19,32,30,2,29,27,2,27,55,93,59,34,55,13,6,8,5,3,,,
"Aug 21, 2022 2:00 PM",77,45,32,230,95,135,188,100,88,183,97,86,41,22,19,30,21,21,0,13,12,1,23,54,98,65,33,53,15,8,3,3,0,,,
"Aug 21, 2022 3:00 PM",74,39,35,235,122,113,215,95,120,191,101,90,23,14,9,28,22,21,1,15,14,1,19,36,107,59,48,45,10,6,12,4,8,,,
"Aug 21, 2022 4:00 PM",75,37,38,175,85,90,188,86,102,171,72,99,38,22,16,31,24,23,1,20,20,0,25,36,90,45,45,46,5,9,5,3,2,,,
"Aug 21, 2022 5:00 PM",54,25,29,170,76,94,176,74,102,158,66,92,23,15,8,23,13,13,0,16,15,1,14,28,83,36,47,56,5,0,4,4,0,,,
"Aug 21, 2022 6:00 PM",70,32,38,140,64,76,155,66,89,127,44,83,38,14,24,10,16,14,2,14,13,1,14,24,60,27,33,45,3,5,7,4,3,,,
"Aug 21, 2022 7:00 PM",61,24,37,46,26,20,99,52,47,59,31,28,8,3,5,7,16,13,3,10,9,1,10,17,49,24,25,33,6,5,7,3,4,,,
"Aug 21, 2022 8:00 PM",34,20,14,38,14,24,70,29,41,27,9,18,5,3,2,11,16,14,2,4,3,1,11,11,31,6,25,17,2,2,3,1,2,,,
"Aug 21, 2022 9:00 PM",41,21,20,27,14,13,34,11,23,25,7,18,3,1,2,7,13,13,0,9,8,1,14,7,21,13,8,20,3,1,4,2,2,,,
"Aug 21, 2022 10:00 PM",19,5,14,2,1,1,6,2,4,2,0,2,2,1,1,2,6,6,0,7,6,1,7,7,4,3,1,8,0,3,3,1,2,,,
"Aug 21, 2022 11:00 PM",12,4,8,2,0,2,4,1,3,2,0,2,3,1,2,2,2,2,0,1,1,0,2,2,1,1,0,2,0,0,6,5,1,,,
"Aug 22, 2022 12:00 AM",4,2,2,0,0,0,3,2,1,4,0,4,1,1,0,1,0,0,0,2,2,0,1,3,2,2,0,6,0,0,1,1,0,,,
"Aug 22, 2022 1:00 AM",6,1,5,0,0,0,0,0,0,1,1,0,0,0,0,0,1,1,0,1,1,0,1,3,5,5,0,1,0,0,1,1,0,,,
"Aug 22, 2022 2:00 AM",6,5,1,0,0,0,0,0,0,1,0,1,0,0,0,0,0,0,0,0,0,0,0,1,1,1,0,0,0,0,0,0,0,,,
"Aug 22, 2022 3:00 AM",2,1,1,0,0,0,0,0,0,2,2,0,2,2,0,1,0,0,0,1,1,0,0,0,0,0,0,0,0,0,0,0,0,,,
"Aug 22, 2022 4:00 AM",1,0,1,1,0,1,2,1,1,2,1,1,0,0,0,0,0,0,0,0,0,0,0,0,1,0,1,0,0,0,0,0,0,,,
"Aug 22, 2022 5:00 AM",6,3,3,0,0,0,3,1,2,2,1,1,0,0,0,2,9,9,0,1,0,1,8,0,0,0,0,10,0,0,0,0,0,,,
"Aug 22, 2022 6:00 AM",55,32,23,14,4,10,24,9,15,14,4,10,2,0,2,10,19,19,0,8,5,3,19,15,4,1,3,37,2,3,2,2,0,,,
"Aug 22, 2022 7:00 AM",110,79,31,56,24,32,63,25,38,57,27,30,8,6,2,15,87,84,3,19,14,5,75,30,21,8,13,97,1,3,6,5,1,,,
"Aug 22, 2022 8:00 AM",175,127,48,56,14,42,99,29,70,69,23,46,20,16,4,19,119,118,1,18,12,6,121,35,61,16,45,135,2,2,7,6,1,,,
"Aug 22, 2022 9:00 AM",95,76,19,33,13,20,54,30,24,44,29,15,16,11,5,9,50,49,1,20,13,7,40,21,28,15,13,55,2,4,7,4,3,,,
"Aug 22, 2022 10:00 AM",57,41,16,36,13,23,59,30,29,39,19,20,4,4,0,8,22,21,1,14,8,6,17,19,30,18,12,21,3,0,4,2,2,,,
"Aug 22, 2022 11:00 AM",31,23,8,42,17,25,52,25,27,38,19,19,10,8,2,7,24,24,0,8,8,0,18,14,25,15,10,23,5,3,4,2,2,,,
"Aug 22, 2022 12:00 PM",50,31,19,38,22,16,44,26,18,36,22,14,20,13,7,15,24,18,6,14,12,2,16,22,13,6,7,29,4,0,4,4,0,,,
"Aug 22, 2022 1:00 PM",57,34,23,66,38,28,67,42,25,56,38,18,20,11,9,14,20,19,1,20,15,5,21,27,32,20,12,18,3,6,5,2,3,,,
"Aug 22, 2022 2:00 PM",61,28,33,79,42,37,53,28,25,40,24,16,21,5,16,14,15,14,1,21,19,2,17,15,25,16,9,24,4,2,9,4,5,,,
"Aug 22, 2022 3:00 PM",87,36,51,74,35,39,80,48,32,62,37,25,22,16,6,8,23,21,2,14,10,4,13,34,28,14,14,24,2,2,8,6,2,,,
"Aug 22, 2022 4:00 PM",118,33,85,71,45,26,66,39,27,80,46,34,19,12,7,27,26,24,2,50,48,2,19,43,54,36,18,53,5,5,5,4,1,,,
"Aug 22, 2022 5:00 PM",204,48,156,122,70,52,160,95,65,111,59,52,25,8,17,28,36,32,4,97,94,3,24,112,74,46,28,61,6,10,5,3,2,,,
"Aug 22, 2022 6:00 PM",166,46,120,128,71,57,182,113,69,120,74,46,33,14,19,22,36,29,7,67,66,1,28,111,73,58,15,47,8,3,14,11,3,,,
"Aug 22, 2022 7:00 PM",105,31,74,96,52,44,132,70,62,90,48,42,14,8,6,28,25,19,6,43,40,3,19,47,64,35,29,42,8,5,7,5,2,,,
"Aug 22, 2022 8:00 PM",68,18,50,67,34,33,99,52,47,65,37,28,12,1,11,19,12,10,2,16,14,2,11,30,43,22,21,34,3,3,13,10,3,,,
"Aug 22, 2022 9:00 PM",35,13,22,26,16,10,43,17,26,21,11,10,7,3,4,6,7,5,2,15,14,1,6,17,17,10,7,19,3,1,6,1,5,,,
"Aug 22, 2022 10:00 PM",36,12,24,14,5,9,24,12,12,18,4,14,3,2,1,5,6,5,1,16,16,0,4,8,7,5,2,13,3,1,7,3,4,,,
"Aug 22, 2022 11:00 PM",8,2,6,1,1,0,6,5,1,5,4,1,3,2,1,4,2,2,0,6,6,0,2,16,2,1,1,5,0,0,1,1,0,,,
"Aug 23, 2022 12:00 AM",12,2,10,0,0,0,3,1,2,6,5,1,5,0,5,2,0,0,0,3,3,0,0,1,0,0,0,2,0,1,0,0,0,,,
"Aug 23, 2022 1:00 AM",3,1,2,0,0,0,1,1,0,0,0,0,0,0,0,0,0,0,0,0,0,0,0,5,4,3,1,0,0,0,0,0,0,,,
"Aug 23, 2022 2:00 AM",6,5,1,2,1,1,0,0,0,1,1,0,0,0,0,1,1,1,0,4,3,1,1,0,0,0,0,0,0,0,0,0,0,,,
"Aug 23, 2022 3:00 AM",0,0,0,0,0,0,0,0,0,0,0,0,0,0,0,0,0,0,0,1,1,0,0,1,0,0,0,1,0,0,0,0,0,,,
"Aug 23, 2022 4:00 AM",2,1,1,1,0,1,3,2,1,2,1,1,0,0,0,0,1,1,0,0,0,0,1,1,2,0,2,1,0,0,1,1,0,,,
"Aug 23, 2022 5:00 AM",7,4,3,1,0,1,3,1,2,3,2,1,1,0,1,2,5,5,0,1,0,1,5,3,2,2,0,16,0,0,0,0,0,,,
"Aug 23, 2022 6:00 AM",51,30,21,27,10,17,37,14,23,33,11,22,1,1,0,8,27,27,0,13,10,3,31,16,15,5,10,48,0,5,1,1,0,,,
"Aug 23, 2022 7:00 AM",141,104,37,61,22,39,104,39,65,62,27,35,7,5,2,16,91,89,2,24,18,6,84,44,36,12,24,132,4,9,7,7,0,,,
"Aug 23, 2022 8:00 AM",246,192,54,114,32,82,183,67,116,135,52,83,19,15,4,24,164,162,2,27,22,5,153,68,87,28,59,211,6,6,8,7,1,,,
"Aug 23, 2022 9:00 AM",124,91,33,54,19,35,112,55,57,62,37,25,24,13,11,17,57,55,2,24,17,7,52,25,48,25,23,74,8,6,8,5,3,,,
"Aug 23, 2022 10:00 AM",66,47,19,87,46,41,96,63,33,60,45,15,7,5,2,15,22,21,1,15,13,2,23,32,42,27,15,30,4,7,6,5,1,,,
"Aug 23, 2022 11:00 AM",48,23,25,68,36,32,103,62,41,61,31,30,19,6,13,25,26,23,3,9,6,3,24,15,50,32,18,27,4,6,1,0,1,,,
"Aug 23, 2022 12:00 PM",58,36,22,83,36,47,98,44,54,56,29,27,16,9,7,20,21,20,1,19,16,3,17,35,36,10,26,31,3,4,4,3,1,,,
"Aug 23, 2022 1:00 PM",81,28,53,78,31,47,95,38,57,70,28,42,27,14,13,15,23,22,1,26,24,2,22,25,38,15,23,37,4,7,4,3,1,,,
"Aug 23, 2022 2:00 PM",70,39,31,64,36,28,82,43,39,63,38,25,29,17,12,22,19,18,1,32,29,3,14,18,42,27,15,26,9,1,6,5,1,,,
"Aug 23, 2022 3:00 PM",65,32,33,82,50,32,72,47,25,64,44,20,25,5,20,39,15,12,3,27,25,2,12,27,41,30,11,26,4,5,7,4,3,,,
"Aug 23, 2022 4:00 PM",137,39,98,78,36,42,105,52,53,81,37,44,23,9,14,26,30,24,6,56,56,0,24,68,69,48,21,44,4,5,6,4,2,,,
"Aug 23, 2022 5:00 PM",244,60,184,125,72,53,152,98,54,131,84,47,29,9,20,28,49,44,5,79,76,3,37,135,89,57,32,70,15,2,15,13,2,,,
"Aug 23, 2022 6:00 PM",235,68,167,159,114,45,211,154,57,149,110,39,20,6,14,32,31,24,7,110,105,5,27,172,116,95,21,63,5,7,12,10,2,,,
"Aug 23, 2022 7:00 PM",143,57,86,172,97,75,215,133,82,129,75,54,18,8,10,22,30,28,2,54,52,2,24,81,88,54,34,49,9,3,11,6,5,,,
"Aug 23, 2022 8:00 PM",96,32,64,109,49,60,174,69,105,90,37,53,18,8,10,18,15,14,1,16,16,0,15,35,68,25,43,58,7,6,15,7,8,,,
"Aug 23, 2022 9:00 PM",71,18,53,50,29,21,61,19,42,40,14,26,15,9,6,8,13,9,4,16,15,1,7,19,33,17,16,27,3,1,5,4,1,,,
"Aug 23, 2022 10:00 PM",42,17,25,17,15,2,20,8,12,23,5,18,4,1,3,5,9,7,2,17,14,3,6,12,7,5,2,22,3,1,0,0,0,,,
"Aug 23, 2022 11:00 PM",19,5,14,1,1,0,4,3,1,4,0,4,0,0,0,0,3,2,1,6,6,0,3,8,2,1,1,0,0,0,2,1,1,,,
"Aug 24, 2022 12:00 AM",7,2,5,0,0,0,5,3,2,3,1,2,0,0,0,3,1,0,1,2,2,0,0,2,2,2,0,6,0,1,0,0,0,,,
"Aug 24, 2022 1:00 AM",6,1,5,0,0,0,3,1,2,4,2,2,0,0,0,0,0,0,0,0,0,0,0,3,1,1,0,3,2,0,2,2,0,,,
"Aug 24, 2022 2:00 AM",9,8,1,1,1,0,1,1,0,1,1,0,0,0,0,0,1,1,0,0,0,0,1,0,0,0,0,0,0,0,2,1,1,,,
"Aug 24, 2022 3:00 AM",1,0,1,1,1,0,0,0,0,0,0,0,1,0,1,0,0,0,0,0,0,0,1,1,0,0,0,0,0,1,0,0,0,,,
"Aug 24, 2022 4:00 AM",2,2,0,2,0,2,3,2,1,3,1,2,0,0,0,0,0,0,0,0,0,0,0,1,0,0,0,2,0,0,0,0,0,,,
"Aug 24, 2022 5:00 AM",9,5,4,5,3,2,2,1,1,3,2,1,1,1,0,3,10,10,0,3,1,2,9,2,0,0,0,13,0,0,0,0,0,,,
"Aug 24, 2022 6:00 AM",59,38,21,17,9,8,29,13,16,23,12,11,3,3,0,6,21,21,0,9,7,2,21,20,4,1,3,36,0,1,3,3,0,,,
"Aug 24, 2022 7:00 AM",136,93,43,91,28,63,81,26,55,79,29,50,10,7,3,16,84,82,2,24,23,1,80,39,38,13,25,98,3,7,8,8,0,,,
"Aug 24, 2022 8:00 AM",244,179,65,69,21,48,148,55,93,90,38,52,14,13,1,17,153,151,2,31,20,11,143,60,68,29,39,224,6,4,8,5,3,,,
"Aug 24, 2022 9:00 AM",113,85,28,73,26,47,85,42,43,81,42,39,6,2,4,11,53,53,0,21,18,3,51,20,49,19,30,79,2,5,7,5,2,,,
"Aug 24, 2022 10:00 AM",77,54,23,52,23,29,70,43,27,48,31,17,13,9,4,13,26,25,1,10,7,3,19,11,40,22,18,28,7,2,4,3,1,,,
"Aug 24, 2022 11:00 AM",42,19,23,68,28,40,63,30,33,56,28,28,19,11,8,14,23,21,2,10,9,1,19,17,34,18,16,41,5,1,4,2,2,,,
"Aug 24, 2022 12:00 PM",74,37,37,61,33,28,85,42,43,61,32,29,20,10,10,13,20,17,3,20,18,2,16,28,44,23,21,43,10,4,8,7,1,,,
"Aug 24, 2022 1:00 PM",74,39,35,70,39,31,79,42,37,74,42,32,15,8,7,14,24,22,2,21,20,1,15,33,38,18,20,30,6,3,8,3,5,,,
"Aug 24, 2022 2:00 PM",56,28,28,61,29,32,62,33,29,52,27,25,20,12,8,20,17,14,3,20,19,1,15,21,33,17,16,26,1,2,9,5,4,,,
"Aug 24, 2022 3:00 PM",96,33,63,53,26,27,58,34,24,44,27,17,18,9,9,27,22,18,4,29,28,1,16,22,29,21,8,30,5,1,11,10,1,,,
"Aug 24, 2022 4:00 PM",155,58,97,84,49,35,101,67,34,83,50,33,27,8,19,36,26,22,4,43,41,2,24,70,50,37,13,54,7,6,9,4,5,,,
"Aug 24, 2022 5:00 PM",226,60,166,114,64,50,133,84,49,113,64,49,23,8,15,21,55,49,6,100,95,5,45,111,78,57,21,71,9,16,11,5,6,,,
"Aug 24, 2022 6:00 PM",201,60,141,143,98,45,172,110,62,159,104,55,28,15,13,28,45,43,2,80,78,2,38,121,104,75,29,50,7,1,13,4,9,,,
"Aug 24, 2022 7:00 PM",101,40,61,115,60,55,126,75,51,95,55,40,23,13,10,22,28,27,1,34,33,1,28,59,71,46,25,31,6,3,11,6,5,,,
"Aug 24, 2022 8:00 PM",99,37,62,75,36,39,101,50,51,84,38,46,24,9,15,18,19,18,1,38,38,0,15,45,46,25,21,38,10,8,12,9,3,,,
"Aug 24, 2022 9:00 PM",49,16,33,45,24,21,65,25,40,45,15,30,6,4,2,3,18,13,5,24,21,3,15,23,18,9,9,28,2,0,4,3,1,,,
"Aug 24, 2022 10:00 PM",40,12,28,25,14,11,42,17,25,33,13,20,6,4,2,10,8,7,1,14,14,0,6,16,7,6,1,13,2,0,7,4,3,,,
"Aug 24, 2022 11:00 PM",25,8,17,5,3,2,13,6,7,15,6,9,5,5,0,3,5,5,0,8,7,1,5,7,10,7,3,11,1,2,0,0,0,,,
"Aug 25, 2022 12:00 AM",5,2,3,0,0,0,10,1,9,8,1,7,0,0,0,0,4,4,0,7,7,0,5,0,2,2,0,5,0,1,0,0,0,,,
"Aug 25, 2022 1:00 AM",8,2,6,1,1,0,2,2,0,3,3,0,0,0,0,0,1,0,1,1,1,0,0,1,3,2,1,2,1,0,0,0,0,,,
"Aug 25, 2022 2:00 AM",6,5,1,0,0,0,2,1,1,0,0,0,0,0,0,0,1,1,0,0,0,0,1,1,0,0,0,2,0,0,0,0,0,,,
"Aug 25, 2022 3:00 AM",2,0,2,0,0,0,0,0,0,0,0,0,0,0,0,0,0,0,0,1,1,0,0,1,1,1,0,0,0,0,0,0,0,,,
"Aug 25, 2022 4:00 AM",0,0,0,2,0,2,2,1,1,2,1,1,0,0,0,0,1,1,0,0,0,0,1,0,0,0,0,1,0,0,0,0,0,,,
"Aug 25, 2022 5:00 AM",7,5,2,1,1,0,3,1,2,2,1,1,0,0,0,1,6,6,0,3,1,2,5,2,1,1,0,11,1,0,1,1,0,,,
"Aug 25, 2022 6:00 AM",43,27,16,25,13,12,25,8,17,22,9,13,2,1,1,11,25,25,0,8,6,2,24,20,13,4,9,38,1,3,5,5,0,,,
"Aug 25, 2022 7:00 AM",133,92,41,68,29,39,87,37,50,70,35,35,11,8,3,17,89,88,1,24,19,5,83,37,31,7,24,116,1,4,5,5,0,,,
"Aug 25, 2022 8:00 AM",233,169,64,94,27,67,163,59,104,117,41,76,20,12,8,31,131,129,2,30,26,4,126,62,89,30,59,170,6,2,6,6,0,,,
"Aug 25, 2022 9:00 AM",105,77,28,73,25,48,111,46,65,78,38,40,14,8,6,11,58,58,0,27,21,6,51,20,54,20,34,76,3,4,3,1,2,,,
"Aug 25, 2022 10:00 AM",68,46,22,65,25,40,75,46,29,53,35,18,20,16,4,9,34,34,0,12,10,2,34,19,36,27,9,39,2,2,3,2,1,,,
"Aug 25, 2022 11:00 AM",53,29,24,88,37,51,112,64,48,72,37,35,15,4,11,15,14,11,3,9,6,3,11,18,69,44,25,25,4,3,2,0,2,,,
"Aug 25, 2022 12:00 PM",71,38,33,95,48,47,146,77,69,89,46,43,35,22,13,11,23,21,2,15,12,3,16,33,50,26,24,25,3,4,7,5,2,,,
"Aug 25, 2022 1:00 PM",78,41,37,96,53,43,122,57,65,83,47,36,25,16,9,20,22,19,3,20,16,4,19,28,60,31,29,33,6,0,12,10,2,,,
"Aug 25, 2022 2:00 PM",68,38,30,81,35,46,88,39,49,63,31,32,18,12,6,15,25,24,1,22,19,3,22,31,40,22,18,30,4,9,6,4,2,,,
"Aug 25, 2022 3:00 PM",87,34,53,67,35,32,76,42,34,62,40,22,30,16,14,18,22,21,1,28,23,5,20,41,52,31,21,38,1,3,6,4,2,,,
"Aug 25, 2022 4:00 PM",146,51,95,69,43,26,67,38,29,89,54,35,30,11,19,31,34,28,6,51,46,5,29,52,41,22,19,57,12,6,7,6,1,,,
"Aug 25, 2022 5:00 PM",234,69,165,167,76,91,169,111,58,156,109,47,29,16,13,28,47,39,8,90,88,2,35,105,98,60,38,70,11,8,16,6,10,,,
"Aug 25, 2022 6:00 PM",200,70,130,115,78,37,161,118,43,134,106,28,18,7,11,24,40,33,7,82,77,5,34,129,105,81,24,55,10,6,13,9,4,,,
"Aug 25, 2022 7:00 PM",103,32,71,103,67,36,109,77,32,95,65,30,25,8,17,17,22,18,4,50,46,4,16,68,59,45,14,46,5,2,13,10,3,,,
"Aug 25, 2022 8:00 PM",74,25,49,71,24,47,76,33,43,71,18,53,14,10,4,13,12,12,0,34,30,4,11,32,40,18,22,35,1,5,13,9,4,,,
"Aug 25, 2022 9:00 PM",58,17,41,47,31,16,47,13,34,51,17,34,13,7,6,10,12,12,0,20,17,3,13,33,15,8,7,24,6,3,14,6,8,,,
"Aug 25, 2022 10:00 PM",38,13,25,36,29,7,33,10,23,33,4,29,8,0,8,4,8,4,4,24,23,1,5,12,13,8,5,13,1,1,3,3,0,,,
"Aug 25, 2022 11:00 PM",24,11,13,20,18,2,17,6,11,17,5,12,6,0,6,2,4,4,0,9,9,0,3,10,4,3,1,12,0,1,2,1,1,,,
"Aug 26, 2022 12:00 AM",10,2,8,1,1,0,10,3,7,13,3,10,5,1,4,0,2,2,0,8,8,0,2,13,5,1,4,3,1,1,3,1,2,,,
"Aug 26, 2022 1:00 AM",5,1,4,5,3,2,4,0,4,4,0,4,0,0,0,0,0,0,0,5,4,1,0,5,2,0,2,4,0,0,0,0,0,,,
"Aug 26, 2022 2:00 AM",9,6,3,3,3,0,2,0,2,3,1,2,0,0,0,0,1,1,0,0,0,0,1,0,1,1,0,2,0,0,1,0,1,,,
"Aug 26, 2022 3:00 AM",1,0,1,0,0,0,2,1,1,0,0,0,0,0,0,1,0,0,0,0,0,0,0,4,0,0,0,3,0,0,1,1,0,,,
"Aug 26, 2022 4:00 AM",2,2,0,1,0,1,2,2,0,2,2,0,0,0,0,0,0,0,0,0,0,0,1,0,0,0,0,3,0,0,0,0,0,,,
"Aug 26, 2022 5:00 AM",7,5,2,4,2,2,2,1,1,3,1,2,0,0,0,1,5,5,0,2,1,1,4,2,1,0,1,8,1,0,0,0,0,,,
"Aug 26, 2022 6:00 AM",51,30,21,24,18,6,25,11,14,23,17,6,1,0,1,7,21,21,0,13,9,4,20,15,6,5,1,35,1,1,2,2,0,,,
"Aug 26, 2022 7:00 AM",72,49,23,74,29,45,60,23,37,61,32,29,10,6,4,11,49,48,1,17,16,1,45,41,27,12,15,72,3,2,2,2,0,,,
"Aug 26, 2022 8:00 AM",157,109,48,77,23,54,112,38,74,77,28,49,20,13,7,15,91,90,1,22,17,5,85,42,67,24,43,116,11,1,5,5,0,,,
"Aug 26, 2022 9:00 AM",83,59,24,55,25,30,84,42,42,58,32,26,10,7,3,13,44,43,1,15,9,6,35,25,25,13,12,56,6,12,6,4,2,,,
"Aug 26, 2022 10:00 AM",69,45,24,61,22,39,48,22,26,35,10,25,12,8,4,13,18,17,1,13,10,3,15,16,15,10,5,27,5,4,6,3,3,,,
"Aug 26, 2022 11:00 AM",50,28,22,60,29,31,55,32,23,40,27,13,18,10,8,15,13,13,0,11,9,2,13,18,17,10,7,26,16,1,9,7,2,,,
"Aug 26, 2022 12:00 PM",52,27,25,37,12,25,55,30,25,46,23,23,17,9,8,9,18,16,2,13,13,0,13,18,45,23,22,22,4,1,5,4,1,,,
"Aug 26, 2022 1:00 PM",59,28,31,46,28,18,65,32,33,45,22,23,28,14,14,14,30,28,2,19,17,2,25,28,43,25,18,21,4,5,9,3,6,,,
"Aug 26, 2022 2:00 PM",68,34,34,54,29,25,62,33,29,45,27,18,21,9,12,13,18,16,2,15,13,2,15,27,35,18,17,28,7,1,6,4,2,,,
"Aug 26, 2022 3:00 PM",95,44,51,55,36,19,59,36,23,49,31,18,22,7,15,16,23,22,1,28,27,1,21,38,29,18,11,29,6,3,2,1,1,,,
"Aug 26, 2022 4:00 PM",114,37,77,73,40,33,69,41,28,73,46,27,29,11,18,28,32,30,2,33,32,1,21,46,32,22,10,33,3,2,9,8,1,,,
"Aug 26, 2022 5:00 PM",150,49,101,111,58,53,111,63,48,98,55,43,15,11,4,24,30,25,5,56,51,5,21,68,55,33,22,50,4,4,6,3,3,,,
"Aug 26, 2022 6:00 PM",115,42,73,92,48,44,75,49,26,75,45,30,14,2,12,32,32,27,5,40,36,4,27,62,45,36,9,40,1,3,5,3,2,,,
"Aug 26, 2022 7:00 PM",94,42,52,72,45,27,61,38,23,54,33,21,17,6,11,10,20,19,1,30,28,2,17,28,37,29,8,22,5,2,4,3,1,,,
"Aug 26, 2022 8:00 PM",47,13,34,62,31,31,42,23,19,46,24,22,12,3,9,6,13,12,1,18,16,2,12,13,26,15,11,17,4,2,12,7,5,,,
"Aug 26, 2022 9:00 PM",40,16,24,28,17,11,28,7,21,24,10,14,3,1,2,7,7,7,0,17,15,2,6,13,7,5,2,19,3,5,6,3,3,,,
"Aug 26, 2022 10:00 PM",34,15,19,26,18,8,21,7,14,20,4,16,14,7,7,11,8,6,2,3,2,1,5,5,3,3,0,6,0,2,5,4,1,,,
"Aug 26, 2022 11:00 PM",25,7,18,7,4,3,8,3,5,11,2,9,4,0,4,5,4,4,0,6,6,0,4,8,3,3,0,7,1,0,5,4,1,,,
"Aug 27, 2022 12:00 AM",13,4,9,1,1,0,8,3,5,8,2,6,3,3,0,3,1,1,0,6,6,0,2,4,4,3,1,4,2,2,1,1,0,,,
"Aug 27, 2022 1:00 AM",8,2,6,2,0,2,5,1,4,7,0,7,3,1,2,0,1,1,0,5,5,0,1,6,3,3,0,2,1,0,2,1,1,,,
"Aug 27, 2022 2:00 AM",5,3,2,1,1,0,3,3,0,6,4,2,0,0,0,0,1,1,0,4,4,0,1,4,3,2,1,2,0,0,0,0,0,,,
"Aug 27, 2022 3:00 AM",3,0,3,2,2,0,0,0,0,1,0,1,0,0,0,0,0,0,0,1,1,0,0,1,1,1,0,1,0,0,0,0,0,,,
"Aug 27, 2022 4:00 AM",4,0,4,1,0,1,5,3,2,2,1,1,1,1,0,0,1,0,1,0,0,0,0,1,2,2,0,3,0,0,0,0,0,,,
"Aug 27, 2022 5:00 AM",3,1,2,1,0,1,1,0,1,0,0,0,3,3,0,0,3,3,0,1,1,0,2,2,1,1,0,3,0,0,2,2,0,,,
"Aug 27, 2022 6:00 AM",11,6,5,3,2,1,9,7,2,7,5,2,1,0,1,2,4,4,0,4,3,1,5,6,2,1,1,9,0,0,0,0,0,,,
"Aug 27, 2022 7:00 AM",24,13,11,32,20,12,32,20,12,30,22,8,4,1,3,8,6,6,0,5,4,1,7,15,10,7,3,20,1,1,1,0,1,,,
"Aug 27, 2022 8:00 AM",41,19,22,74,44,30,55,34,21,64,52,12,13,10,3,16,20,19,1,4,4,0,19,19,14,8,6,19,4,9,7,4,3,,,
"Aug 27, 2022 9:00 AM",68,37,31,107,55,52,91,54,37,90,66,24,11,5,6,16,15,14,1,9,7,2,17,31,29,19,10,29,12,4,8,4,4,,,
"Aug 27, 2022 10:00 AM",53,36,17,178,88,90,159,98,61,132,83,49,24,7,17,26,24,23,1,12,7,5,19,52,65,38,27,32,6,3,2,1,1,,,
"Aug 27, 2022 11:00 AM",79,32,47,194,95,99,217,130,87,183,104,79,44,19,25,22,21,21,0,18,14,4,21,51,95,68,27,41,2,11,3,2,1,,,
"Aug 27, 2022 12:00 PM",63,35,28,194,117,77,245,153,92,163,110,53,56,30,26,22,29,27,2,9,9,0,24,47,119,81,38,52,9,11,9,4,5,,,
"Aug 27, 2022 1:00 PM",83,45,38,204,100,104,261,148,113,184,108,76,35,17,18,23,28,27,1,29,22,7,25,56,123,74,49,52,5,14,4,3,1,,,
"Aug 27, 2022 2:00 PM",78,51,27,180,105,75,246,144,102,174,114,60,44,14,30,23,23,22,1,23,21,2,22,57,123,83,40,55,13,5,10,8,2,,,
"Aug 27, 2022 3:00 PM",72,32,40,182,110,72,202,108,94,158,97,61,44,16,28,17,22,19,3,21,20,1,15,52,84,39,45,44,9,5,11,7,4,,,
"Aug 27, 2022 4:00 PM",54,25,29,141,72,69,176,76,100,140,72,68,50,25,25,26,31,27,4,16,13,3,28,32,70,28,42,49,4,6,10,8,2,,,
"Aug 27, 2022 5:00 PM",64,27,37,170,78,92,157,54,103,135,43,92,46,27,19,30,20,18,2,15,13,2,14,33,68,21,47,54,9,3,6,4,2,,,
"Aug 27, 2022 6:00 PM",66,32,34,118,48,70,107,38,69,116,33,83,33,24,9,13,10,10,0,16,15,1,8,21,50,15,35,41,7,1,6,4,2,,,
"Aug 27, 2022 7:00 PM",64,23,41,89,39,50,76,36,40,71,35,36,24,13,11,11,10,10,0,8,7,1,9,25,40,25,15,38,3,3,7,6,1,,,
"Aug 27, 2022 8:00 PM",35,15,20,57,26,31,60,20,40,57,18,39,18,5,13,9,5,5,0,12,12,0,4,8,26,4,22,33,4,4,5,2,3,,,
"Aug 27, 2022 9:00 PM",19,8,11,30,15,15,22,5,17,23,6,17,13,11,2,11,7,6,1,10,9,1,7,9,6,4,2,19,0,1,3,2,1,,,
"Aug 27, 2022 10:00 PM",25,10,15,6,5,1,15,5,10,17,2,15,17,15,2,5,5,5,0,5,5,0,4,7,4,3,1,17,2,2,2,1,1,,,
"Aug 27, 2022 11:00 PM",14,6,8,8,6,2,10,4,6,6,2,4,5,2,3,9,1,1,0,7,7,0,1,4,3,2,1,4,1,0,2,1,1,,,
"Aug 28, 2022 12:00 AM",13,6,7,1,1,0,7,3,4,4,1,3,5,5,0,0,4,4,0,3,2,1,3,4,7,5,2,9,1,3,3,2,1,,,
"Aug 28, 2022 1:00 AM",9,2,7,9,7,2,5,2,3,5,4,1,3,3,0,0,2,2,0,3,3,0,3,5,4,3,1,3,1,1,2,2,0,,,
"Aug 28, 2022 2:00 AM",3,1,2,5,3,2,10,5,5,5,3,2,0,0,0,0,4,4,0,0,0,0,4,1,1,1,0,5,0,0,1,0,1,,,
"Aug 28, 2022 3:00 AM",3,0,3,0,0,0,1,1,0,1,0,1,0,0,0,0,0,0,0,3,2,1,2,2,5,4,1,4,0,1,0,0,0,,,
"Aug 28, 2022 4:00 AM",7,0,7,0,0,0,1,1,0,1,1,0,1,1,0,0,1,1,0,0,0,0,1,2,1,1,0,0,1,0,1,1,0,,,
"Aug 28, 2022 5:00 AM",6,3,3,2,1,1,4,2,2,3,1,2,0,0,0,1,3,3,0,0,0,0,3,2,0,0,0,3,0,0,0,0,0,,,
"Aug 28, 2022 6:00 AM",14,11,3,7,3,4,6,3,3,5,3,2,2,1,1,0,4,4,0,6,4,2,3,7,2,0,2,8,0,0,0,0,0,,,
"Aug 28, 2022 7:00 AM",13,6,7,19,10,9,25,17,8,21,15,6,1,1,0,3,6,5,1,5,4,1,5,14,10,4,6,18,4,6,5,2,3,,,
"Aug 28, 2022 8:00 AM",32,11,21,103,58,45,86,49,37,75,54,21,4,2,2,3,21,21,0,5,5,0,19,35,26,16,10,17,3,5,3,2,1,,,
"Aug 28, 2022 9:00 AM",30,17,13,135,75,60,109,72,37,126,88,38,9,2,7,10,14,14,0,8,7,1,12,46,47,35,12,26,5,2,4,3,1,,,
"Aug 28, 2022 10:00 AM",57,37,20,151,82,69,161,90,71,131,77,54,18,7,11,15,16,14,2,10,9,1,12,34,70,36,34,39,6,7,4,2,2,,,
"Aug 28, 2022 11:00 AM",57,39,18,183,103,80,159,92,67,149,89,60,37,22,15,13,17,16,1,8,5,3,16,41,70,44,26,48,12,2,11,10,1,,,
"Aug 28, 2022 12:00 PM",77,38,39,168,99,69,161,92,69,143,100,43,32,17,15,30,15,15,0,15,13,2,11,35,91,59,32,50,3,5,4,3,1,,,
"Aug 28, 2022 1:00 PM",59,28,31,153,84,69,156,92,64,133,79,54,42,9,33,21,26,24,2,20,19,1,23,42,102,58,44,33,11,5,11,11,0,,,
"Aug 28, 2022 2:00 PM",51,25,26,179,90,89,141,83,58,121,78,43,53,32,21,32,29,27,2,6,5,1,21,41,70,40,30,35,9,2,8,5,3,,,
"Aug 28, 2022 3:00 PM",45,21,24,153,91,62,143,68,75,137,71,66,36,15,21,13,20,20,0,13,13,0,17,28,50,26,24,42,10,2,5,0,5,,,
"Aug 28, 2022 4:00 PM",62,32,30,151,75,76,127,53,74,125,41,84,59,22,37,15,19,19,0,11,8,3,20,26,62,24,38,38,4,3,6,1,5,,,
"Aug 28, 2022 5:00 PM",54,21,33,138,48,90,111,37,74,99,34,65,35,19,16,8,12,12,0,10,10,0,10,28,54,14,40,48,5,1,8,5,3,,,
"Aug 28, 2022 6:00 PM",68,22,46,106,39,67,71,31,40,94,31,63,41,25,16,4,10,7,3,11,11,0,9,19,26,9,17,43,4,2,12,9,3,,,
"Aug 28, 2022 7:00 PM",44,17,27,43,21,22,44,18,26,38,10,28,19,13,6,4,13,13,0,8,6,2,11,16,15,8,7,21,2,1,11,5,6,,,
"Aug 28, 2022 8:00 PM",45,21,24,38,23,15,42,16,26,26,12,14,19,10,9,10,14,13,1,14,12,2,14,9,15,6,9,18,1,3,3,2,1,,,
"Aug 28, 2022 9:00 PM",26,11,15,14,8,6,14,5,9,13,3,10,8,4,4,7,15,14,1,7,6,1,14,12,6,4,2,15,4,1,1,1,0,,,
"Aug 28, 2022 10:00 PM",13,6,7,2,2,0,13,6,7,7,4,3,0,0,0,4,7,7,0,4,4,0,7,8,0,0,0,10,0,2,1,0,1,,,
"Aug 28, 2022 11:00 PM",9,4,5,5,4,1,4,1,3,6,3,3,2,1,1,0,3,3,0,3,3,0,4,4,5,4,1,6,1,0,0,0,0,,,
"Aug 29, 2022 12:00 AM",7,0,7,0,0,0,5,4,1,3,0,3,0,0,0,9,5,5,0,5,5,0,6,5,1,1,0,2,0,0,1,0,1,,,
"Aug 29, 2022 1:00 AM",3,1,2,0,0,0,0,0,0,0,0,0,1,1,0,0,0,0,0,2,1,1,0,1,1,1,0,1,1,0,0,0,0,,,
"Aug 29, 2022 2:00 AM",3,2,1,0,0,0,0,0,0,0,0,0,0,0,0,4,1,1,0,0,0,0,1,0,0,0,0,0,0,0,0,0,0,,,
"Aug 29, 2022 3:00 AM",2,0,2,0,0,0,0,0,0,0,0,0,0,0,0,0,0,0,0,0,0,0,0,0,0,0,0,0,0,0,0,0,0,,,
"Aug 29, 2022 4:00 AM",1,1,0,0,0,0,1,0,1,0,0,0,0,0,0,0,1,1,0,0,0,0,1,0,0,0,0,0,0,1,0,0,0,,,
"Aug 29, 2022 5:00 AM",9,6,3,1,0,1,3,0,3,2,1,1,0,0,0,2,8,8,0,2,0,2,9,3,2,1,1,8,0,1,0,0,0,,,
"Aug 29, 2022 6:00 AM",56,36,20,16,5,11,25,7,18,18,8,10,2,0,2,8,26,26,0,9,8,1,25,14,12,5,7,38,3,2,3,3,0,,,
"Aug 29, 2022 7:00 AM",104,73,31,64,21,43,66,20,46,57,19,38,15,10,5,14,84,83,1,16,12,4,78,34,44,16,28,104,1,1,7,7,0,,,
"Aug 29, 2022 8:00 AM",221,151,70,83,20,63,137,39,98,98,37,61,26,19,7,32,146,146,0,29,23,6,132,56,76,25,51,199,6,9,11,6,5,,,
"Aug 29, 2022 9:00 AM",115,88,27,79,23,56,91,44,47,79,35,44,13,10,3,13,51,51,0,20,14,6,43,27,41,15,26,73,2,8,5,4,1,,,
"Aug 29, 2022 10:00 AM",50,32,18,60,32,28,77,38,39,61,33,28,17,9,8,13,27,26,1,15,12,3,23,16,29,20,9,45,5,5,4,2,2,,,
"Aug 29, 2022 11:00 AM",70,45,25,64,39,25,88,56,32,63,41,22,17,7,10,20,18,16,2,18,16,2,20,17,34,23,11,17,10,6,3,1,2,,,
"Aug 29, 2022 12:00 PM",72,35,37,104,45,59,144,96,48,87,45,42,27,20,7,34,31,29,2,15,14,1,26,51,59,36,23,29,9,5,8,7,1,,,
"Aug 29, 2022 1:00 PM",81,40,41,123,72,51,183,97,86,98,53,45,33,11,22,15,24,24,0,23,21,2,22,29,91,56,35,36,5,7,4,4,0,,,
"Aug 29, 2022 2:00 PM",72,45,27,106,54,52,143,66,77,77,42,35,12,4,8,20,21,18,3,26,23,3,16,38,65,48,17,58,4,3,5,1,4,,,
"Aug 29, 2022 3:00 PM",92,38,54,82,45,37,128,73,55,74,52,22,13,4,9,30,34,29,5,29,20,9,28,44,67,41,26,31,6,1,10,7,3,,,
"Aug 29, 2022 4:00 PM",132,46,86,90,47,43,129,73,56,106,51,55,16,7,9,24,26,22,4,54,49,5,19,65,82,53,29,57,3,6,6,4,2,,,
"Aug 29, 2022 5:00 PM",232,65,167,121,73,48,163,101,62,137,85,52,25,12,13,33,43,37,6,95,93,2,31,115,87,56,31,70,14,11,20,11,9,,,
"Aug 29, 2022 6:00 PM",189,46,143,131,85,46,150,98,52,124,79,45,21,6,15,40,37,32,5,97,93,4,27,135,75,47,28,49,10,6,11,7,4,,,
"Aug 29, 2022 7:00 PM",105,41,64,105,59,46,119,70,49,118,78,40,18,6,12,20,25,19,6,56,55,1,18,65,66,47,19,43,7,2,11,8,3,,,
"Aug 29, 2022 8:00 PM",80,33,47,79,32,47,83,38,45,93,40,53,9,8,1,9,22,22,0,26,23,3,16,24,43,21,22,33,4,3,3,1,2,,,
"Aug 29, 2022 9:00 PM",33,13,20,18,8,10,32,11,21,22,5,17,5,0,5,10,10,8,2,15,12,3,10,15,9,6,3,25,6,1,3,2,1,,,
"Aug 29, 2022 10:00 PM",28,8,20,10,5,5,16,6,10,18,3,15,0,0,0,4,12,11,1,5,4,1,7,10,5,3,2,13,2,1,6,5,1,,,
"Aug 29, 2022 11:00 PM",14,6,8,4,2,2,5,4,1,4,4,0,2,0,2,0,6,6,0,2,2,0,6,6,2,2,0,4,0,1,0,0,0,,,
"Aug 30, 2022 12:00 AM",5,0,5,0,0,0,5,2,3,3,1,2,0,0,0,0,2,2,0,6,5,1,3,7,1,1,0,3,0,0,1,1,0,,,
"Aug 30, 2022 1:00 AM",5,0,5,0,0,0,0,0,0,0,0,0,0,0,0,0,2,2,0,0,0,0,2,1,0,0,0,2,0,1,0,0,0,,,
"Aug 30, 2022 2:00 AM",11,10,1,0,0,0,1,0,1,0,0,0,0,0,0,0,1,1,0,1,1,0,1,0,0,0,0,0,0,0,0,0,0,,,
"Aug 30, 2022 3:00 AM",2,0,2,0,0,0,0,0,0,1,0,1,0,0,0,0,0,0,0,0,0,0,0,0,0,0,0,0,0,0,0,0,0,,,
"Aug 30, 2022 4:00 AM",2,0,2,0,0,0,1,1,0,1,1,0,0,0,0,0,0,0,0,0,0,0,0,0,0,0,0,1,0,1,0,0,0,,,
"Aug 30, 2022 5:00 AM",9,6,3,2,1,1,5,1,4,3,1,2,0,0,0,0,9,9,0,2,0,2,8,3,2,1,1,8,1,0,0,0,0,,,
"Aug 30, 2022 6:00 AM",54,34,20,23,13,10,36,12,24,24,14,10,6,3,3,11,34,34,0,11,8,3,34,16,14,4,10,40,0,6,4,3,1,,,
"Aug 30, 2022 7:00 AM",175,127,48,83,26,57,103,27,76,74,26,48,9,4,5,16,98,97,1,32,24,8,95,39,43,16,27,146,8,5,8,6,2,,,
"Aug 30, 2022 8:00 AM",298,211,87,116,24,92,171,54,117,117,42,75,29,20,9,30,166,165,1,39,29,10,152,64,119,42,77,228,6,9,13,11,2,,,
"Aug 30, 2022 9:00 AM",127,94,33,91,41,50,112,60,52,95,57,38,25,15,10,11,85,85,0,26,19,7,72,30,57,30,27,91,2,9,4,3,1,,,
"Aug 30, 2022 10:00 AM",59,42,17,73,34,39,79,48,31,73,40,33,16,10,6,12,37,36,1,10,6,4,33,26,31,18,13,26,3,2,7,3,4,,,
"Aug 30, 2022 11:00 AM",55,36,19,88,36,52,90,42,48,80,37,43,22,10,12,17,12,12,0,10,9,1,12,24,41,22,19,25,1,3,4,1,3,,,
"Aug 30, 2022 12:00 PM",57,35,22,81,45,36,127,82,45,93,62,31,26,10,16,16,28,27,1,17,15,2,23,34,44,27,17,34,9,3,5,4,1,,,
"Aug 30, 2022 1:00 PM",84,34,50,85,36,49,136,66,70,78,35,43,33,23,10,18,22,20,2,31,30,1,19,39,66,38,28,38,5,4,6,3,3,,,
"Aug 30, 2022 2:00 PM",58,24,34,81,45,36,137,85,52,58,37,21,25,17,8,15,21,19,2,21,19,2,20,40,70,52,18,30,10,6,5,3,2,,,
"Aug 30, 2022 3:00 PM",95,34,61,97,51,46,153,81,72,95,50,45,37,17,20,18,29,25,4,25,22,3,22,33,59,42,17,51,6,3,6,3,3,,,
"Aug 30, 2022 4:00 PM",146,41,105,90,56,34,156,89,67,95,65,30,37,14,23,29,33,27,6,56,54,2,26,87,78,53,25,59,14,4,5,2,3,,,
"Aug 30, 2022 5:00 PM",267,82,185,142,67,75,219,122,97,141,85,56,28,14,14,39,50,36,14,111,108,3,34,144,100,75,25,85,13,10,15,11,4,,,
"Aug 30, 2022 6:00 PM",262,84,178,156,104,52,232,148,84,163,108,55,25,15,10,34,47,42,5,96,93,3,35,150,125,75,50,67,12,1,17,12,5,,,
"Aug 30, 2022 7:00 PM",115,43,72,139,70,69,126,68,58,110,62,48,20,8,12,34,29,29,0,53,51,2,26,77,58,42,16,62,10,5,16,9,7,,,
"Aug 30, 2022 8:00 PM",106,37,69,80,34,46,94,41,53,73,29,44,14,9,5,26,23,21,2,32,32,0,20,32,38,19,19,37,6,5,4,2,2,,,
"Aug 30, 2022 9:00 PM",50,13,37,36,26,10,25,9,16,19,6,13,10,1,9,6,14,13,1,19,18,1,10,23,8,5,3,14,1,2,5,2,3,,,
"Aug 30, 2022 10:00 PM",29,6,23,24,20,4,28,9,19,29,11,18,4,0,4,2,10,8,2,13,13,0,8,16,11,6,5,11,2,0,2,1,1,,,
"Aug 30, 2022 11:00 PM",21,6,15,5,4,1,12,6,6,7,4,3,1,1,0,3,6,6,0,11,11,0,4,10,6,4,2,6,0,1,0,0,0,,,
"Aug 31, 2022 12:00 AM",6,1,5,0,0,0,3,2,1,3,3,0,0,0,0,0,0,0,0,2,2,0,1,7,5,4,1,1,0,0,0,0,0,,,
"Aug 31, 2022 1:00 AM",2,0,2,0,0,0,2,1,1,4,4,0,2,1,1,0,0,0,0,0,0,0,0,2,3,2,1,1,0,0,0,0,0,,,
"Aug 31, 2022 2:00 AM",8,7,1,0,0,0,0,0,0,0,0,0,0,0,0,0,1,1,0,0,0,0,1,2,2,2,0,0,0,0,0,0,0,,,
"Aug 31, 2022 3:00 AM",1,0,1,0,0,0,1,1,0,1,1,0,0,0,0,0,0,0,0,0,0,0,0,0,1,1,0,0,0,0,1,1,0,,,
"Aug 31, 2022 4:00 AM",1,0,1,0,0,0,1,1,0,2,2,0,1,1,0,0,0,0,0,0,0,0,0,0,0,0,0,4,0,0,1,1,0,,,
"Aug 31, 2022 5:00 AM",6,3,3,3,2,1,1,0,1,2,1,1,0,0,0,0,13,13,0,3,1,2,12,3,0,0,0,7,0,1,0,0,0,,,
"Aug 31, 2022 6:00 AM",61,39,22,20,8,12,27,7,20,20,8,12,2,1,1,6,22,22,0,8,5,3,21,13,10,10,0,45,1,5,3,2,1,,,
"Aug 31, 2022 7:00 AM",157,106,51,68,28,40,98,30,68,68,30,38,9,6,3,16,100,98,2,18,16,2,95,47,46,43,3,136,5,8,11,10,1,,,
"Aug 31, 2022 8:00 AM",308,222,86,118,24,94,180,52,128,143,46,97,64,36,28,38,186,185,1,38,33,5,178,67,106,96,10,264,8,11,7,3,4,,,
"Aug 31, 2022 9:00 AM",122,79,43,78,25,53,100,50,50,95,49,46,26,12,14,19,60,59,1,21,17,4,54,25,61,55,6,90,7,6,8,4,4,,,
"Aug 31, 2022 10:00 AM",68,50,18,68,34,34,60,33,27,58,31,27,16,5,11,14,36,34,2,16,12,4,28,24,30,28,2,33,3,2,3,1,2,,,
"Aug 31, 2022 11:00 AM",54,33,21,76,35,41,79,38,41,64,36,28,20,15,5,10,30,27,3,9,9,0,24,18,32,31,1,37,1,2,2,2,0,,,
"Aug 31, 2022 12:00 PM",76,43,33,62,32,30,77,48,29,68,42,26,22,12,10,11,20,19,1,20,14,6,17,26,39,38,1,29,3,5,2,2,0,,,
"Aug 31, 2022 1:00 PM",85,39,46,87,46,41,140,90,50,87,57,30,20,8,12,25,31,27,4,29,27,2,24,43,56,47,9,22,2,6,5,2,3,,,
"Aug 31, 2022 2:00 PM",75,37,38,91,57,34,104,57,47,78,46,32,24,9,15,13,26,24,2,29,28,1,18,23,72,59,13,31,8,3,9,6,3,,,
"Aug 31, 2022 3:00 PM",95,37,58,103,56,47,138,90,48,82,52,30,32,10,22,30,22,21,1,22,19,3,21,48,68,63,5,30,8,4,8,5,3,,,
"Aug 31, 2022 4:00 PM",156,57,99,79,44,35,139,82,57,91,51,40,23,8,15,26,35,29,6,35,33,2,28,98,66,61,5,48,8,3,16,10,6,,,
"Aug 31, 2022 5:00 PM",265,75,190,123,71,52,194,106,88,122,72,50,19,9,10,48,43,32,11,115,109,6,33,128,106,102,4,82,10,12,12,5,7,,,
"Aug 31, 2022 6:00 PM",231,65,166,117,82,35,163,105,58,115,79,36,17,8,9,25,52,47,5,108,106,2,45,151,99,91,8,53,10,2,7,6,1,,,
"Aug 31, 2022 7:00 PM",131,35,96,103,53,50,131,77,54,96,52,44,14,8,6,23,24,20,4,50,49,1,17,59,61,58,3,34,9,5,12,9,3,,,
"Aug 31, 2022 8:00 PM",64,21,43,69,32,37,73,31,42,52,22,30,7,2,5,22,15,13,2,13,10,3,11,29,31,25,6,36,6,4,16,9,7,,,
"Aug 31, 2022 9:00 PM",56,21,35,19,11,8,44,20,24,29,6,23,8,1,7,10,10,6,4,11,11,0,6,17,16,9,7,18,4,3,4,3,1,,,
"Aug 31, 2022 10:00 PM",42,11,31,10,6,4,17,11,6,12,6,6,3,1,2,5,10,9,1,25,23,2,8,15,9,7,2,11,4,1,3,3,0,,,
"Aug 31, 2022 11:00 PM",24,5,19,7,7,0,9,3,6,2,0,2,5,0,5,5,4,4,0,4,4,0,4,11,4,4,0,6,0,0,1,1,0,,,
"Sep 1, 2022 12:00 AM",16,3,13,0,0,0,4,1,3,3,0,3,1,0,1,0,1,1,0,4,3,1,1,4,0,0,0,5,1,0,1,1,0,,,
"Sep 1, 2022 1:00 AM",7,2,5,1,0,1,1,1,0,1,0,1,0,0,0,0,2,2,0,2,2,0,2,4,0,0,0,2,0,0,0,0,0,,,
"Sep 1, 2022 2:00 AM",9,8,1,3,3,0,1,1,0,2,2,0,0,0,0,0,2,1,1,0,0,0,0,1,0,0,0,1,0,0,0,0,0,,,
"Sep 1, 2022 3:00 AM",0,0,0,0,0,0,0,0,0,0,0,0,0,0,0,0,0,0,0,1,1,0,0,0,0,0,0,0,0,0,0,0,0,,,
"Sep 1, 2022 4:00 AM",3,2,1,1,0,1,2,2,0,2,1,1,0,0,0,0,0,0,0,1,1,0,0,0,0,0,0,1,0,0,0,0,0,,,
"Sep 1, 2022 5:00 AM",9,6,3,4,1,3,3,1,2,3,1,2,0,0,0,2,10,10,0,3,2,1,9,2,1,0,1,9,1,1,0,0,0,,,
"Sep 1, 2022 6:00 AM",45,33,12,25,12,13,26,13,13,27,13,14,1,1,0,7,23,23,0,11,7,4,23,15,7,2,5,30,2,6,4,3,1,,,
"Sep 1, 2022 7:00 AM",155,110,45,74,21,53,90,25,65,66,20,46,18,11,7,19,88,87,1,21,18,3,84,44,44,16,28,116,7,8,5,4,1,,,
"Sep 1, 2022 8:00 AM",324,232,92,129,33,96,165,53,112,126,49,77,53,26,27,47,162,156,6,51,41,10,146,62,95,36,59,226,10,3,15,14,1,,,
"Sep 1, 2022 9:00 AM",130,98,32,82,27,55,90,45,45,78,41,37,29,23,6,22,75,74,1,17,17,0,67,24,43,19,24,95,2,8,5,4,1,,,
"Sep 1, 2022 10:00 AM",59,41,18,68,37,31,68,43,25,68,45,23,20,6,14,11,33,33,0,14,11,3,32,19,20,11,9,34,6,7,3,2,1,,,
"Sep 1, 2022 11:00 AM",60,29,31,59,25,34,55,28,27,55,28,27,16,8,8,11,24,22,2,9,8,1,23,14,38,15,23,25,4,3,10,7,3,,,
"Sep 1, 2022 12:00 PM",54,29,25,59,23,36,86,39,47,64,26,38,24,9,15,8,24,22,2,20,19,1,18,21,32,20,12,30,10,2,14,11,3,,,
"Sep 1, 2022 1:00 PM",78,35,43,78,46,32,104,67,37,59,34,25,18,10,8,14,24,24,0,22,20,2,22,31,52,36,16,23,7,2,5,4,1,,,
"Sep 1, 2022 2:00 PM",79,36,43,73,40,33,103,56,47,61,32,29,21,10,11,21,21,16,5,21,16,5,14,35,44,29,15,24,8,3,9,7,2,,,
"Sep 1, 2022 3:00 PM",102,41,61,55,33,22,99,57,42,53,36,17,24,14,10,17,47,43,4,44,35,9,36,40,69,43,26,32,5,6,10,4,6,,,
"Sep 1, 2022 4:00 PM",147,60,87,110,54,56,160,101,59,109,73,36,28,14,14,32,39,37,2,56,48,8,40,82,79,51,28,54,12,10,13,5,8,,,
"Sep 1, 2022 5:00 PM",249,74,175,125,73,52,187,114,73,119,74,45,29,17,12,34,50,44,6,90,87,3,38,127,114,75,39,83,6,5,9,6,3,,,
"Sep 1, 2022 6:00 PM",246,80,166,121,77,44,167,104,63,123,83,40,15,6,9,40,41,32,9,92,88,4,31,119,101,73,28,64,14,6,11,8,3,,,
"Sep 1, 2022 7:00 PM",132,43,89,100,53,47,114,68,46,94,46,48,13,7,6,16,22,19,3,43,38,5,23,51,50,34,16,34,8,10,19,13,6,,,
"Sep 1, 2022 8:00 PM",108,36,72,51,30,21,75,38,37,58,30,28,5,2,3,14,16,13,3,29,27,2,15,28,35,15,20,32,8,3,16,9,7,,,
"Sep 1, 2022 9:00 PM",47,10,37,32,23,9,25,13,12,26,12,14,7,1,6,12,11,9,2,18,15,3,10,21,11,6,5,20,6,0,4,3,1,,,
"Sep 1, 2022 10:00 PM",47,18,29,16,16,0,22,11,11,22,12,10,4,0,4,6,13,9,4,12,11,1,7,22,7,5,2,9,1,2,1,0,1,,,
"Sep 1, 2022 11:00 PM",18,7,11,14,10,4,10,7,3,10,5,5,2,1,1,6,6,6,0,9,8,1,8,8,5,3,2,8,0,1,3,2,1,,,
"Sep 2, 2022 12:00 AM",10,2,8,0,0,0,5,2,3,3,1,2,4,3,1,0,2,2,0,7,7,0,2,5,5,3,2,4,0,0,0,0,0,,,
"Sep 2, 2022 1:00 AM",11,2,9,3,3,0,2,1,1,1,1,0,2,1,1,0,0,0,0,5,5,0,1,3,1,1,0,4,0,0,1,1,0,,,
"Sep 2, 2022 2:00 AM",8,6,2,0,0,0,0,0,0,0,0,0,0,0,0,0,1,1,0,2,2,0,1,0,0,0,0,0,0,0,0,0,0,,,
"Sep 2, 2022 3:00 AM",0,0,0,0,0,0,0,0,0,0,0,0,0,0,0,0,0,0,0,0,0,0,0,0,1,1,0,0,0,0,0,0,0,,,
"Sep 2, 2022 4:00 AM",2,1,1,1,0,1,1,1,0,2,1,1,0,0,0,0,1,1,0,0,0,0,1,0,0,0,0,2,0,1,0,0,0,,,
"Sep 2, 2022 5:00 AM",9,6,3,0,0,0,0,0,0,0,0,0,0,0,0,1,8,8,0,1,0,1,8,2,0,0,0,8,2,1,0,0,0,,,
"Sep 2, 2022 6:00 AM",44,29,15,31,16,15,29,11,18,27,12,15,0,0,0,5,18,18,0,9,8,1,18,13,17,13,4,24,0,3,1,1,0,,,
"Sep 2, 2022 7:00 AM",117,79,38,91,36,55,88,25,63,58,21,37,12,6,6,16,69,69,0,18,17,1,65,30,39,15,24,100,4,4,5,5,0,,,
"Sep 2, 2022 8:00 AM",215,146,69,111,26,85,162,56,106,118,42,76,41,28,13,28,106,104,2,36,34,2,92,53,83,24,59,163,15,9,22,18,4,,,
"Sep 2, 2022 9:00 AM",91,68,23,63,32,31,70,34,36,58,32,26,22,12,10,16,50,49,1,21,18,3,43,28,26,14,12,65,3,6,3,1,2,,,
"Sep 2, 2022 10:00 AM",51,36,15,86,38,48,63,33,30,61,36,25,17,10,7,18,27,26,1,9,6,3,22,14,26,14,12,31,6,7,10,7,3,,,
"Sep 2, 2022 11:00 AM",67,36,31,75,27,48,78,41,37,66,29,37,11,7,4,20,17,15,2,9,8,1,14,23,18,11,7,21,7,3,8,6,2,,,
"Sep 2, 2022 12:00 PM",78,37,41,82,45,37,76,42,34,71,42,29,18,6,12,19,33,29,4,23,21,2,23,24,20,12,8,25,4,2,4,2,2,,,
"Sep 2, 2022 1:00 PM",109,49,60,86,41,45,92,51,41,80,40,40,20,11,9,14,33,32,1,28,24,4,27,37,40,27,13,37,10,4,9,7,2,,,
"Sep 2, 2022 2:00 PM",90,46,44,50,27,23,69,45,24,42,26,16,24,10,14,15,18,16,2,18,16,2,15,32,43,22,21,28,2,6,6,4,2,,,
"Sep 2, 2022 3:00 PM",110,52,58,42,16,26,89,42,47,47,25,22,13,7,6,15,22,19,3,27,22,5,14,36,40,26,14,35,2,6,15,7,8,,,
"Sep 2, 2022 4:00 PM",109,31,78,67,43,24,92,61,31,71,57,14,24,8,16,26,32,28,4,47,44,3,27,70,47,33,14,41,4,1,14,10,4,,,
"Sep 2, 2022 5:00 PM",188,59,129,96,52,44,136,85,51,94,64,30,22,9,13,23,22,20,2,65,63,2,16,83,70,48,22,60,12,8,14,11,3,,,
"Sep 2, 2022 6:00 PM",131,42,89,89,60,29,109,73,36,100,66,34,19,6,13,19,21,18,3,51,49,2,21,67,54,39,15,33,9,1,7,5,2,,,
"Sep 2, 2022 7:00 PM",84,35,49,51,25,26,58,37,21,41,24,17,16,4,12,19,10,9,1,42,40,2,10,41,38,23,15,20,6,4,3,3,0,,,
"Sep 2, 2022 8:00 PM",54,19,35,33,22,11,45,19,26,30,11,19,11,4,7,11,8,6,2,11,11,0,7,18,13,8,5,17,7,0,7,6,1,,,
"Sep 2, 2022 9:00 PM",43,23,20,29,21,8,25,10,15,25,11,14,5,1,4,7,12,10,2,7,7,0,8,8,7,5,2,18,2,0,3,2,1,,,
"Sep 2, 2022 10:00 PM",38,13,25,26,16,10,18,6,12,21,4,17,2,2,0,4,7,7,0,5,5,0,9,7,13,10,3,6,1,3,2,1,1,,,
"Sep 2, 2022 11:00 PM",18,6,12,12,11,1,12,8,4,14,10,4,2,0,2,2,3,3,0,7,6,1,4,5,3,2,1,6,0,0,2,2,0,,,
"Sep 3, 2022 12:00 AM",12,2,10,0,0,0,5,3,2,7,2,5,1,1,0,0,0,0,0,2,2,0,0,8,4,2,2,12,0,1,2,0,2,,,
"Sep 3, 2022 1:00 AM",9,2,7,1,1,0,6,2,4,3,1,2,0,0,0,0,0,0,0,3,3,0,1,2,4,2,2,2,1,1,0,0,0,,,
"Sep 3, 2022 2:00 AM",11,5,6,0,0,0,1,0,1,2,1,1,0,0,0,0,2,2,0,1,1,0,2,2,0,0,0,4,0,0,0,0,0,,,
"Sep 3, 2022 3:00 AM",0,0,0,0,0,0,0,0,0,0,0,0,0,0,0,0,0,0,0,0,0,0,0,3,1,1,0,0,0,0,0,0,0,,,
"Sep 3, 2022 4:00 AM",2,0,2,0,0,0,0,0,0,0,0,0,1,0,1,0,0,0,0,1,0,1,0,0,0,0,0,0,0,0,0,0,0,,,
"Sep 3, 2022 5:00 AM",7,2,5,2,0,2,1,0,1,1,0,1,0,0,0,0,1,1,0,0,0,0,0,2,2,1,1,1,0,0,0,0,0,,,
"Sep 3, 2022 6:00 AM",7,5,2,6,1,5,6,2,4,5,2,3,1,0,1,1,4,4,0,2,1,1,4,3,0,0,0,8,0,0,0,0,0,,,
"Sep 3, 2022 7:00 AM",16,11,5,12,8,4,16,9,7,15,11,4,0,0,0,3,5,4,1,4,4,0,3,6,6,3,3,15,1,3,1,1,0,,,
"Sep 3, 2022 8:00 AM",9,5,4,17,7,10,9,7,2,18,9,9,7,5,2,4,5,5,0,4,4,0,7,5,5,4,1,7,1,4,2,2,0,,,
"Sep 3, 2022 9:00 AM",28,21,7,20,6,14,23,13,10,13,10,3,9,8,1,5,6,6,0,4,4,0,6,9,15,11,4,6,0,0,2,1,1,,,
"Sep 3, 2022 10:00 AM",26,17,9,23,6,17,16,10,6,15,8,7,3,1,2,4,4,4,0,4,4,0,4,9,7,2,5,8,1,1,1,1,0,,,
"Sep 3, 2022 11:00 AM",23,9,14,26,9,17,17,5,12,20,11,9,2,2,0,11,7,7,0,7,7,0,7,4,10,6,4,13,0,2,2,1,1,,,
"Sep 3, 2022 12:00 PM",15,10,5,24,10,14,17,13,4,17,15,2,8,7,1,6,6,6,0,9,9,0,6,13,4,4,0,9,1,3,3,2,1,,,
"Sep 3, 2022 1:00 PM",17,9,8,15,10,5,9,4,5,12,9,3,8,4,4,3,5,5,0,4,2,2,4,10,3,2,1,7,1,0,2,1,1,,,
"Sep 3, 2022 2:00 PM",17,7,10,8,6,2,8,3,5,8,2,6,5,2,3,14,6,6,0,3,3,0,6,1,3,2,1,8,2,1,2,2,0,,,
"Sep 3, 2022 3:00 PM",25,14,11,22,18,4,12,5,7,11,8,3,4,1,3,1,6,6,0,6,5,1,7,7,5,3,2,8,1,0,2,1,1,,,
"Sep 3, 2022 4:00 PM",23,12,11,15,12,3,14,6,8,11,4,7,4,0,4,2,7,7,0,2,2,0,6,7,2,1,1,9,2,0,2,2,0,,,
"Sep 3, 2022 5:00 PM",24,13,11,9,7,2,14,2,12,8,0,8,5,2,3,5,4,4,0,5,5,0,3,2,6,3,3,6,2,0,1,1,0,,,
"Sep 3, 2022 6:00 PM",35,15,20,13,8,5,12,7,5,6,4,2,3,1,2,2,3,3,0,5,5,0,1,9,4,2,2,5,1,2,1,1,0,,,
"Sep 3, 2022 7:00 PM",40,20,20,11,8,3,11,7,4,9,4,5,5,3,2,7,6,6,0,8,6,2,7,8,7,3,4,9,0,1,4,1,3,,,
"Sep 3, 2022 8:00 PM",26,14,12,16,10,6,8,3,5,10,3,7,6,3,3,10,5,5,0,2,2,0,6,3,7,3,4,3,1,1,2,2,0,,,
"Sep 3, 2022 9:00 PM",15,8,7,13,7,6,6,3,3,4,1,3,7,3,4,4,9,9,0,5,4,1,9,3,7,4,3,10,0,0,1,0,1,,,
"Sep 3, 2022 10:00 PM",9,2,7,5,4,1,3,1,2,2,0,2,5,3,2,4,0,0,0,1,1,0,0,2,9,6,3,7,0,0,1,0,1,,,
"Sep 3, 2022 11:00 PM",12,5,7,1,1,0,2,0,2,2,1,1,6,5,1,3,5,4,1,3,2,1,4,1,1,1,0,3,0,0,1,0,1,,,
"Sep 4, 2022 12:00 AM",7,3,4,0,0,0,3,2,1,5,4,1,1,1,0,1,3,3,0,3,2,1,2,3,0,0,0,5,0,1,0,0,0,,,
"Sep 4, 2022 1:00 AM",12,4,8,1,0,1,1,0,1,1,0,1,1,0,1,0,0,0,0,0,0,0,0,2,1,1,0,1,0,0,1,1,0,,,
"Sep 4, 2022 2:00 AM",6,2,4,2,2,0,4,1,3,1,1,0,1,0,1,0,0,0,0,0,0,0,0,1,0,0,0,2,0,0,0,0,0,,,
"Sep 4, 2022 3:00 AM",1,1,0,0,0,0,0,0,0,0,0,0,0,0,0,1,0,0,0,1,0,1,0,0,0,0,0,0,0,0,1,1,0,,,
"Sep 4, 2022 4:00 AM",1,0,1,0,0,0,0,0,0,0,0,0,0,0,0,0,0,0,0,1,1,0,0,0,0,0,0,0,0,0,0,0,0,,,
"Sep 4, 2022 5:00 AM",1,0,1,0,0,0,0,0,0,0,0,0,0,0,0,0,0,0,0,0,0,0,1,0,0,0,0,0,0,0,0,0,0,,,
"Sep 4, 2022 6:00 AM",3,1,2,2,0,2,2,1,1,1,0,1,0,0,0,0,5,4,1,4,4,0,4,4,0,0,0,0,0,0,0,0,0,,,
"Sep 4, 2022 7:00 AM",9,5,4,11,9,2,17,8,9,15,12,3,0,0,0,4,5,5,0,3,3,0,4,6,7,5,2,0,0,2,1,0,1,,,
"Sep 4, 2022 8:00 AM",22,10,12,35,15,20,36,20,16,32,18,14,5,4,1,10,9,9,0,4,4,0,9,10,13,10,3,0,0,5,4,2,2,,,
"Sep 4, 2022 9:00 AM",33,19,14,104,53,51,104,70,34,78,55,23,13,7,6,12,11,11,0,11,9,2,11,21,42,30,12,6,23,9,5,3,2,,,
"Sep 4, 2022 10:00 AM",49,23,26,169,94,75,146,78,68,162,95,67,13,6,7,20,17,17,0,10,8,2,15,29,53,35,18,4,5,7,7,5,2,,,
"Sep 4, 2022 11:00 AM",59,41,18,155,75,80,135,69,66,136,81,55,18,13,5,29,19,19,0,13,11,2,17,23,63,41,22,31,5,5,10,7,3,,,
"Sep 4, 2022 12:00 PM",62,27,35,180,94,86,136,77,59,165,99,66,35,15,20,29,20,19,1,20,10,10,16,38,69,45,24,31,12,3,14,10,4,,,
"Sep 4, 2022 1:00 PM",64,25,39,151,64,87,149,85,64,161,78,83,42,27,15,19,23,18,5,13,12,1,16,33,80,44,36,42,7,2,9,6,3,,,
"Sep 4, 2022 2:00 PM",65,36,29,151,76,75,131,71,60,119,64,55,29,13,16,13,33,31,2,14,13,1,25,34,72,43,29,37,4,3,2,1,1,,,
"Sep 4, 2022 3:00 PM",51,26,25,148,80,68,136,65,71,160,77,83,41,22,19,22,32,28,4,17,15,2,24,30,83,52,31,29,7,4,6,3,3,,,
"Sep 4, 2022 4:00 PM",56,34,22,154,71,83,169,83,86,145,56,89,34,12,22,32,19,17,2,16,15,1,18,21,81,46,35,47,9,5,3,2,1,,,
"Sep 4, 2022 5:00 PM",47,19,28,124,68,56,162,71,91,125,53,72,28,17,11,27,16,11,5,10,10,0,9,27,74,30,44,45,2,2,9,4,5,,,
"Sep 4, 2022 6:00 PM",67,24,43,94,50,44,130,49,81,83,34,49,12,7,5,24,18,16,2,14,11,3,15,21,59,19,40,49,1,3,11,5,6,,,
"Sep 4, 2022 7:00 PM",69,40,29,56,22,34,65,26,39,47,16,31,12,4,8,12,8,7,1,5,4,1,8,27,31,17,14,26,7,2,5,3,2,,,
"Sep 4, 2022 8:00 PM",32,12,20,25,11,14,30,11,19,26,10,16,5,4,1,17,10,8,2,10,9,1,6,12,19,12,7,18,2,2,10,7,3,,,
"Sep 4, 2022 9:00 PM",24,8,16,10,9,1,6,1,5,4,1,3,2,0,2,8,5,5,0,10,8,2,7,7,2,2,0,9,1,1,2,2,0,,,
"Sep 4, 2022 10:00 PM",9,2,7,7,4,3,5,1,4,5,1,4,1,0,1,3,4,4,0,5,5,0,5,3,1,1,0,7,2,1,0,0,0,,,
"Sep 4, 2022 11:00 PM",12,3,9,0,0,0,2,0,2,2,0,2,2,0,2,2,2,2,0,0,0,0,2,2,2,2,0,3,0,3,3,1,2,,,
"Sep 5, 2022 12:00 AM",5,1,4,0,0,0,2,0,2,3,1,2,1,0,1,0,2,2,0,5,5,0,2,1,0,0,0,5,1,0,1,1,0,,,
"Sep 5, 2022 1:00 AM",5,0,5,0,0,0,0,0,0,0,0,0,0,0,0,1,0,0,0,1,1,0,0,0,1,1,0,0,0,0,0,0,0,,,
"Sep 5, 2022 2:00 AM",3,1,2,0,0,0,0,0,0,0,0,0,0,0,0,0,1,1,0,0,0,0,1,0,0,0,0,0,0,0,0,0,0,,,
"Sep 5, 2022 3:00 AM",2,1,1,0,0,0,0,0,0,0,0,0,0,0,0,0,0,0,0,0,0,0,0,0,0,0,0,0,0,0,0,0,0,,,
"Sep 5, 2022 4:00 AM",1,1,0,0,0,0,0,0,0,1,1,0,0,0,0,0,1,1,0,0,0,0,0,0,0,0,0,2,0,0,1,1,0,,,
"Sep 5, 2022 5:00 AM",5,2,3,1,0,1,2,1,1,1,1,0,1,1,0,1,9,9,0,2,1,1,7,1,0,0,0,10,0,1,0,0,0,,,
"Sep 5, 2022 6:00 AM",45,27,18,17,5,12,27,12,15,22,11,11,2,2,0,9,19,18,1,4,2,2,19,10,11,5,6,28,2,3,0,0,0,,,
"Sep 5, 2022 7:00 AM",129,88,41,62,26,36,91,28,63,54,23,31,9,7,2,16,89,89,0,24,22,2,84,29,36,17,19,115,2,5,9,7,2,,,
"Sep 5, 2022 8:00 AM",248,184,64,116,31,85,166,55,111,124,47,77,51,29,22,42,145,140,5,45,34,11,130,57,96,33,63,194,11,6,13,9,4,,,
"Sep 5, 2022 9:00 AM",115,96,19,76,26,50,108,55,53,77,45,32,18,12,6,12,59,59,0,20,15,5,56,47,62,30,32,73,5,8,7,5,2,,,
"Sep 5, 2022 10:00 AM",51,35,16,74,25,49,76,42,34,61,32,29,13,8,5,16,26,26,0,9,7,2,21,20,37,23,14,19,6,5,11,4,7,,,
"Sep 5, 2022 11:00 AM",42,27,15,76,37,39,75,33,42,61,34,27,17,9,8,8,17,16,1,18,13,5,14,14,21,8,13,27,5,6,4,4,0,,,
"Sep 5, 2022 12:00 PM",57,29,28,65,31,34,64,30,34,49,25,24,18,12,6,6,20,19,1,13,12,1,21,20,30,16,14,26,4,2,5,3,2,,,
"Sep 5, 2022 1:00 PM",81,47,34,72,39,33,66,32,34,51,26,25,19,9,10,12,24,21,3,22,20,2,16,15,29,18,11,24,5,7,1,0,1,,,
"Sep 5, 2022 2:00 PM",65,30,35,47,24,23,50,24,26,44,19,25,18,11,7,13,16,15,1,30,29,1,14,14,25,14,11,26,3,1,3,0,3,,,
"Sep 5, 2022 3:00 PM",94,44,50,41,19,22,39,23,16,32,17,15,13,4,9,13,38,35,3,34,27,7,27,33,34,21,13,22,4,7,6,3,3,,,
"Sep 5, 2022 4:00 PM",118,38,80,56,36,20,60,46,14,59,38,21,16,4,12,16,21,20,1,59,54,5,20,63,29,25,4,45,11,2,13,9,4,,,
"Sep 5, 2022 5:00 PM",202,54,148,49,35,14,78,47,31,68,42,26,18,3,15,20,44,34,10,108,103,5,31,97,61,50,11,62,8,4,7,3,4,,,
"Sep 5, 2022 6:00 PM",154,33,121,59,46,13,85,75,10,67,47,20,17,2,15,29,26,20,6,78,76,2,20,97,57,48,9,27,4,9,13,5,8,,,
"Sep 5, 2022 7:00 PM",84,27,57,28,19,9,53,32,21,26,16,10,5,1,4,11,17,14,3,27,26,1,13,36,27,20,7,15,8,3,11,7,4,,,
"Sep 5, 2022 8:00 PM",49,13,36,11,8,3,26,17,9,19,13,6,3,3,0,13,12,9,3,16,16,0,8,11,18,14,4,15,3,4,6,3,3,,,
"Sep 5, 2022 9:00 PM",35,8,27,6,4,2,12,7,5,8,6,2,0,0,0,1,9,8,1,8,7,1,5,13,6,4,2,7,2,1,2,1,1,,,
"Sep 5, 2022 10:00 PM",20,9,11,1,1,0,5,2,3,4,1,3,1,0,1,5,3,3,0,5,4,1,2,7,1,1,0,7,2,0,7,5,2,,,
"Sep 5, 2022 11:00 PM",12,4,8,1,1,0,5,4,1,4,1,3,0,0,0,3,1,1,0,3,3,0,1,6,0,0,0,4,0,0,2,1,1,,,
"Sep 6, 2022 12:00 AM",7,2,5,0,0,0,1,1,0,1,1,0,0,0,0,0,2,2,0,3,2,1,2,2,0,0,0,2,0,1,1,0,1,,,
"Sep 6, 2022 1:00 AM",0,0,0,1,1,0,1,1,0,3,2,1,0,0,0,0,0,0,0,1,1,0,0,1,0,0,0,0,0,0,1,1,0,,,
"Sep 6, 2022 2:00 AM",4,3,1,0,0,0,0,0,0,0,0,0,0,0,0,0,1,1,0,0,0,0,0,0,0,0,0,0,0,0,0,0,0,,,
"Sep 6, 2022 3:00 AM",0,0,0,0,0,0,0,0,0,0,0,0,0,0,0,0,0,0,0,0,0,0,0,0,0,0,0,1,0,0,1,1,0,,,
"Sep 6, 2022 4:00 AM",1,0,1,0,0,0,1,1,0,1,1,0,0,0,0,0,1,1,0,0,0,0,1,1,1,1,0,1,0,0,0,0,0,,,
"Sep 6, 2022 5:00 AM",5,2,3,0,0,0,2,2,0,1,1,0,0,0,0,1,6,6,0,3,1,2,5,1,0,0,0,5,1,1,0,0,0,,,
"Sep 6, 2022 6:00 AM",37,25,12,16,7,9,20,7,13,19,9,10,2,1,1,8,17,16,1,3,1,2,17,15,5,3,2,39,0,5,0,0,0,,,
"Sep 6, 2022 7:00 AM",162,114,48,40,8,32,74,14,60,44,9,35,7,5,2,20,73,72,1,26,22,4,67,27,47,15,32,131,2,7,7,7,0,,,
"Sep 6, 2022 8:00 AM",291,216,75,99,17,82,166,58,108,106,40,66,32,20,12,37,173,169,4,41,33,8,152,65,88,31,57,202,8,9,14,14,0,,,
"Sep 6, 2022 9:00 AM",100,82,18,64,22,42,77,42,35,60,28,32,21,14,7,11,77,76,1,13,11,2,60,23,48,18,30,82,4,5,5,2,3,,,
"Sep 6, 2022 10:00 AM",51,32,19,38,11,27,36,17,19,29,14,15,4,3,1,7,28,28,0,11,9,2,26,11,16,8,8,18,2,3,3,3,0,,,
"Sep 6, 2022 11:00 AM",28,13,15,24,12,12,29,11,18,20,7,13,3,0,3,8,14,12,2,7,5,2,10,9,14,6,8,22,3,1,0,0,0,,,
"Sep 6, 2022 12:00 PM",36,22,14,16,6,10,29,14,15,23,11,12,13,4,9,6,11,11,0,6,5,1,9,8,13,7,6,12,2,2,3,3,0,,,
"Sep 6, 2022 1:00 PM",43,8,35,18,12,6,28,20,8,20,15,5,2,2,0,4,12,12,0,15,15,0,11,12,9,7,2,12,1,3,4,4,0,,,
"Sep 6, 2022 2:00 PM",34,8,26,12,11,1,15,8,7,8,6,2,10,9,1,10,9,7,2,21,18,3,7,21,13,8,5,14,1,1,4,3,1,,,
"Sep 6, 2022 3:00 PM",77,36,41,17,8,9,35,27,8,21,14,7,8,5,3,16,28,24,4,24,19,5,17,28,20,18,2,20,2,3,4,2,2,,,
"Sep 6, 2022 4:00 PM",119,35,84,33,25,8,53,37,16,60,44,16,17,5,12,16,23,18,5,49,48,1,15,50,38,30,8,36,7,3,6,2,4,,,
"Sep 6, 2022 5:00 PM",224,64,160,67,42,25,93,55,38,75,47,28,25,9,16,26,30,26,4,102,94,8,24,102,57,44,13,54,10,7,5,5,0,,,
"Sep 6, 2022 6:00 PM",192,52,140,79,53,26,118,89,29,85,59,26,13,5,8,29,35,31,4,85,82,3,30,115,73,59,14,41,5,3,11,4,7,,,
"Sep 6, 2022 7:00 PM",119,40,79,38,22,16,66,35,31,41,18,23,3,1,2,15,26,23,3,35,33,2,23,52,42,28,14,22,3,0,8,4,4,,,
"Sep 6, 2022 8:00 PM",83,22,61,40,36,4,47,33,14,30,27,3,6,3,3,13,11,10,1,25,23,2,11,23,17,13,4,14,2,5,3,0,3,,,
"Sep 6, 2022 9:00 PM",33,6,27,14,10,4,16,10,6,14,7,7,1,0,1,5,12,9,3,14,13,1,7,14,4,2,2,16,1,0,4,2,2,,,
"Sep 6, 2022 10:00 PM",19,6,13,5,3,2,11,5,6,9,4,5,1,1,0,2,4,3,1,7,6,1,4,11,6,4,2,12,0,0,7,6,1,,,
"Sep 6, 2022 11:00 PM",11,3,8,5,1,4,8,5,3,7,3,4,1,0,1,1,3,3,0,8,8,0,3,5,4,2,2,3,1,0,4,1,3,,,
"Sep 7, 2022 12:00 AM",3,0,3,0,0,0,4,3,1,4,2,2,1,0,1,0,2,2,0,0,0,0,2,3,0,0,0,0,0,0,1,1,0,,,
"Sep 7, 2022 1:00 AM",4,0,4,0,0,0,1,1,0,0,0,0,0,0,0,0,0,0,0,2,2,0,0,1,1,1,0,2,0,0,0,0,0,,,
"Sep 7, 2022 2:00 AM",4,4,0,0,0,0,0,0,0,0,0,0,0,0,0,0,1,1,0,1,1,0,1,1,0,0,0,0,0,0,0,0,0,,,
"Sep 7, 2022 3:00 AM",0,0,0,0,0,0,1,1,0,0,0,0,0,0,0,0,0,0,0,0,0,0,0,1,1,1,0,0,0,0,0,0,0,,,
"Sep 7, 2022 4:00 AM",2,1,1,0,0,0,1,1,0,2,2,0,1,1,0,0,1,1,0,1,1,0,1,1,0,0,0,0,0,0,0,0,0,,,
"Sep 7, 2022 5:00 AM",8,6,2,2,1,1,2,0,2,1,0,1,0,0,0,1,6,6,0,1,0,1,6,2,0,0,0,8,1,3,0,0,0,,,
"Sep 7, 2022 6:00 AM",39,25,14,21,8,13,22,8,14,24,10,14,2,2,0,8,20,20,0,6,3,3,18,11,13,4,9,28,0,2,1,1,0,,,
"Sep 7, 2022 7:00 AM",133,81,52,45,11,34,74,21,53,49,13,36,9,7,2,14,74,74,0,19,18,1,73,26,37,12,25,126,0,4,8,8,0,,,
"Sep 7, 2022 8:00 AM",280,207,73,60,18,42,118,41,77,77,32,45,14,7,7,33,141,139,2,45,43,2,131,72,76,22,54,175,5,9,8,7,1,,,
"Sep 7, 2022 9:00 AM",101,76,25,49,19,30,59,32,27,47,25,22,6,5,1,6,58,56,2,14,13,1,46,20,39,15,24,56,3,4,2,2,0,,,
"Sep 7, 2022 10:00 AM",32,21,11,43,11,32,49,19,30,45,19,26,4,2,2,15,19,19,0,4,4,0,18,14,15,8,7,21,2,3,2,2,0,,,
"Sep 7, 2022 11:00 AM",31,22,9,14,6,8,29,12,17,16,9,7,8,4,4,9,15,14,1,7,5,2,13,8,18,8,10,17,1,4,6,4,2,,,
"Sep 7, 2022 12:00 PM",31,11,20,23,10,13,19,9,10,26,16,10,6,2,4,8,15,14,1,7,6,1,13,11,10,6,4,11,2,1,4,3,1,,,
"Sep 7, 2022 1:00 PM",72,32,40,34,19,15,45,26,19,37,19,18,10,6,4,7,30,27,3,21,18,3,24,20,18,15,3,19,0,1,4,3,1,,,
"Sep 7, 2022 2:00 PM",47,17,30,40,21,19,30,12,18,29,15,14,7,5,2,19,19,19,0,20,20,0,15,18,19,13,6,27,3,3,5,4,1,,,
"Sep 7, 2022 3:00 PM",63,23,40,25,15,10,31,18,13,21,11,10,5,3,2,14,24,23,1,25,19,6,21,20,19,15,4,27,3,3,2,0,2,,,
"Sep 7, 2022 4:00 PM",126,42,84,44,25,19,57,34,23,54,26,28,17,5,12,25,29,26,3,51,45,6,24,49,28,21,7,52,9,3,8,7,1,,,
"Sep 7, 2022 5:00 PM",200,53,147,55,35,20,83,52,31,77,48,29,17,2,15,17,47,41,6,85,78,7,34,107,66,50,16,57,3,4,11,5,6,,,
"Sep 7, 2022 6:00 PM",198,53,145,66,43,23,91,66,25,85,62,23,24,10,14,19,37,32,5,75,71,4,33,94,57,44,13,36,8,1,11,5,6,,,
"Sep 7, 2022 7:00 PM",98,26,72,59,32,27,60,39,21,55,28,27,12,8,4,17,25,19,6,36,34,2,14,53,38,33,5,21,6,3,9,4,5,,,
"Sep 7, 2022 8:00 PM",66,16,50,25,20,5,37,25,12,17,11,6,7,3,4,11,16,13,3,20,18,2,9,24,15,10,5,22,5,2,7,3,4,,,
"Sep 7, 2022 9:00 PM",37,14,23,11,8,3,18,12,6,14,8,6,1,1,0,5,7,4,3,11,11,0,2,10,7,4,3,9,6,1,3,2,1,,,
"Sep 7, 2022 10:00 PM",23,6,17,12,3,9,8,4,4,4,0,4,2,0,2,0,4,3,1,9,9,0,3,8,4,3,1,2,2,0,3,1,2,,,
"Sep 7, 2022 11:00 PM",20,5,15,0,0,0,6,4,2,2,0,2,0,0,0,1,5,5,0,5,5,0,5,6,5,3,2,1,1,0,2,2,0,,,
"Sep 8, 2022 12:00 AM",12,5,7,1,1,0,2,1,1,2,1,1,0,0,0,1,2,2,0,5,4,1,3,9,2,2,0,1,1,0,1,1,0,,,
"Sep 8, 2022 1:00 AM",3,0,3,0,0,0,2,1,1,1,0,1,1,1,0,0,0,0,0,1,1,0,0,0,0,0,0,1,0,0,1,1,0,,,
"Sep 8, 2022 2:00 AM",6,5,1,0,0,0,0,0,0,0,0,0,0,0,0,0,2,1,1,0,0,0,1,1,0,0,0,1,0,0,0,0,0,,,
"Sep 8, 2022 3:00 AM",1,0,1,0,0,0,0,0,0,0,0,0,0,0,0,0,0,0,0,0,0,0,0,1,1,1,0,0,0,0,0,0,0,,,
"Sep 8, 2022 4:00 AM",4,1,3,0,0,0,2,2,0,1,1,0,0,0,0,0,2,2,0,1,1,0,2,0,0,0,0,1,0,0,0,0,0,,,
"Sep 8, 2022 5:00 AM",8,5,3,1,0,1,4,2,2,2,1,1,0,0,0,2,8,8,0,2,1,1,6,1,0,0,0,8,1,1,0,0,0,,,
"Sep 8, 2022 6:00 AM",33,19,14,9,2,7,20,7,13,13,4,9,1,1,0,7,16,15,1,9,5,4,17,14,6,2,4,27,2,2,1,1,0,,,
"Sep 8, 2022 7:00 AM",115,72,43,40,10,30,74,16,58,45,14,31,6,5,1,18,66,65,1,18,16,2,64,31,35,11,24,122,1,3,7,6,1,,,
"Sep 8, 2022 8:00 AM",227,158,69,69,15,54,101,33,68,83,26,57,29,12,17,25,131,128,3,35,33,2,113,53,69,20,49,185,9,3,16,13,3,,,
"Sep 8, 2022 9:00 AM",89,72,17,37,11,26,58,33,25,46,28,18,12,7,5,11,66,65,1,19,13,6,53,25,36,17,19,61,3,3,5,4,1,,,
"Sep 8, 2022 10:00 AM",56,41,15,37,18,19,44,23,21,34,19,15,7,5,2,9,25,23,2,9,5,4,21,19,22,10,12,22,2,3,1,1,0,,,
"Sep 8, 2022 11:00 AM",38,19,19,21,5,16,45,20,25,23,8,15,8,6,2,8,10,9,1,8,4,4,8,15,17,10,7,25,4,1,1,1,0,,,
"Sep 8, 2022 12:00 PM",55,27,28,51,25,26,41,24,17,30,20,10,11,5,6,7,12,12,0,14,13,1,10,18,23,13,10,18,2,3,5,3,2,,,
"Sep 8, 2022 1:00 PM",57,22,35,39,21,18,58,32,26,44,21,23,8,6,2,12,17,14,3,16,15,1,14,21,30,16,14,24,2,0,4,3,1,,,
"Sep 8, 2022 2:00 PM",41,18,23,29,12,17,25,17,8,20,14,6,7,3,4,17,19,16,3,16,14,2,12,25,16,11,5,20,3,1,11,3,8,,,
"Sep 8, 2022 3:00 PM",77,30,47,30,16,14,52,31,21,36,21,15,18,8,10,16,39,32,7,21,14,7,21,39,24,16,8,34,2,2,9,5,4,,,
"Sep 8, 2022 4:00 PM",136,41,95,36,23,13,59,37,22,42,24,18,12,3,9,24,31,27,4,46,43,3,23,54,35,26,9,44,7,3,6,4,2,,,
"Sep 8, 2022 5:00 PM",202,68,134,65,34,31,91,58,33,72,43,29,14,8,6,19,18,14,4,77,75,2,13,102,55,44,11,58,7,4,9,7,2,,,
"Sep 8, 2022 6:00 PM",184,72,112,88,61,27,115,86,29,118,77,41,17,5,12,26,34,28,6,76,72,4,26,97,65,53,12,39,8,4,8,4,4,,,
"Sep 8, 2022 7:00 PM",136,59,77,84,46,38,82,44,38,68,35,33,13,4,9,21,25,22,3,47,41,6,15,51,44,29,15,39,4,2,7,4,3,,,
"Sep 8, 2022 8:00 PM",73,26,47,45,23,22,40,23,17,41,19,22,12,8,4,23,21,21,0,24,23,1,19,27,16,6,10,25,3,1,9,4,5,,,
"Sep 8, 2022 9:00 PM",40,14,26,16,13,3,33,18,15,19,9,10,3,3,0,6,9,4,5,9,9,0,2,14,9,5,4,16,4,0,2,2,0,,,
"Sep 8, 2022 10:00 PM",34,9,25,11,8,3,5,2,3,11,6,5,3,3,0,4,9,7,2,6,6,0,9,9,3,2,1,8,0,1,2,1,1,,,
"Sep 8, 2022 11:00 PM",15,3,12,6,4,2,16,8,8,14,7,7,5,3,2,5,6,5,1,11,11,0,4,5,5,3,2,4,0,0,0,0,0,,,
"Sep 9, 2022 12:00 AM",8,1,7,0,0,0,5,1,4,5,0,5,1,1,0,3,4,2,2,7,6,1,2,4,0,0,0,4,0,0,0,0,0,,,
"Sep 9, 2022 1:00 AM",7,1,6,0,0,0,2,1,1,0,0,0,0,0,0,0,1,1,0,3,3,0,1,2,1,1,0,1,0,0,0,0,0,,,
"Sep 9, 2022 2:00 AM",7,3,4,0,0,0,1,0,1,1,0,1,0,0,0,0,1,1,0,1,1,0,1,0,0,0,0,1,0,0,0,0,0,,,
"Sep 9, 2022 3:00 AM",1,1,0,0,0,0,0,0,0,0,0,0,0,0,0,0,0,0,0,2,2,0,2,1,0,0,0,0,0,0,1,1,0,,,
"Sep 9, 2022 4:00 AM",2,0,2,0,0,0,0,0,0,0,0,0,0,0,0,0,0,0,0,0,0,0,0,1,0,0,0,1,0,0,0,0,0,,,
"Sep 9, 2022 5:00 AM",6,3,3,1,1,0,2,1,1,2,1,1,0,0,0,1,5,5,0,1,0,1,5,2,1,1,0,8,0,1,0,0,0,,,
"Sep 9, 2022 6:00 AM",29,17,12,17,5,12,15,6,9,14,4,10,1,1,0,7,9,9,0,7,5,2,9,10,3,2,1,25,0,1,3,3,0,,,
"Sep 9, 2022 7:00 AM",82,48,34,29,6,23,36,10,26,34,11,23,3,2,1,9,39,39,0,11,9,2,33,20,17,6,11,51,1,1,4,4,0,,,
"Sep 9, 2022 8:00 AM",182,126,56,53,16,37,87,22,65,55,21,34,20,7,13,25,81,79,2,32,27,5,72,36,54,14,40,104,5,0,9,7,2,,,
"Sep 9, 2022 9:00 AM",100,74,26,47,18,29,56,37,19,54,32,22,9,7,2,12,41,40,1,13,11,2,35,20,26,12,14,49,1,3,7,6,1,,,
"Sep 9, 2022 10:00 AM",59,39,20,31,6,25,42,22,20,25,13,12,12,9,3,13,28,27,1,8,6,2,21,11,24,12,12,22,4,3,9,5,4,,,
"Sep 9, 2022 11:00 AM",49,26,23,33,18,15,50,36,14,35,25,10,11,5,6,9,15,13,2,9,8,1,13,16,19,16,3,22,3,4,3,1,2,,,
"Sep 9, 2022 12:00 PM",53,27,26,53,31,22,52,28,24,37,23,14,6,3,3,10,29,25,4,23,23,0,23,25,25,13,12,26,2,2,8,6,2,,,
"Sep 9, 2022 1:00 PM",82,30,52,57,35,22,73,40,33,48,26,22,13,5,8,13,21,21,0,19,16,3,19,24,32,17,15,28,5,1,4,3,1,,,
"Sep 9, 2022 2:00 PM",58,31,27,43,18,25,46,22,24,41,24,17,9,5,4,15,22,18,4,16,15,1,17,22,17,13,4,20,4,3,10,7,3,,,
"Sep 9, 2022 3:00 PM",88,37,51,42,21,21,31,14,17,26,9,17,9,2,7,15,17,13,4,18,16,2,12,22,9,6,3,28,2,2,12,5,7,,,
"Sep 9, 2022 4:00 PM",109,34,75,61,32,29,50,25,25,46,30,16,10,5,5,18,17,15,2,34,29,5,10,41,35,25,10,49,3,2,6,5,1,,,
"Sep 9, 2022 5:00 PM",143,43,100,75,45,30,88,57,31,85,61,24,17,8,9,22,36,31,5,57,54,3,23,63,43,28,15,48,2,4,9,6,3,,,
"Sep 9, 2022 6:00 PM",113,41,72,71,43,28,91,48,43,81,46,35,15,4,11,48,30,27,3,49,47,2,27,54,45,32,13,36,3,3,6,4,2,,,
"Sep 9, 2022 7:00 PM",103,41,62,54,27,27,65,43,22,37,20,17,11,3,8,20,17,16,1,26,25,1,17,26,36,18,18,25,6,2,5,4,1,,,
"Sep 9, 2022 8:00 PM",65,30,35,20,9,11,34,19,15,25,15,10,2,1,1,8,14,12,2,18,14,4,13,16,14,9,5,10,3,0,3,2,1,,,
"Sep 9, 2022 9:00 PM",42,15,27,25,13,12,17,10,7,17,9,8,4,4,0,8,6,5,1,16,16,0,4,8,3,2,1,15,1,1,3,2,1,,,
"Sep 9, 2022 10:00 PM",23,9,14,4,4,0,12,9,3,8,6,2,4,2,2,5,6,5,1,10,9,1,5,5,15,8,7,8,1,1,2,1,1,,,
"Sep 9, 2022 11:00 PM",16,7,9,3,1,2,7,5,2,2,0,2,0,0,0,6,3,3,0,8,7,1,4,5,6,5,1,6,1,0,0,0,0,,,
"Sep 10, 2022 12:00 AM",9,1,8,0,0,0,8,2,6,12,5,7,0,0,0,1,3,2,1,3,3,0,2,7,1,1,0,3,0,0,0,0,0,,,
"Sep 10, 2022 1:00 AM",14,3,11,2,2,0,4,3,1,2,1,1,0,0,0,2,1,1,0,2,2,0,1,5,3,3,0,4,0,1,0,0,0,,,
"Sep 10, 2022 2:00 AM",12,6,6,6,2,4,6,2,4,5,2,3,0,0,0,0,1,1,0,2,1,1,1,3,2,2,0,2,0,0,1,1,0,,,
"Sep 10, 2022 3:00 AM",3,1,2,0,0,0,0,0,0,0,0,0,0,0,0,1,0,0,0,0,0,0,1,2,5,4,1,0,0,0,0,0,0,,,
"Sep 10, 2022 4:00 AM",2,0,2,1,1,0,5,4,1,3,3,0,0,0,0,0,1,1,0,3,3,0,1,1,0,0,0,1,0,0,0,0,0,,,
"Sep 10, 2022 5:00 AM",2,1,1,8,7,1,8,7,1,5,4,1,0,0,0,0,2,2,0,0,0,0,2,6,2,2,0,2,2,1,0,0,0,,,
"Sep 10, 2022 6:00 AM",9,4,5,4,2,2,11,8,3,6,5,1,0,0,0,3,5,5,0,3,1,2,5,5,1,1,0,4,2,0,2,2,0,,,
"Sep 10, 2022 7:00 AM",20,11,9,49,28,21,41,21,20,41,25,16,0,0,0,4,15,15,0,5,5,0,13,17,11,7,4,19,0,2,0,0,0,,,
"Sep 10, 2022 8:00 AM",50,28,22,49,24,25,59,33,26,50,30,20,0,0,0,17,15,15,0,7,5,2,14,19,27,15,12,28,4,5,7,1,6,,,
"Sep 10, 2022 9:00 AM",68,45,23,102,67,35,96,56,40,102,72,30,0,0,0,19,20,20,0,16,15,1,16,34,36,27,9,42,7,8,9,7,2,,,
"Sep 10, 2022 10:00 AM",62,40,22,152,87,65,132,70,62,129,78,51,0,0,0,10,20,19,1,17,17,0,19,35,36,23,13,29,8,10,2,1,1,,,
"Sep 10, 2022 11:00 AM",61,29,32,129,59,70,134,73,61,121,61,60,0,0,0,35,24,22,2,19,19,0,20,36,69,37,32,53,7,5,12,10,2,,,
"Sep 10, 2022 12:00 PM",65,32,33,162,70,92,184,102,82,153,95,58,0,0,0,17,28,26,2,27,21,6,25,40,87,53,34,61,10,6,7,4,3,,,
"Sep 10, 2022 1:00 PM",74,35,39,141,57,84,178,105,73,133,82,51,0,0,0,15,24,20,4,20,17,3,19,45,72,41,31,50,4,6,13,8,5,,,
"Sep 10, 2022 2:00 PM",66,38,28,174,93,81,154,91,63,141,84,57,0,0,0,20,34,26,8,15,10,5,19,46,88,57,31,42,9,2,9,6,3,,,
"Sep 10, 2022 3:00 PM",58,32,26,180,97,83,180,89,91,165,96,69,0,0,0,18,24,23,1,14,13,1,17,50,85,73,12,44,11,1,6,4,2,,,
"Sep 10, 2022 4:00 PM",78,39,39,162,72,90,159,75,84,138,67,71,0,0,0,23,26,23,3,26,20,6,15,37,78,45,33,54,11,1,8,6,2,,,
"Sep 10, 2022 5:00 PM",84,36,48,138,78,60,143,62,81,135,57,78,0,0,0,31,29,25,4,19,18,1,23,35,79,36,43,51,6,2,2,1,1,,,
"Sep 10, 2022 6:00 PM",64,26,38,99,35,64,91,30,61,85,32,53,0,0,0,20,15,15,0,10,10,0,16,19,63,27,36,40,6,5,11,6,5,,,
"Sep 10, 2022 7:00 PM",63,32,31,72,38,34,67,24,43,73,22,51,0,0,0,18,12,9,3,11,10,1,10,22,28,13,15,34,2,0,3,3,0,,,
"Sep 10, 2022 8:00 PM",38,17,21,30,8,22,38,11,27,30,9,21,0,0,0,15,14,14,0,6,6,0,13,10,7,4,3,15,2,2,3,3,0,,,
"Sep 10, 2022 9:00 PM",36,13,23,17,10,7,15,7,8,20,9,11,0,0,0,3,7,4,3,2,2,0,5,7,7,7,0,13,1,1,2,2,0,,,
"Sep 10, 2022 10:00 PM",19,8,11,1,0,1,17,5,12,4,1,3,0,0,0,5,16,16,0,6,5,1,13,4,7,4,3,5,2,2,4,2,2,,,
"Sep 10, 2022 11:00 PM",22,4,18,5,2,3,7,5,2,7,3,4,0,0,0,3,5,5,0,6,5,1,6,8,6,5,1,3,0,0,1,1,0,,,
"Sep 11, 2022 12:00 AM",11,4,7,2,1,1,9,5,4,10,5,5,0,0,0,1,3,3,0,5,4,1,3,6,1,1,0,6,0,0,0,0,0,,,
"Sep 11, 2022 1:00 AM",8,1,7,6,5,1,4,0,4,1,0,1,0,0,0,0,1,1,0,3,3,0,1,3,2,2,0,2,0,1,0,0,0,,,
"Sep 11, 2022 2:00 AM",9,5,4,1,1,0,4,3,1,4,3,1,0,0,0,0,1,1,0,2,2,0,1,2,0,0,0,2,0,2,0,0,0,,,
"Sep 11, 2022 3:00 AM",5,0,5,0,0,0,1,0,1,1,0,1,0,0,0,0,1,1,0,3,2,1,1,2,1,1,0,0,0,0,0,0,0,,,
"Sep 11, 2022 4:00 AM",2,0,2,1,0,1,0,0,0,1,0,1,0,0,0,0,0,0,0,2,2,0,0,0,0,0,0,0,0,0,0,0,0,,,
"Sep 11, 2022 5:00 AM",3,1,2,1,0,1,1,1,0,1,1,0,0,0,0,0,2,2,0,1,1,0,2,0,0,0,0,1,1,0,0,0,0,,,
"Sep 11, 2022 6:00 AM",6,3,3,2,0,2,8,6,2,3,2,1,0,0,0,0,2,2,0,3,3,0,1,3,5,5,0,5,1,0,0,0,0,,,
"Sep 11, 2022 7:00 AM",14,6,8,23,14,9,27,14,13,22,15,7,1,0,1,4,7,7,0,9,5,4,6,13,6,3,3,13,0,1,1,0,1,,,
"Sep 11, 2022 8:00 AM",26,11,15,54,27,27,44,24,20,46,24,22,3,3,0,7,9,9,0,4,3,1,9,7,18,10,8,17,1,4,2,2,0,,,
"Sep 11, 2022 9:00 AM",32,15,17,46,20,26,41,26,15,46,28,18,3,3,0,9,15,15,0,4,4,0,11,18,19,14,5,19,2,3,0,0,0,,,
"Sep 11, 2022 10:00 AM",39,24,15,92,38,54,85,45,40,74,34,40,7,1,6,12,11,8,3,13,9,4,7,15,11,9,2,21,7,5,5,4,1,,,
"Sep 11, 2022 11:00 AM",24,11,13,38,14,24,32,10,22,23,9,14,5,3,2,7,7,6,1,6,6,0,5,15,10,2,8,18,2,0,2,2,0,,,
"Sep 11, 2022 12:00 PM",19,8,11,15,7,8,24,12,12,17,7,10,5,1,4,8,12,9,3,8,7,1,6,9,2,1,1,6,3,0,3,2,1,,,
"Sep 11, 2022 1:00 PM",15,8,7,14,5,9,7,3,4,9,1,8,4,3,1,8,15,14,1,7,7,0,10,5,4,1,3,7,3,0,5,2,3,,,
"Sep 11, 2022 2:00 PM",33,18,15,4,2,2,11,4,7,11,2,9,2,2,0,6,8,8,0,7,7,0,6,5,7,4,3,16,1,0,2,1,1,,,
"Sep 11, 2022 3:00 PM",40,19,21,15,10,5,10,7,3,17,11,6,8,3,5,6,11,11,0,5,5,0,9,5,5,3,2,3,2,2,3,1,2,,,
"Sep 11, 2022 4:00 PM",34,21,13,33,13,20,26,9,17,25,10,15,4,1,3,17,13,13,0,11,7,4,6,5,14,9,5,11,2,4,4,3,1,,,
"Sep 11, 2022 5:00 PM",50,23,27,35,18,17,33,17,16,34,20,14,10,4,6,12,14,13,1,8,7,1,15,7,13,8,5,6,2,0,2,1,1,,,
"Sep 11, 2022 6:00 PM",44,17,27,31,16,15,42,23,19,24,13,11,4,2,2,14,8,7,1,5,5,0,5,4,18,10,8,9,1,3,9,5,4,,,
"Sep 11, 2022 7:00 PM",34,17,17,22,9,13,20,11,9,18,9,9,10,2,8,2,9,7,2,9,7,2,8,8,13,7,6,12,2,1,2,2,0,,,
"Sep 11, 2022 8:00 PM",38,15,23,14,8,6,20,6,14,18,7,11,3,1,2,23,12,12,0,6,4,2,7,9,2,1,1,7,0,1,3,1,2,,,
"Sep 11, 2022 9:00 PM",16,7,9,6,3,3,8,2,6,9,3,6,1,1,0,2,6,4,2,1,1,0,2,4,3,2,1,7,1,0,1,1,0,,,
"Sep 11, 2022 10:00 PM",17,5,12,5,1,4,6,3,3,3,1,2,0,0,0,2,4,3,1,1,1,0,3,5,0,0,0,7,1,1,3,1,2,,,
"Sep 11, 2022 11:00 PM",9,3,6,5,3,2,4,3,1,3,2,1,0,0,0,2,1,1,0,2,2,0,2,3,1,1,0,2,0,0,0,0,0,,,
"Sep 12, 2022 12:00 AM",8,2,6,0,0,0,4,2,2,3,2,1,0,0,0,0,1,0,1,4,3,1,0,0,5,4,1,3,0,0,0,0,0,,,
"Sep 12, 2022 1:00 AM",3,0,3,0,0,0,1,0,1,0,0,0,0,0,0,1,0,0,0,1,1,0,0,3,1,1,0,1,0,0,0,0,0,,,
"Sep 12, 2022 2:00 AM",2,1,1,0,0,0,0,0,0,0,0,0,0,0,0,0,0,0,0,0,0,0,0,0,0,0,0,2,0,0,1,1,0,,,
"Sep 12, 2022 3:00 AM",1,1,0,0,0,0,0,0,0,0,0,0,0,0,0,0,0,0,0,1,1,0,1,0,0,0,0,2,0,0,0,0,0,,,
"Sep 12, 2022 4:00 AM",3,1,2,0,0,0,1,1,0,1,1,0,0,0,0,0,1,1,0,0,0,0,1,0,0,0,0,1,0,0,0,0,0,,,
"Sep 12, 2022 5:00 AM",5,3,2,0,0,0,0,0,0,0,0,0,0,0,0,0,6,6,0,0,0,0,5,2,0,0,0,7,1,1,0,0,0,,,
"Sep 12, 2022 6:00 AM",40,26,14,11,2,9,16,4,12,13,5,8,2,2,0,9,14,14,0,10,7,3,13,11,5,2,3,29,1,2,2,2,0,,,
"Sep 12, 2022 7:00 AM",121,77,44,51,22,29,58,15,43,45,15,30,10,7,3,17,96,96,0,33,25,8,84,31,31,11,20,111,1,5,10,8,2,,,
"Sep 12, 2022 8:00 AM",317,252,65,110,31,79,142,40,102,107,33,74,39,29,10,57,178,175,3,43,33,10,148,49,72,28,44,198,11,5,13,12,1,,,
"Sep 12, 2022 9:00 AM",142,123,19,46,16,30,48,26,22,49,28,21,16,10,6,10,81,81,0,18,12,6,61,21,26,13,13,62,6,5,6,4,2,,,
"Sep 12, 2022 10:00 AM",70,50,20,31,14,17,39,20,19,31,17,14,19,14,5,8,48,46,2,7,6,1,31,22,9,5,4,23,2,1,3,2,1,,,
"Sep 12, 2022 11:00 AM",52,28,24,30,16,14,36,16,20,27,13,14,10,8,2,9,20,17,3,11,8,3,11,13,11,5,6,21,7,1,2,1,1,,,
"Sep 12, 2022 12:00 PM",59,27,32,26,8,18,42,21,21,28,11,17,16,7,9,15,32,29,3,13,12,1,17,12,18,12,6,21,6,2,9,7,2,,,
"Sep 12, 2022 1:00 PM",90,45,45,35,21,14,49,23,26,34,17,17,16,7,9,8,30,25,5,25,23,2,20,23,23,11,12,22,4,6,6,5,1,,,
"Sep 12, 2022 2:00 PM",75,22,53,36,17,19,39,21,18,32,20,12,24,13,11,9,24,19,5,29,26,3,14,19,21,11,10,27,2,6,2,0,2,,,
"Sep 12, 2022 3:00 PM",101,38,63,23,13,10,29,19,10,18,11,7,22,12,10,14,34,32,2,33,29,4,20,28,20,13,7,23,5,2,11,5,6,,,
"Sep 12, 2022 4:00 PM",154,40,114,38,31,7,61,45,16,48,39,9,16,7,9,15,36,26,10,48,44,4,24,56,34,26,8,42,4,0,9,4,5,,,
"Sep 12, 2022 5:00 PM",228,48,180,45,35,10,83,60,23,65,41,24,21,0,21,16,43,28,15,112,107,5,22,78,42,36,6,49,4,7,3,2,1,,,
"Sep 12, 2022 6:00 PM",167,45,122,54,39,15,67,45,22,49,37,12,17,7,10,18,50,37,13,94,91,3,32,103,55,44,11,32,8,5,3,2,1,,,
"Sep 12, 2022 7:00 PM",87,25,62,55,31,24,49,30,19,49,26,23,8,4,4,19,25,19,6,31,30,1,16,45,31,21,10,24,4,4,8,8,0,,,
"Sep 12, 2022 8:00 PM",64,19,45,25,14,11,30,16,14,33,18,15,3,2,1,10,19,15,4,18,18,0,12,22,12,6,6,22,7,2,5,4,1,,,
"Sep 12, 2022 9:00 PM",40,7,33,16,12,4,13,10,3,12,8,4,2,0,2,6,11,8,3,11,11,0,7,12,10,6,4,9,4,1,6,4,2,,,
"Sep 12, 2022 10:00 PM",28,5,23,3,3,0,11,5,6,7,3,4,0,0,0,2,10,6,4,10,8,2,6,9,3,2,1,7,3,1,3,2,1,,,
"Sep 12, 2022 11:00 PM",12,2,10,0,0,0,5,3,2,1,1,0,1,0,1,1,2,2,0,3,3,0,2,7,1,1,0,1,0,2,0,0,0,,,
"Sep 13, 2022 12:00 AM",5,3,2,1,0,1,2,2,0,2,2,0,0,0,0,0,1,0,1,2,2,0,0,8,0,0,0,3,0,1,1,1,0,,,
"Sep 13, 2022 1:00 AM",7,1,6,1,1,0,1,1,0,1,1,0,0,0,0,1,0,0,0,4,4,0,0,2,0,0,0,0,0,1,0,0,0,,,
"Sep 13, 2022 2:00 AM",7,4,3,1,0,1,2,1,1,2,1,1,0,0,0,1,2,1,1,1,1,0,1,0,0,0,0,1,0,0,0,0,0,,,
"Sep 13, 2022 3:00 AM",1,0,1,0,0,0,0,0,0,0,0,0,0,0,0,0,0,0,0,2,2,0,0,1,0,0,0,0,0,0,0,0,0,,,
"Sep 13, 2022 4:00 AM",2,1,1,1,1,0,2,2,0,2,2,0,0,0,0,0,4,3,1,3,2,1,3,0,0,0,0,1,0,1,0,0,0,,,
"Sep 13, 2022 5:00 AM",8,4,4,0,0,0,1,0,1,2,0,2,0,0,0,0,9,9,0,0,0,0,8,2,2,1,1,9,0,0,0,0,0,,,
"Sep 13, 2022 6:00 AM",51,30,21,15,8,7,26,11,15,17,11,6,1,1,0,7,16,16,0,9,5,4,16,17,8,2,6,44,0,4,2,2,0,,,
"Sep 13, 2022 7:00 AM",178,126,52,69,18,51,86,18,68,71,20,51,0,0,0,20,121,120,1,35,28,7,114,43,37,13,24,157,2,5,12,11,1,,,
"Sep 13, 2022 8:00 AM",370,287,83,142,36,106,199,64,135,142,50,92,0,0,0,46,219,218,1,53,40,13,176,62,123,34,89,241,6,8,17,16,1,,,
"Sep 13, 2022 9:00 AM",148,128,20,75,22,53,80,26,54,82,37,45,0,0,0,9,100,99,1,24,20,4,80,29,50,19,31,86,4,6,5,3,2,,,
"Sep 13, 2022 10:00 AM",95,71,24,42,20,22,45,28,17,45,30,15,0,0,0,16,44,41,3,14,11,3,22,21,17,12,5,27,3,1,3,2,1,,,
"Sep 13, 2022 11:00 AM",78,47,31,55,29,26,54,24,30,53,29,24,0,0,0,8,28,24,4,18,15,3,22,16,18,9,9,35,1,2,2,2,0,,,
"Sep 13, 2022 12:00 PM",75,38,37,46,20,26,54,26,28,38,20,18,0,0,0,15,38,37,1,29,27,2,27,24,18,12,6,30,7,2,4,3,1,,,
"Sep 13, 2022 1:00 PM",111,42,69,59,26,33,79,41,38,60,30,30,0,0,0,20,31,24,7,29,29,0,26,28,29,19,10,34,4,3,7,6,1,,,
"Sep 13, 2022 2:00 PM",75,32,43,50,25,25,73,44,29,45,26,19,0,0,0,17,41,32,9,29,26,3,23,31,45,33,12,37,2,6,8,5,3,,,
"Sep 13, 2022 3:00 PM",140,53,87,64,40,24,73,45,28,42,25,17,0,0,0,24,43,32,11,43,36,7,24,55,48,27,21,35,5,2,8,3,5,,,
"Sep 13, 2022 4:00 PM",192,57,135,75,51,24,122,77,45,81,54,27,0,0,0,28,43,33,10,72,63,9,28,92,65,46,19,46,6,5,7,3,4,,,
"Sep 13, 2022 5:00 PM",281,63,218,92,61,31,172,104,68,114,72,42,0,0,0,29,60,48,12,127,122,5,42,123,99,78,21,83,13,6,18,10,8,,,
"Sep 13, 2022 6:00 PM",238,59,179,134,94,40,174,124,50,126,92,34,0,0,0,34,62,48,14,112,104,8,48,144,93,75,18,56,9,8,16,7,9,,,
"Sep 13, 2022 7:00 PM",154,49,105,88,51,37,95,57,38,76,47,29,0,0,0,33,26,23,3,54,53,1,24,84,62,38,24,37,4,5,5,4,1,,,
"Sep 13, 2022 8:00 PM",106,25,81,66,31,35,77,45,32,57,25,32,0,0,0,19,26,21,5,31,31,0,20,26,25,18,7,28,9,2,10,5,5,,,
"Sep 13, 2022 9:00 PM",56,13,43,18,12,6,34,21,13,23,14,9,0,0,0,4,8,6,2,17,15,2,6,25,17,9,8,15,4,0,4,2,2,,,
"Sep 13, 2022 10:00 PM",31,11,20,6,4,2,14,7,7,12,6,6,0,0,0,1,11,7,4,15,13,2,6,13,5,3,2,8,0,1,2,0,2,,,
"Sep 13, 2022 11:00 PM",11,2,9,4,3,1,6,4,2,4,3,1,0,0,0,2,6,5,1,9,8,1,4,9,0,0,0,0,0,1,0,0,0,,,
"Sep 14, 2022 12:00 AM",9,0,9,1,1,0,3,1,2,4,2,2,0,0,0,3,1,1,0,4,4,0,1,4,5,3,2,2,0,0,1,1,0,,,
"Sep 14, 2022 1:00 AM",3,1,2,5,3,2,2,2,0,1,1,0,0,0,0,0,3,1,2,3,3,0,1,3,0,0,0,0,0,0,0,0,0,,,
"Sep 14, 2022 2:00 AM",8,5,3,0,0,0,0,0,0,0,0,0,0,0,0,0,3,1,2,1,0,1,2,1,0,0,0,0,0,0,0,0,0,,,
"Sep 14, 2022 3:00 AM",2,1,1,0,0,0,0,0,0,0,0,0,0,0,0,0,0,0,0,0,0,0,0,1,1,1,0,0,0,0,0,0,0,,,
"Sep 14, 2022 4:00 AM",2,1,1,0,0,0,1,1,0,1,1,0,0,0,0,0,1,1,0,1,1,0,1,0,0,0,0,1,0,0,0,0,0,,,
"Sep 14, 2022 5:00 AM",13,9,4,6,3,3,0,0,0,1,0,1,0,0,0,2,8,8,0,2,0,2,7,3,1,0,1,10,1,1,0,0,0,,,
"Sep 14, 2022 6:00 AM",53,33,20,19,9,10,23,6,17,16,8,8,0,0,0,7,19,19,0,8,6,2,17,19,6,3,3,27,0,3,2,2,0,,,
"Sep 14, 2022 7:00 AM",150,100,50,76,25,51,79,22,57,73,28,45,0,0,0,21,106,106,0,30,26,4,97,30,40,14,26,133,3,5,6,6,0,,,
"Sep 14, 2022 8:00 AM",372,282,90,93,19,74,157,50,107,129,41,88,0,0,0,48,207,205,2,55,45,10,184,80,110,30,80,257,8,6,24,22,2,,,
"Sep 14, 2022 9:00 AM",141,115,26,70,25,45,83,35,48,73,38,35,0,0,0,19,106,104,2,28,19,9,82,21,49,18,31,77,4,8,6,6,0,,,
"Sep 14, 2022 10:00 AM",91,65,26,51,28,23,60,37,23,43,27,16,0,0,0,21,48,48,0,9,8,1,34,19,26,20,6,38,1,2,4,1,3,,,
"Sep 14, 2022 11:00 AM",61,37,24,47,21,26,56,28,28,49,29,20,0,0,0,16,31,27,4,8,4,4,15,20,23,13,10,34,4,2,5,3,2,,,
"Sep 14, 2022 12:00 PM",75,42,33,37,18,19,57,30,27,45,22,23,0,0,0,9,36,31,5,23,22,1,21,18,27,17,10,32,5,1,4,3,1,,,
"Sep 14, 2022 1:00 PM",80,42,38,44,30,14,74,42,32,60,40,20,0,0,0,22,33,30,3,34,32,2,24,40,30,21,9,33,1,3,5,0,5,,,
"Sep 14, 2022 2:00 PM",92,33,59,52,24,28,65,40,25,44,24,20,0,0,0,24,38,28,10,30,29,1,19,34,30,19,11,37,4,3,5,2,3,,,
"Sep 14, 2022 3:00 PM",115,40,75,52,28,24,52,30,22,46,26,20,0,0,0,14,39,33,6,32,24,8,17,39,46,29,17,26,4,1,8,6,2,,,
"Sep 14, 2022 4:00 PM",164,41,123,75,39,36,106,68,38,84,49,35,0,0,0,22,45,33,12,54,49,5,25,65,53,41,12,67,4,5,10,6,4,,,
"Sep 14, 2022 5:00 PM",276,68,208,91,67,24,144,90,54,112,73,39,0,0,0,36,65,55,10,110,102,8,43,129,77,55,22,83,7,7,5,5,0,,,
"Sep 14, 2022 6:00 PM",235,65,170,82,60,22,132,93,39,105,76,29,0,0,0,29,58,46,12,105,100,5,37,141,71,50,21,46,9,7,11,4,7,,,
"Sep 14, 2022 7:00 PM",133,40,93,63,41,22,81,46,35,59,35,24,0,0,0,15,35,26,9,38,35,3,24,64,34,27,7,32,5,3,10,5,5,,,
"Sep 14, 2022 8:00 PM",78,28,50,20,16,4,34,19,15,29,14,15,0,0,0,7,16,14,2,28,26,2,12,36,12,8,4,28,6,3,6,5,1,,,
"Sep 14, 2022 9:00 PM",66,19,47,9,9,0,19,9,10,16,4,12,0,0,0,8,19,12,7,19,17,2,11,14,11,7,4,6,7,2,7,4,3,,,
"Sep 14, 2022 10:00 PM",43,7,36,5,4,1,11,7,4,6,2,4,0,0,0,8,14,11,3,12,11,1,10,13,7,4,3,9,4,0,3,1,2,,,
"Sep 14, 2022 11:00 PM",20,7,13,2,1,1,9,7,2,4,3,1,0,0,0,6,7,7,0,9,8,1,7,8,2,2,0,2,1,2,2,2,0,,,
"Sep 15, 2022 12:00 AM",10,3,7,0,0,0,2,2,0,2,2,0,0,0,0,4,2,2,0,1,1,0,2,10,4,3,1,0,0,0,0,0,0,,,
"Sep 15, 2022 1:00 AM",3,0,3,0,0,0,0,0,0,0,0,0,0,0,0,1,2,1,1,1,1,0,0,3,0,0,0,0,0,0,0,0,0,,,
"Sep 15, 2022 2:00 AM",9,4,5,1,1,0,1,1,0,1,1,0,0,0,0,0,2,2,0,1,1,0,2,1,0,0,0,0,0,1,0,0,0,,,
"Sep 15, 2022 3:00 AM",0,0,0,0,0,0,0,0,0,0,0,0,0,0,0,0,0,0,0,0,0,0,0,0,1,1,0,1,0,0,0,0,0,,,
"Sep 15, 2022 4:00 AM",2,1,1,0,0,0,1,1,0,1,1,0,0,0,0,0,1,1,0,1,1,0,1,0,0,0,0,0,0,0,1,1,0,,,
"Sep 15, 2022 5:00 AM",11,5,6,1,0,1,1,0,1,1,0,1,0,0,0,4,9,9,0,3,2,1,9,1,0,0,0,13,0,0,0,0,0,,,
"Sep 15, 2022 6:00 AM",51,33,18,14,6,8,26,10,16,17,7,10,0,0,0,10,21,21,0,10,7,3,19,12,7,2,5,37,1,6,1,1,0,,,
"Sep 15, 2022 7:00 AM",173,117,56,63,22,41,69,21,48,55,22,33,0,0,0,20,103,102,1,28,24,4,98,37,42,13,29,121,4,2,9,8,1,,,
"Sep 15, 2022 8:00 AM",369,276,93,113,27,86,147,44,103,119,36,83,0,0,0,46,218,217,1,41,28,13,171,59,78,22,56,212,8,5,20,17,3,,,
"Sep 15, 2022 9:00 AM",169,150,19,62,31,31,85,36,49,69,35,34,0,0,0,13,91,91,0,28,22,6,70,24,46,21,25,86,6,8,6,5,1,,,
"Sep 15, 2022 10:00 AM",91,71,20,53,26,27,62,35,27,64,40,24,0,0,0,12,48,43,5,17,16,1,31,23,23,13,10,37,2,2,5,4,1,,,
"Sep 15, 2022 11:00 AM",67,37,30,53,35,18,45,22,23,34,20,14,0,0,0,12,36,34,2,9,6,3,24,15,18,12,6,34,4,5,6,3,3,,,
"Sep 15, 2022 12:00 PM",89,41,48,45,20,25,63,28,35,53,28,25,0,0,0,18,28,25,3,19,17,2,18,22,22,15,7,35,4,6,3,2,1,,,
"Sep 15, 2022 1:00 PM",95,38,57,36,19,17,75,39,36,54,30,24,0,0,0,21,35,24,11,32,28,4,24,27,24,16,8,30,2,4,9,7,2,,,
"Sep 15, 2022 2:00 PM",85,30,55,50,26,24,70,43,27,43,27,16,0,0,0,14,34,26,8,35,33,2,21,30,25,17,8,39,2,6,5,1,4,,,
"Sep 15, 2022 3:00 PM",123,46,77,38,24,14,77,48,29,45,29,16,0,0,0,20,28,23,5,41,37,4,13,0,42,28,14,28,3,3,8,5,3,,,
"Sep 15, 2022 4:00 PM",153,51,102,40,32,8,103,61,42,67,53,14,0,0,0,18,39,31,8,66,60,6,22,0,43,30,13,54,6,5,15,6,9,,,
"Sep 15, 2022 5:00 PM",274,76,198,91,52,39,141,90,51,107,62,45,0,0,0,34,54,40,14,101,100,1,42,0,79,58,21,66,12,5,12,8,4,,,
"Sep 15, 2022 6:00 PM",216,56,160,81,50,31,123,73,50,99,61,38,0,0,0,28,50,43,7,101,96,5,38,0,66,50,16,54,7,5,12,7,5,,,
"Sep 15, 2022 7:00 PM",126,33,93,50,28,22,69,44,25,55,33,22,0,0,0,28,32,27,5,45,38,7,20,0,37,29,8,33,12,0,15,9,6,,,
"Sep 15, 2022 8:00 PM",76,21,55,22,14,8,42,19,23,31,13,18,0,0,0,6,16,10,6,44,43,1,7,0,20,10,10,16,12,5,6,3,3,,,
"Sep 15, 2022 9:00 PM",54,13,41,15,11,4,16,11,5,16,9,7,0,0,0,16,4,3,1,17,14,3,1,0,10,6,4,8,3,1,3,1,2,,,
"Sep 15, 2022 10:00 PM",23,5,18,9,7,2,8,5,3,15,10,5,0,0,0,0,10,9,1,10,9,1,9,0,6,3,3,8,3,0,2,1,1,,,
"Sep 15, 2022 11:00 PM",18,7,11,4,2,2,10,5,5,6,3,3,0,0,0,4,0,0,0,3,3,0,0,0,10,5,5,4,1,1,1,0,1,,,
"Sep 16, 2022 12:00 AM",11,1,10,0,0,0,4,1,3,4,3,1,0,0,0,0,3,1,2,7,7,0,1,0,2,2,0,5,0,0,0,0,0,,,
"Sep 16, 2022 1:00 AM",14,2,12,2,2,0,4,3,1,3,2,1,0,0,0,1,1,0,1,4,4,0,0,0,0,0,0,1,0,0,0,0,0,,,
"Sep 16, 2022 2:00 AM",7,4,3,1,1,0,1,1,0,2,2,0,0,0,0,0,2,0,2,2,1,1,1,0,0,0,0,0,0,0,0,0,0,,,
"Sep 16, 2022 3:00 AM",3,0,3,0,0,0,0,0,0,1,1,0,0,0,0,0,1,0,1,4,4,0,0,0,1,1,0,0,0,0,0,0,0,,,
"Sep 16, 2022 4:00 AM",4,1,3,2,2,0,2,2,0,1,1,0,0,0,0,0,3,2,1,1,1,0,2,0,0,0,0,1,0,0,0,0,0,,,
"Sep 16, 2022 5:00 AM",8,4,4,1,1,0,5,3,2,2,1,1,0,0,0,2,6,6,0,1,1,0,5,0,2,1,1,11,1,0,0,0,0,,,
"Sep 16, 2022 6:00 AM",35,23,12,16,8,8,28,14,14,18,6,12,0,0,0,6,13,13,0,10,8,2,13,0,10,8,2,30,2,4,0,0,0,,,
"Sep 16, 2022 7:00 AM",119,73,46,69,29,40,71,20,51,53,27,26,0,0,0,14,81,81,0,20,18,2,74,0,18,4,14,76,3,4,5,4,1,,,
"Sep 16, 2022 8:00 AM",246,177,69,90,24,66,126,42,84,101,40,61,0,0,0,26,124,120,4,47,43,4,101,0,70,31,39,166,9,3,16,13,3,,,
"Sep 16, 2022 9:00 AM",118,105,13,57,24,33,75,34,41,65,37,28,0,0,0,14,70,69,1,20,18,2,47,0,34,16,18,53,2,8,2,1,1,,,
"Sep 16, 2022 10:00 AM",85,64,21,69,34,35,56,30,26,52,31,21,0,0,0,13,42,40,2,5,3,2,24,0,22,12,10,33,3,7,3,3,0,,,
"Sep 16, 2022 11:00 AM",67,39,28,49,32,17,50,31,19,43,28,15,0,0,0,3,26,20,6,19,16,3,10,0,23,11,12,38,5,3,5,3,2,,,
"Sep 16, 2022 12:00 PM",103,55,48,65,31,34,82,48,34,59,33,26,0,0,0,12,26,19,7,11,8,3,21,0,34,20,14,22,6,2,9,6,3,,,
"Sep 16, 2022 1:00 PM",110,40,70,62,31,31,81,39,42,59,31,28,0,0,0,9,37,33,4,26,21,5,27,0,46,27,19,40,4,1,8,4,4,,,
"Sep 16, 2022 2:00 PM",102,45,57,44,27,17,71,47,24,41,28,13,0,0,0,24,31,25,6,33,30,3,19,0,43,22,21,30,5,2,6,0,6,,,
"Sep 16, 2022 3:00 PM",114,43,71,53,29,24,82,58,24,61,43,18,0,0,0,21,45,37,8,36,34,2,29,0,35,25,10,37,3,7,11,7,4,,,
"Sep 16, 2022 4:00 PM",141,45,96,100,60,40,136,86,50,86,58,28,0,0,0,18,41,29,12,66,59,7,36,0,62,45,17,40,12,4,15,11,4,,,
"Sep 16, 2022 5:00 PM",188,53,135,103,59,44,136,78,58,99,60,39,0,0,0,28,36,29,7,70,68,2,20,0,60,44,16,68,7,3,5,5,0,,,
"Sep 16, 2022 6:00 PM",133,45,88,65,31,34,116,70,46,84,51,33,0,0,0,30,32,28,4,63,55,8,27,0,64,35,29,41,4,3,3,1,2,,,
"Sep 16, 2022 7:00 PM",102,38,64,69,35,34,62,38,24,49,23,26,0,0,0,14,16,14,2,32,32,0,13,0,29,14,15,36,8,5,7,3,4,,,
"Sep 16, 2022 8:00 PM",67,19,48,24,14,10,39,23,16,22,15,7,0,0,0,9,13,12,1,12,11,1,16,0,19,10,9,16,7,3,7,5,2,,,
"Sep 16, 2022 9:00 PM",43,18,25,14,13,1,16,7,9,20,9,11,0,0,0,4,10,10,0,8,7,1,10,0,10,6,4,11,1,3,3,1,2,,,
"Sep 16, 2022 10:00 PM",28,10,18,8,4,4,20,6,14,21,4,17,0,0,0,3,14,9,5,12,12,0,8,0,6,5,1,10,2,1,1,1,0,,,
"Sep 16, 2022 11:00 PM",25,3,22,7,5,2,10,5,5,9,4,5,0,0,0,5,5,5,0,5,5,0,4,0,3,1,2,2,0,1,2,2,0,,,
"Sep 17, 2022 12:00 AM",12,2,10,1,1,0,3,2,1,3,2,1,0,0,0,2,2,2,0,7,7,0,2,0,1,1,0,2,1,1,2,1,1,,,
"Sep 17, 2022 1:00 AM",13,1,12,2,2,0,3,2,1,5,3,2,0,0,0,1,3,3,0,2,2,0,3,0,2,1,1,2,0,1,0,0,0,,,
"Sep 17, 2022 2:00 AM",13,6,7,3,0,3,4,2,2,4,1,3,0,0,0,0,0,0,0,3,2,1,1,0,5,3,2,2,0,1,0,0,0,,,
"Sep 17, 2022 3:00 AM",3,0,3,1,1,0,0,0,0,1,1,0,0,0,0,0,0,0,0,1,1,0,0,0,1,1,0,5,2,1,2,1,1,,,
"Sep 17, 2022 4:00 AM",5,1,4,0,0,0,1,1,0,1,1,0,0,0,0,0,1,1,0,2,2,0,0,0,0,0,0,1,0,0,0,0,0,,,
"Sep 17, 2022 5:00 AM",3,1,2,1,0,1,4,2,2,3,2,1,0,0,0,1,3,3,0,2,2,0,1,0,1,0,1,4,1,0,0,0,0,,,
"Sep 17, 2022 6:00 AM",13,10,3,2,1,1,6,6,0,5,4,1,0,0,0,2,7,7,0,3,3,0,5,0,1,1,0,12,1,3,2,1,1,,,
"Sep 17, 2022 7:00 AM",29,15,14,28,14,14,30,18,12,23,15,8,0,0,0,1,17,16,1,88,35,53,16,0,6,2,4,25,0,7,0,0,0,,,
"Sep 17, 2022 8:00 AM",40,20,20,47,27,20,41,29,12,37,31,6,0,0,0,10,15,15,0,4,3,1,12,0,18,15,3,23,3,8,0,0,0,,,
"Sep 17, 2022 9:00 AM",49,36,13,88,37,51,77,46,31,76,45,31,0,0,0,22,13,12,1,13,13,0,12,0,28,20,8,27,4,1,1,1,0,,,
"Sep 17, 2022 10:00 AM",52,34,18,123,73,50,116,61,55,121,82,39,0,0,0,17,17,16,1,8,8,0,14,0,41,29,12,30,9,5,10,6,4,,,
"Sep 17, 2022 11:00 AM",77,43,34,126,64,62,107,61,46,124,74,50,0,0,0,18,29,21,8,15,12,3,16,0,51,37,14,34,6,1,6,3,3,,,
"Sep 17, 2022 12:00 PM",67,39,28,160,75,85,132,77,55,166,104,62,0,0,0,21,24,21,3,15,12,3,13,0,55,34,21,48,2,5,5,3,2,,,
"Sep 17, 2022 1:00 PM",78,40,38,93,46,47,104,58,46,109,62,47,0,0,0,13,28,26,2,19,18,1,20,0,41,22,19,43,12,4,8,6,2,,,
"Sep 17, 2022 2:00 PM",72,39,33,81,42,39,89,50,39,78,53,25,0,0,0,29,23,20,3,16,13,3,18,0,65,38,27,30,5,3,10,7,3,,,
"Sep 17, 2022 3:00 PM",63,40,23,111,58,53,122,71,51,78,45,33,0,0,0,17,18,15,3,15,15,0,18,0,60,27,33,42,5,3,10,6,4,,,
"Sep 17, 2022 4:00 PM",74,39,35,103,49,54,148,75,73,111,53,58,0,0,0,16,17,17,0,16,13,3,11,0,56,31,25,33,8,0,4,3,1,,,
"Sep 17, 2022 5:00 PM",71,27,44,118,63,55,147,60,87,108,47,61,0,0,0,31,17,17,0,19,18,1,21,0,61,39,22,47,6,7,11,6,5,,,
"Sep 17, 2022 6:00 PM",56,23,33,73,38,35,99,50,49,71,27,44,0,0,0,10,12,10,2,21,18,3,14,0,63,34,29,37,1,6,6,1,5,,,
"Sep 17, 2022 7:00 PM",53,26,27,29,16,13,40,16,24,46,16,30,0,0,0,12,15,13,2,9,8,1,11,0,26,8,18,35,4,3,3,1,2,,,
"Sep 17, 2022 8:00 PM",43,22,21,24,10,14,31,14,17,14,8,6,0,0,0,7,12,12,0,10,7,3,10,0,19,11,8,18,0,3,4,2,2,,,
"Sep 17, 2022 9:00 PM",34,15,19,13,10,3,20,10,10,9,3,6,0,0,0,3,5,4,1,7,7,0,5,0,9,6,3,6,1,1,1,1,0,,,
"Sep 17, 2022 10:00 PM",16,6,10,5,3,2,14,7,7,11,3,8,0,0,0,1,9,8,1,3,3,0,8,0,4,0,4,9,0,2,4,1,3,,,
"Sep 17, 2022 11:00 PM",16,5,11,6,3,3,5,1,4,10,2,8,0,0,0,2,5,4,1,2,2,0,6,0,3,1,2,8,1,0,1,1,0,,,
"Sep 18, 2022 12:00 AM",23,8,15,0,0,0,13,7,6,13,8,5,0,0,0,0,2,1,1,5,4,1,1,0,6,3,3,11,4,2,2,1,1,,,
"Sep 18, 2022 1:00 AM",6,2,4,1,1,0,1,1,0,1,1,0,0,0,0,0,1,1,0,3,1,2,0,0,0,0,0,1,1,0,2,1,1,,,
"Sep 18, 2022 2:00 AM",8,2,6,3,3,0,4,3,1,3,2,1,0,0,0,0,0,0,0,1,1,0,0,0,0,0,0,1,0,1,0,0,0,,,
"Sep 18, 2022 3:00 AM",5,2,3,0,0,0,1,1,0,1,1,0,0,0,0,0,0,0,0,1,1,0,1,0,2,2,0,0,0,0,0,0,0,,,
"Sep 18, 2022 4:00 AM",2,0,2,1,0,1,0,0,0,0,0,0,0,0,0,0,0,0,0,2,2,0,0,0,1,1,0,0,0,0,1,0,1,,,
"Sep 18, 2022 5:00 AM",1,0,1,0,0,0,0,0,0,0,0,0,0,0,0,0,1,1,0,0,0,0,1,0,0,0,0,2,0,0,0,0,0,,,
"Sep 18, 2022 6:00 AM",8,7,1,2,0,2,10,5,5,4,1,3,0,0,0,1,1,1,0,2,2,0,1,0,3,2,1,11,0,0,1,1,0,,,
"Sep 18, 2022 7:00 AM",13,5,8,24,12,12,15,7,8,17,11,6,0,0,0,3,9,9,0,2,1,1,7,0,4,2,2,17,1,2,0,0,0,,,
"Sep 18, 2022 8:00 AM",29,17,12,41,33,8,65,43,22,52,41,11,0,0,0,2,28,28,0,10,9,1,29,0,30,21,9,17,1,9,0,0,0,,,
"Sep 18, 2022 9:00 AM",29,15,14,114,54,60,86,51,35,93,59,34,0,0,0,5,17,16,1,4,3,1,16,0,29,17,12,25,5,9,5,3,2,,,
"Sep 18, 2022 10:00 AM",59,37,22,145,83,62,127,75,52,121,86,35,0,0,0,16,15,12,3,13,12,1,10,0,68,40,28,55,4,10,12,9,3,,,
"Sep 18, 2022 11:00 AM",55,31,24,172,86,86,164,81,83,169,107,62,0,0,0,10,19,16,3,9,9,0,15,0,89,57,32,30,7,5,7,3,4,,,
"Sep 18, 2022 12:00 PM",80,34,46,200,97,103,148,77,71,170,94,76,0,0,0,20,21,21,0,28,26,2,17,0,91,42,49,42,10,7,8,6,2,,,
"Sep 18, 2022 1:00 PM",73,39,34,152,72,80,150,84,66,143,75,68,0,0,0,33,20,19,1,22,19,3,18,0,71,36,35,54,10,6,8,4,4,,,
"Sep 18, 2022 2:00 PM",67,40,27,161,82,79,153,88,65,152,85,67,0,0,0,20,25,24,1,24,19,5,15,0,56,37,19,65,6,7,8,7,1,,,
"Sep 18, 2022 3:00 PM",54,32,22,139,66,73,180,98,82,130,61,69,0,0,0,23,22,21,1,19,18,1,19,0,76,45,31,52,8,3,4,3,1,,,
"Sep 18, 2022 4:00 PM",73,33,40,172,88,84,189,88,101,140,63,77,0,0,0,21,36,30,6,20,18,2,26,0,79,38,41,48,4,3,6,3,3,,,
"Sep 18, 2022 5:00 PM",87,36,51,115,61,54,168,85,83,107,51,56,0,0,0,12,34,31,3,11,11,0,22,0,71,32,39,54,3,3,10,4,6,,,
"Sep 18, 2022 6:00 PM",44,16,28,76,40,36,105,46,59,60,25,35,0,0,0,10,19,16,3,11,10,1,14,0,40,19,21,35,2,1,5,4,1,,,
"Sep 18, 2022 7:00 PM",41,14,27,38,10,28,62,24,38,39,16,23,0,0,0,11,15,13,2,9,9,0,13,0,27,10,17,34,1,2,8,4,4,,,
"Sep 18, 2022 8:00 PM",40,15,25,27,15,12,23,8,15,14,7,7,0,0,0,3,9,9,0,10,7,3,11,0,4,2,2,26,2,1,2,1,1,,,
"Sep 18, 2022 9:00 PM",27,10,17,11,6,5,19,7,12,15,4,11,0,0,0,5,6,5,1,5,5,0,5,0,5,3,2,12,1,1,1,0,1,,,
"Sep 18, 2022 10:00 PM",20,9,11,6,4,2,7,3,4,6,3,3,0,0,0,3,10,9,1,1,1,0,9,0,6,0,6,7,0,1,1,1,0,,,
"Sep 18, 2022 11:00 PM",12,4,8,1,0,1,2,0,2,2,0,2,0,0,0,2,1,1,0,5,5,0,1,0,0,0,0,4,0,0,0,0,0,,,
"Sep 19, 2022 12:00 AM",4,1,3,1,1,0,2,1,1,1,1,0,0,0,0,0,0,0,0,4,4,0,0,0,2,2,0,0,0,0,0,0,0,,,
"Sep 19, 2022 1:00 AM",4,0,4,0,0,0,0,0,0,0,0,0,0,0,0,0,0,0,0,0,0,0,0,0,1,1,0,0,0,0,0,0,0,,,
"Sep 19, 2022 2:00 AM",4,1,3,0,0,0,1,0,1,0,0,0,0,0,0,0,1,1,0,2,2,0,2,0,0,0,0,0,0,0,0,0,0,,,
"Sep 19, 2022 3:00 AM",1,1,0,0,0,0,0,0,0,0,0,0,0,0,0,0,0,0,0,0,0,0,0,0,0,0,0,0,1,0,1,1,0,,,
"Sep 19, 2022 4:00 AM",1,1,0,1,0,1,3,1,2,3,1,2,0,0,0,0,2,2,0,0,0,0,2,0,2,0,2,0,0,1,1,1,0,,,
"Sep 19, 2022 5:00 AM",6,4,2,2,0,2,2,1,1,4,1,3,0,0,0,1,7,7,0,0,0,0,7,0,2,1,1,12,0,0,0,0,0,,,
"Sep 19, 2022 6:00 AM",46,29,17,12,5,7,25,10,15,19,7,12,0,0,0,10,24,23,1,14,11,3,21,0,7,2,5,28,1,2,1,1,0,,,
"Sep 19, 2022 7:00 AM",131,85,46,59,17,42,79,26,53,63,22,41,0,0,0,18,86,86,0,29,25,4,82,0,39,13,26,121,3,4,7,6,1,,,
"Sep 19, 2022 8:00 AM",347,262,85,99,25,74,172,52,120,131,46,85,0,0,0,55,239,235,4,43,38,5,178,0,86,16,70,236,6,5,17,13,4,,,
"Sep 19, 2022 9:00 AM",186,159,27,64,28,36,100,50,50,72,41,31,0,0,0,22,93,92,1,25,16,9,73,0,52,25,27,69,4,9,5,3,2,,,
"Sep 19, 2022 10:00 AM",91,60,31,43,23,20,51,29,22,46,24,22,0,0,0,10,51,49,2,9,7,2,31,0,25,14,11,31,4,0,3,3,0,,,
"Sep 19, 2022 11:00 AM",69,35,34,54,26,28,51,24,27,34,24,10,0,0,0,23,19,18,1,11,8,3,9,0,19,9,10,25,2,1,1,1,0,,,
"Sep 19, 2022 12:00 PM",48,22,26,41,16,25,34,13,21,42,18,24,0,0,0,11,43,38,5,16,16,0,26,0,22,7,15,24,3,3,8,5,3,,,
"Sep 19, 2022 1:00 PM",106,51,55,40,25,15,61,33,28,49,25,24,0,0,0,16,25,21,4,28,25,3,14,0,26,14,12,19,1,2,4,2,2,,,
"Sep 19, 2022 2:00 PM",64,26,38,56,34,22,33,22,11,42,25,17,0,0,0,16,28,21,7,28,26,2,13,0,28,13,15,31,7,2,8,5,3,,,
"Sep 19, 2022 3:00 PM",92,33,59,50,27,23,61,37,24,48,29,19,0,0,0,20,30,27,3,34,29,5,18,0,30,24,6,27,6,3,8,4,4,,,
"Sep 19, 2022 4:00 PM",171,42,129,58,41,17,72,55,17,65,44,21,0,0,0,20,37,29,8,58,53,5,24,0,43,36,7,38,6,1,4,3,1,,,
"Sep 19, 2022 5:00 PM",273,68,205,71,43,28,117,73,44,91,57,34,0,0,0,48,71,44,27,115,112,3,42,0,77,60,17,55,8,4,11,8,3,,,
"Sep 19, 2022 6:00 PM",218,49,169,67,46,21,138,93,45,86,53,33,0,0,0,35,62,50,12,100,97,3,44,0,81,55,26,39,7,5,7,5,2,,,
"Sep 19, 2022 7:00 PM",126,36,90,55,28,27,90,53,37,70,41,29,0,0,0,24,33,25,8,53,52,1,15,0,39,30,9,31,8,5,15,6,9,,,
"Sep 19, 2022 8:00 PM",91,23,68,21,12,9,29,15,14,25,14,11,0,0,0,13,24,19,5,26,25,1,19,0,16,11,5,25,5,3,6,4,2,,,
"Sep 19, 2022 9:00 PM",45,8,37,8,5,3,7,2,5,6,1,5,0,0,0,11,17,13,4,15,14,1,9,0,2,1,1,10,6,0,2,2,0,,,
"Sep 19, 2022 10:00 PM",33,7,26,7,5,2,6,4,2,7,4,3,0,0,0,4,11,7,4,18,17,1,7,0,4,1,3,2,2,2,2,2,0,,,
"Sep 19, 2022 11:00 PM",17,2,15,6,3,3,4,2,2,4,2,2,0,0,0,2,6,5,1,7,7,0,4,0,1,1,0,2,1,0,0,0,0,,,
"Sep 20, 2022 12:00 AM",5,2,3,0,0,0,2,1,1,1,1,0,0,0,0,0,0,0,0,2,2,0,1,0,0,0,0,1,0,1,1,1,0,,,
"Sep 20, 2022 1:00 AM",1,0,1,1,1,0,0,0,0,0,0,0,0,0,0,1,1,0,1,1,1,0,0,0,0,0,0,0,0,0,1,0,1,,,
"Sep 20, 2022 2:00 AM",7,5,2,0,0,0,1,1,0,0,0,0,0,0,0,0,0,0,0,0,0,0,0,0,0,0,0,0,0,0,1,1,0,,,
"Sep 20, 2022 3:00 AM",1,0,1,0,0,0,0,0,0,0,0,0,0,0,0,0,0,0,0,0,0,0,0,0,0,0,0,0,0,0,0,0,0,,,
"Sep 20, 2022 4:00 AM",2,2,0,2,0,2,1,0,1,1,0,1,0,0,0,0,3,3,0,1,1,0,3,0,1,0,1,1,0,1,0,0,0,,,
"Sep 20, 2022 5:00 AM",10,5,5,0,0,0,4,2,2,5,2,3,0,0,0,1,4,4,0,0,0,0,3,0,3,2,1,11,0,1,0,0,0,,,
"Sep 20, 2022 6:00 AM",51,32,19,0,0,0,36,13,23,25,8,17,0,0,0,17,17,17,0,14,10,4,17,0,14,7,7,39,1,5,2,2,0,,,
"Sep 20, 2022 7:00 AM",181,121,60,0,0,0,82,29,53,49,21,28,0,0,0,25,100,99,1,36,28,8,94,0,39,13,26,137,4,2,11,10,1,,,
"Sep 20, 2022 8:00 AM",382,299,83,0,0,0,217,65,152,157,47,110,0,0,0,56,261,258,3,57,42,15,210,0,103,20,83,263,9,11,24,22,2,,,
"Sep 20, 2022 9:00 AM",177,144,33,0,0,0,93,49,44,82,52,30,0,0,0,19,109,108,1,20,16,4,84,0,60,26,34,77,2,8,5,3,2,,,
"Sep 20, 2022 10:00 AM",93,62,31,0,0,0,99,55,44,59,30,29,0,0,0,12,48,45,3,19,12,7,31,0,37,25,12,38,3,3,5,4,1,,,
"Sep 20, 2022 11:00 AM",72,46,26,0,0,0,64,28,36,47,21,26,0,0,0,9,29,28,1,12,8,4,17,0,23,11,12,37,4,5,8,4,4,,,
"Sep 20, 2022 12:00 PM",91,43,48,0,0,0,47,26,21,40,26,14,0,0,0,10,35,34,1,19,18,1,23,0,22,12,10,23,3,5,2,0,2,,,
"Sep 20, 2022 1:00 PM",91,40,51,28,11,17,71,38,33,47,27,20,0,0,0,13,43,35,8,21,18,3,27,0,39,16,23,28,9,5,7,5,2,,,
"Sep 20, 2022 2:00 PM",96,33,63,47,24,23,53,29,24,42,25,17,0,0,0,12,43,29,14,25,23,2,16,0,41,23,18,31,5,4,10,5,5,,,
"Sep 20, 2022 3:00 PM",129,47,82,64,34,30,78,52,26,67,41,26,0,0,0,24,43,35,8,45,37,8,28,0,39,28,11,42,7,1,7,5,2,,,
"Sep 20, 2022 4:00 PM",192,65,127,93,60,33,91,56,35,88,50,38,0,0,0,29,51,31,20,74,65,9,21,0,55,42,13,60,9,2,9,3,6,,,
"Sep 20, 2022 5:00 PM",316,82,234,107,75,32,149,104,45,114,75,39,0,0,0,39,71,53,18,152,149,3,50,0,81,63,18,74,10,6,12,8,4,,,
"Sep 20, 2022 6:00 PM",263,63,200,109,78,31,166,112,54,133,85,48,0,0,0,31,57,49,8,120,114,6,40,0,94,75,19,56,5,5,12,8,4,,,
"Sep 20, 2022 7:00 PM",164,46,118,80,45,35,107,58,49,73,33,40,0,0,0,14,39,35,4,43,40,3,22,0,69,42,27,45,6,5,11,5,6,,,
"Sep 20, 2022 8:00 PM",104,28,76,46,29,17,58,32,26,43,27,16,0,0,0,13,29,22,7,45,44,1,19,0,30,12,18,33,6,2,7,3,4,,,
"Sep 20, 2022 9:00 PM",58,13,45,11,7,4,20,10,10,16,9,7,0,0,0,10,12,8,4,15,13,2,6,0,8,4,4,17,9,3,2,1,1,,,
"Sep 20, 2022 10:00 PM",38,9,29,6,6,0,12,8,4,12,5,7,0,0,0,2,15,10,5,16,14,2,9,0,4,2,2,4,1,2,2,1,1,,,
"Sep 20, 2022 11:00 PM",19,1,18,1,1,0,8,6,2,3,3,0,0,0,0,4,4,3,1,5,4,1,2,0,1,0,1,2,0,1,1,0,1,,,
"Sep 21, 2022 12:00 AM",5,0,5,0,0,0,1,1,0,2,1,1,0,0,0,3,5,5,0,6,6,0,5,0,3,1,2,0,0,0,1,1,0,,,
"Sep 21, 2022 1:00 AM",6,3,3,1,1,0,2,2,0,1,0,1,0,0,0,0,1,1,0,2,2,0,1,0,0,0,0,0,0,0,0,0,0,,,
"Sep 21, 2022 2:00 AM",5,3,2,0,0,0,1,1,0,0,0,0,0,0,0,0,0,0,0,1,1,0,0,0,0,0,0,1,0,0,0,0,0,,,
"Sep 21, 2022 3:00 AM",0,0,0,0,0,0,0,0,0,0,0,0,0,0,0,1,0,0,0,3,3,0,0,0,1,1,0,0,0,0,0,0,0,,,
"Sep 21, 2022 4:00 AM",3,1,2,1,0,1,2,0,2,3,0,3,0,0,0,1,3,3,0,1,1,0,3,0,1,0,1,1,0,1,0,0,0,,,
"Sep 21, 2022 5:00 AM",11,7,4,2,0,2,1,1,0,1,1,0,0,0,0,1,9,9,0,1,1,0,6,0,0,0,0,9,1,0,0,0,0,,,
"Sep 21, 2022 6:00 AM",61,42,19,0,0,0,32,9,23,23,8,15,0,0,0,9,19,19,0,9,7,2,18,0,15,9,6,42,1,4,3,3,0,,,
"Sep 21, 2022 7:00 AM",176,116,60,0,0,0,95,32,63,67,26,41,0,0,0,20,96,96,0,31,26,5,85,0,43,19,24,148,7,5,7,4,3,,,
"Sep 21, 2022 8:00 AM",397,312,85,0,0,0,196,68,128,142,53,89,0,0,0,44,246,243,3,60,49,11,206,0,119,32,87,266,8,7,23,21,2,,,
"Sep 21, 2022 9:00 AM",187,169,18,0,0,0,111,61,50,81,48,33,0,0,0,22,106,106,0,29,13,16,73,0,59,31,28,90,7,12,5,2,3,,,
"Sep 21, 2022 10:00 AM",95,70,25,0,0,0,83,40,43,56,26,30,0,0,0,17,60,57,3,18,14,4,36,0,42,19,23,50,5,4,0,0,0,,,
"Sep 21, 2022 11:00 AM",72,47,25,0,0,0,80,45,35,56,29,27,0,0,0,10,35,31,4,15,10,5,20,0,20,14,6,41,2,4,5,3,2,,,
"Sep 21, 2022 12:00 PM",80,30,50,0,0,0,84,45,39,60,35,25,0,0,0,9,43,35,8,28,25,3,26,0,41,21,20,35,3,1,5,3,2,,,
"Sep 21, 2022 1:00 PM",112,50,62,0,0,0,105,54,51,84,44,40,0,0,0,18,49,43,6,45,42,3,28,0,47,29,18,29,6,5,8,2,6,,,
"Sep 21, 2022 2:00 PM",92,35,57,18,10,8,58,31,27,48,29,19,0,0,0,12,49,38,11,33,31,2,19,0,34,18,16,41,9,5,8,5,3,,,
"Sep 21, 2022 3:00 PM",120,48,72,42,29,13,50,33,17,47,27,20,0,0,0,26,51,41,10,42,36,6,24,0,46,37,9,24,5,1,11,4,7,,,
"Sep 21, 2022 4:00 PM",188,51,137,63,37,26,81,51,30,71,43,28,0,0,0,32,41,26,15,64,61,3,22,0,57,35,22,57,7,2,8,4,4,,,
"Sep 21, 2022 5:00 PM",288,72,216,90,59,31,150,97,53,113,72,41,0,0,0,40,72,55,17,108,98,10,48,0,87,61,26,74,7,6,7,5,2,,,
"Sep 21, 2022 6:00 PM",247,62,185,108,72,36,159,112,47,129,82,47,0,0,0,32,58,46,12,118,112,6,30,0,99,75,24,62,3,6,8,6,2,,,
"Sep 21, 2022 7:00 PM",152,47,105,86,38,48,95,56,39,74,40,34,0,0,0,37,29,24,5,46,42,4,20,0,46,34,12,46,13,2,12,6,6,,,
"Sep 21, 2022 8:00 PM",93,26,67,28,21,7,40,19,21,33,12,21,0,0,0,6,28,19,9,35,32,3,17,0,19,8,11,27,6,2,6,5,1,,,
"Sep 21, 2022 9:00 PM",75,17,58,16,13,3,35,21,14,21,13,8,0,0,0,9,12,6,6,26,24,2,4,0,15,11,4,14,5,0,3,2,1,,,
"Sep 21, 2022 10:00 PM",39,6,33,8,5,3,9,4,5,11,4,7,0,0,0,4,16,14,2,13,13,0,13,0,8,6,2,8,3,0,5,2,3,,,
"Sep 21, 2022 11:00 PM",23,7,16,5,4,1,6,4,2,6,4,2,0,0,0,3,6,3,3,5,5,0,4,0,2,1,1,3,0,1,0,0,0,,,
"Sep 22, 2022 12:00 AM",8,1,7,0,0,0,3,1,2,3,1,2,0,0,0,0,1,1,0,1,1,0,3,0,1,1,0,3,0,1,2,1,1,,,
"Sep 22, 2022 1:00 AM",2,0,2,0,0,0,1,1,0,1,1,0,0,0,0,0,5,3,2,4,4,0,3,0,1,1,0,2,0,0,0,0,0,,,
"Sep 22, 2022 2:00 AM",8,5,3,0,0,0,1,1,0,0,0,0,0,0,0,1,1,1,0,3,2,1,1,0,0,0,0,0,0,0,0,0,0,,,
"Sep 22, 2022 3:00 AM",5,0,5,0,0,0,0,0,0,0,0,0,0,0,0,0,0,0,0,3,3,0,0,0,0,0,0,0,0,0,0,0,0,,,
"Sep 22, 2022 4:00 AM",4,2,2,1,0,1,3,1,2,2,1,1,0,0,0,0,3,3,0,1,1,0,3,0,1,0,1,0,0,0,0,0,0,,,
"Sep 22, 2022 5:00 AM",11,6,5,0,0,0,2,1,1,2,1,1,0,0,0,4,6,6,0,1,1,0,6,0,0,0,0,9,0,0,0,0,0,,,
"Sep 22, 2022 6:00 AM",32,23,9,9,4,5,14,6,8,12,5,7,0,0,0,6,13,13,0,6,3,3,11,0,4,1,3,33,2,4,2,2,0,,,
"Sep 22, 2022 7:00 AM",102,70,32,16,1,15,33,8,25,17,4,13,0,0,0,7,68,67,1,12,11,1,62,0,19,3,16,84,1,2,4,3,1,,,
"Sep 22, 2022 8:00 AM",244,198,46,39,7,32,82,22,60,49,17,32,0,0,0,25,141,141,0,35,26,9,113,0,43,9,34,152,2,7,16,11,5,,,
"Sep 22, 2022 9:00 AM",102,88,14,15,2,13,29,8,21,23,11,12,0,0,0,8,55,53,2,14,9,5,35,0,26,6,20,35,1,1,4,4,0,,,
"Sep 22, 2022 10:00 AM",54,39,15,11,5,6,15,9,6,14,6,8,0,0,0,6,21,19,2,8,6,2,11,0,10,5,5,11,1,2,0,0,0,,,
"Sep 22, 2022 11:00 AM",28,17,11,8,2,6,9,3,6,7,4,3,0,0,0,5,13,9,4,5,3,2,3,0,5,2,3,10,0,3,2,0,2,,,
"Sep 22, 2022 12:00 PM",37,21,16,10,5,5,16,10,6,10,5,5,0,0,0,5,23,19,4,13,10,3,12,0,2,1,1,8,1,0,7,5,2,,,
"Sep 22, 2022 1:00 PM",71,23,48,10,5,5,24,12,12,15,4,11,0,0,0,6,17,15,2,14,12,2,12,0,8,4,4,8,2,1,5,3,2,,,
"Sep 22, 2022 2:00 PM",46,14,32,8,3,5,10,6,4,6,4,2,0,0,0,2,22,16,6,9,8,1,9,0,8,6,2,12,2,0,5,3,2,,,
"Sep 22, 2022 3:00 PM",76,27,49,7,5,2,21,14,7,12,7,5,0,0,0,7,26,19,7,25,20,5,16,0,11,10,1,16,1,1,5,0,5,,,
"Sep 22, 2022 4:00 PM",124,35,89,32,22,10,35,26,9,33,27,6,0,0,0,9,26,16,10,36,33,3,15,0,23,19,4,34,2,1,4,3,1,,,
"Sep 22, 2022 5:00 PM",196,47,149,44,32,12,71,50,21,60,44,16,0,0,0,13,40,30,10,70,65,5,26,0,39,30,9,40,9,3,6,4,2,,,
"Sep 22, 2022 6:00 PM",159,47,112,68,42,26,83,63,20,65,42,23,0,0,0,39,33,28,5,64,60,4,21,0,52,38,14,31,3,3,9,4,5,,,
"Sep 22, 2022 7:00 PM",116,35,81,49,23,26,49,29,20,39,18,21,0,0,0,23,21,17,4,48,42,6,16,0,32,20,12,20,3,1,12,8,4,,,
"Sep 22, 2022 8:00 PM",83,26,57,26,18,8,45,23,22,35,17,18,0,0,0,9,18,15,3,25,23,2,9,0,7,5,2,19,8,1,7,3,4,,,
"Sep 22, 2022 9:00 PM",45,9,36,23,16,7,23,10,13,17,11,6,0,0,0,9,7,3,4,17,15,2,2,0,7,5,2,14,2,0,1,0,1,,,
"Sep 22, 2022 10:00 PM",31,6,25,6,5,1,9,4,5,7,2,5,0,0,0,5,8,7,1,5,3,2,8,0,5,3,2,2,1,0,1,0,1,,,
"Sep 22, 2022 11:00 PM",17,8,9,2,1,1,5,4,1,3,2,1,0,0,0,1,10,9,1,9,8,1,8,0,3,3,0,5,0,1,0,0,0,,,
"Sep 23, 2022 12:00 AM",9,2,7,1,1,0,2,1,1,1,1,0,0,0,0,0,1,1,0,3,2,1,1,0,1,0,1,1,0,0,0,0,0,,,
"Sep 23, 2022 1:00 AM",3,0,3,1,1,0,3,2,1,1,0,1,0,0,0,0,1,1,0,2,2,0,1,0,0,0,0,2,0,0,0,0,0,,,
"Sep 23, 2022 2:00 AM",8,1,7,0,0,0,0,0,0,0,0,0,0,0,0,0,0,0,0,3,2,1,0,0,0,0,0,0,0,0,0,0,0,,,
"Sep 23, 2022 3:00 AM",1,0,1,2,2,0,0,0,0,1,1,0,0,0,0,0,0,0,0,0,0,0,0,0,0,0,0,0,0,0,0,0,0,,,
"Sep 23, 2022 4:00 AM",6,1,5,1,0,1,1,0,1,2,1,1,0,0,0,0,3,2,1,0,0,0,2,0,1,0,1,0,0,0,0,0,0,,,
"Sep 23, 2022 5:00 AM",10,7,3,1,1,0,3,2,1,3,2,1,0,0,0,0,5,5,0,3,3,0,4,0,3,2,1,9,1,0,0,0,0,,,
"Sep 23, 2022 6:00 AM",44,25,19,23,11,12,30,14,16,22,13,9,0,0,0,7,13,11,2,7,5,2,12,0,13,12,1,33,3,3,0,0,0,,,
"Sep 23, 2022 7:00 AM",112,68,44,62,29,33,79,28,51,65,31,34,0,0,0,9,62,62,0,19,15,4,50,0,30,10,20,80,4,4,7,4,3,,,
"Sep 23, 2022 8:00 AM",249,184,65,110,35,75,151,57,94,121,49,72,0,0,0,37,126,123,3,44,34,10,98,0,80,26,54,150,10,6,22,19,3,,,
"Sep 23, 2022 9:00 AM",142,118,24,55,21,34,87,43,44,65,40,25,0,0,0,8,74,72,2,24,20,4,57,0,39,20,19,67,5,9,1,0,1,,,
"Sep 23, 2022 10:00 AM",65,51,14,63,26,37,74,39,35,57,31,26,0,0,0,13,48,47,1,17,14,3,29,0,28,14,14,36,1,3,3,1,2,,,
"Sep 23, 2022 11:00 AM",72,38,34,50,29,21,59,32,27,52,28,24,0,0,0,9,47,40,7,10,9,1,25,0,36,21,15,45,6,5,7,5,2,,,
"Sep 23, 2022 12:00 PM",98,52,46,77,38,39,103,63,40,67,39,28,0,0,0,10,32,28,4,23,22,1,23,0,33,20,13,50,3,6,11,6,5,,,
"Sep 23, 2022 1:00 PM",110,38,72,68,37,31,103,53,50,70,34,36,0,0,0,10,34,27,7,35,26,9,23,0,36,20,16,28,7,5,11,7,4,,,
"Sep 23, 2022 2:00 PM",85,30,55,71,32,39,80,36,44,62,31,31,0,0,0,16,30,21,9,33,32,1,17,0,34,19,15,31,7,8,6,4,2,,,
"Sep 23, 2022 3:00 PM",113,43,70,68,42,26,60,35,25,58,37,21,0,0,0,27,33,28,5,31,27,4,18,0,38,25,13,34,6,7,6,2,4,,,
"Sep 23, 2022 4:00 PM",141,45,96,49,33,16,72,41,31,67,37,30,0,0,0,18,26,21,5,47,44,3,17,0,41,21,20,32,7,0,4,3,1,,,
"Sep 23, 2022 5:00 PM",172,45,127,54,35,19,80,54,26,75,46,29,0,0,0,22,37,31,6,68,61,7,28,0,55,40,15,51,4,4,6,2,4,,,
"Sep 23, 2022 6:00 PM",144,54,90,46,34,12,73,50,23,52,36,16,0,0,0,16,32,23,9,54,50,4,22,0,39,28,11,38,2,2,7,3,4,,,
"Sep 23, 2022 7:00 PM",108,37,71,35,20,15,42,29,13,39,28,11,0,0,0,10,29,24,5,30,26,4,22,0,29,22,7,40,3,1,4,0,4,,,
"Sep 23, 2022 8:00 PM",62,25,37,12,10,2,24,7,17,23,11,12,0,0,0,8,16,12,4,21,17,4,12,0,4,3,1,17,1,0,2,1,1,,,
"Sep 23, 2022 9:00 PM",53,11,42,16,11,5,12,10,2,12,6,6,0,0,0,10,11,9,2,17,17,0,5,0,6,3,3,9,3,0,1,0,1,,,
"Sep 23, 2022 10:00 PM",45,11,34,6,5,1,10,4,6,7,2,5,0,0,0,1,8,6,2,14,13,1,6,0,3,3,0,10,2,0,2,2,0,,,
"Sep 23, 2022 11:00 PM",24,8,16,4,1,3,10,6,4,10,7,3,0,0,0,7,5,4,1,9,9,0,4,0,1,1,0,7,0,0,0,0,0,,,
"Sep 24, 2022 12:00 AM",8,2,6,0,0,0,9,4,5,7,5,2,0,0,0,1,1,1,0,2,2,0,1,0,1,1,0,7,1,2,0,0,0,,,
"Sep 24, 2022 1:00 AM",7,0,7,2,1,1,4,3,1,4,3,1,0,0,0,0,0,0,0,5,5,0,1,0,0,0,0,4,0,0,0,0,0,,,
"Sep 24, 2022 2:00 AM",11,3,8,0,0,0,0,0,0,0,0,0,0,0,0,0,2,2,0,0,0,0,1,0,1,1,0,3,0,0,0,0,0,,,
"Sep 24, 2022 3:00 AM",8,2,6,0,0,0,0,0,0,1,0,1,0,0,0,0,0,0,0,4,4,0,0,0,1,1,0,1,0,0,1,1,0,,,
"Sep 24, 2022 4:00 AM",4,1,3,0,0,0,0,0,0,0,0,0,0,0,0,0,3,3,0,0,0,0,4,0,0,0,0,1,0,0,0,0,0,,,
"Sep 24, 2022 5:00 AM",3,0,3,0,0,0,0,0,0,0,0,0,0,0,0,0,2,2,0,1,1,0,2,0,0,0,0,0,0,0,0,0,0,,,
"Sep 24, 2022 6:00 AM",15,10,5,2,1,1,2,2,0,2,1,1,0,0,0,0,1,1,0,6,4,2,2,0,0,0,0,4,1,1,0,0,0,,,
"Sep 24, 2022 7:00 AM",20,6,14,21,14,7,17,10,7,18,12,6,0,0,0,5,9,9,0,6,4,2,6,0,6,5,1,16,0,2,1,1,0,,,
"Sep 24, 2022 8:00 AM",54,32,22,44,22,22,58,31,27,38,25,13,0,0,0,12,14,13,1,5,3,2,12,0,20,12,8,26,4,9,2,2,0,,,
"Sep 24, 2022 9:00 AM",63,35,28,83,42,41,83,61,22,68,52,16,0,0,0,15,21,18,3,12,10,2,18,0,32,24,8,24,9,2,3,2,1,,,
"Sep 24, 2022 10:00 AM",76,49,27,85,42,43,100,59,41,79,39,40,0,0,0,22,28,24,4,17,13,4,19,0,36,17,19,21,5,10,4,3,1,,,
"Sep 24, 2022 11:00 AM",65,37,28,120,53,67,113,60,53,72,35,37,0,0,0,15,13,9,4,12,11,1,9,0,43,27,16,32,12,5,9,3,6,,,
"Sep 24, 2022 12:00 PM",77,35,42,116,32,84,141,84,57,104,57,47,0,0,0,25,21,18,3,10,9,1,19,0,51,28,23,45,7,8,7,2,5,,,
"Sep 24, 2022 1:00 PM",72,34,38,89,52,37,128,69,59,97,65,32,0,0,0,21,31,29,2,23,19,4,20,0,44,22,22,39,4,9,4,4,0,,,
"Sep 24, 2022 2:00 PM",62,32,30,89,45,44,95,42,53,76,36,40,0,0,0,27,36,35,1,15,13,2,32,0,39,17,22,49,6,3,5,3,2,,,
"Sep 24, 2022 3:00 PM",59,31,28,84,43,41,85,43,42,79,42,37,0,0,0,31,24,20,4,13,12,1,21,0,44,24,20,28,8,3,3,2,1,,,
"Sep 24, 2022 4:00 PM",72,39,33,91,52,39,98,53,45,91,54,37,0,0,0,20,25,23,2,21,20,1,17,0,47,31,16,34,5,3,6,3,3,,,
"Sep 24, 2022 5:00 PM",64,34,30,86,42,44,104,31,73,102,26,76,0,0,0,23,20,15,5,17,13,4,11,0,44,20,24,46,4,2,3,2,1,,,
"Sep 24, 2022 6:00 PM",54,23,31,70,50,20,65,32,33,48,18,30,0,0,0,10,19,12,7,16,15,1,10,0,41,15,26,26,3,1,3,0,3,,,
"Sep 24, 2022 7:00 PM",55,26,29,38,12,26,43,20,23,30,10,20,0,0,0,9,12,10,2,10,9,1,8,0,6,4,2,32,3,1,2,2,0,,,
"Sep 24, 2022 8:00 PM",33,18,15,21,16,5,23,16,7,22,13,9,0,0,0,5,9,8,1,8,7,1,7,0,4,3,1,6,2,0,7,4,3,,,
"Sep 24, 2022 9:00 PM",28,11,17,7,5,2,12,5,7,11,3,8,0,0,0,3,11,9,2,5,4,1,8,0,3,2,1,7,0,0,0,0,0,,,
"Sep 24, 2022 10:00 PM",17,7,10,11,9,2,18,7,11,20,9,11,0,0,0,2,13,11,2,5,5,0,10,0,6,3,3,6,1,1,2,2,0,,,
"Sep 24, 2022 11:00 PM",20,5,15,5,5,0,3,1,2,7,4,3,0,0,0,5,3,3,0,0,0,0,2,0,2,2,0,4,0,1,1,0,1,,,
"Sep 25, 2022 12:00 AM",16,5,11,1,0,1,9,3,6,6,1,5,0,0,0,2,1,1,0,4,4,0,1,0,4,3,1,7,0,1,0,0,0,,,
"Sep 25, 2022 1:00 AM",15,2,13,3,2,1,4,1,3,2,0,2,0,0,0,1,2,2,0,1,1,0,1,0,2,1,1,5,0,1,0,0,0,,,
"Sep 25, 2022 2:00 AM",8,2,6,4,4,0,1,1,0,3,3,0,0,0,0,1,5,3,2,0,0,0,1,0,0,0,0,2,0,0,0,0,0,,,
"Sep 25, 2022 3:00 AM",2,0,2,1,1,0,0,0,0,1,1,0,0,0,0,0,0,0,0,2,2,0,0,0,1,1,0,0,0,0,0,0,0,,,
"Sep 25, 2022 4:00 AM",2,1,1,0,0,0,0,0,0,0,0,0,0,0,0,0,0,0,0,2,2,0,0,0,0,0,0,0,0,0,0,0,0,,,
"Sep 25, 2022 5:00 AM",1,0,1,1,0,1,0,0,0,0,0,0,0,0,0,1,0,0,0,1,1,0,0,0,0,0,0,0,0,0,0,0,0,,,
"Sep 25, 2022 6:00 AM",16,12,4,3,1,2,6,3,3,4,1,3,0,0,0,0,3,3,0,3,2,1,3,0,2,2,0,12,0,0,0,0,0,,,
"Sep 25, 2022 7:00 AM",17,6,11,11,4,7,17,10,7,11,3,8,0,0,0,2,16,16,0,5,3,2,17,0,8,2,6,14,1,7,3,3,0,,,
"Sep 25, 2022 8:00 AM",25,10,15,35,18,17,53,28,25,41,28,13,0,0,0,2,11,11,0,9,7,2,10,0,13,9,4,17,1,6,1,1,0,,,
"Sep 25, 2022 9:00 AM",40,16,24,111,56,55,92,65,27,82,63,19,0,0,0,9,15,14,1,4,2,2,13,0,19,13,6,27,5,4,3,2,1,,,
"Sep 25, 2022 10:00 AM",47,22,25,107,53,54,97,59,38,96,52,44,0,0,0,14,23,18,5,11,9,2,23,0,36,27,9,34,2,9,5,5,0,,,
"Sep 25, 2022 11:00 AM",54,35,19,122,55,67,123,71,52,112,57,55,0,0,0,24,18,17,1,12,11,1,12,0,39,26,13,39,4,3,4,1,3,,,
"Sep 25, 2022 12:00 PM",53,29,24,157,68,89,128,66,62,102,50,52,0,0,0,13,23,22,1,11,9,2,17,0,68,37,31,51,7,6,5,2,3,,,
"Sep 25, 2022 1:00 PM",66,29,37,120,60,60,114,61,53,104,73,31,0,0,0,24,26,23,3,31,28,3,19,0,61,42,19,34,8,6,10,7,3,,,
"Sep 25, 2022 2:00 PM",53,25,28,108,58,50,121,66,55,106,59,47,0,0,0,16,26,21,5,15,12,3,14,0,63,37,26,40,7,4,4,4,0,,,
"Sep 25, 2022 3:00 PM",64,28,36,95,54,41,88,42,46,91,37,54,0,0,0,17,12,12,0,13,11,2,12,0,30,6,24,38,2,3,6,5,1,,,
"Sep 25, 2022 4:00 PM",60,29,31,88,47,41,93,34,59,78,30,48,0,0,0,26,21,18,3,10,10,0,12,0,61,24,37,26,5,2,0,0,0,,,
"Sep 25, 2022 5:00 PM",65,29,36,83,41,42,65,33,32,68,22,46,0,0,0,6,18,17,1,13,11,2,12,0,29,15,14,30,4,1,4,4,0,,,
"Sep 25, 2022 6:00 PM",51,18,33,39,18,21,41,19,22,43,22,21,0,0,0,11,15,12,3,15,15,0,10,0,25,11,14,15,2,2,5,5,0,,,
"Sep 25, 2022 7:00 PM",46,23,23,27,14,13,31,9,22,24,5,19,0,0,0,8,7,6,1,12,11,1,7,0,17,8,9,21,5,2,7,5,2,,,
"Sep 25, 2022 8:00 PM",39,18,21,7,4,3,19,8,11,16,7,9,0,0,0,7,6,6,0,2,2,0,6,0,7,3,4,16,3,1,3,1,2,,,
"Sep 25, 2022 9:00 PM",20,7,13,7,6,1,3,1,2,4,1,3,0,0,0,5,8,7,1,6,5,1,7,0,0,0,0,5,1,0,0,0,0,,,
"Sep 25, 2022 10:00 PM",18,8,10,8,4,4,2,0,2,5,1,4,0,0,0,0,11,11,0,7,7,0,12,0,1,0,1,5,0,0,5,3,2,,,
"Sep 25, 2022 11:00 PM",12,4,8,2,0,2,4,1,3,2,0,2,0,0,0,1,1,0,1,4,4,0,0,0,0,0,0,1,1,2,2,1,1,,,
"Sep 26, 2022 12:00 AM",3,2,1,0,0,0,2,2,0,1,1,0,0,0,0,1,0,0,0,3,2,1,0,0,0,0,0,1,0,0,1,0,1,,,
"Sep 26, 2022 1:00 AM",3,1,2,0,0,0,0,0,0,0,0,0,0,0,0,2,1,1,0,0,0,0,1,0,0,0,0,0,0,0,0,0,0,,,
"Sep 26, 2022 2:00 AM",2,2,0,0,0,0,0,0,0,0,0,0,0,0,0,0,1,1,0,1,1,0,0,0,0,0,0,0,0,0,0,0,0,,,
"Sep 26, 2022 3:00 AM",1,0,1,0,0,0,0,0,0,0,0,0,0,0,0,0,0,0,0,0,0,0,0,0,0,0,0,0,0,2,0,0,0,,,
"Sep 26, 2022 4:00 AM",3,0,3,0,0,0,1,1,0,1,1,0,0,0,0,0,1,1,0,0,0,0,1,0,0,0,0,0,0,0,0,0,0,,,
"Sep 26, 2022 5:00 AM",8,4,4,4,1,3,0,0,0,2,1,1,0,0,0,2,5,5,0,1,0,1,4,0,1,0,1,8,1,0,0,0,0,,,
"Sep 26, 2022 6:00 AM",59,41,18,5,2,3,15,6,9,4,1,3,0,0,0,8,20,20,0,7,5,2,18,0,6,3,3,36,1,2,3,3,0,,,
"Sep 26, 2022 7:00 AM",129,84,45,52,18,34,60,20,40,51,21,30,0,0,0,16,75,74,1,17,15,2,65,0,28,11,17,111,1,2,5,5,0,,,
"Sep 26, 2022 8:00 AM",319,237,82,94,29,65,130,36,94,116,41,75,0,0,0,60,223,222,1,28,16,12,173,0,75,27,48,214,5,4,23,21,2,,,
"Sep 26, 2022 9:00 AM",190,162,28,50,15,35,65,32,33,59,28,31,0,0,0,18,99,98,1,20,11,9,59,0,49,16,33,68,4,7,1,0,1,,,
"Sep 26, 2022 10:00 AM",99,74,25,34,14,20,43,24,19,34,16,18,0,0,0,9,64,61,3,11,8,3,37,0,18,10,8,40,0,4,1,0,1,,,
"Sep 26, 2022 11:00 AM",59,36,23,44,23,21,59,29,30,40,18,22,0,0,0,8,31,28,3,10,8,2,17,0,18,9,9,24,7,6,3,3,0,,,
"Sep 26, 2022 12:00 PM",66,40,26,40,25,15,53,32,21,26,19,7,0,0,0,15,29,24,5,15,14,1,16,0,24,11,13,26,5,1,1,1,0,,,
"Sep 26, 2022 1:00 PM",102,46,56,29,17,12,55,27,28,33,17,16,0,0,0,10,33,30,3,23,22,1,26,0,22,11,11,22,0,4,2,2,0,,,
"Sep 26, 2022 2:00 PM",83,36,47,42,22,20,41,18,23,39,26,13,0,0,0,16,33,22,11,26,21,5,12,0,22,12,10,19,4,3,7,5,2,,,
"Sep 26, 2022 3:00 PM",104,40,64,46,24,22,50,28,22,34,22,12,0,0,0,22,33,20,13,40,38,2,14,0,18,15,3,31,5,0,9,5,4,,,
"Sep 26, 2022 4:00 PM",178,48,130,49,33,16,63,40,23,63,35,28,0,0,0,23,35,23,12,45,40,5,20,0,30,21,9,44,5,2,6,3,3,,,
"Sep 26, 2022 5:00 PM",234,58,176,54,41,13,84,52,32,67,39,28,0,0,0,35,55,38,17,103,100,3,32,0,36,32,4,57,7,6,10,7,3,,,
"Sep 26, 2022 6:00 PM",233,60,173,58,39,19,95,68,27,71,44,27,0,0,0,25,59,41,18,107,105,2,35,0,60,48,12,44,6,5,7,2,5,,,
"Sep 26, 2022 7:00 PM",126,36,90,40,23,17,38,27,11,42,26,16,0,0,0,11,25,17,8,57,55,2,15,0,23,18,5,23,9,3,11,7,4,,,
"Sep 26, 2022 8:00 PM",82,17,65,13,11,2,21,10,11,20,10,10,0,0,0,9,28,22,6,24,22,2,17,0,6,5,1,9,6,2,4,3,1,,,
"Sep 26, 2022 9:00 PM",44,12,32,17,12,5,12,7,5,11,7,4,0,0,0,9,16,9,7,18,18,0,6,0,8,4,4,11,1,0,2,0,2,,,
"Sep 26, 2022 10:00 PM",31,7,24,6,4,2,10,7,3,11,7,4,0,0,0,1,8,2,6,11,10,1,2,0,3,3,0,4,2,1,0,0,0,,,
"Sep 26, 2022 11:00 PM",16,4,12,5,4,1,4,3,1,5,4,1,0,0,0,4,5,3,2,7,7,0,3,0,4,3,1,1,0,0,0,0,0,,,
"Sep 27, 2022 12:00 AM",4,1,3,0,0,0,4,3,1,3,3,0,0,0,0,0,4,4,0,4,3,1,4,0,1,1,0,2,1,0,0,0,0,,,
"Sep 27, 2022 1:00 AM",5,1,4,0,0,0,1,1,0,0,0,0,0,0,0,0,0,0,0,0,0,0,0,0,1,1,0,1,0,1,0,0,0,,,
"Sep 27, 2022 2:00 AM",3,2,1,0,0,0,0,0,0,0,0,0,0,0,0,0,1,0,1,0,0,0,0,0,0,0,0,0,0,0,0,0,0,,,
"Sep 27, 2022 3:00 AM",1,0,1,0,0,0,0,0,0,0,0,0,0,0,0,0,0,0,0,1,1,0,1,0,0,0,0,0,0,0,0,0,0,,,
"Sep 27, 2022 4:00 AM",2,0,2,0,0,0,1,1,0,1,1,0,0,0,0,0,1,1,0,0,0,0,1,0,0,0,0,0,0,1,0,0,0,,,
"Sep 27, 2022 5:00 AM",8,4,4,1,0,1,4,1,3,2,0,2,0,0,0,2,9,9,0,1,0,1,6,0,1,0,1,2,0,0,0,0,0,,,
"Sep 27, 2022 6:00 AM",53,35,18,14,4,10,18,7,11,18,8,10,0,0,0,7,16,16,0,9,7,2,18,0,8,3,5,37,1,2,0,0,0,,,
"Sep 27, 2022 7:00 AM",167,120,47,52,15,37,71,14,57,53,14,39,0,0,0,22,84,84,0,26,23,3,82,0,31,12,19,145,2,5,7,6,1,,,
"Sep 27, 2022 8:00 AM",392,307,85,114,18,96,157,42,115,134,36,98,0,0,0,42,267,264,3,63,47,16,198,0,92,22,70,241,6,8,22,21,1,,,
"Sep 27, 2022 9:00 AM",164,137,27,45,18,27,71,30,41,60,30,30,0,0,0,18,110,107,3,25,16,9,72,0,43,14,29,76,6,11,6,2,4,,,
"Sep 27, 2022 10:00 AM",98,74,24,34,15,19,56,34,22,42,31,11,0,0,0,9,57,53,4,13,11,2,31,0,31,22,9,30,1,4,2,2,0,,,
"Sep 27, 2022 11:00 AM",66,40,26,50,26,24,55,32,23,36,18,18,0,0,0,12,35,32,3,19,15,4,21,0,28,13,15,31,5,3,3,1,2,,,
"Sep 27, 2022 12:00 PM",74,34,40,60,29,31,55,25,30,40,20,20,0,0,0,11,35,31,4,21,18,3,20,0,28,16,12,25,1,2,3,2,1,,,
"Sep 27, 2022 1:00 PM",94,48,46,37,19,18,54,29,25,40,20,20,0,0,0,18,40,34,6,26,24,2,24,0,22,10,12,33,3,1,7,3,4,,,
"Sep 27, 2022 2:00 PM",77,38,39,25,12,13,32,15,17,25,16,9,0,0,0,16,37,31,6,41,36,5,16,0,15,9,6,16,3,0,7,4,3,,,
"Sep 27, 2022 3:00 PM",134,50,84,28,16,12,44,24,20,29,17,12,0,0,0,19,39,33,6,49,40,9,25,0,27,16,11,31,5,2,18,4,14,,,
"Sep 27, 2022 4:00 PM",187,49,138,48,34,14,68,46,22,50,37,13,0,0,0,30,44,33,11,79,74,5,27,0,47,36,11,49,7,0,7,3,4,,,
"Sep 27, 2022 5:00 PM",305,73,232,88,69,19,110,67,43,105,64,41,0,0,0,37,76,45,31,111,109,2,38,0,75,54,21,53,12,5,7,4,3,,,
"Sep 27, 2022 6:00 PM",251,67,184,74,54,20,109,85,24,79,55,24,0,0,0,49,55,46,9,98,96,2,35,0,70,56,14,44,5,4,8,5,3,,,
"Sep 27, 2022 7:00 PM",160,48,112,47,33,14,57,41,16,48,34,14,0,0,0,16,32,21,11,48,44,4,19,0,31,23,8,29,4,0,6,5,1,,,
"Sep 27, 2022 8:00 PM",86,26,60,12,9,3,21,14,7,21,14,7,0,0,0,8,23,17,6,26,25,1,12,0,9,6,3,22,3,1,4,1,3,,,
"Sep 27, 2022 9:00 PM",47,14,33,6,5,1,17,14,3,8,5,3,0,0,0,7,16,12,4,20,19,1,10,0,19,8,11,11,3,0,4,2,2,,,
"Sep 27, 2022 10:00 PM",58,7,51,4,3,1,14,8,6,9,2,7,0,0,0,4,10,9,1,22,20,2,8,0,8,6,2,9,1,2,2,1,1,,,
"Sep 27, 2022 11:00 PM",22,5,17,4,4,0,8,7,1,6,5,1,0,0,0,4,2,2,0,7,6,1,2,0,3,2,1,1,0,1,0,0,0,,,
"Sep 28, 2022 12:00 AM",10,0,10,0,0,0,6,5,1,5,4,1,0,0,0,2,2,1,1,2,2,0,0,0,2,2,0,1,1,0,3,3,0,,,
"Sep 28, 2022 1:00 AM",4,1,3,3,3,0,1,0,1,0,0,0,0,0,0,0,0,0,0,0,0,0,0,0,0,0,0,1,0,0,0,0,0,,,
"Sep 28, 2022 2:00 AM",5,4,1,0,0,0,1,1,0,1,1,0,0,0,0,0,1,1,0,0,0,0,1,0,0,0,0,0,0,0,0,0,0,,,
"Sep 28, 2022 3:00 AM",3,0,3,0,0,0,0,0,0,0,0,0,0,0,0,0,0,0,0,0,0,0,0,0,0,0,0,0,0,0,0,0,0,,,
"Sep 28, 2022 4:00 AM",0,0,0,1,0,1,0,0,0,2,1,1,0,0,0,0,3,2,1,1,1,0,2,0,0,0,0,0,0,0,0,0,0,,,
"Sep 28, 2022 5:00 AM",8,5,3,2,0,2,4,1,3,3,1,2,0,0,0,1,6,6,0,2,2,0,5,0,1,0,1,8,1,0,0,0,0,,,
"Sep 28, 2022 6:00 AM",54,38,16,14,5,9,24,6,18,20,8,12,0,0,0,7,11,11,0,9,6,3,9,0,9,3,6,36,2,1,0,0,0,,,
"Sep 28, 2022 7:00 AM",152,96,56,67,24,43,73,26,47,71,26,45,0,0,0,20,90,90,0,23,19,4,83,0,33,12,21,116,4,5,11,11,0,,,
"Sep 28, 2022 8:00 AM",362,280,82,121,29,92,176,59,117,142,58,84,0,0,0,47,259,256,3,61,41,20,199,0,92,29,63,273,5,10,18,17,1,,,
"Sep 28, 2022 9:00 AM",188,160,28,60,22,38,77,38,39,68,40,28,0,0,0,10,122,120,2,30,21,9,84,0,41,22,19,77,8,6,9,5,4,,,
"Sep 28, 2022 10:00 AM",119,94,25,48,25,23,53,29,24,44,25,19,0,0,0,11,53,52,1,11,8,3,28,0,31,18,13,42,2,1,0,0,0,,,
"Sep 28, 2022 11:00 AM",65,40,25,56,29,27,49,29,20,48,27,21,0,0,0,6,37,33,4,17,13,4,24,0,35,19,16,28,1,4,4,3,1,,,
"Sep 28, 2022 12:00 PM",79,39,40,44,18,26,58,26,32,40,20,20,0,0,0,11,39,28,11,18,16,2,21,0,20,13,7,35,1,3,6,3,3,,,
"Sep 28, 2022 1:00 PM",90,36,54,47,31,16,66,35,31,50,33,17,0,0,0,13,51,43,8,31,28,3,28,0,31,16,15,29,3,3,3,1,2,,,
"Sep 28, 2022 2:00 PM",93,39,54,23,11,12,46,29,17,28,21,7,0,0,0,14,34,29,5,38,32,6,18,0,27,17,10,24,3,4,8,2,6,,,
"Sep 28, 2022 3:00 PM",107,28,79,31,21,10,52,32,20,31,20,11,0,0,0,8,36,32,4,33,30,3,22,0,13,10,3,25,5,0,4,3,1,,,
"Sep 28, 2022 4:00 PM",159,59,100,45,25,20,61,33,28,53,27,26,0,0,0,27,33,18,15,51,49,2,14,0,37,26,11,37,9,3,7,5,2,,,
"Sep 28, 2022 5:00 PM",285,61,224,76,61,15,110,68,42,81,46,35,0,0,0,34,63,48,15,107,105,2,41,0,69,51,18,83,5,5,13,7,6,,,
"Sep 28, 2022 6:00 PM",269,76,193,70,53,17,139,99,40,101,64,37,0,0,0,35,55,43,12,112,107,5,39,0,99,77,22,54,9,7,11,5,6,,,
"Sep 28, 2022 7:00 PM",129,31,98,41,27,14,73,44,29,45,26,19,0,0,0,24,32,16,16,47,43,4,12,0,29,23,6,28,3,2,17,8,9,,,
"Sep 28, 2022 8:00 PM",98,27,71,23,19,4,24,19,5,24,19,5,0,0,0,10,27,22,5,39,38,1,20,0,9,8,1,16,6,4,9,7,2,,,
"Sep 28, 2022 9:00 PM",53,14,39,4,3,1,16,11,5,9,4,5,0,0,0,10,15,9,6,21,21,0,6,0,10,9,1,9,8,0,6,4,2,,,
"Sep 28, 2022 10:00 PM",32,8,24,4,2,2,8,3,5,6,1,5,0,0,0,2,11,9,2,17,17,0,9,0,2,2,0,10,2,2,1,0,1,,,
"Sep 28, 2022 11:00 PM",20,4,16,4,4,0,6,4,2,4,4,0,0,0,0,3,7,3,4,13,13,0,2,0,2,1,1,1,1,0,2,2,0,,,
"Sep 29, 2022 12:00 AM",11,2,9,0,0,0,1,0,1,4,2,2,0,0,0,1,2,2,0,8,8,0,2,0,0,0,0,0,1,0,0,0,0,,,
"Sep 29, 2022 1:00 AM",3,0,3,0,0,0,3,1,2,0,0,0,0,0,0,0,0,0,0,2,2,0,0,0,1,1,0,2,0,0,0,0,0,,,
"Sep 29, 2022 2:00 AM",3,2,1,0,0,0,1,1,0,1,1,0,0,0,0,0,1,1,0,1,1,0,1,0,1,1,0,0,0,0,0,0,0,,,
"Sep 29, 2022 3:00 AM",1,0,1,0,0,0,0,0,0,0,0,0,0,0,0,0,0,0,0,0,0,0,1,0,0,0,0,0,0,0,0,0,0,,,
"Sep 29, 2022 4:00 AM",2,1,1,0,0,0,0,0,0,0,0,0,0,0,0,0,2,2,0,1,1,0,2,0,0,0,0,0,0,0,0,0,0,,,
"Sep 29, 2022 5:00 AM",7,4,3,0,0,0,4,1,3,2,1,1,0,0,0,1,9,9,0,1,1,0,8,0,0,0,0,4,0,0,0,0,0,,,
"Sep 29, 2022 6:00 AM",52,34,18,14,9,5,18,10,8,17,14,3,0,0,0,7,9,9,0,9,7,2,10,0,4,2,2,24,2,2,0,0,0,,,
"Sep 29, 2022 7:00 AM",134,86,48,61,16,45,78,20,58,63,22,41,0,0,0,19,74,73,1,22,19,3,68,0,27,8,19,118,3,2,9,8,1,,,
"Sep 29, 2022 8:00 AM",352,268,84,105,29,76,155,47,108,132,46,86,0,0,0,38,217,211,6,45,37,8,168,0,81,23,58,243,12,8,19,17,2,,,
"Sep 29, 2022 9:00 AM",191,166,25,50,12,38,74,32,42,59,31,28,0,0,0,18,114,110,4,31,24,7,78,0,47,21,26,81,2,6,8,6,2,,,
"Sep 29, 2022 10:00 AM",94,71,23,42,12,30,42,20,22,43,22,21,0,0,0,12,62,60,2,10,8,2,38,0,15,5,10,39,3,5,1,1,0,,,
"Sep 29, 2022 11:00 AM",68,39,29,34,19,15,41,26,15,35,22,13,0,0,0,13,43,40,3,16,10,6,30,0,18,10,8,24,2,3,10,8,2,,,
"Sep 29, 2022 12:00 PM",87,42,45,39,14,25,51,22,29,29,11,18,0,0,0,13,24,17,7,19,17,2,15,0,14,8,6,23,2,3,2,2,0,,,
"Sep 29, 2022 1:00 PM",108,53,55,37,19,18,62,33,29,44,24,20,0,0,0,11,45,38,7,30,26,4,29,0,27,13,14,27,5,3,2,2,0,,,
"Sep 29, 2022 2:00 PM",84,34,50,47,23,24,67,36,31,50,26,24,0,0,0,15,36,30,6,30,30,0,17,0,29,17,12,34,4,6,7,4,3,,,
"Sep 29, 2022 3:00 PM",123,44,79,38,20,18,56,32,24,40,20,20,0,0,0,20,48,36,12,41,33,8,19,0,38,22,16,37,1,6,7,2,5,,,
"Sep 29, 2022 4:00 PM",170,63,107,57,39,18,79,56,23,54,36,18,0,0,0,24,47,30,17,64,58,6,26,0,52,38,14,47,8,0,10,5,5,,,
"Sep 29, 2022 5:00 PM",256,72,184,77,52,25,125,83,42,96,64,32,0,0,0,41,53,40,13,111,100,11,38,0,80,62,18,68,8,5,12,9,3,,,
"Sep 29, 2022 6:00 PM",236,53,183,98,71,27,129,91,38,100,65,35,0,0,0,41,57,47,10,96,91,5,38,0,74,53,21,52,7,4,6,2,4,,,
"Sep 29, 2022 7:00 PM",139,42,97,53,21,32,75,44,31,64,30,34,0,0,0,24,24,21,3,49,45,4,20,0,35,25,10,21,14,4,7,5,2,,,
"Sep 29, 2022 8:00 PM",96,30,66,18,13,5,42,26,16,32,20,12,0,0,0,8,20,15,5,35,32,3,18,0,19,12,7,22,4,3,12,6,6,,,
"Sep 29, 2022 9:00 PM",62,12,50,15,11,4,21,12,9,18,10,8,0,0,0,7,8,8,0,21,18,3,8,0,7,6,1,12,3,2,6,3,3,,,
"Sep 29, 2022 10:00 PM",43,8,35,7,6,1,20,10,10,11,5,6,0,0,0,1,15,10,5,19,14,5,9,0,6,4,2,7,1,1,4,2,2,,,
"Sep 29, 2022 11:00 PM",32,6,26,6,4,2,8,4,4,7,4,3,0,0,0,1,4,3,1,12,12,0,3,0,5,4,1,5,1,1,0,0,0,,,
"Sep 30, 2022 12:00 AM",14,4,10,1,1,0,10,7,3,9,5,4,0,0,0,2,1,0,1,5,5,0,0,0,3,2,1,3,1,0,0,0,0,,,
"Sep 30, 2022 1:00 AM",8,0,8,1,1,0,2,2,0,0,0,0,0,0,0,0,0,0,0,4,4,0,0,0,1,1,0,2,1,0,0,0,0,,,
"Sep 30, 2022 2:00 AM",9,3,6,2,2,0,1,1,0,1,1,0,0,0,0,0,2,0,2,1,1,0,0,0,0,0,0,0,0,0,0,0,0,,,
"Sep 30, 2022 3:00 AM",3,1,2,0,0,0,0,0,0,0,0,0,0,0,0,0,0,0,0,2,2,0,0,0,0,0,0,0,0,0,0,0,0,,,
"Sep 30, 2022 4:00 AM",2,1,1,0,0,0,0,0,0,1,1,0,0,0,0,0,1,1,0,2,2,0,1,0,0,0,0,0,0,0,1,1,0,,,
"Sep 30, 2022 5:00 AM",9,4,5,2,1,1,2,2,0,2,2,0,0,0,0,1,9,9,0,1,0,1,7,0,3,0,3,4,0,0,0,0,0,,,
"Sep 30, 2022 6:00 AM",37,22,15,6,2,4,10,5,5,10,3,7,0,0,0,8,9,8,1,3,3,0,11,0,4,4,0,16,0,2,0,0,0,,,
"Sep 30, 2022 7:00 AM",66,41,25,22,4,18,31,8,23,22,5,17,0,0,0,8,37,37,0,9,7,2,34,0,13,3,10,58,3,0,5,2,3,,,
"Sep 30, 2022 8:00 AM",160,116,44,41,15,26,64,27,37,49,22,27,0,0,0,20,100,98,2,25,18,7,70,0,30,11,19,110,5,2,7,5,2,,,
"Sep 30, 2022 9:00 AM",79,67,12,32,8,24,45,19,26,32,16,16,0,0,0,9,47,46,1,14,10,4,27,0,26,8,18,27,1,4,2,1,1,,,
"Sep 30, 2022 10:00 AM",48,29,19,9,4,5,13,5,8,11,6,5,0,0,0,7,18,16,2,10,9,1,10,0,7,1,6,14,2,0,0,0,0,,,
"Sep 30, 2022 11:00 AM",28,17,11,11,4,7,7,4,3,8,4,4,0,0,0,6,14,11,3,8,6,2,9,0,4,2,2,5,1,3,2,0,2,,,
"Sep 30, 2022 12:00 PM",34,19,15,17,9,8,19,13,6,15,13,2,0,0,0,2,21,15,6,17,10,7,11,0,7,7,0,14,0,1,1,0,1,,,
"Sep 30, 2022 1:00 PM",79,32,47,18,6,12,65,23,42,56,7,49,0,0,0,4,14,9,5,15,12,3,7,0,61,9,52,14,1,1,2,0,2,,,
"Sep 30, 2022 2:00 PM",62,27,35,11,6,5,31,15,16,19,11,8,0,0,0,11,29,26,3,23,20,3,17,0,10,5,5,18,2,1,4,1,3,,,
"Sep 30, 2022 3:00 PM",75,30,45,22,12,10,33,21,12,20,14,6,0,0,0,6,22,12,10,23,21,2,14,0,16,10,6,26,3,3,7,4,3,,,
"Sep 30, 2022 4:00 PM",115,38,77,35,26,9,67,48,19,59,54,5,0,0,0,19,17,16,1,32,31,1,10,0,30,20,10,28,5,3,5,4,1,,,
"Sep 30, 2022 5:00 PM",134,39,95,49,33,16,77,41,36,74,43,31,0,0,0,15,34,24,10,47,40,7,19,0,29,19,10,39,5,5,4,1,3,,,
"Sep 30, 2022 6:00 PM",118,33,85,44,24,20,57,35,22,38,25,13,0,0,0,16,28,26,2,42,39,3,24,0,20,16,4,22,7,3,6,6,0,,,
"Sep 30, 2022 7:00 PM",72,26,46,24,15,9,36,22,14,31,19,12,0,0,0,12,32,30,2,20,15,5,25,0,15,9,6,18,6,0,9,7,2,,,
"Sep 30, 2022 8:00 PM",63,26,37,11,8,3,15,5,10,18,7,11,0,0,0,11,11,7,4,19,18,1,6,0,12,8,4,14,4,0,3,3,0,,,
"Sep 30, 2022 9:00 PM",36,9,27,5,4,1,11,8,3,6,3,3,0,0,0,4,5,4,1,6,5,1,2,0,3,1,2,6,1,0,0,0,0,,,
"Sep 30, 2022 10:00 PM",26,9,17,6,5,1,14,9,5,10,5,5,0,0,0,1,5,4,1,7,6,1,5,0,6,5,1,6,0,1,2,0,2,,,
"Sep 30, 2022 11:00 PM",29,10,19,1,1,0,9,5,4,7,2,5,0,0,0,3,6,3,3,5,5,0,3,0,1,1,0,2,0,0,0,0,0,,,
"Oct 1, 2022 12:00 AM",16,1,15,0,0,0,5,3,2,3,2,1,0,0,0,3,1,1,0,8,7,1,1,0,0,0,0,1,0,0,0,0,0,,,
"Oct 1, 2022 1:00 AM",8,1,7,1,0,1,3,1,2,0,0,0,0,0,0,1,3,2,1,3,3,0,2,0,1,1,0,0,0,0,0,0,0,,,
"Oct 1, 2022 2:00 AM",4,1,3,0,0,0,2,2,0,0,0,0,0,0,0,2,2,2,0,1,1,0,0,0,2,2,0,2,0,0,0,0,0,,,
"Oct 1, 2022 3:00 AM",1,0,1,2,0,2,1,1,0,2,1,1,0,0,0,0,0,0,0,1,1,0,1,0,3,3,0,0,0,0,0,0,0,,,
"Oct 1, 2022 4:00 AM",3,1,2,0,0,0,0,0,0,0,0,0,0,0,0,0,0,0,0,1,1,0,0,0,0,0,0,1,0,0,0,0,0,,,
"Oct 1, 2022 5:00 AM",2,1,1,2,0,2,3,1,2,3,0,3,0,0,0,1,0,0,0,1,0,1,0,0,1,0,1,2,0,0,0,0,0,,,
"Oct 1, 2022 6:00 AM",9,6,3,3,2,1,6,4,2,2,1,1,0,0,0,1,4,4,0,2,2,0,3,0,3,1,2,5,1,0,2,1,1,,,
"Oct 1, 2022 7:00 AM",17,5,12,18,10,8,20,12,8,16,10,6,0,0,0,2,6,5,1,7,5,2,6,0,2,1,1,24,0,1,0,0,0,,,
"Oct 1, 2022 8:00 AM",36,21,15,36,24,12,36,19,17,39,28,11,0,0,0,9,12,11,1,13,11,2,7,0,10,5,5,12,2,7,3,1,2,,,
"Oct 1, 2022 9:00 AM",58,39,19,57,32,25,52,33,19,62,40,22,0,0,0,8,16,16,0,6,4,2,14,0,26,21,5,20,1,3,5,4,1,,,
"Oct 1, 2022 10:00 AM",62,31,31,99,48,51,78,45,33,101,58,43,0,0,0,24,27,26,1,20,14,6,24,0,28,12,16,21,5,3,3,1,2,,,
"Oct 1, 2022 11:00 AM",71,32,39,109,48,61,90,46,44,89,50,39,0,0,0,19,17,14,3,12,9,3,12,0,43,30,13,37,4,3,7,6,1,,,
"Oct 1, 2022 12:00 PM",69,38,31,125,41,84,107,60,47,113,59,54,0,0,0,11,23,20,3,12,8,4,21,0,34,22,12,29,6,2,4,4,0,,,
"Oct 1, 2022 1:00 PM",55,31,24,82,44,38,65,37,28,68,45,23,0,0,0,18,26,24,2,16,15,1,21,0,40,20,20,28,4,6,6,4,2,,,
"Oct 1, 2022 2:00 PM",59,35,24,61,35,26,81,44,37,62,36,26,0,0,0,17,22,22,0,14,13,1,17,0,37,24,13,35,6,3,5,5,0,,,
"Oct 1, 2022 3:00 PM",63,29,34,87,38,49,111,62,49,74,38,36,0,0,0,20,19,16,3,11,9,2,13,0,47,23,24,29,5,2,5,5,0,,,
"Oct 1, 2022 4:00 PM",61,26,35,99,56,43,107,57,50,83,45,38,0,0,0,22,21,17,4,21,16,5,11,0,49,26,23,26,5,1,10,7,3,,,
"Oct 1, 2022 5:00 PM",63,25,38,76,37,39,113,41,72,92,31,61,0,0,0,23,18,15,3,14,14,0,11,0,49,25,24,43,1,6,6,4,2,,,
"Oct 1, 2022 6:00 PM",52,18,34,62,33,29,74,31,43,69,30,39,0,0,0,20,28,23,5,9,9,0,19,0,31,11,20,17,0,1,3,0,3,,,
"Oct 1, 2022 7:00 PM",56,31,25,33,13,20,33,20,13,27,11,16,0,0,0,15,14,13,1,7,4,3,12,0,20,9,11,13,3,0,4,1,3,,,
"Oct 1, 2022 8:00 PM",34,21,13,18,13,5,22,8,14,15,6,9,0,0,0,5,9,6,3,6,4,2,5,0,10,5,5,11,1,1,2,0,2,,,
"Oct 1, 2022 9:00 PM",21,8,13,13,6,7,16,7,9,10,5,5,0,0,0,5,3,3,0,4,4,0,4,0,3,1,2,8,0,1,1,1,0,,,
"Oct 1, 2022 10:00 PM",15,7,8,9,8,1,5,2,3,3,2,1,0,0,0,3,7,7,0,8,8,0,6,0,1,1,0,3,2,2,0,0,0,,,
"Oct 1, 2022 11:00 PM",22,7,15,3,2,1,10,3,7,9,2,7,0,0,0,3,6,6,0,7,5,2,7,0,4,3,1,1,0,2,1,1,0,,,
"Oct 2, 2022 12:00 AM",6,2,4,1,0,1,3,0,3,3,0,3,0,0,0,4,3,3,0,4,4,0,4,0,2,2,0,5,1,0,0,0,0,,,
"Oct 2, 2022 1:00 AM",10,2,8,3,2,1,8,4,4,3,2,1,0,0,0,0,2,2,0,1,1,0,2,0,2,2,0,5,1,0,2,1,1,,,
"Oct 2, 2022 2:00 AM",6,1,5,2,1,1,5,1,4,2,1,1,0,0,0,0,1,1,0,3,3,0,0,0,0,0,0,7,0,0,0,0,0,,,
"Oct 2, 2022 3:00 AM",6,1,5,0,0,0,0,0,0,0,0,0,0,0,0,0,0,0,0,1,1,0,1,0,3,2,1,1,0,0,0,0,0,,,
"Oct 2, 2022 4:00 AM",2,0,2,0,0,0,0,0,0,0,0,0,0,0,0,0,0,0,0,0,0,0,0,0,0,0,0,1,0,1,1,1,0,,,
"Oct 2, 2022 5:00 AM",3,1,2,1,0,1,2,0,2,1,0,1,0,0,0,1,0,0,0,0,0,0,0,0,1,0,1,2,1,0,0,0,0,,,
"Oct 2, 2022 6:00 AM",9,6,3,2,1,1,2,1,1,3,1,2,0,0,0,1,2,2,0,1,0,1,2,0,1,1,0,9,1,0,0,0,0,,,
"Oct 2, 2022 7:00 AM",12,1,11,15,9,6,16,10,6,14,10,4,0,0,0,4,4,4,0,5,5,0,4,0,5,4,1,8,1,3,5,2,3,,,
"Oct 2, 2022 8:00 AM",26,15,11,67,41,26,48,31,17,53,41,12,0,0,0,4,14,14,0,6,5,1,13,0,11,8,3,15,1,5,2,1,1,,,
"Oct 2, 2022 9:00 AM",58,42,16,128,91,37,96,53,43,112,80,32,0,0,0,11,25,25,0,8,6,2,24,0,30,21,9,14,3,10,4,4,0,,,
"Oct 2, 2022 10:00 AM",59,30,29,190,111,79,170,103,67,180,127,53,0,0,0,3,21,18,3,11,9,2,15,0,63,41,22,34,4,4,11,6,5,,,
"Oct 2, 2022 11:00 AM",59,35,24,182,96,86,114,56,58,136,72,64,0,0,0,14,23,23,0,12,10,2,20,0,56,35,21,42,15,3,10,8,2,,,
"Oct 2, 2022 12:00 PM",60,36,24,190,86,104,161,92,69,158,89,69,0,0,0,21,40,38,2,19,15,4,29,0,69,34,35,55,12,6,7,5,2,,,
"Oct 2, 2022 1:00 PM",90,38,52,151,64,87,146,85,61,148,90,58,0,0,0,27,25,23,2,18,16,2,19,0,55,31,24,47,8,1,3,3,0,,,
"Oct 2, 2022 2:00 PM",54,35,19,163,88,75,111,69,42,123,65,58,0,0,0,27,22,20,2,19,17,2,14,0,42,23,19,38,5,6,8,4,4,,,
"Oct 2, 2022 3:00 PM",54,29,25,110,58,52,125,58,67,105,41,64,0,0,0,15,11,11,0,11,11,0,10,0,57,29,28,49,7,3,8,5,3,,,
"Oct 2, 2022 4:00 PM",69,33,36,65,27,38,107,52,55,57,22,35,0,0,0,24,22,21,1,13,13,0,18,0,52,25,27,41,5,4,6,5,1,,,
"Oct 2, 2022 5:00 PM",83,34,49,83,45,38,103,43,60,83,36,47,0,0,0,15,24,23,1,13,12,1,17,0,53,28,25,30,8,2,4,3,1,,,
"Oct 2, 2022 6:00 PM",65,31,34,52,24,28,85,31,54,62,26,36,0,0,0,22,21,18,3,12,11,1,15,0,19,7,12,26,5,3,3,2,1,,,
"Oct 2, 2022 7:00 PM",46,26,20,35,16,19,34,16,18,27,10,17,0,0,0,7,10,7,3,16,8,8,10,0,11,5,6,18,1,0,1,1,0,,,
"Oct 2, 2022 8:00 PM",35,11,24,11,3,8,12,6,6,10,3,7,0,0,0,7,11,10,1,6,6,0,10,0,6,2,4,8,2,1,1,1,0,,,
"Oct 2, 2022 9:00 PM",23,13,10,10,5,5,12,7,5,11,5,6,0,0,0,1,5,5,0,2,2,0,4,0,4,2,2,3,2,0,2,0,2,,,
"Oct 2, 2022 10:00 PM",20,8,12,5,3,2,8,3,5,9,4,5,0,0,0,1,4,4,0,4,4,0,4,0,2,1,1,5,2,1,0,0,0,,,
"Oct 2, 2022 11:00 PM",5,1,4,3,3,0,11,9,2,5,5,0,0,0,0,1,3,3,0,6,6,0,3,0,1,1,0,1,0,0,1,1,0,,,
"Oct 3, 2022 12:00 AM",3,2,1,0,0,0,1,1,0,0,0,0,0,0,0,0,3,3,0,1,1,0,3,0,1,1,0,1,0,1,0,0,0,,,
"Oct 3, 2022 1:00 AM",3,2,1,3,3,0,1,1,0,1,1,0,0,0,0,1,1,1,0,0,0,0,1,0,1,1,0,1,0,0,0,0,0,,,
"Oct 3, 2022 2:00 AM",2,1,1,0,0,0,1,1,0,0,0,0,0,0,0,0,1,1,0,2,2,0,1,0,0,0,0,0,0,1,0,0,0,,,
"Oct 3, 2022 3:00 AM",0,0,0,0,0,0,0,0,0,0,0,0,0,0,0,0,0,0,0,0,0,0,0,0,0,0,0,0,0,0,0,0,0,,,
"Oct 3, 2022 4:00 AM",1,0,1,1,0,1,2,1,1,2,1,1,0,0,0,0,1,1,0,0,0,0,1,0,1,0,1,0,0,0,0,0,0,,,
"Oct 3, 2022 5:00 AM",7,5,2,0,0,0,5,2,3,3,1,2,0,0,0,1,6,6,0,3,2,1,5,0,1,1,0,9,0,1,0,0,0,,,
"Oct 3, 2022 6:00 AM",57,35,22,16,6,10,26,9,17,15,7,8,0,0,0,6,21,21,0,5,2,3,18,0,8,2,6,37,2,4,0,0,0,,,
"Oct 3, 2022 7:00 AM",124,78,46,59,18,41,72,27,45,47,16,31,0,0,0,21,101,101,0,32,29,3,86,0,36,17,19,119,1,4,9,6,3,,,
"Oct 3, 2022 8:00 AM",323,265,58,112,32,80,163,51,112,143,52,91,0,0,0,32,227,225,2,49,36,13,175,0,89,24,65,233,8,11,14,11,3,,,
"Oct 3, 2022 9:00 AM",188,163,25,44,16,28,75,33,42,57,26,31,0,0,0,14,111,109,2,22,15,7,58,0,49,26,23,75,5,6,5,4,1,,,
"Oct 3, 2022 10:00 AM",75,63,12,45,15,30,54,29,25,49,31,18,0,0,0,10,70,68,2,16,10,6,41,0,28,12,16,26,3,4,1,0,1,,,
"Oct 3, 2022 11:00 AM",57,41,16,44,20,24,49,23,26,49,26,23,0,0,0,20,29,22,7,10,7,3,11,0,19,8,11,16,4,6,4,3,1,,,
"Oct 3, 2022 12:00 PM",60,30,30,42,23,19,51,25,26,44,22,22,0,0,0,10,30,27,3,13,11,2,20,0,13,7,6,41,3,1,1,1,0,,,
"Oct 3, 2022 1:00 PM",93,46,47,82,40,42,50,23,27,38,18,20,0,0,0,5,26,18,8,29,24,5,14,0,23,10,13,33,3,3,8,4,4,,,
"Oct 3, 2022 2:00 PM",75,31,44,48,25,23,54,35,19,57,29,28,0,0,0,7,34,26,8,33,27,6,12,0,32,20,12,27,5,2,6,3,3,,,
"Oct 3, 2022 3:00 PM",100,34,66,38,25,13,61,39,22,35,22,13,0,0,0,14,45,36,9,25,22,3,30,0,37,26,11,34,3,0,4,2,2,,,
"Oct 3, 2022 4:00 PM",167,32,135,35,25,10,68,49,19,60,39,21,0,0,0,29,38,23,15,59,50,9,20,0,46,30,16,39,12,7,9,7,2,,,
"Oct 3, 2022 5:00 PM",254,49,205,71,49,22,126,79,47,96,57,39,0,0,0,29,73,53,20,132,128,4,44,0,77,52,25,71,7,8,8,3,5,,,
"Oct 3, 2022 6:00 PM",231,50,181,72,49,23,144,101,43,83,54,29,0,0,0,18,59,42,17,99,92,7,37,0,67,55,12,32,6,7,10,5,5,,,
"Oct 3, 2022 7:00 PM",147,35,112,34,17,17,62,38,24,39,25,14,0,0,0,15,29,21,8,46,46,0,14,0,36,22,14,34,10,4,8,7,1,,,
"Oct 3, 2022 8:00 PM",84,19,65,22,12,10,25,16,9,21,10,11,0,0,0,9,32,23,9,29,26,3,19,0,13,6,7,18,8,0,3,2,1,,,
"Oct 3, 2022 9:00 PM",58,12,46,13,6,7,14,6,8,15,6,9,0,0,0,8,20,13,7,17,17,0,11,0,9,7,2,16,3,0,3,3,0,,,
"Oct 3, 2022 10:00 PM",31,3,28,3,2,1,8,4,4,6,1,5,0,0,0,3,6,2,4,15,14,1,2,0,5,3,2,6,3,1,1,1,0,,,
"Oct 3, 2022 11:00 PM",11,3,8,6,5,1,0,0,0,0,0,0,0,0,0,4,7,4,3,8,8,0,4,0,0,0,0,2,0,0,1,0,1,,,
"Oct 4, 2022 12:00 AM",7,1,6,1,0,1,3,2,1,2,0,2,0,0,0,0,1,0,1,3,3,0,0,0,2,2,0,1,1,0,1,0,1,,,
"Oct 4, 2022 1:00 AM",2,0,2,0,0,0,2,2,0,0,0,0,0,0,0,0,2,0,2,1,1,0,0,0,2,1,1,1,0,0,0,0,0,,,
"Oct 4, 2022 2:00 AM",5,4,1,0,0,0,3,2,1,1,1,0,0,0,0,0,1,1,0,0,0,0,1,0,3,3,0,0,0,0,0,0,0,,,
"Oct 4, 2022 3:00 AM",0,0,0,0,0,0,0,0,0,0,0,0,0,0,0,0,0,0,0,1,1,0,0,0,1,1,0,0,0,0,0,0,0,,,
"Oct 4, 2022 4:00 AM",2,1,1,1,0,1,1,0,1,1,0,1,0,0,0,0,2,2,0,1,1,0,2,0,1,0,1,1,0,0,0,0,0,,,
"Oct 4, 2022 5:00 AM",11,7,4,4,1,3,6,3,3,6,1,5,0,0,0,5,6,6,0,2,1,1,4,0,2,1,1,8,0,0,1,1,0,,,
"Oct 4, 2022 6:00 AM",55,35,20,13,5,8,28,7,21,18,9,9,0,0,0,11,23,23,0,7,5,2,25,0,17,4,13,36,0,3,1,1,0,,,
"Oct 4, 2022 7:00 AM",145,101,44,40,11,29,59,16,43,33,10,23,0,0,0,17,68,67,1,21,17,4,59,0,27,10,17,111,1,3,6,6,0,,,
"Oct 4, 2022 8:00 AM",325,249,76,91,21,70,151,42,109,99,35,64,0,0,0,30,216,215,1,43,29,14,173,0,84,26,58,216,8,12,22,21,1,,,
"Oct 4, 2022 9:00 AM",170,149,21,44,8,36,83,41,42,64,35,29,0,0,0,13,105,100,5,21,19,2,71,0,46,19,27,61,2,5,5,1,4,,,
"Oct 4, 2022 10:00 AM",83,67,16,44,21,23,37,24,13,33,18,15,0,0,0,12,59,57,2,11,7,4,32,0,23,8,15,31,1,1,6,4,2,,,
"Oct 4, 2022 11:00 AM",68,41,27,38,16,22,36,18,18,38,15,23,0,0,0,9,36,33,3,13,13,0,19,0,19,14,5,26,4,5,9,7,2,,,
"Oct 4, 2022 12:00 PM",69,35,34,15,8,7,27,11,16,16,8,8,0,0,0,6,40,40,0,7,5,2,27,0,11,7,4,15,3,2,1,1,0,,,
"Oct 4, 2022 1:00 PM",88,36,52,22,14,8,32,21,11,24,14,10,0,0,0,13,41,37,4,24,22,2,18,0,14,10,4,22,2,5,1,0,1,,,
"Oct 4, 2022 2:00 PM",90,38,52,31,17,14,42,21,21,44,18,26,0,0,0,15,35,30,5,25,21,4,16,0,31,21,10,33,6,1,7,4,3,,,
"Oct 4, 2022 3:00 PM",112,35,77,30,19,11,32,20,12,29,22,7,0,0,0,17,41,32,9,32,26,6,24,0,13,4,9,21,7,1,6,4,2,,,
"Oct 4, 2022 4:00 PM",170,53,117,41,26,15,58,40,18,45,23,22,0,0,0,15,39,24,15,55,53,2,24,0,51,40,11,37,6,1,9,4,5,,,
"Oct 4, 2022 5:00 PM",262,73,189,42,35,7,88,59,29,64,42,22,0,0,0,25,56,36,20,95,92,3,29,0,48,37,11,55,7,1,14,8,6,,,
"Oct 4, 2022 6:00 PM",238,56,182,38,32,6,89,59,30,64,42,22,0,0,0,17,45,29,16,107,102,5,23,0,52,45,7,47,9,6,11,6,5,,,
"Oct 4, 2022 7:00 PM",130,33,97,38,29,9,56,31,25,38,27,11,0,0,0,18,32,21,11,56,51,5,17,0,35,27,8,21,2,3,9,5,4,,,
"Oct 4, 2022 8:00 PM",93,31,62,13,10,3,27,18,9,21,14,7,0,0,0,6,29,16,13,29,29,0,15,0,8,3,5,16,5,4,10,6,4,,,
"Oct 4, 2022 9:00 PM",49,12,37,9,5,4,25,15,10,18,10,8,0,0,0,4,17,11,6,17,16,1,6,0,7,7,0,12,1,3,2,2,0,,,
"Oct 4, 2022 10:00 PM",45,5,40,10,7,3,10,6,4,8,4,4,0,0,0,5,8,4,4,18,16,2,3,0,9,4,5,4,0,1,1,0,1,,,
"Oct 4, 2022 11:00 PM",25,5,20,2,2,0,5,4,1,4,4,0,0,0,0,2,7,4,3,5,5,0,4,0,1,1,0,1,0,0,0,0,0,,,
"Oct 5, 2022 12:00 AM",10,2,8,0,0,0,5,3,2,3,2,1,0,0,0,0,2,1,1,2,2,0,1,0,1,1,0,7,1,0,0,0,0,,,
"Oct 5, 2022 1:00 AM",3,0,3,0,0,0,2,1,1,0,0,0,0,0,0,1,0,0,0,0,0,0,0,0,0,0,0,0,0,0,0,0,0,,,
"Oct 5, 2022 2:00 AM",6,5,1,0,0,0,0,0,0,0,0,0,0,0,0,0,0,0,0,0,0,0,0,0,0,0,0,0,0,0,0,0,0,,,
"Oct 5, 2022 3:00 AM",0,0,0,0,0,0,0,0,0,0,0,0,0,0,0,0,0,0,0,0,0,0,0,0,0,0,0,0,0,0,0,0,0,,,
"Oct 5, 2022 4:00 AM",3,1,2,2,0,2,1,1,0,3,2,1,0,0,0,1,2,2,0,0,0,0,2,0,2,1,1,0,0,0,1,1,0,,,
"Oct 5, 2022 5:00 AM",12,7,5,0,0,0,1,0,1,0,0,0,0,0,0,1,10,10,0,3,2,1,10,0,0,0,0,9,1,0,0,0,0,,,
"Oct 5, 2022 6:00 AM",44,27,17,14,2,12,23,8,15,19,4,15,0,0,0,7,17,17,0,7,5,2,15,0,7,5,2,34,0,1,1,1,0,,,
"Oct 5, 2022 7:00 AM",116,77,39,50,17,33,61,20,41,51,25,26,0,0,0,16,82,82,0,22,17,5,80,0,27,8,19,94,3,1,10,9,1,,,
"Oct 5, 2022 8:00 AM",337,264,73,90,17,73,140,43,97,96,27,69,0,0,0,31,182,181,1,45,32,13,150,0,86,15,71,208,6,7,25,21,4,,,
"Oct 5, 2022 9:00 AM",147,128,19,44,10,34,67,34,33,59,32,27,0,0,0,10,99,98,1,22,17,5,72,0,47,21,26,63,10,5,8,5,3,,,
"Oct 5, 2022 10:00 AM",72,61,11,28,9,19,43,21,22,41,26,15,0,0,0,15,60,59,1,10,7,3,26,0,13,7,6,33,3,5,2,1,1,,,
"Oct 5, 2022 11:00 AM",55,38,17,30,16,14,28,13,15,29,10,19,0,0,0,9,38,36,2,7,5,2,23,0,16,7,9,19,2,4,5,3,2,,,
"Oct 5, 2022 12:00 PM",57,38,19,33,16,17,43,23,20,41,15,26,0,0,0,8,37,31,6,14,14,0,19,0,26,15,11,27,2,2,1,1,0,,,
"Oct 5, 2022 1:00 PM",120,58,62,36,23,13,60,30,30,48,31,17,0,0,0,9,42,37,5,28,23,5,20,0,27,15,12,25,2,6,3,2,1,,,
"Oct 5, 2022 2:00 PM",57,16,41,13,5,8,19,8,11,17,8,9,0,0,0,3,22,15,7,20,17,3,10,0,10,7,3,17,2,4,4,3,1,,,
"Oct 5, 2022 3:00 PM",95,33,62,24,14,10,35,27,8,31,22,9,0,0,0,13,33,24,9,29,26,3,18,0,19,13,6,28,7,2,9,5,4,,,
"Oct 5, 2022 4:00 PM",148,38,110,25,13,12,47,32,15,42,23,19,0,0,0,22,39,21,18,60,57,3,17,0,36,29,7,36,2,4,11,4,7,,,
"Oct 5, 2022 5:00 PM",248,53,195,78,60,18,102,68,34,83,55,28,0,0,0,38,56,33,23,97,95,2,33,0,57,48,9,56,8,4,5,3,2,,,
"Oct 5, 2022 6:00 PM",217,61,156,73,49,24,101,68,33,75,45,30,0,0,0,19,50,37,13,108,101,7,27,0,77,56,21,47,3,7,4,4,0,,,
"Oct 5, 2022 7:00 PM",131,36,95,29,21,8,51,35,16,38,26,12,0,0,0,14,31,23,8,49,47,2,19,0,31,20,11,26,3,5,14,8,6,,,
"Oct 5, 2022 8:00 PM",103,27,76,18,13,5,32,22,10,21,13,8,0,0,0,12,29,22,7,27,22,5,16,0,11,8,3,11,6,3,4,4,0,,,
"Oct 5, 2022 9:00 PM",53,11,42,14,11,3,21,12,9,18,14,4,0,0,0,6,13,8,5,27,26,1,8,0,8,5,3,8,9,1,4,3,1,,,
"Oct 5, 2022 10:00 PM",48,11,37,4,4,0,10,8,2,11,6,5,0,0,0,7,10,5,5,15,15,0,5,0,6,5,1,5,1,1,0,0,0,,,
"Oct 5, 2022 11:00 PM",17,5,12,5,4,1,0,0,0,2,2,0,0,0,0,0,6,4,2,2,2,0,2,0,1,1,0,3,1,0,0,0,0,,,
"Oct 6, 2022 12:00 AM",11,3,8,0,0,0,5,2,3,5,4,1,0,0,0,1,2,1,1,3,2,1,1,0,1,1,0,2,0,0,0,0,0,,,
"Oct 6, 2022 1:00 AM",3,0,3,0,0,0,2,2,0,1,1,0,0,0,0,0,0,0,0,0,0,0,0,0,3,2,1,0,0,0,0,0,0,,,
"Oct 6, 2022 2:00 AM",3,3,0,0,0,0,0,0,0,0,0,0,0,0,0,0,1,0,1,0,0,0,0,0,0,0,0,0,0,1,0,0,0,,,
"Oct 6, 2022 3:00 AM",1,1,0,0,0,0,1,1,0,0,0,0,0,0,0,0,2,1,1,0,0,0,1,0,0,0,0,0,0,0,0,0,0,,,
"Oct 6, 2022 4:00 AM",1,1,0,1,0,1,1,0,1,1,0,1,0,0,0,0,1,1,0,1,0,1,1,0,1,0,1,2,0,0,1,1,0,,,
"Oct 6, 2022 5:00 AM",8,5,3,1,0,1,3,1,2,2,1,1,0,0,0,1,10,10,0,2,1,1,8,0,1,0,1,6,0,0,0,0,0,,,
"Oct 6, 2022 6:00 AM",47,28,19,15,4,11,20,9,11,13,6,7,0,0,0,9,14,14,0,9,6,3,12,0,7,2,5,34,1,2,2,1,1,,,
"Oct 6, 2022 7:00 AM",128,87,41,40,13,27,81,35,46,51,21,30,0,0,0,12,83,82,1,27,25,2,75,0,39,14,25,119,1,2,10,9,1,,,
"Oct 6, 2022 8:00 AM",344,262,82,108,29,79,172,72,100,133,49,84,0,0,0,20,227,226,1,58,41,17,182,0,96,34,62,225,5,6,18,15,3,,,
"Oct 6, 2022 9:00 AM",144,122,22,58,19,39,95,39,56,66,33,33,0,0,0,10,101,100,1,30,20,10,72,0,53,22,31,96,1,11,6,3,3,,,
"Oct 6, 2022 10:00 AM",90,76,14,63,27,36,72,38,34,43,26,17,0,0,0,13,53,51,2,16,12,4,24,0,19,8,11,39,5,5,5,3,2,,,
"Oct 6, 2022 11:00 AM",58,40,18,39,19,20,57,27,30,48,15,33,0,0,0,11,42,40,2,7,2,5,27,0,30,15,15,22,1,4,6,3,3,,,
"Oct 6, 2022 12:00 PM",76,39,37,44,24,20,56,33,23,36,22,14,0,0,0,13,35,33,2,18,17,1,20,0,20,9,11,18,3,3,3,3,0,,,
"Oct 6, 2022 1:00 PM",84,36,48,52,24,28,77,29,48,64,27,37,0,0,0,11,32,27,5,16,14,2,18,0,25,8,17,29,4,4,6,4,2,,,
"Oct 6, 2022 2:00 PM",84,39,45,37,22,15,35,20,15,32,19,13,0,0,0,9,41,30,11,19,19,0,18,0,23,9,14,30,1,3,10,6,4,,,
"Oct 6, 2022 3:00 PM",114,39,75,24,15,9,30,20,10,18,11,7,0,0,0,13,40,28,12,39,33,6,18,0,22,16,6,35,2,6,7,4,3,,,
"Oct 6, 2022 4:00 PM",182,44,138,48,36,12,68,47,21,60,46,14,0,0,0,17,54,34,20,56,52,4,26,0,44,37,7,45,4,1,7,3,4,,,
"Oct 6, 2022 5:00 PM",248,74,174,87,58,29,118,81,37,102,63,39,0,0,0,22,66,50,16,104,99,5,44,0,79,63,16,60,12,8,9,6,3,,,
"Oct 6, 2022 6:00 PM",230,58,172,76,54,22,106,73,33,69,47,22,0,0,0,24,49,40,9,108,100,8,28,0,79,55,24,45,8,6,19,12,7,,,
"Oct 6, 2022 7:00 PM",157,46,111,33,18,15,54,39,15,38,23,15,0,0,0,20,25,17,8,53,49,4,13,0,27,22,5,34,2,3,8,6,2,,,
"Oct 6, 2022 8:00 PM",79,26,53,17,10,7,31,19,12,23,12,11,0,0,0,11,21,12,9,40,37,3,9,0,17,16,1,13,3,2,9,5,4,,,
"Oct 6, 2022 9:00 PM",48,15,33,19,16,3,20,15,5,12,10,2,0,0,0,5,13,7,6,17,16,1,5,0,6,3,3,16,3,2,4,3,1,,,
"Oct 6, 2022 10:00 PM",43,9,34,3,3,0,8,7,1,1,1,0,0,0,0,5,12,5,7,18,12,6,8,0,6,5,1,4,1,1,0,0,0,,,
"Oct 6, 2022 11:00 PM",26,3,23,3,1,2,4,1,3,6,2,4,0,0,0,3,6,3,3,11,11,0,3,0,4,2,2,1,0,0,1,0,1,,,
"Oct 7, 2022 12:00 AM",14,0,14,0,0,0,9,8,1,8,5,3,0,0,0,0,3,2,1,4,4,0,0,,2,0,2,2,0,0,1,1,0,,,
"Oct 7, 2022 1:00 AM",7,1,6,0,0,0,2,1,1,0,0,0,0,0,0,0,1,0,1,2,2,0,0,,1,1,0,0,0,0,0,0,0,,,
"Oct 7, 2022 2:00 AM",8,3,5,1,1,0,3,2,1,4,3,1,0,0,0,0,1,1,0,1,1,0,1,,0,0,0,0,0,0,0,0,0,,,
"Oct 7, 2022 3:00 AM",2,1,1,1,0,1,0,0,0,0,0,0,0,0,0,1,0,0,0,0,0,0,0,,0,0,0,0,0,0,0,0,0,,,
"Oct 7, 2022 4:00 AM",0,0,0,1,1,0,2,1,1,1,0,1,0,0,0,1,2,1,1,1,1,0,0,,3,2,1,1,0,0,0,0,0,,,
"Oct 7, 2022 5:00 AM",12,9,3,0,0,0,1,0,1,0,0,0,0,0,0,1,8,8,0,0,0,0,7,,1,0,1,6,1,0,0,0,0,,,
"Oct 7, 2022 6:00 AM",39,22,17,7,2,5,12,4,8,10,3,7,0,0,0,6,8,7,1,7,4,3,7,,6,5,1,21,2,2,0,0,0,,,
"Oct 7, 2022 7:00 AM",75,50,25,26,10,16,38,18,20,27,14,13,0,0,0,11,39,38,1,24,19,5,38,,19,9,10,63,1,0,9,7,2,,,
"Oct 7, 2022 8:00 AM",199,158,41,54,12,42,91,31,60,67,24,43,0,0,0,17,129,127,2,18,14,4,101,,55,16,39,122,5,7,6,5,1,,,
"Oct 7, 2022 9:00 AM",97,79,18,26,11,15,63,31,32,46,24,22,0,0,0,9,49,48,1,16,13,3,33,,29,13,16,49,1,4,8,4,4,,,
"Oct 7, 2022 10:00 AM",49,31,18,30,11,19,32,19,13,33,19,14,0,0,0,9,49,45,4,7,5,2,26,,26,15,11,26,2,1,3,2,1,,,
"Oct 7, 2022 11:00 AM",77,43,34,39,11,28,42,19,23,35,14,21,0,0,0,8,42,37,5,14,10,4,16,,29,17,12,25,3,5,1,1,0,,,
"Oct 7, 2022 12:00 PM",61,28,33,28,13,15,66,36,30,39,19,20,0,0,0,7,30,27,3,17,15,2,23,,32,17,15,26,1,0,4,2,2,,,
"Oct 7, 2022 1:00 PM",116,46,70,40,29,11,59,25,34,50,32,18,0,0,0,14,22,21,1,27,23,4,16,,27,10,17,19,3,4,6,2,4,,,
"Oct 7, 2022 2:00 PM",66,30,36,43,21,22,53,30,23,35,19,16,0,0,0,9,31,22,9,21,19,2,17,,23,16,7,24,2,2,1,0,1,,,
"Oct 7, 2022 3:00 PM",75,28,47,23,13,10,33,22,11,23,18,5,0,0,0,17,22,17,5,21,20,1,15,,17,11,6,26,3,2,6,4,2,,,
"Oct 7, 2022 4:00 PM",151,40,111,51,28,23,64,41,23,51,31,20,0,0,0,13,38,28,10,32,30,2,27,,35,26,9,37,6,3,10,8,2,,,
"Oct 7, 2022 5:00 PM",175,57,118,50,36,14,61,35,26,63,34,29,0,0,0,21,35,24,11,59,57,2,20,,44,25,19,45,7,9,6,5,1,,,
"Oct 7, 2022 6:00 PM",140,48,92,48,31,17,73,52,21,50,34,16,0,0,0,14,34,30,4,50,48,2,23,,38,29,9,29,2,5,5,3,2,,,
"Oct 7, 2022 7:00 PM",91,31,60,26,18,8,37,21,16,35,20,15,0,0,0,14,17,11,6,32,30,2,8,,14,7,7,18,5,2,6,3,3,,,
"Oct 7, 2022 8:00 PM",39,16,23,11,6,5,19,14,5,16,10,6,0,0,0,5,15,8,7,17,17,0,8,,9,5,4,10,1,3,4,2,2,,,
"Oct 7, 2022 9:00 PM",44,9,35,11,7,4,13,6,7,13,5,8,0,0,0,6,9,8,1,11,10,1,6,,1,0,1,9,1,1,1,1,0,,,
"Oct 7, 2022 10:00 PM",43,12,31,7,5,2,12,6,6,9,5,4,0,0,0,5,10,6,4,11,8,3,7,,12,7,5,11,1,2,1,0,1,,,
"Oct 7, 2022 11:00 PM",26,10,16,2,2,0,7,4,3,6,3,3,0,0,0,3,3,3,0,5,5,0,4,,7,4,3,3,1,1,3,2,1,,,
"Oct 8, 2022 12:00 AM",16,7,9,2,2,0,5,2,3,2,1,1,0,0,0,0,5,3,2,9,9,0,3,,2,2,0,3,0,1,0,0,0,,,
"Oct 8, 2022 1:00 AM",17,4,13,3,2,1,2,2,0,1,0,1,0,0,0,0,0,0,0,2,2,0,0,,1,1,0,2,0,0,0,0,0,,,
"Oct 8, 2022 2:00 AM",8,6,2,2,0,2,4,2,2,3,1,2,0,0,0,0,1,0,1,1,1,0,0,,1,1,0,2,0,0,0,0,0,,,
"Oct 8, 2022 3:00 AM",4,0,4,2,2,0,0,0,0,2,1,1,0,0,0,0,0,0,0,1,1,0,0,,1,1,0,0,0,0,0,0,0,,,
"Oct 8, 2022 4:00 AM",2,0,2,0,0,0,1,1,0,1,1,0,0,0,0,0,1,0,1,0,0,0,0,,0,0,0,1,0,1,0,0,0,,,
"Oct 8, 2022 5:00 AM",2,2,0,1,0,1,2,1,1,2,1,1,0,0,0,1,0,0,0,2,2,0,0,,1,1,0,3,1,0,0,0,0,,,
"Oct 8, 2022 6:00 AM",13,7,6,11,10,1,12,10,2,10,9,1,0,0,0,2,3,3,0,2,2,0,2,,2,1,1,6,0,2,0,0,0,,,
"Oct 8, 2022 7:00 AM",20,14,6,16,8,8,19,12,7,15,10,5,0,0,0,7,11,11,0,10,8,2,10,,7,7,0,23,1,1,0,0,0,,,
"Oct 8, 2022 8:00 AM",32,17,15,58,31,27,48,30,18,51,32,19,0,0,0,15,21,20,1,12,11,1,12,,19,11,8,27,3,1,3,3,0,,,
"Oct 8, 2022 9:00 AM",67,31,36,65,38,27,91,60,31,71,48,23,0,0,0,18,16,16,0,7,6,1,15,,29,15,14,22,2,9,5,3,2,,,
"Oct 8, 2022 10:00 AM",63,38,25,125,62,63,116,76,40,120,70,50,0,0,0,15,17,16,1,13,13,0,12,,57,40,17,25,3,6,5,4,1,,,
"Oct 8, 2022 11:00 AM",80,44,36,150,70,80,155,91,64,109,65,44,0,0,0,23,42,40,2,15,13,2,30,,70,42,28,41,8,4,6,1,5,,,
"Oct 8, 2022 12:00 PM",65,29,36,160,78,82,200,111,89,132,71,61,0,0,0,13,34,33,1,14,12,2,25,,77,47,30,47,7,6,7,3,4,,,
"Oct 8, 2022 1:00 PM",72,37,35,122,59,63,163,69,94,117,66,51,0,0,0,23,34,30,4,18,16,2,24,,68,28,40,49,6,10,10,6,4,,,
"Oct 8, 2022 2:00 PM",62,31,31,106,56,50,132,65,67,102,56,46,0,0,0,25,35,30,5,20,12,8,20,,65,34,31,42,5,4,5,2,3,,,
"Oct 8, 2022 3:00 PM",84,42,42,127,68,59,118,61,57,113,62,51,0,0,0,27,14,12,2,17,14,3,9,,69,36,33,50,9,7,13,7,6,,,
"Oct 8, 2022 4:00 PM",83,54,29,101,45,56,101,44,57,105,37,68,0,0,0,20,28,24,4,18,17,1,24,,54,25,29,47,12,0,4,3,1,,,
"Oct 8, 2022 5:00 PM",66,26,40,89,47,42,98,39,59,99,39,60,0,0,0,21,22,21,1,20,17,3,16,,46,20,26,52,7,7,5,2,3,,,
"Oct 8, 2022 6:00 PM",63,24,39,55,26,29,76,33,43,63,26,37,0,0,0,12,10,9,1,24,19,5,7,,27,12,15,33,1,2,2,1,1,,,
"Oct 8, 2022 7:00 PM",63,23,40,24,11,13,25,13,12,25,12,13,0,0,0,12,15,13,2,18,17,1,14,,19,6,13,20,0,1,1,0,1,,,
"Oct 8, 2022 8:00 PM",40,17,23,13,6,7,21,11,10,14,7,7,0,0,0,15,17,15,2,11,11,0,10,,10,5,5,16,0,0,2,2,0,,,
"Oct 8, 2022 9:00 PM",37,16,21,6,6,0,13,6,7,7,2,5,0,0,0,3,4,4,0,4,4,0,5,,3,2,1,5,1,0,3,1,2,,,
"Oct 8, 2022 10:00 PM",20,6,14,9,4,5,8,4,4,5,2,3,0,0,0,3,2,2,0,7,6,1,1,,5,3,2,2,1,0,3,3,0,,,
"Oct 8, 2022 11:00 PM",23,7,16,7,6,1,6,0,6,4,0,4,0,0,0,2,5,3,2,5,5,0,4,,3,1,2,6,2,1,2,1,1,,,
"Oct 9, 2022 12:00 AM",12,7,5,1,1,0,7,4,3,6,1,5,0,0,0,2,3,3,0,2,2,0,4,,2,0,2,3,0,0,1,1,0,,,
"Oct 9, 2022 1:00 AM",10,2,8,2,1,1,5,2,3,3,2,1,0,0,0,3,0,0,0,4,3,1,0,,1,1,0,3,0,0,0,0,0,,,
"Oct 9, 2022 2:00 AM",10,4,6,3,3,0,6,6,0,4,4,0,0,0,0,0,0,0,0,4,4,0,0,,2,0,2,4,0,0,1,1,0,,,
"Oct 9, 2022 3:00 AM",5,0,5,0,0,0,0,0,0,2,2,0,0,0,0,0,0,0,0,4,4,0,0,,4,4,0,0,0,0,0,0,0,,,
"Oct 9, 2022 4:00 AM",6,0,6,0,0,0,0,0,0,0,0,0,0,0,0,0,0,0,0,0,0,0,0,,0,0,0,0,0,0,0,0,0,,,
"Oct 9, 2022 5:00 AM",4,3,1,1,1,0,1,1,0,1,1,0,0,0,0,0,1,0,1,0,0,0,0,,1,1,0,2,1,0,0,0,0,,,
"Oct 9, 2022 6:00 AM",7,3,4,4,3,1,6,5,1,5,4,1,0,0,0,1,2,2,0,2,2,0,2,,0,0,0,6,0,0,1,0,1,,,
"Oct 9, 2022 7:00 AM",14,4,10,11,8,3,10,6,4,15,11,4,0,0,0,3,6,6,0,2,2,0,6,,5,4,1,21,0,0,1,1,0,,,
"Oct 9, 2022 8:00 AM",20,13,7,33,18,15,28,16,12,38,22,16,0,0,0,5,13,13,0,3,3,0,10,,20,16,4,25,1,7,1,0,1,,,
"Oct 9, 2022 9:00 AM",37,18,19,80,38,42,74,45,29,72,48,24,0,0,0,15,15,14,1,7,6,1,12,,20,14,6,39,2,11,2,2,0,,,
"Oct 9, 2022 10:00 AM",40,23,17,72,33,39,77,44,33,67,36,31,0,0,0,12,16,15,1,13,12,1,12,,30,14,16,20,2,1,4,2,2,,,
"Oct 9, 2022 11:00 AM",48,19,29,72,33,39,79,40,39,71,36,35,0,0,0,9,20,18,2,8,6,2,12,,39,24,15,29,6,4,8,6,2,,,
"Oct 9, 2022 12:00 PM",56,30,26,49,18,31,57,20,37,43,18,25,0,0,0,9,12,12,0,11,10,1,7,,17,8,9,30,5,2,12,8,4,,,
"Oct 9, 2022 1:00 PM",33,14,19,15,6,9,25,12,13,16,7,9,0,0,0,7,19,17,2,11,10,1,12,,10,3,7,12,3,0,1,1,0,,,
"Oct 9, 2022 2:00 PM",29,16,13,20,13,7,18,10,8,16,9,7,0,0,0,4,13,12,1,7,5,2,9,,8,6,2,15,5,2,4,3,1,,,
"Oct 9, 2022 3:00 PM",29,14,15,15,9,6,20,9,11,17,10,7,0,0,0,3,9,9,0,5,4,1,8,,8,5,3,10,1,0,4,3,1,,,
"Oct 9, 2022 4:00 PM",21,7,14,13,8,5,18,8,10,17,11,6,0,0,0,5,8,6,2,10,10,0,6,,15,9,6,6,1,2,3,2,1,,,
"Oct 9, 2022 5:00 PM",40,15,25,12,10,2,21,12,9,19,10,9,0,0,0,10,9,7,2,5,4,1,5,,12,6,6,10,1,0,6,3,3,,,
"Oct 9, 2022 6:00 PM",47,23,24,20,10,10,25,10,15,14,8,6,0,0,0,5,10,7,3,11,10,1,5,,9,4,5,12,2,2,9,6,3,,,
"Oct 9, 2022 7:00 PM",32,12,20,6,2,4,13,5,8,13,4,9,0,0,0,6,2,2,0,3,2,1,0,,4,4,0,9,1,1,2,1,1,,,
"Oct 9, 2022 8:00 PM",26,14,12,1,1,0,4,1,3,4,0,4,0,0,0,4,4,3,1,6,6,0,5,,0,0,0,9,1,0,4,3,1,,,
"Oct 9, 2022 9:00 PM",15,5,10,4,1,3,5,1,4,6,0,6,0,0,0,3,4,4,0,6,6,0,4,,0,0,0,8,3,0,0,0,0,,,
"Oct 9, 2022 10:00 PM",17,9,8,1,0,1,5,0,5,4,0,4,0,0,0,0,2,2,0,4,3,1,2,,1,0,1,4,0,0,1,1,0,,,
"Oct 9, 2022 11:00 PM",6,1,5,2,0,2,5,1,4,4,1,3,0,0,0,0,2,2,0,2,2,0,2,,2,1,1,3,0,1,0,0,0,,,
"Oct 10, 2022 12:00 AM",5,1,4,1,1,0,3,2,1,2,1,1,0,0,0,1,0,0,0,1,1,0,0,,2,2,0,1,0,1,1,1,0,,,
"Oct 10, 2022 1:00 AM",2,0,2,2,1,1,1,1,0,1,1,0,0,0,0,0,1,1,0,1,1,0,1,,0,0,0,0,0,0,0,0,0,,,
"Oct 10, 2022 2:00 AM",2,2,0,0,0,0,2,2,0,2,1,1,0,0,0,0,0,0,0,0,0,0,0,,2,2,0,0,0,0,0,0,0,,,
"Oct 10, 2022 3:00 AM",0,0,0,0,0,0,0,0,0,0,0,0,0,0,0,0,0,0,0,1,1,0,0,,0,0,0,1,0,0,0,0,0,,,
"Oct 10, 2022 4:00 AM",1,0,1,0,0,0,1,1,0,1,1,0,0,0,0,1,1,1,0,0,0,0,1,,0,0,0,1,0,0,0,0,0,,,
"Oct 10, 2022 5:00 AM",7,5,2,3,1,2,2,0,2,3,0,3,0,0,0,2,10,10,0,1,0,1,10,,1,0,1,8,1,0,0,0,0,,,
"Oct 10, 2022 6:00 AM",55,32,23,11,5,6,16,4,12,17,8,9,0,0,0,5,20,20,0,9,7,2,18,,5,2,3,41,1,0,0,0,0,,,
"Oct 10, 2022 7:00 AM",138,93,45,49,10,39,72,23,49,63,23,40,0,0,0,14,84,84,0,30,26,4,80,,24,9,15,129,4,4,6,5,1,,,
"Oct 10, 2022 8:00 AM",328,262,66,111,30,81,160,52,108,138,49,89,0,0,0,35,222,220,2,61,46,15,180,,84,19,65,249,5,7,24,21,3,,,
"Oct 10, 2022 9:00 AM",148,126,22,63,22,41,83,40,43,84,47,37,0,0,0,14,107,106,1,19,9,10,70,,51,17,34,72,3,6,3,2,1,,,
"Oct 10, 2022 10:00 AM",101,77,24,34,13,21,38,15,23,31,19,12,0,0,0,12,53,49,4,15,13,2,29,,13,7,6,41,0,4,2,1,1,,,
"Oct 10, 2022 11:00 AM",59,42,17,47,23,24,58,29,29,42,23,19,0,0,0,10,35,32,3,10,8,2,17,,16,10,6,24,5,3,1,1,0,,,
"Oct 10, 2022 12:00 PM",82,45,37,47,27,20,53,33,20,50,29,21,0,0,0,14,31,23,8,21,17,4,19,,30,21,9,24,4,1,2,2,0,,,
"Oct 10, 2022 1:00 PM",89,41,48,64,30,34,84,38,46,54,25,29,0,0,0,13,31,25,6,22,17,5,12,,39,16,23,28,3,3,2,1,1,,,
"Oct 10, 2022 2:00 PM",91,30,61,39,21,18,74,43,31,44,26,18,0,0,0,25,31,26,5,32,29,3,18,,38,24,14,21,1,5,5,2,3,,,
"Oct 10, 2022 3:00 PM",96,40,56,43,23,20,60,30,30,41,28,13,0,0,0,18,51,38,13,34,27,7,27,,35,22,13,32,5,1,10,9,1,,,
"Oct 10, 2022 4:00 PM",159,48,111,58,37,21,83,51,32,75,46,29,0,0,0,22,44,27,17,63,59,4,26,,49,36,13,41,8,3,8,3,5,,,
"Oct 10, 2022 5:00 PM",267,57,210,88,65,23,115,77,38,112,78,34,0,0,0,35,63,47,16,109,101,8,39,,78,49,29,61,6,10,9,5,4,,,
"Oct 10, 2022 6:00 PM",204,42,162,73,53,20,122,83,39,86,55,31,0,0,0,23,54,36,18,125,122,3,36,,60,47,13,55,5,3,17,10,7,,,
"Oct 10, 2022 7:00 PM",126,36,90,41,21,20,60,42,18,36,21,15,0,0,0,12,26,20,6,48,46,2,17,,31,23,8,25,7,5,17,9,8,,,
"Oct 10, 2022 8:00 PM",83,17,66,24,18,6,34,17,17,30,16,14,0,0,0,6,19,10,9,23,19,4,9,,9,6,3,23,5,1,5,3,2,,,
"Oct 10, 2022 9:00 PM",71,17,54,18,11,7,19,9,10,22,8,14,0,0,0,11,18,10,8,21,20,1,7,,7,5,2,13,4,0,6,3,3,,,
"Oct 10, 2022 10:00 PM",39,10,29,10,5,5,6,2,4,9,4,5,0,0,0,4,6,2,4,20,16,4,2,,5,2,3,9,3,1,1,1,0,,,
"Oct 10, 2022 11:00 PM",14,4,10,0,0,0,2,2,0,2,2,0,0,0,0,0,3,3,0,6,6,0,2,,1,1,0,3,0,0,0,0,0,,,
"Oct 11, 2022 12:00 AM",2,0,2,0,0,0,2,2,0,2,2,0,0,0,0,0,3,3,0,3,3,0,4,,1,0,1,1,1,0,0,0,0,,,
"Oct 11, 2022 1:00 AM",2,1,1,0,0,0,0,0,0,0,0,0,0,0,0,0,2,0,2,1,1,0,0,,1,1,0,0,1,0,0,0,0,,,
"Oct 11, 2022 2:00 AM",4,3,1,0,0,0,0,0,0,0,0,0,0,0,0,2,1,1,0,0,0,0,1,,0,0,0,0,0,0,0,0,0,,,
"Oct 11, 2022 3:00 AM",2,0,2,0,0,0,0,0,0,0,0,0,0,0,0,0,1,0,1,0,0,0,0,,0,0,0,0,0,0,0,0,0,,,
"Oct 11, 2022 4:00 AM",2,1,1,0,0,0,0,0,0,0,0,0,0,0,0,2,2,2,0,0,0,0,2,,1,1,0,0,0,0,1,1,0,,,
"Oct 11, 2022 5:00 AM",7,4,3,1,0,1,1,1,0,1,1,0,0,0,0,2,8,8,0,1,0,1,6,,1,1,0,12,1,1,0,0,0,,,
"Oct 11, 2022 6:00 AM",63,37,26,14,5,9,15,5,10,12,4,8,0,0,0,8,28,27,1,5,5,0,28,,5,3,2,42,0,3,0,0,0,,,
"Oct 11, 2022 7:00 AM",142,101,41,43,12,31,88,22,66,65,23,42,0,0,0,19,93,91,2,32,27,5,83,,36,17,19,158,3,7,5,5,0,,,
"Oct 11, 2022 8:00 AM",422,327,95,123,28,95,179,57,122,142,47,95,0,0,0,41,255,254,1,50,32,18,212,,107,29,78,260,10,6,23,21,2,,,
"Oct 11, 2022 9:00 AM",180,146,34,69,21,48,85,40,45,76,42,34,0,0,0,23,128,127,1,21,14,7,82,,42,12,30,91,1,3,4,3,1,,,
"Oct 11, 2022 10:00 AM",80,66,14,54,21,33,58,27,31,41,23,18,0,0,0,10,54,53,1,5,4,1,33,,24,11,13,36,2,5,3,3,0,,,
"Oct 11, 2022 11:00 AM",67,48,19,45,25,20,58,35,23,39,23,16,0,0,0,11,56,53,3,12,10,2,27,,22,12,10,34,3,1,6,5,1,,,
"Oct 11, 2022 12:00 PM",98,54,44,39,16,23,57,30,27,36,19,17,0,0,0,11,36,32,4,22,22,0,18,,21,9,12,31,0,0,2,1,1,,,
"Oct 11, 2022 1:00 PM",92,48,44,59,33,26,77,42,35,51,26,25,0,0,0,15,43,32,11,26,26,0,23,,24,17,7,29,4,4,4,3,1,,,
"Oct 11, 2022 2:00 PM",80,33,47,40,24,16,46,21,25,39,22,17,0,0,0,7,29,26,3,20,17,3,14,,19,12,7,31,5,7,8,3,5,,,
"Oct 11, 2022 3:00 PM",124,47,77,38,23,15,79,42,37,51,31,20,0,0,0,17,40,29,11,40,35,5,21,,36,25,11,41,7,3,8,2,6,,,
"Oct 11, 2022 4:00 PM",193,64,129,57,39,18,81,50,31,66,41,25,0,0,0,24,40,30,10,68,61,7,25,,56,41,15,57,3,3,4,3,1,,,
"Oct 11, 2022 5:00 PM",299,66,233,82,53,29,132,87,45,95,55,40,0,0,0,47,63,43,20,130,126,4,38,,91,63,28,66,14,6,16,13,3,,,
"Oct 11, 2022 6:00 PM",261,55,206,90,73,17,143,100,43,114,76,38,0,0,0,29,50,38,12,117,114,3,36,,86,70,16,59,10,4,18,13,5,,,
"Oct 11, 2022 7:00 PM",146,38,108,54,31,23,70,42,28,65,38,27,0,0,0,12,32,22,10,64,57,7,24,,39,28,11,27,1,1,9,4,5,,,
"Oct 11, 2022 8:00 PM",92,25,67,22,15,7,46,34,12,42,33,9,0,0,0,9,23,15,8,46,41,5,13,,33,24,9,30,4,1,5,2,3,,,
"Oct 11, 2022 9:00 PM",65,15,50,13,10,3,21,12,9,17,8,9,0,0,0,7,10,7,3,22,20,2,6,,9,6,3,7,3,1,3,0,3,,,
"Oct 11, 2022 10:00 PM",42,10,32,6,5,1,22,10,12,22,5,17,0,0,0,2,11,6,5,16,14,2,5,,1,1,0,21,0,2,1,1,0,,,
"Oct 11, 2022 11:00 PM",17,2,15,2,2,0,4,4,0,3,3,0,0,0,0,6,3,1,2,4,3,1,1,,0,0,0,3,0,2,0,0,0,,,
"Oct 12, 2022 12:00 AM",9,2,7,0,0,0,3,2,1,0,0,0,0,0,0,0,1,0,1,4,4,0,0,,2,2,0,2,1,1,1,1,0,,,
"Oct 12, 2022 1:00 AM",3,0,3,0,0,0,0,0,0,1,0,1,0,0,0,0,1,0,1,0,0,0,2,,0,0,0,1,0,0,0,0,0,,,
"Oct 12, 2022 2:00 AM",7,4,3,0,0,0,0,0,0,0,0,0,0,0,0,0,2,1,1,0,0,0,1,,0,0,0,0,0,0,1,1,0,,,
"Oct 12, 2022 3:00 AM",2,0,2,0,0,0,1,1,0,1,1,0,0,0,0,0,1,0,1,0,0,0,1,,1,1,0,0,0,0,0,0,0,,,
"Oct 12, 2022 4:00 AM",1,0,1,3,1,2,0,0,0,1,0,1,0,0,0,1,2,2,0,0,0,0,2,,0,0,0,1,0,0,0,0,0,,,
"Oct 12, 2022 5:00 AM",12,8,4,4,1,3,3,2,1,4,2,2,0,0,0,2,6,6,0,4,3,1,5,,2,1,1,9,1,1,0,0,0,,,
"Oct 12, 2022 6:00 AM",50,33,17,7,2,5,16,4,12,11,3,8,0,0,0,10,19,19,0,6,4,2,18,,8,6,2,46,0,0,0,0,0,,,
"Oct 12, 2022 7:00 AM",135,82,53,58,20,38,70,17,53,63,25,38,0,0,0,13,94,94,0,26,22,4,89,,30,22,8,130,3,4,7,6,1,,,
"Oct 12, 2022 8:00 AM",349,264,85,101,28,73,150,56,94,112,40,72,0,0,0,40,225,219,6,55,43,12,178,,95,50,45,242,7,3,24,18,6,,,
"Oct 12, 2022 9:00 AM",174,144,30,88,26,62,78,32,46,65,31,34,0,0,0,16,123,121,2,30,21,9,77,,45,32,13,81,4,5,7,3,4,,,
"Oct 12, 2022 10:00 AM",94,77,17,67,36,31,49,31,18,33,23,10,0,0,0,10,45,43,2,18,14,4,23,,23,14,9,33,6,3,2,1,1,,,
"Oct 12, 2022 11:00 AM",63,46,17,52,19,33,51,28,23,43,19,24,0,0,0,5,35,32,3,9,7,2,22,,14,4,10,18,4,4,6,3,3,,,
"Oct 12, 2022 12:00 PM",80,42,38,39,12,27,61,34,27,32,17,15,0,0,0,10,37,32,5,15,13,2,11,,22,11,11,33,7,1,5,5,0,,,
"Oct 12, 2022 1:00 PM",111,56,55,81,51,30,80,41,39,57,30,27,0,0,0,13,50,41,9,42,36,6,21,,31,20,11,31,2,3,4,0,4,,,
"Oct 12, 2022 2:00 PM",82,36,46,57,32,25,49,27,22,37,23,14,0,0,0,15,31,28,3,29,24,5,21,,20,14,6,35,6,2,8,4,4,,,
"Oct 12, 2022 3:00 PM",100,36,64,39,18,21,46,29,17,39,19,20,0,0,0,16,32,24,8,39,34,5,16,,31,24,7,30,8,3,22,15,7,,,
"Oct 12, 2022 4:00 PM",190,58,132,56,35,21,77,45,32,58,37,21,0,0,0,26,45,28,17,50,49,1,23,,31,25,6,47,3,3,11,8,3,,,
"Oct 12, 2022 5:00 PM",280,77,203,78,49,29,127,71,56,87,41,46,0,0,0,38,63,42,21,119,113,6,32,,69,52,17,59,7,2,7,5,2,,,
"Oct 12, 2022 6:00 PM",226,56,170,78,64,14,107,84,23,81,62,19,0,0,0,18,56,38,18,121,121,0,31,,73,63,10,53,4,3,10,6,4,,,
"Oct 12, 2022 7:00 PM",128,39,89,38,25,13,61,37,24,37,17,20,0,0,0,15,36,25,11,49,47,2,18,,37,26,11,27,2,6,7,4,3,,,
"Oct 12, 2022 8:00 PM",105,30,75,24,16,8,29,19,10,23,17,6,0,0,0,10,21,11,10,28,27,1,12,,15,12,3,23,6,6,3,3,0,,,
"Oct 12, 2022 9:00 PM",59,11,48,6,6,0,12,8,4,13,4,9,0,0,0,9,15,9,6,22,21,1,7,,13,8,5,11,8,4,2,1,1,,,
"Oct 12, 2022 10:00 PM",56,9,47,9,5,4,12,7,5,12,6,6,0,0,0,5,11,5,6,21,20,1,3,,4,3,1,7,2,1,1,0,1,,,
"Oct 12, 2022 11:00 PM",18,3,15,8,2,6,5,2,3,3,0,3,0,0,0,4,1,1,0,7,6,1,1,,4,4,0,6,1,0,0,0,0,,,
"Oct 13, 2022 12:00 AM",7,0,7,0,0,0,6,5,1,4,4,0,0,0,0,0,3,1,2,3,2,1,1,,0,0,0,4,0,0,0,0,0,,,
"Oct 13, 2022 1:00 AM",6,4,2,2,2,0,1,1,0,2,2,0,0,0,0,0,2,0,2,2,2,0,0,,0,0,0,0,0,0,0,0,0,,,
"Oct 13, 2022 2:00 AM",6,3,3,0,0,0,0,0,0,0,0,0,0,0,0,2,0,0,0,0,0,0,0,,0,0,0,0,0,0,0,0,0,,,
"Oct 13, 2022 3:00 AM",1,0,1,0,0,0,0,0,0,0,0,0,0,0,0,0,0,0,0,0,0,0,0,,0,0,0,0,0,0,0,0,0,,,
"Oct 13, 2022 4:00 AM",0,0,0,0,0,0,1,1,0,1,1,0,0,0,0,0,5,4,1,0,0,0,4,,1,1,0,1,0,0,0,0,0,,,
"Oct 13, 2022 5:00 AM",5,5,0,4,2,2,2,2,0,2,1,1,0,0,0,3,5,5,0,3,2,1,5,,0,0,0,9,1,1,0,0,0,,,
"Oct 13, 2022 6:00 AM",45,31,14,7,2,5,10,4,6,7,3,4,0,0,0,8,25,24,1,6,3,3,28,,4,0,4,31,3,3,0,0,0,,,
"Oct 13, 2022 7:00 AM",146,98,48,49,13,36,71,17,54,61,19,42,0,0,0,14,72,70,2,25,20,5,65,,26,7,19,122,3,2,5,5,0,,,
"Oct 13, 2022 8:00 AM",342,261,81,117,32,85,152,53,99,127,47,80,0,0,0,25,216,214,2,52,40,12,181,,86,24,62,238,5,9,15,12,3,,,
"Oct 13, 2022 9:00 AM",185,153,32,53,17,36,60,25,35,69,35,34,0,0,0,18,94,92,2,32,20,12,66,,46,25,21,79,5,2,4,4,0,,,
"Oct 13, 2022 10:00 AM",102,83,19,53,27,26,63,34,29,54,36,18,0,0,0,9,61,58,3,15,12,3,34,,31,24,7,32,2,3,5,2,3,,,
"Oct 13, 2022 11:00 AM",85,50,35,47,21,26,57,26,31,47,23,24,0,0,0,11,55,51,4,16,14,2,27,,21,12,9,42,6,4,9,7,2,,,
"Oct 13, 2022 12:00 PM",72,35,37,72,37,35,70,42,28,54,32,22,0,0,0,13,37,34,3,15,11,4,26,,24,17,7,26,3,5,9,8,1,,,
"Oct 13, 2022 1:00 PM",103,51,52,76,39,37,87,45,42,64,37,27,0,0,0,15,30,26,4,21,19,2,20,,43,18,25,29,6,5,4,2,2,,,
"Oct 13, 2022 2:00 PM",81,37,44,54,32,22,57,27,30,41,20,21,0,0,0,16,33,30,3,17,15,2,17,,34,21,13,22,5,3,6,5,1,,,
"Oct 13, 2022 3:00 PM",114,41,73,53,34,19,65,42,23,44,27,17,0,0,0,23,33,20,13,31,28,3,16,,32,22,10,39,4,1,8,5,3,,,
"Oct 13, 2022 4:00 PM",176,56,120,75,50,25,95,65,30,80,58,22,0,0,0,26,40,26,14,51,47,4,25,,55,39,16,59,9,6,9,6,3,,,
"Oct 13, 2022 5:00 PM",271,72,199,95,55,40,132,82,50,113,65,48,0,0,0,26,58,39,19,107,103,4,37,,86,58,28,68,9,5,13,6,7,,,
"Oct 13, 2022 6:00 PM",241,67,174,72,52,20,120,81,39,96,65,31,0,0,0,40,50,38,12,114,109,5,32,,82,59,23,49,2,10,10,7,3,,,
"Oct 13, 2022 7:00 PM",150,37,113,44,23,21,52,30,22,42,25,17,0,0,0,12,23,15,8,64,60,4,13,,24,18,6,27,3,3,12,7,5,,,
"Oct 13, 2022 8:00 PM",110,32,78,16,11,5,21,16,5,19,9,10,0,0,0,7,25,16,9,38,35,3,16,,7,6,1,16,8,3,4,2,2,,,
"Oct 13, 2022 9:00 PM",57,16,41,18,16,2,24,16,8,24,14,10,0,0,0,1,17,14,3,19,17,2,12,,8,8,0,21,3,2,10,6,4,,,
"Oct 13, 2022 10:00 PM",56,14,42,4,4,0,10,7,3,4,3,1,0,0,0,4,9,6,3,12,11,1,6,,6,5,1,10,1,1,4,3,1,,,
"Oct 13, 2022 11:00 PM",23,5,18,2,0,2,5,1,4,4,1,3,0,0,0,7,4,2,2,12,10,2,2,,1,0,1,3,0,1,1,0,1,,,
"Oct 14, 2022 12:00 AM",15,1,14,0,0,0,7,5,2,3,1,2,0,0,0,0,1,1,0,5,5,0,1,,0,0,0,4,0,0,1,0,1,,,
"Oct 14, 2022 1:00 AM",9,1,8,0,0,0,0,0,0,0,0,0,0,0,0,0,2,1,1,0,0,0,1,,0,0,0,1,0,0,0,0,0,,,
"Oct 14, 2022 2:00 AM",5,3,2,0,0,0,0,0,0,0,0,0,0,0,0,3,0,0,0,1,1,0,0,,0,0,0,0,0,0,0,0,0,,,
"Oct 14, 2022 3:00 AM",1,0,1,0,0,0,0,0,0,0,0,0,0,0,0,0,0,0,0,1,1,0,0,,0,0,0,0,0,0,0,0,0,,,
"Oct 14, 2022 4:00 AM",4,1,3,0,0,0,0,0,0,0,0,0,0,0,0,2,3,2,1,1,1,0,2,,1,1,0,1,0,0,0,0,0,,,
"Oct 14, 2022 5:00 AM",8,6,2,2,2,0,3,2,1,3,2,1,0,0,0,2,7,7,0,2,1,1,6,,1,0,1,8,1,0,1,1,0,,,
"Oct 14, 2022 6:00 AM",43,24,19,13,6,7,16,7,9,12,7,5,0,0,0,5,16,16,0,6,4,2,15,,5,3,2,27,1,1,0,0,0,,,
"Oct 14, 2022 7:00 AM",130,86,44,57,22,35,47,15,32,35,18,17,0,0,0,12,56,55,1,18,14,4,54,,30,13,17,69,1,3,4,2,2,,,
"Oct 14, 2022 8:00 AM",278,215,63,104,31,73,158,52,106,107,40,67,0,0,0,28,134,131,3,47,38,9,101,,71,23,48,172,11,7,18,13,5,,,
"Oct 14, 2022 9:00 AM",141,110,31,59,22,37,72,23,49,71,35,36,0,0,0,13,68,67,1,22,17,5,51,,42,17,25,73,2,4,7,5,2,,,
"Oct 14, 2022 10:00 AM",101,65,36,38,19,19,54,35,19,54,29,25,0,0,0,6,54,52,2,14,13,1,35,,27,14,13,34,3,6,3,1,2,,,
"Oct 14, 2022 11:00 AM",60,39,21,42,21,21,44,24,20,42,23,19,0,0,0,7,40,36,4,8,7,1,23,,25,13,12,26,3,1,4,1,3,,,
"Oct 14, 2022 12:00 PM",92,54,38,53,30,23,70,41,29,49,26,23,0,0,0,12,33,29,4,23,20,3,16,,20,14,6,17,5,1,7,4,3,,,
"Oct 14, 2022 1:00 PM",117,45,72,50,24,26,65,36,29,49,24,25,0,0,0,8,36,30,6,27,24,3,23,,27,18,9,29,4,4,5,3,2,,,
"Oct 14, 2022 2:00 PM",111,48,63,49,27,22,51,27,24,42,21,21,0,0,0,14,20,16,4,24,21,3,12,,41,20,21,28,4,0,2,1,1,,,
"Oct 14, 2022 3:00 PM",112,45,67,61,32,29,64,41,23,46,29,17,0,0,0,30,31,25,6,22,19,3,21,,49,31,18,37,5,7,6,3,3,,,
"Oct 14, 2022 4:00 PM",150,49,101,61,36,25,96,60,36,68,45,23,0,0,0,31,34,29,5,54,50,4,26,,57,29,28,48,4,4,4,4,0,,,
"Oct 14, 2022 5:00 PM",188,51,137,75,50,25,109,56,53,73,40,33,0,0,0,25,37,28,9,60,56,4,21,,56,40,16,58,7,4,8,4,4,,,
"Oct 14, 2022 6:00 PM",143,41,102,57,34,23,86,51,35,62,35,27,0,0,0,19,38,30,8,69,67,2,31,,50,31,19,45,3,4,7,2,5,,,
"Oct 14, 2022 7:00 PM",112,31,81,40,23,17,47,31,16,38,19,19,0,0,0,21,31,24,7,31,29,2,24,,26,17,9,22,9,0,7,4,3,,,
"Oct 14, 2022 8:00 PM",68,24,44,29,22,7,19,14,5,13,11,2,0,0,0,11,11,7,4,23,23,0,7,,11,9,2,14,2,1,10,5,5,,,
"Oct 14, 2022 9:00 PM",45,19,26,16,9,7,13,7,6,16,7,9,0,0,0,5,14,11,3,10,9,1,10,,13,10,3,17,1,0,4,3,1,,,
"Oct 14, 2022 10:00 PM",39,9,30,7,5,2,11,5,6,10,5,5,0,0,0,7,7,5,2,11,10,1,7,,7,4,3,9,1,1,2,2,0,,,
"Oct 14, 2022 11:00 PM",25,9,16,10,5,5,15,7,8,12,4,8,0,0,0,3,1,1,0,8,6,2,2,,6,3,3,3,0,1,1,0,1,,,
"Oct 15, 2022 12:00 AM",16,5,11,0,0,0,6,3,3,4,2,2,0,0,0,3,4,2,2,8,8,0,2,,2,0,2,3,1,0,1,1,0,,,
"Oct 15, 2022 1:00 AM",14,2,12,1,1,0,2,1,1,0,0,0,0,0,0,5,3,2,1,4,4,0,2,,1,1,0,1,0,1,0,0,0,,,
"Oct 15, 2022 2:00 AM",6,1,5,3,3,0,0,0,0,0,0,0,0,0,0,1,1,1,0,1,1,0,0,,1,1,0,3,0,0,0,0,0,,,
"Oct 15, 2022 3:00 AM",7,1,6,2,1,1,0,0,0,2,1,1,0,0,0,0,0,0,0,2,2,0,1,,0,0,0,1,0,0,0,0,0,,,
"Oct 15, 2022 4:00 AM",2,1,1,0,0,0,0,0,0,0,0,0,0,0,0,0,0,0,0,2,2,0,0,,0,0,0,1,0,0,0,0,0,,,
"Oct 15, 2022 5:00 AM",3,1,2,0,0,0,2,1,1,1,0,1,0,0,0,3,2,2,0,1,1,0,2,,0,0,0,0,1,0,0,0,0,,,
"Oct 15, 2022 6:00 AM",7,5,2,5,1,4,6,6,0,7,5,2,0,0,0,0,1,1,0,3,3,0,1,,1,1,0,8,1,0,0,0,0,,,
"Oct 15, 2022 7:00 AM",11,5,6,27,13,14,16,10,6,16,12,4,0,0,0,1,5,4,1,5,4,1,2,,8,5,3,18,0,0,1,1,0,,,
"Oct 15, 2022 8:00 AM",35,16,19,38,24,14,39,20,19,42,29,13,0,0,0,4,17,17,0,4,4,0,17,,13,8,5,16,3,11,2,2,0,,,
"Oct 15, 2022 9:00 AM",55,32,23,65,32,33,64,36,28,61,36,25,0,0,0,16,22,22,0,9,8,1,24,,29,18,11,27,2,2,8,7,1,,,
"Oct 15, 2022 10:00 AM",53,31,22,74,34,40,54,31,23,70,46,24,0,0,0,13,14,13,1,16,13,3,8,,24,14,10,28,3,3,4,2,2,,,
"Oct 15, 2022 11:00 AM",54,28,26,86,40,46,71,38,33,74,43,31,0,0,0,10,19,18,1,15,13,2,15,,31,19,12,36,3,5,5,2,3,,,
"Oct 15, 2022 12:00 PM",55,33,22,85,38,47,73,45,28,83,44,39,0,0,0,9,24,23,1,13,12,1,22,,32,22,10,33,3,10,11,7,4,,,
"Oct 15, 2022 1:00 PM",50,27,23,71,35,36,90,54,36,64,44,20,0,0,0,12,20,20,0,20,16,4,14,,34,18,16,29,4,4,8,4,4,,,
"Oct 15, 2022 2:00 PM",42,21,21,49,29,20,50,26,24,39,19,20,0,0,0,16,20,20,0,12,12,0,17,,19,9,10,20,4,0,8,6,2,,,
"Oct 15, 2022 3:00 PM",37,16,21,41,24,17,69,32,37,58,24,34,0,0,0,22,19,18,1,9,5,4,8,,25,13,12,27,2,1,7,4,3,,,
"Oct 15, 2022 4:00 PM",46,18,28,64,26,38,62,27,35,55,24,31,0,0,0,11,9,6,3,13,12,1,7,,23,12,11,29,4,1,8,5,3,,,
"Oct 15, 2022 5:00 PM",57,28,29,51,26,25,64,28,36,56,30,26,0,0,0,9,13,7,6,17,14,3,7,,30,14,16,32,2,1,3,2,1,,,
"Oct 15, 2022 6:00 PM",58,25,33,30,19,11,39,22,17,31,14,17,0,0,0,6,18,14,4,8,8,0,13,,22,5,17,21,3,1,3,0,3,,,
"Oct 15, 2022 7:00 PM",49,23,26,17,12,5,21,8,13,24,11,13,0,0,0,5,10,10,0,9,8,1,6,,8,7,1,14,1,1,3,0,3,,,
"Oct 15, 2022 8:00 PM",29,16,13,4,2,2,12,6,6,9,6,3,0,0,0,4,4,4,0,3,3,0,3,,4,4,0,8,1,0,2,1,1,,,
"Oct 15, 2022 9:00 PM",13,6,7,3,2,1,10,4,6,7,3,4,0,0,0,2,5,5,0,4,4,0,5,,3,1,2,6,1,1,2,0,2,,,
"Oct 15, 2022 10:00 PM",11,1,10,5,4,1,5,3,2,6,2,4,0,0,0,3,2,2,0,2,2,0,3,,2,2,0,6,2,1,3,3,0,,,
"Oct 15, 2022 11:00 PM",24,9,15,4,3,1,10,4,6,5,1,4,0,0,0,3,2,2,0,7,6,1,2,,3,1,2,2,0,0,0,0,0,,,
"Oct 16, 2022 12:00 AM",7,2,5,0,0,0,2,2,0,0,0,0,0,0,0,1,2,2,0,2,2,0,2,,3,1,2,5,0,0,0,0,0,,,
"Oct 16, 2022 1:00 AM",5,4,1,3,1,2,3,0,3,6,0,6,0,0,0,1,4,4,0,2,2,0,1,,2,1,1,1,0,1,0,0,0,,,
"Oct 16, 2022 2:00 AM",10,2,8,0,0,0,2,1,1,0,0,0,0,0,0,0,0,0,0,0,0,0,0,,0,0,0,2,0,0,0,0,0,,,
"Oct 16, 2022 3:00 AM",5,2,3,0,0,0,1,0,1,0,0,0,0,0,0,0,0,0,0,0,0,0,0,,1,1,0,2,0,0,0,0,0,,,
"Oct 16, 2022 4:00 AM",5,1,4,0,0,0,0,0,0,0,0,0,0,0,0,0,0,0,0,1,1,0,0,,1,1,0,1,0,0,0,0,0,,,
"Oct 16, 2022 5:00 AM",1,0,1,0,0,0,0,0,0,0,0,0,0,0,0,0,0,0,0,0,0,0,0,,1,0,1,1,0,0,0,0,0,,,
"Oct 16, 2022 6:00 AM",7,3,4,1,0,1,4,2,2,4,2,2,0,0,0,1,3,3,0,1,1,0,4,,2,2,0,9,0,0,0,0,0,,,
"Oct 16, 2022 7:00 AM",10,5,5,12,6,6,13,5,8,8,4,4,0,0,0,2,5,5,0,5,3,2,5,,4,1,3,15,0,2,3,2,1,,,
"Oct 16, 2022 8:00 AM",27,14,13,36,25,11,42,29,13,37,26,11,0,0,0,2,7,6,1,6,5,1,3,,20,12,8,21,1,7,5,3,2,,,
"Oct 16, 2022 9:00 AM",50,23,27,108,64,44,91,54,37,100,78,22,0,0,0,7,17,16,1,9,7,2,17,,33,23,10,33,5,10,7,5,2,,,
"Oct 16, 2022 10:00 AM",53,31,22,167,82,85,130,69,61,133,79,54,0,0,0,15,22,20,2,10,8,2,22,,63,31,32,30,3,10,13,8,5,,,
"Oct 16, 2022 11:00 AM",70,43,27,130,65,65,121,64,57,119,60,59,0,0,0,10,14,12,2,7,7,0,9,,43,24,19,38,11,7,11,6,5,,,
"Oct 16, 2022 12:00 PM",43,22,21,130,57,73,106,50,56,112,55,57,0,0,0,15,27,25,2,15,14,1,25,,34,21,13,32,9,4,6,4,2,,,
"Oct 16, 2022 1:00 PM",66,35,31,121,42,79,109,51,58,123,53,70,0,0,0,15,24,22,2,16,14,2,16,,44,26,18,50,7,6,7,6,1,,,
"Oct 16, 2022 2:00 PM",46,19,27,67,27,40,98,47,51,83,38,45,0,0,0,10,22,19,3,17,13,4,14,,35,15,20,32,8,2,8,2,6,,,
"Oct 16, 2022 3:00 PM",49,28,21,54,25,29,44,18,26,41,11,30,0,0,0,17,8,8,0,8,8,0,8,,23,12,11,20,1,2,4,2,2,,,
"Oct 16, 2022 4:00 PM",44,16,28,31,21,10,42,17,25,33,16,17,0,0,0,7,9,5,4,10,9,1,5,,21,6,15,24,3,1,6,3,3,,,
"Oct 16, 2022 5:00 PM",58,24,34,19,11,8,17,5,12,22,10,12,0,0,0,6,8,8,0,10,8,2,6,,6,4,2,16,3,0,3,2,1,,,
"Oct 16, 2022 6:00 PM",36,19,17,4,1,3,13,5,8,10,5,5,0,0,0,3,8,6,2,7,7,0,4,,4,1,3,10,0,1,0,0,0,,,
"Oct 16, 2022 7:00 PM",30,15,15,6,3,3,4,3,1,5,3,2,0,0,0,5,2,2,0,5,4,1,1,,1,0,1,6,0,0,2,1,1,,,
"Oct 16, 2022 8:00 PM",26,8,18,2,1,1,3,0,3,6,1,5,0,0,0,2,4,2,2,1,1,0,2,,2,1,1,4,0,1,3,2,1,,,
"Oct 16, 2022 9:00 PM",8,2,6,2,2,0,6,3,3,2,1,1,0,0,0,1,3,2,1,2,2,0,1,,3,3,0,6,1,0,1,1,0,,,
"Oct 16, 2022 10:00 PM",9,4,5,2,1,1,2,0,2,3,1,2,0,0,0,2,5,4,1,1,1,0,5,,0,0,0,3,0,0,0,0,0,,,
"Oct 16, 2022 11:00 PM",5,1,4,2,2,0,2,1,1,1,1,0,0,0,0,1,1,1,0,3,2,1,1,,0,0,0,0,0,0,0,0,0,,,
"Oct 17, 2022 12:00 AM",1,1,0,0,0,0,0,0,0,0,0,0,0,0,0,0,0,0,0,1,1,0,0,,1,1,0,1,0,0,0,0,0,,,
"Oct 17, 2022 1:00 AM",4,3,1,0,0,0,1,1,0,0,0,0,0,0,0,0,1,0,1,1,1,0,0,,0,0,0,1,0,0,0,0,0,,,
"Oct 17, 2022 2:00 AM",1,1,0,0,0,0,0,0,0,0,0,0,0,0,0,0,0,0,0,1,1,0,0,,0,0,0,0,0,1,0,0,0,,,
"Oct 17, 2022 3:00 AM",1,0,1,0,0,0,0,0,0,0,0,0,0,0,0,0,0,0,0,0,0,0,0,,0,0,0,0,0,0,0,0,0,,,
"Oct 17, 2022 4:00 AM",1,0,1,0,0,0,1,0,1,3,0,3,0,0,0,1,2,2,0,0,0,0,2,,0,0,0,0,0,0,0,0,0,,,
"Oct 17, 2022 5:00 AM",7,3,4,2,1,1,2,2,0,2,2,0,0,0,0,1,6,6,0,2,2,0,5,,0,0,0,9,0,0,0,0,0,,,
"Oct 17, 2022 6:00 AM",35,21,14,2,0,2,7,1,6,6,2,4,0,0,0,3,15,15,0,5,3,2,14,,1,0,1,21,0,1,1,1,0,,,
"Oct 17, 2022 7:00 AM",112,82,30,27,10,17,39,11,28,23,9,14,0,0,0,7,63,62,1,16,14,2,51,,20,7,13,78,0,2,3,3,0,,,
"Oct 17, 2022 8:00 AM",242,190,52,55,10,45,100,34,66,80,34,46,0,0,0,30,156,152,4,35,23,12,115,,50,12,38,152,7,3,12,10,2,,,
"Oct 17, 2022 9:00 AM",133,114,19,25,11,14,43,17,26,37,23,14,0,0,0,11,71,70,1,21,11,10,44,,31,10,21,47,1,3,2,2,0,,,
"Oct 17, 2022 10:00 AM",74,60,14,17,4,13,14,6,8,15,8,7,0,0,0,7,39,36,3,9,6,3,16,,6,3,3,16,2,0,1,0,1,,,
"Oct 17, 2022 11:00 AM",42,31,11,16,9,7,15,10,5,17,11,6,0,0,0,7,29,26,3,6,3,3,17,,6,4,2,14,1,2,3,2,1,,,
"Oct 17, 2022 12:00 PM",49,23,26,16,9,7,15,9,6,13,4,9,0,0,0,2,23,20,3,13,10,3,12,,14,12,2,16,2,1,0,0,0,,,
"Oct 17, 2022 1:00 PM",73,34,39,33,17,16,17,9,8,28,15,13,0,0,0,12,34,27,7,26,22,4,16,,11,11,0,23,2,1,2,1,1,,,
"Oct 17, 2022 2:00 PM",65,28,37,21,10,11,29,22,7,20,13,7,0,0,0,6,28,24,4,12,9,3,16,,17,8,9,15,1,2,4,3,1,,,
"Oct 17, 2022 3:00 PM",82,34,48,19,11,8,45,25,20,30,16,14,0,0,0,19,23,17,6,23,17,6,11,,17,13,4,28,1,1,5,1,4,,,
"Oct 17, 2022 4:00 PM",140,47,93,47,30,17,73,40,33,53,28,25,0,0,0,21,29,19,10,50,47,3,18,,34,23,11,39,1,5,8,3,5,,,
"Oct 17, 2022 5:00 PM",226,50,176,59,31,28,110,69,41,63,32,31,0,0,0,21,43,26,17,82,78,4,23,,69,51,18,47,3,5,6,3,3,,,
"Oct 17, 2022 6:00 PM",213,57,156,61,42,19,120,83,37,77,50,27,0,0,0,26,48,40,8,80,78,2,31,,66,37,29,36,3,6,12,8,4,,,
"Oct 17, 2022 7:00 PM",99,26,73,36,26,10,53,31,22,38,26,12,0,0,0,20,26,14,12,30,29,1,10,,26,16,10,17,6,3,11,4,7,,,
"Oct 17, 2022 8:00 PM",74,15,59,24,19,5,22,11,11,20,12,8,0,0,0,6,19,12,7,23,19,4,9,,17,11,6,13,0,4,5,2,3,,,
"Oct 17, 2022 9:00 PM",69,19,50,12,8,4,13,7,6,10,3,7,0,0,0,6,8,4,4,19,17,2,5,,10,7,3,13,3,0,3,3,0,,,
"Oct 17, 2022 10:00 PM",31,7,24,7,4,3,9,4,5,6,3,3,0,0,0,4,10,4,6,16,15,1,5,,4,3,1,5,3,1,2,1,1,,,
"Oct 17, 2022 11:00 PM",19,9,10,0,0,0,5,3,2,4,3,1,0,0,0,2,2,1,1,6,6,0,3,,2,1,1,4,1,0,0,0,0,,,
"Oct 18, 2022 12:00 AM",1,0,1,0,0,0,0,0,0,0,0,0,0,0,0,0,2,1,1,1,1,0,1,,0,0,0,0,0,0,0,0,0,,,
"Oct 18, 2022 1:00 AM",3,0,3,1,0,1,1,1,0,1,1,0,0,0,0,1,1,1,0,0,0,0,1,,1,1,0,0,0,0,0,0,0,,,
"Oct 18, 2022 2:00 AM",6,3,3,0,0,0,1,1,0,0,0,0,0,0,0,0,0,0,0,0,0,0,0,,1,0,1,1,0,0,0,0,0,,,
"Oct 18, 2022 3:00 AM",2,0,2,0,0,0,0,0,0,0,0,0,0,0,0,0,2,0,2,0,0,0,0,,0,0,0,0,0,0,0,0,0,,,
"Oct 18, 2022 4:00 AM",2,1,1,1,0,1,2,1,1,1,1,0,0,0,0,2,1,1,0,0,0,0,1,,0,0,0,0,0,0,0,0,0,,,
"Oct 18, 2022 5:00 AM",6,3,3,4,1,3,6,1,5,3,1,2,0,0,0,0,10,10,0,2,1,1,9,,5,2,3,7,0,0,0,0,0,,,
"Oct 18, 2022 6:00 AM",60,42,18,11,4,7,23,7,16,16,4,12,0,0,0,7,30,30,0,6,4,2,28,,7,2,5,40,1,3,2,2,0,,,
"Oct 18, 2022 7:00 AM",180,126,54,45,10,35,83,26,57,48,15,33,0,0,0,14,90,89,1,24,19,5,86,,36,15,21,133,3,3,7,7,0,,,
"Oct 18, 2022 8:00 AM",383,292,91,112,20,92,222,74,148,133,45,88,0,0,0,51,249,247,2,52,35,17,210,,100,30,70,277,10,10,14,11,3,,,
"Oct 18, 2022 9:00 AM",187,150,37,74,21,53,97,36,61,88,47,41,0,0,0,43,116,114,2,27,17,10,70,,56,21,35,90,4,11,6,5,1,,,
"Oct 18, 2022 10:00 AM",82,62,20,62,30,32,61,36,25,62,32,30,0,0,0,11,71,66,5,14,8,6,32,,31,14,17,31,0,3,6,4,2,,,
"Oct 18, 2022 11:00 AM",65,36,29,45,23,22,71,33,38,48,26,22,0,0,0,12,32,32,0,5,3,2,19,,36,16,20,34,3,6,8,7,1,,,
"Oct 18, 2022 12:00 PM",61,29,32,38,20,18,54,33,21,36,19,17,0,0,0,16,38,36,2,19,18,1,20,,28,13,15,29,3,4,1,1,0,,,
"Oct 18, 2022 1:00 PM",95,43,52,60,29,31,69,35,34,48,29,19,0,0,0,17,45,41,4,22,18,4,29,,30,17,13,25,3,10,1,0,1,,,
"Oct 18, 2022 2:00 PM",87,34,53,48,24,24,52,33,19,42,27,15,0,0,0,27,22,14,8,25,18,7,14,,34,19,15,35,2,3,2,1,1,,,
"Oct 18, 2022 3:00 PM",121,46,75,45,27,18,78,45,33,47,27,20,0,0,0,17,40,32,8,45,40,5,20,,35,22,13,24,8,10,10,3,7,,,
"Oct 18, 2022 4:00 PM",193,60,133,71,42,29,102,62,40,92,56,36,0,0,0,26,44,29,15,71,67,4,27,,57,39,18,48,6,3,5,2,3,,,
"Oct 18, 2022 5:00 PM",303,80,223,80,52,28,152,87,65,99,52,47,0,0,0,34,69,54,15,132,128,4,42,,71,54,17,104,7,3,14,10,4,,,
"Oct 18, 2022 6:00 PM",256,68,188,85,71,14,156,107,49,95,62,33,0,0,0,26,58,40,18,137,130,7,34,,84,56,28,57,10,3,13,10,3,,,
"Oct 18, 2022 7:00 PM",174,48,126,45,30,15,66,48,18,48,32,16,0,0,0,16,45,32,13,58,56,2,31,,33,27,6,24,2,2,6,5,1,,,
"Oct 18, 2022 8:00 PM",102,34,68,21,16,5,40,23,17,38,23,15,0,0,0,10,19,12,7,33,33,0,9,,13,8,5,20,7,0,5,2,3,,,
"Oct 18, 2022 9:00 PM",45,12,33,17,10,7,26,13,13,21,12,9,0,0,0,9,5,1,4,29,28,1,2,,11,7,4,11,3,1,3,3,0,,,
"Oct 18, 2022 10:00 PM",56,8,48,5,4,1,7,5,2,5,4,1,0,0,0,3,9,4,5,19,17,2,4,,6,6,0,5,1,2,1,0,1,,,
"Oct 18, 2022 11:00 PM",12,2,10,1,1,0,6,4,2,4,4,0,0,0,0,4,3,2,1,5,4,1,0,,4,4,0,4,0,0,0,0,0,,,
"Oct 19, 2022 12:00 AM",6,1,5,0,0,0,0,0,0,0,0,0,0,0,0,1,1,1,0,3,2,1,0,,1,1,0,0,0,0,0,0,0,,,
"Oct 19, 2022 1:00 AM",8,1,7,0,0,0,1,1,0,1,0,1,0,0,0,0,3,0,3,1,1,0,1,,2,2,0,1,0,0,0,0,0,,,
"Oct 19, 2022 2:00 AM",4,3,1,0,0,0,0,0,0,0,0,0,0,0,0,0,1,1,0,1,1,0,1,,0,0,0,1,0,0,0,0,0,,,
"Oct 19, 2022 3:00 AM",1,0,1,0,0,0,0,0,0,0,0,0,0,0,0,0,0,0,0,0,0,0,0,,0,0,0,0,0,0,0,0,0,,,
"Oct 19, 2022 4:00 AM",3,1,2,0,0,0,0,0,0,0,0,0,0,0,0,1,3,2,1,0,0,0,2,,0,0,0,0,0,0,1,1,0,,,
"Oct 19, 2022 5:00 AM",5,3,2,2,1,1,2,1,1,2,1,1,0,0,0,1,5,5,0,1,1,0,4,,2,1,1,6,0,0,0,0,0,,,
"Oct 19, 2022 6:00 AM",41,28,13,6,2,4,8,0,8,7,1,6,0,0,0,2,11,11,0,3,2,1,9,,4,1,3,29,0,1,1,1,0,,,
"Oct 19, 2022 7:00 AM",85,57,28,13,3,10,22,5,17,11,2,9,0,0,0,7,55,55,0,11,10,1,50,,11,2,9,24,1,1,4,2,2,,,
"Oct 19, 2022 8:00 AM",206,158,48,28,5,23,57,18,39,32,12,20,0,0,0,32,119,117,2,17,12,5,89,,29,7,22,49,2,2,6,4,2,,,
"Oct 19, 2022 9:00 AM",130,118,12,17,2,15,46,15,31,28,13,15,0,0,0,13,63,61,2,24,14,10,32,,25,9,16,5,3,3,5,2,3,,,
"Oct 19, 2022 10:00 AM",68,50,18,6,2,4,16,11,5,6,4,2,0,0,0,12,43,41,2,7,2,5,20,,5,5,0,3,1,0,2,2,0,,,
"Oct 19, 2022 11:00 AM",35,27,8,3,1,2,11,4,7,5,2,3,0,0,0,6,18,16,2,5,3,2,10,,8,4,4,16,1,1,2,1,1,,,
"Oct 19, 2022 12:00 PM",48,31,17,2,0,2,7,2,5,2,0,2,0,0,0,7,17,14,3,10,9,1,10,,4,2,2,10,2,2,3,2,1,,,
"Oct 19, 2022 1:00 PM",48,17,31,3,1,2,11,5,6,8,4,4,0,0,0,5,10,7,3,17,15,2,3,,3,1,2,12,1,2,0,0,0,,,
"Oct 19, 2022 2:00 PM",47,20,27,5,2,3,15,7,8,7,3,4,0,0,0,8,10,7,3,9,9,0,5,,7,4,3,13,0,0,0,0,0,,,
"Oct 19, 2022 3:00 PM",54,23,31,4,3,1,15,9,6,12,7,5,0,0,0,5,15,12,3,15,13,2,7,,5,5,0,9,3,1,2,0,2,,,
"Oct 19, 2022 4:00 PM",83,19,64,12,10,2,20,16,4,15,11,4,0,0,0,5,22,15,7,25,22,3,9,,17,14,3,15,1,1,1,0,1,,,
"Oct 19, 2022 5:00 PM",183,40,143,23,18,5,51,39,12,40,25,15,0,0,0,14,31,20,11,62,61,1,18,,36,30,6,40,1,2,6,3,3,,,
"Oct 19, 2022 6:00 PM",167,44,123,27,22,5,49,31,18,34,24,10,0,0,0,19,25,12,13,62,56,6,13,,37,27,10,16,3,3,4,2,2,,,
"Oct 19, 2022 7:00 PM",91,20,71,16,11,5,32,22,10,24,12,12,0,0,0,6,18,14,4,32,30,2,9,,15,9,6,17,3,1,4,3,1,,,
"Oct 19, 2022 8:00 PM",65,18,47,7,7,0,12,9,3,9,6,3,0,0,0,3,11,7,4,18,18,0,7,,4,4,0,10,1,1,4,2,2,,,
"Oct 19, 2022 9:00 PM",43,10,33,2,2,0,7,5,2,8,4,4,0,0,0,3,6,3,3,10,10,0,3,,4,2,2,4,9,0,2,2,0,,,
"Oct 19, 2022 10:00 PM",21,5,16,3,2,1,2,2,0,1,1,0,0,0,0,1,5,1,4,5,5,0,2,,0,0,0,1,0,0,0,0,0,,,
"Oct 19, 2022 11:00 PM",8,1,7,2,1,1,0,0,0,2,1,1,0,0,0,1,1,0,1,3,3,0,0,,0,0,0,0,0,0,0,0,0,,,
"Oct 20, 2022 12:00 AM",8,1,7,0,0,0,1,1,0,0,0,0,0,0,0,0,3,1,2,0,0,0,1,,0,0,0,1,0,0,0,0,0,,,
"Oct 20, 2022 1:00 AM",2,1,1,0,0,0,0,0,0,0,0,0,0,0,0,1,3,1,2,0,0,0,1,,0,0,0,0,0,0,0,0,0,,,
"Oct 20, 2022 2:00 AM",2,1,1,0,0,0,0,0,0,0,0,0,0,0,0,0,1,0,1,0,0,0,1,,0,0,0,0,0,0,0,0,0,,,
"Oct 20, 2022 3:00 AM",1,0,1,0,0,0,0,0,0,0,0,0,0,0,0,0,0,0,0,0,0,0,0,,0,0,0,0,0,0,0,0,0,,,
"Oct 20, 2022 4:00 AM",2,1,1,0,0,0,1,1,0,0,0,0,0,0,0,0,0,0,0,0,0,0,0,,0,0,0,0,0,0,0,0,0,,,
"Oct 20, 2022 5:00 AM",9,7,2,2,1,1,2,1,1,2,2,0,0,0,0,1,8,8,0,4,3,1,7,,0,0,0,2,0,0,0,0,0,,,
"Oct 20, 2022 6:00 AM",42,25,17,9,2,7,12,6,6,15,8,7,0,0,0,7,22,22,0,5,3,2,18,,6,1,5,5,1,2,1,1,0,,,
"Oct 20, 2022 7:00 AM",140,89,51,35,7,28,68,19,49,47,15,32,0,0,0,15,63,61,2,16,13,3,57,,37,14,23,27,1,4,8,7,1,,,
"Oct 20, 2022 8:00 AM",325,244,81,89,20,69,151,43,108,122,44,78,0,0,0,37,222,221,1,47,35,12,170,,81,22,59,75,6,7,18,14,4,,,
"Oct 20, 2022 9:00 AM",180,150,30,68,25,43,106,50,56,75,40,35,0,0,0,15,105,101,4,28,18,10,71,,51,23,28,27,3,5,2,1,1,,,
"Oct 20, 2022 10:00 AM",80,59,21,44,20,24,67,35,32,40,27,13,0,0,0,11,56,55,1,14,12,2,36,,26,18,8,23,0,1,3,2,1,,,
"Oct 20, 2022 11:00 AM",62,41,21,37,17,20,69,37,32,52,23,29,0,0,0,13,47,43,4,13,9,4,23,,27,16,11,24,2,4,4,4,0,,,
"Oct 20, 2022 12:00 PM",79,46,33,39,15,24,70,32,38,48,20,28,0,0,0,19,38,34,4,22,18,4,23,,30,15,15,28,2,1,1,1,0,,,
"Oct 20, 2022 1:00 PM",85,36,49,65,38,27,53,28,25,48,26,22,0,0,0,17,29,26,3,20,18,2,18,,27,11,16,30,3,2,4,3,1,,,
"Oct 20, 2022 2:00 PM",96,36,60,31,18,13,33,17,16,31,17,14,0,0,0,22,33,26,7,22,20,2,15,,26,12,14,29,0,0,3,3,0,,,
"Oct 20, 2022 3:00 PM",95,33,62,23,13,10,51,35,16,32,25,7,0,0,0,8,37,25,12,30,26,4,19,,32,24,8,39,5,3,5,2,3,,,
"Oct 20, 2022 4:00 PM",163,46,117,42,30,12,91,68,23,79,58,21,0,0,0,16,39,25,14,54,49,5,17,,72,59,13,47,3,0,4,3,1,,,
"Oct 20, 2022 5:00 PM",265,79,186,64,45,19,117,77,40,94,58,36,0,0,0,30,51,34,17,107,101,6,31,,70,58,12,58,8,2,9,7,2,,,
"Oct 20, 2022 6:00 PM",217,50,167,70,54,16,125,90,35,88,64,24,0,0,0,19,48,37,11,109,106,3,31,,65,51,14,46,4,6,10,7,3,,,
"Oct 20, 2022 7:00 PM",136,39,97,36,25,11,55,45,10,39,29,10,0,0,0,12,35,23,12,47,45,2,17,,40,33,7,20,5,2,7,5,2,,,
"Oct 20, 2022 8:00 PM",95,26,69,18,15,3,27,15,12,27,17,10,0,0,0,8,21,15,6,38,36,2,11,,14,10,4,17,3,1,3,1,2,,,
"Oct 20, 2022 9:00 PM",75,21,54,16,14,2,15,10,5,10,6,4,0,0,0,10,6,4,2,20,19,1,3,,9,6,3,12,2,1,1,1,0,,,
"Oct 20, 2022 10:00 PM",56,14,42,3,2,1,8,6,2,4,2,2,0,0,0,3,8,4,4,16,15,1,4,,8,5,3,6,0,0,2,1,1,,,
"Oct 20, 2022 11:00 PM",24,6,18,10,4,6,9,6,3,3,1,2,0,0,0,3,8,5,3,8,8,0,4,,2,2,0,4,0,1,1,1,0,,,
"Oct 21, 2022 12:00 AM",21,6,15,0,0,0,0,0,0,2,1,1,0,0,0,2,2,1,1,2,2,0,1,,2,2,0,5,0,0,0,0,0,,,
"Oct 21, 2022 1:00 AM",6,2,4,0,0,0,1,1,0,0,0,0,0,0,0,0,4,1,3,3,3,0,0,,2,2,0,3,0,0,0,0,0,,,
"Oct 21, 2022 2:00 AM",5,3,2,0,0,0,6,5,1,4,4,0,0,0,0,0,3,0,3,0,0,0,0,,2,2,0,0,0,0,1,0,1,,,
"Oct 21, 2022 3:00 AM",1,0,1,0,0,0,0,0,0,0,0,0,0,0,0,0,0,0,0,2,2,0,0,,0,0,0,0,0,0,0,0,0,,,
"Oct 21, 2022 4:00 AM",4,2,2,0,0,0,0,0,0,0,0,0,0,0,0,0,2,2,0,0,0,0,2,,0,0,0,1,0,0,1,1,0,,,
"Oct 21, 2022 5:00 AM",5,3,2,4,2,2,4,3,1,5,3,2,0,0,0,1,6,6,0,0,0,0,5,,1,1,0,6,0,0,0,0,0,,,
"Oct 21, 2022 6:00 AM",28,12,16,7,2,5,11,5,6,11,4,7,0,0,0,2,13,13,0,6,5,1,13,,5,2,3,18,0,2,0,0,0,,,
"Oct 21, 2022 7:00 AM",88,60,28,17,5,12,35,14,21,23,6,17,0,0,0,8,42,42,0,13,10,3,36,,14,3,11,62,1,2,4,4,0,,,
"Oct 21, 2022 8:00 AM",171,128,43,37,9,28,82,24,58,49,13,36,0,0,0,23,92,89,3,27,21,6,77,,44,14,30,115,5,1,13,11,2,,,
"Oct 21, 2022 9:00 AM",79,60,19,22,5,17,48,18,30,30,18,12,0,0,0,7,48,48,0,15,9,6,28,,22,10,12,26,2,3,1,1,0,,,
"Oct 21, 2022 10:00 AM",45,27,18,13,4,9,14,6,8,9,4,5,0,0,0,5,14,14,0,5,5,0,12,,7,5,2,12,0,1,0,0,0,,,
"Oct 21, 2022 11:00 AM",34,19,15,7,4,3,10,6,4,10,7,3,0,0,0,2,15,12,3,5,5,0,5,,3,1,2,7,1,1,2,2,0,,,
"Oct 21, 2022 12:00 PM",52,29,23,15,4,11,17,10,7,15,9,6,0,0,0,3,21,18,3,11,10,1,12,,8,5,3,9,0,2,1,1,0,,,
"Oct 21, 2022 1:00 PM",94,44,50,25,14,11,36,23,13,26,15,11,0,0,0,9,28,25,3,20,16,4,22,,17,8,9,21,3,4,8,2,6,,,
"Oct 21, 2022 2:00 PM",75,38,37,15,8,7,35,19,16,19,10,9,0,0,0,10,16,11,5,20,19,1,8,,18,14,4,15,3,3,5,2,3,,,
"Oct 21, 2022 3:00 PM",81,35,46,22,17,5,38,23,15,24,19,5,0,0,0,8,23,16,7,25,19,6,15,,23,13,10,30,1,2,6,5,1,,,
"Oct 21, 2022 4:00 PM",97,28,69,47,28,19,58,37,21,50,29,21,0,0,0,29,24,22,2,33,30,3,20,,29,20,9,31,8,2,6,5,1,,,
"Oct 21, 2022 5:00 PM",149,42,107,59,38,21,56,41,15,45,32,13,0,0,0,19,22,18,4,48,47,1,14,,30,24,6,34,3,5,7,2,5,,,
"Oct 21, 2022 6:00 PM",123,40,83,24,14,10,49,32,17,35,20,15,0,0,0,30,22,16,6,38,37,1,13,,22,15,7,32,6,3,3,1,2,,,
"Oct 21, 2022 7:00 PM",80,24,56,18,16,2,33,22,11,20,12,8,0,0,0,5,11,9,2,23,21,2,9,,16,13,3,21,5,2,7,6,1,,,
"Oct 21, 2022 8:00 PM",49,26,23,8,6,2,11,5,6,5,3,2,0,0,0,7,7,7,0,12,12,0,10,,6,6,0,6,2,1,2,2,0,,,
"Oct 21, 2022 9:00 PM",26,5,21,6,6,0,11,4,7,7,4,3,0,0,0,4,7,4,3,7,6,1,3,,3,2,1,10,1,1,3,0,3,,,
"Oct 21, 2022 10:00 PM",25,12,13,7,3,4,9,2,7,9,3,6,0,0,0,1,5,3,2,6,5,1,2,,2,0,2,9,0,2,1,0,1,,,
"Oct 21, 2022 11:00 PM",20,5,15,3,2,1,8,3,5,6,3,3,0,0,0,2,4,3,1,4,3,1,4,,2,0,2,4,0,0,0,0,0,,,
"Oct 22, 2022 12:00 AM",15,4,11,0,0,0,2,2,0,4,2,2,0,0,0,0,1,1,0,5,4,1,1,,2,1,1,3,0,0,1,1,0,,,
"Oct 22, 2022 1:00 AM",8,2,6,0,0,0,4,4,0,0,0,0,0,0,0,3,3,3,0,3,3,0,3,,3,3,0,3,1,0,0,0,0,,,
"Oct 22, 2022 2:00 AM",5,0,5,1,1,0,1,1,0,1,1,0,0,0,0,1,1,1,0,1,1,0,1,,0,0,0,1,0,0,0,0,0,,,
"Oct 22, 2022 3:00 AM",2,0,2,0,0,0,0,0,0,0,0,0,0,0,0,0,0,0,0,1,1,0,0,,0,0,0,1,0,1,0,0,0,,,
"Oct 22, 2022 4:00 AM",3,1,2,0,0,0,0,0,0,0,0,0,0,0,0,0,2,2,0,1,1,0,2,,0,0,0,0,0,0,0,0,0,,,
"Oct 22, 2022 5:00 AM",1,0,1,1,1,0,2,1,1,2,1,1,0,0,0,0,2,2,0,1,1,0,2,,0,0,0,1,0,0,0,0,0,,,
"Oct 22, 2022 6:00 AM",8,5,3,1,1,0,5,4,1,2,1,1,0,0,0,1,1,1,0,2,2,0,1,,0,0,0,4,1,0,0,0,0,,,
"Oct 22, 2022 7:00 AM",18,12,6,9,7,2,12,10,2,13,12,1,0,0,0,3,11,10,1,4,4,0,7,,4,3,1,17,1,1,1,1,0,,,
"Oct 22, 2022 8:00 AM",39,22,17,58,38,20,54,35,19,50,40,10,0,0,0,6,15,14,1,5,4,1,15,,10,8,2,15,2,4,3,1,2,,,
"Oct 22, 2022 9:00 AM",59,34,25,64,33,31,79,46,33,52,36,16,0,0,0,10,23,22,1,15,10,5,21,,35,23,12,31,5,7,7,4,3,,,
"Oct 22, 2022 10:00 AM",63,35,28,97,47,50,146,90,56,91,56,35,0,0,0,11,24,23,1,15,13,2,21,,64,48,16,28,3,8,2,1,1,,,
"Oct 22, 2022 11:00 AM",90,52,38,123,67,56,178,104,74,122,78,44,0,0,0,11,38,35,3,16,14,2,29,,73,48,25,50,5,6,5,4,1,,,
"Oct 22, 2022 12:00 PM",82,38,44,142,63,79,192,95,97,132,69,63,0,0,0,25,31,29,2,16,14,2,28,,68,33,35,51,4,6,9,6,3,,,
"Oct 22, 2022 1:00 PM",72,32,40,109,52,57,131,50,81,102,42,60,0,0,0,17,20,17,3,14,12,2,15,,71,30,41,50,5,10,14,10,4,,,
"Oct 22, 2022 2:00 PM",61,37,24,99,50,49,149,74,75,92,50,42,0,0,0,23,25,17,8,17,16,1,14,,67,36,31,36,10,4,14,8,6,,,
"Oct 22, 2022 3:00 PM",87,45,42,102,62,40,115,59,56,95,60,35,0,0,0,52,30,28,2,12,11,1,22,,53,23,30,35,6,4,9,9,0,,,
"Oct 22, 2022 4:00 PM",89,60,29,105,56,49,129,61,68,101,51,50,0,0,0,31,25,24,1,18,16,2,22,,62,38,24,44,7,1,7,6,1,,,
"Oct 22, 2022 5:00 PM",49,23,26,62,32,30,73,33,40,63,25,38,0,0,0,27,26,18,8,18,15,3,18,,39,17,22,24,7,1,11,6,5,,,
"Oct 22, 2022 6:00 PM",49,17,32,41,15,26,37,11,26,34,16,18,0,0,0,21,14,10,4,10,10,0,10,,10,4,6,16,6,2,8,6,2,,,
"Oct 22, 2022 7:00 PM",66,23,43,10,4,6,20,9,11,14,5,9,0,0,0,15,9,7,2,17,15,2,7,,6,5,1,12,1,2,1,1,0,,,
"Oct 22, 2022 8:00 PM",55,27,28,14,10,4,15,8,7,12,6,6,0,0,0,2,9,9,0,13,10,3,9,,6,4,2,14,1,1,3,1,2,,,
"Oct 22, 2022 9:00 PM",26,6,20,11,7,4,11,5,6,15,8,7,0,0,0,5,5,5,0,1,1,0,6,,3,1,2,6,0,1,3,3,0,,,
"Oct 22, 2022 10:00 PM",17,7,10,4,2,2,8,3,5,7,3,4,0,0,0,3,4,4,0,2,2,0,4,,6,4,2,7,1,1,1,1,0,,,
"Oct 22, 2022 11:00 PM",20,7,13,8,7,1,4,3,1,1,1,0,0,0,0,3,9,9,0,3,3,0,7,,7,6,1,2,1,0,0,0,0,,,
"Oct 23, 2022 12:00 AM",18,4,14,0,0,0,3,1,2,4,1,3,0,0,0,2,2,2,0,4,3,1,1,,0,0,0,4,1,0,0,0,0,,,
"Oct 23, 2022 1:00 AM",15,3,12,5,4,1,5,3,2,6,4,2,0,0,0,0,3,1,2,1,1,0,1,,4,4,0,3,0,0,2,2,0,,,
"Oct 23, 2022 2:00 AM",7,3,4,0,0,0,1,1,0,0,0,0,0,0,0,0,3,2,1,1,1,0,2,,1,1,0,5,0,0,0,0,0,,,
"Oct 23, 2022 3:00 AM",6,0,6,0,0,0,1,0,1,1,1,0,0,0,0,2,0,0,0,2,2,0,0,,0,0,0,2,0,1,0,0,0,,,
"Oct 23, 2022 4:00 AM",2,0,2,0,0,0,1,1,0,0,0,0,0,0,0,0,0,0,0,4,2,2,0,,1,1,0,0,0,0,0,0,0,,,
"Oct 23, 2022 5:00 AM",2,1,1,0,0,0,1,1,0,1,1,0,0,0,0,0,2,2,0,1,1,0,2,,0,0,0,2,0,0,0,0,0,,,
"Oct 23, 2022 6:00 AM",5,2,3,0,0,0,3,2,1,1,1,0,0,0,0,2,1,0,1,2,2,0,1,,0,0,0,3,0,0,0,0,0,,,
"Oct 23, 2022 7:00 AM",15,8,7,5,2,3,6,4,2,4,2,2,0,0,0,1,7,7,0,2,2,0,6,,2,1,1,7,1,2,2,2,0,,,
"Oct 23, 2022 8:00 AM",14,9,5,21,10,11,24,18,6,21,15,6,0,0,0,3,9,9,0,1,0,1,7,,13,9,4,12,1,0,1,1,0,,,
"Oct 23, 2022 9:00 AM",14,8,6,17,7,10,22,10,12,16,10,6,0,0,0,2,5,5,0,3,3,0,5,,8,2,6,4,0,1,2,1,1,,,
"Oct 23, 2022 10:00 AM",15,7,8,25,9,16,18,9,9,25,13,12,0,0,0,3,6,3,3,2,1,1,2,,8,3,5,11,0,1,0,0,0,,,
"Oct 23, 2022 11:00 AM",29,21,8,25,11,14,33,21,12,15,11,4,0,0,0,10,11,11,0,3,2,1,10,,9,8,1,11,0,0,1,1,0,,,
"Oct 23, 2022 12:00 PM",40,26,14,76,40,36,68,45,23,44,26,18,0,0,0,12,11,10,1,10,8,2,11,,31,23,8,24,6,0,0,0,0,,,
"Oct 23, 2022 1:00 PM",47,20,27,75,43,32,105,58,47,60,39,21,0,0,0,22,19,18,1,14,14,0,13,,48,27,21,31,6,4,3,3,0,,,
"Oct 23, 2022 2:00 PM",45,30,15,114,60,54,113,69,44,88,53,35,0,0,0,26,19,18,1,13,9,4,11,,55,28,27,28,6,2,12,8,4,,,
"Oct 23, 2022 3:00 PM",50,28,22,154,84,70,151,80,71,137,80,57,0,0,0,34,20,19,1,7,7,0,13,,62,44,18,26,5,6,8,5,3,,,
"Oct 23, 2022 4:00 PM",57,28,29,117,45,72,119,54,65,98,45,53,0,0,0,32,23,22,1,13,13,0,23,,42,19,23,30,6,3,7,6,1,,,
"Oct 23, 2022 5:00 PM",61,27,34,93,39,54,87,35,52,82,31,51,0,0,0,19,20,16,4,21,17,4,14,,44,9,35,21,6,3,7,4,3,,,
"Oct 23, 2022 6:00 PM",72,32,40,41,21,20,50,23,27,36,15,21,0,0,0,4,15,12,3,13,12,1,10,,16,7,9,20,1,2,4,1,3,,,
"Oct 23, 2022 7:00 PM",50,19,31,14,6,8,16,7,9,12,6,6,0,0,0,2,6,5,1,11,11,0,4,,6,5,1,11,0,0,0,0,0,,,
"Oct 23, 2022 8:00 PM",24,7,17,9,6,3,22,9,13,16,10,6,0,0,0,3,9,9,0,10,9,1,9,,2,0,2,11,2,1,1,1,0,,,
"Oct 23, 2022 9:00 PM",15,4,11,6,4,2,10,3,7,6,4,2,0,0,0,4,10,10,0,6,6,0,10,,1,1,0,10,3,0,6,2,4,,,
"Oct 23, 2022 10:00 PM",10,6,4,4,3,1,4,1,3,7,3,4,0,0,0,2,9,8,1,1,1,0,8,,3,2,1,3,0,0,2,0,2,,,
"Oct 23, 2022 11:00 PM",11,3,8,4,2,2,4,2,2,3,2,1,0,0,0,1,2,2,0,0,0,0,3,,3,1,2,1,0,0,1,0,1,,,
"Oct 24, 2022 12:00 AM",7,2,5,0,0,0,1,1,0,2,0,2,0,0,0,1,3,3,0,2,2,0,0,,2,1,1,3,0,1,0,0,0,,,
"Oct 24, 2022 1:00 AM",2,1,1,0,0,0,0,0,0,0,0,0,0,0,0,0,0,0,0,3,3,0,0,,0,0,0,0,0,0,0,0,0,,,
"Oct 24, 2022 2:00 AM",3,1,2,0,0,0,0,0,0,0,0,0,0,0,0,2,2,2,0,0,0,0,2,,0,0,0,0,0,0,0,0,0,,,
"Oct 24, 2022 3:00 AM",2,1,1,0,0,0,0,0,0,0,0,0,0,0,0,0,0,0,0,0,0,0,0,,0,0,0,0,0,0,0,0,0,,,
"Oct 24, 2022 4:00 AM",1,0,1,0,0,0,0,0,0,0,0,0,0,0,0,0,1,1,0,1,1,0,1,,0,0,0,1,0,0,0,0,0,,,
"Oct 24, 2022 5:00 AM",9,5,4,1,0,1,3,1,2,2,1,1,0,0,0,1,7,7,0,3,2,1,7,,2,0,2,8,0,1,0,0,0,,,
"Oct 24, 2022 6:00 AM",61,41,20,10,4,6,23,8,15,13,5,8,0,0,0,4,21,21,0,7,4,3,21,,6,1,5,40,1,1,1,1,0,,,
"Oct 24, 2022 7:00 AM",127,87,40,53,16,37,74,17,57,45,17,28,0,0,0,9,79,79,0,20,19,1,72,,27,9,18,120,3,2,10,10,0,,,
"Oct 24, 2022 8:00 AM",282,223,59,109,32,77,174,56,118,126,47,79,0,0,0,56,196,195,1,43,30,13,145,,88,21,67,211,5,7,13,10,3,,,
"Oct 24, 2022 9:00 AM",177,149,28,77,32,45,90,50,40,93,58,35,0,0,0,24,110,108,2,24,16,8,80,,51,26,25,72,4,4,6,5,1,,,
"Oct 24, 2022 10:00 AM",80,57,23,40,11,29,61,32,29,39,15,24,0,0,0,11,64,63,1,9,6,3,33,,22,12,10,27,1,1,3,0,3,,,
"Oct 24, 2022 11:00 AM",62,35,27,45,18,27,61,28,33,35,17,18,0,0,0,12,28,24,4,17,15,2,17,,20,12,8,21,1,4,5,5,0,,,
"Oct 24, 2022 12:00 PM",81,45,36,43,19,24,74,39,35,49,24,25,0,0,0,11,45,41,4,11,8,3,29,,30,15,15,23,5,1,3,1,2,,,
"Oct 24, 2022 1:00 PM",81,43,38,51,29,22,73,38,35,49,25,24,0,0,0,12,23,16,7,34,29,5,12,,31,14,17,22,2,4,3,1,2,,,
"Oct 24, 2022 2:00 PM",68,25,43,46,23,23,63,30,33,61,39,22,0,0,0,14,31,26,5,18,18,0,15,,28,17,11,20,3,2,6,3,3,,,
"Oct 24, 2022 3:00 PM",104,44,60,58,39,19,64,44,20,48,31,17,0,0,0,14,30,20,10,37,30,7,11,,22,15,7,39,2,1,6,5,1,,,
"Oct 24, 2022 4:00 PM",150,57,93,49,31,18,87,55,32,66,43,23,0,0,0,28,32,23,9,53,46,7,19,,48,30,18,39,9,4,7,4,3,,,
"Oct 24, 2022 5:00 PM",248,69,179,86,52,34,128,72,56,102,55,47,0,0,0,28,51,34,17,122,118,4,31,,62,44,18,62,8,8,5,2,3,,,
"Oct 24, 2022 6:00 PM",202,35,167,71,54,17,128,92,36,93,58,35,0,0,0,28,38,27,11,112,109,3,18,,68,54,14,44,2,4,9,6,3,,,
"Oct 24, 2022 7:00 PM",131,32,99,43,30,13,62,39,23,46,26,20,0,0,0,18,42,28,14,55,50,5,24,,36,29,7,26,5,6,4,2,2,,,
"Oct 24, 2022 8:00 PM",68,16,52,15,10,5,31,17,14,26,11,15,0,0,0,10,17,11,6,27,26,1,10,,15,11,4,24,2,2,5,2,3,,,
"Oct 24, 2022 9:00 PM",56,12,44,10,8,2,20,13,7,11,5,6,0,0,0,8,6,5,1,16,16,0,3,,11,7,4,13,6,2,4,2,2,,,
"Oct 24, 2022 10:00 PM",46,10,36,9,5,4,6,2,4,9,3,6,0,0,0,2,11,6,5,18,17,1,6,,2,1,1,10,1,1,1,0,1,,,
"Oct 24, 2022 11:00 PM",13,6,7,0,0,0,5,5,0,1,1,0,0,0,0,5,5,3,2,14,13,1,4,,2,1,1,4,1,1,0,0,0,,,
"Oct 25, 2022 12:00 AM",9,4,5,0,0,0,1,1,0,1,1,0,0,0,0,0,1,0,1,3,3,0,0,,0,0,0,3,1,0,2,1,1,,,
"Oct 25, 2022 1:00 AM",2,0,2,0,0,0,1,0,1,0,0,0,0,0,0,0,0,0,0,0,0,0,0,,0,0,0,1,0,0,0,0,0,,,
"Oct 25, 2022 2:00 AM",3,1,2,0,0,0,0,0,0,0,0,0,0,0,0,1,1,0,1,1,1,0,0,,1,1,0,0,0,0,0,0,0,,,
"Oct 25, 2022 3:00 AM",0,0,0,0,0,0,0,0,0,0,0,0,0,0,0,0,0,0,0,0,0,0,0,,0,0,0,0,0,0,3,1,2,,,
"Oct 25, 2022 4:00 AM",4,1,3,0,0,0,0,0,0,0,0,0,0,0,0,2,4,3,1,0,0,0,3,,0,0,0,1,0,0,0,0,0,,,
"Oct 25, 2022 5:00 AM",15,12,3,4,1,3,7,3,4,5,1,4,0,0,0,2,7,7,0,1,0,1,5,,3,1,2,9,0,1,0,0,0,,,
"Oct 25, 2022 6:00 AM",57,35,22,17,7,10,23,9,14,19,12,7,0,0,0,4,21,21,0,10,8,2,21,,9,2,7,31,0,4,0,0,0,,,
"Oct 25, 2022 7:00 AM",153,106,47,42,12,30,74,16,58,45,16,29,0,0,0,20,94,92,2,23,20,3,89,,41,13,28,130,4,6,10,9,1,,,
"Oct 25, 2022 8:00 AM",354,280,74,109,27,82,184,56,128,128,44,84,0,0,0,38,238,236,2,52,38,14,191,,100,26,74,237,9,7,13,10,3,,,
"Oct 25, 2022 9:00 AM",163,142,21,54,19,35,92,38,54,74,38,36,0,0,0,15,126,122,4,23,18,5,83,,53,20,33,70,6,5,4,2,2,,,
"Oct 25, 2022 10:00 AM",88,71,17,38,15,23,47,23,24,43,19,24,0,0,0,10,54,54,0,14,7,7,34,,25,14,11,31,0,3,3,3,0,,,
"Oct 25, 2022 11:00 AM",65,44,21,46,28,18,57,33,24,40,27,13,0,0,0,10,37,33,4,12,11,1,14,,31,13,18,26,4,5,4,4,0,,,
"Oct 25, 2022 12:00 PM",67,34,33,45,20,25,74,37,37,50,23,27,0,0,0,7,37,33,4,19,16,3,20,,20,14,6,36,0,4,2,0,2,,,
"Oct 25, 2022 1:00 PM",85,45,40,37,21,16,73,37,36,43,22,21,0,0,0,18,35,29,6,28,25,3,23,,40,27,13,23,7,3,7,6,1,,,
"Oct 25, 2022 2:00 PM",89,38,51,56,28,28,61,29,32,47,28,19,0,0,0,25,31,29,2,28,24,4,20,,39,20,19,25,3,0,7,5,2,,,
"Oct 25, 2022 3:00 PM",131,41,90,32,19,13,63,37,26,39,17,22,0,0,0,16,39,27,12,32,30,2,26,,40,23,17,31,3,0,7,5,2,,,
"Oct 25, 2022 4:00 PM",178,59,119,35,26,9,63,44,19,53,33,20,0,0,0,26,34,23,11,71,66,5,19,,45,36,9,57,3,1,4,3,1,,,
"Oct 25, 2022 5:00 PM",265,52,213,54,43,11,113,79,34,81,52,29,0,0,0,29,61,46,15,119,118,1,41,,80,58,22,53,5,2,5,1,4,,,
"Oct 25, 2022 6:00 PM",227,43,184,49,46,3,112,88,24,60,48,12,0,0,0,15,47,31,16,137,131,6,27,,64,55,9,49,6,2,6,4,2,,,
"Oct 25, 2022 7:00 PM",95,22,73,17,13,4,26,19,7,18,13,5,0,0,0,13,18,10,8,47,42,5,6,,24,17,7,22,0,0,2,1,1,,,
"Oct 25, 2022 8:00 PM",61,18,43,6,5,1,12,8,4,9,3,6,0,0,0,3,13,4,9,25,25,0,5,,7,5,2,15,3,0,0,0,0,,,
"Oct 25, 2022 9:00 PM",51,11,40,3,2,1,2,1,1,3,2,1,0,0,0,5,4,2,2,10,10,0,1,,3,3,0,4,1,0,4,1,3,,,
"Oct 25, 2022 10:00 PM",24,6,18,3,3,0,4,2,2,2,2,0,0,0,0,5,6,3,3,7,6,1,3,,1,1,0,2,0,0,4,3,1,,,
"Oct 25, 2022 11:00 PM",12,4,8,0,0,0,1,1,0,2,1,1,0,0,0,0,2,0,2,3,3,0,0,,1,1,0,1,0,0,3,3,0,,,
"Oct 26, 2022 12:00 AM",8,3,5,0,0,0,1,1,0,1,1,0,0,0,0,2,2,1,1,1,1,0,1,,1,1,0,1,0,0,0,0,0,,,
"Oct 26, 2022 1:00 AM",5,1,4,0,0,0,0,0,0,0,0,0,0,0,0,0,1,0,1,1,0,1,0,,1,1,0,0,0,0,0,0,0,,,
"Oct 26, 2022 2:00 AM",3,1,2,0,0,0,0,0,0,0,0,0,0,0,0,1,0,0,0,0,0,0,0,,0,0,0,0,0,0,0,0,0,,,
"Oct 26, 2022 3:00 AM",0,0,0,0,0,0,2,1,1,0,0,0,0,0,0,0,0,0,0,0,0,0,0,,0,0,0,0,0,0,0,0,0,,,
"Oct 26, 2022 4:00 AM",3,1,2,0,0,0,0,0,0,0,0,0,0,0,0,1,1,1,0,0,0,0,1,,0,0,0,1,0,0,0,0,0,,,
"Oct 26, 2022 5:00 AM",8,6,2,0,0,0,1,1,0,1,1,0,0,0,0,0,4,4,0,1,0,1,2,,2,1,1,4,0,0,0,0,0,,,
"Oct 26, 2022 6:00 AM",38,25,13,8,0,8,11,3,8,7,2,5,0,0,0,4,13,13,0,7,6,1,14,,4,2,2,35,0,1,0,0,0,,,
"Oct 26, 2022 7:00 AM",133,91,42,35,11,24,69,19,50,42,17,25,0,0,0,16,79,79,0,23,19,4,72,,28,9,19,110,0,2,13,12,1,,,
"Oct 26, 2022 8:00 AM",341,272,69,87,19,68,141,50,91,105,38,67,0,0,0,26,216,212,4,47,40,7,181,,94,27,67,208,6,8,18,16,2,,,
"Oct 26, 2022 9:00 AM",160,134,26,57,18,39,85,37,48,69,45,24,0,0,0,20,99,98,1,24,12,12,62,,58,25,33,59,7,7,8,6,2,,,
"Oct 26, 2022 10:00 AM",80,57,23,39,12,27,42,25,17,24,11,13,0,0,0,15,40,40,0,12,7,5,23,,21,12,9,24,1,0,3,3,0,,,
"Oct 26, 2022 11:00 AM",50,33,17,48,23,25,55,25,30,46,22,24,0,0,0,9,38,34,4,15,10,5,16,,25,11,14,14,2,2,5,4,1,,,
"Oct 26, 2022 12:00 PM",56,32,24,54,23,31,70,37,33,49,25,24,0,0,0,10,35,29,6,15,12,3,13,,31,20,11,31,0,1,3,2,1,,,
"Oct 26, 2022 1:00 PM",90,43,47,48,25,23,81,39,42,49,29,20,0,0,0,15,31,27,4,26,20,6,15,,39,23,16,29,2,4,7,5,2,,,
"Oct 26, 2022 2:00 PM",91,44,47,38,24,14,55,27,28,34,21,13,0,0,0,17,17,10,7,19,17,2,5,,27,11,16,27,2,4,8,4,4,,,
"Oct 26, 2022 3:00 PM",101,34,67,38,22,16,57,29,28,43,24,19,0,0,0,16,37,31,6,38,31,7,25,,29,17,12,26,5,1,11,4,7,,,
"Oct 26, 2022 4:00 PM",147,44,103,50,27,23,84,46,38,69,39,30,0,0,0,21,35,20,15,40,35,5,21,,44,28,16,42,6,1,8,6,2,,,
"Oct 26, 2022 5:00 PM",259,65,194,63,45,18,122,79,43,71,42,29,0,0,0,73,48,32,16,111,106,5,33,,76,61,15,53,7,8,5,3,2,,,
"Oct 26, 2022 6:00 PM",238,52,186,47,39,8,103,76,27,73,52,21,0,0,0,37,49,37,12,105,100,5,32,,68,57,11,32,1,7,7,5,2,,,
"Oct 26, 2022 7:00 PM",137,40,97,28,23,5,66,46,20,34,23,11,0,0,0,14,30,17,13,54,52,2,14,,31,24,7,26,4,4,6,3,3,,,
"Oct 26, 2022 8:00 PM",83,23,60,22,17,5,33,24,9,28,19,9,0,0,0,4,23,19,4,30,28,2,20,,18,12,6,18,1,2,4,3,1,,,
"Oct 26, 2022 9:00 PM",65,14,51,17,11,6,22,12,10,19,11,8,0,0,0,5,17,12,5,23,20,3,9,,7,5,2,13,6,0,3,1,2,,,
"Oct 26, 2022 10:00 PM",59,14,45,13,12,1,17,11,6,14,9,5,0,0,0,2,15,9,6,21,20,1,9,,6,5,1,9,1,1,0,0,0,,,
"Oct 26, 2022 11:00 PM",17,6,11,4,2,2,5,3,2,6,3,3,0,0,0,2,4,3,1,10,9,1,3,,4,3,1,3,0,0,0,0,0,,,
"Oct 27, 2022 12:00 AM",7,0,7,0,0,0,2,2,0,1,1,0,0,0,0,0,1,1,0,2,2,0,0,,2,1,1,0,0,2,0,0,0,,,
"Oct 27, 2022 1:00 AM",3,0,3,2,2,0,0,0,0,0,0,0,0,0,0,0,1,0,1,5,4,1,0,,0,0,0,3,1,0,1,1,0,,,
"Oct 27, 2022 2:00 AM",3,1,2,0,0,0,1,1,0,3,2,1,0,0,0,0,1,1,0,0,0,0,1,,0,0,0,0,0,0,0,0,0,,,
"Oct 27, 2022 3:00 AM",2,0,2,0,0,0,0,0,0,0,0,0,0,0,0,0,0,0,0,0,0,0,0,,0,0,0,0,0,0,0,0,0,,,
"Oct 27, 2022 4:00 AM",3,1,2,0,0,0,0,0,0,0,0,0,0,0,0,0,3,2,1,1,1,0,2,,0,0,0,0,0,0,1,1,0,,,
"Oct 27, 2022 5:00 AM",7,6,1,0,0,0,0,0,0,0,0,0,0,0,0,3,6,6,0,6,4,2,4,,2,1,1,5,1,0,0,0,0,,,
"Oct 27, 2022 6:00 AM",38,21,17,6,2,4,11,3,8,10,4,6,0,0,0,8,19,19,0,8,6,2,20,,6,0,6,21,0,1,0,0,0,,,
"Oct 27, 2022 7:00 AM",124,82,42,24,5,19,45,6,39,30,10,20,0,0,0,13,70,67,3,19,19,0,59,,27,9,18,97,2,3,9,9,0,,,
"Oct 27, 2022 8:00 AM",286,230,56,72,19,53,130,44,86,89,31,58,0,0,0,25,178,176,2,53,42,11,139,,71,18,53,185,4,5,16,14,2,,,
"Oct 27, 2022 9:00 AM",150,123,27,42,12,30,68,30,38,46,25,21,0,0,0,13,110,109,1,25,19,6,66,,38,16,22,59,4,2,3,3,0,,,
"Oct 27, 2022 10:00 AM",81,65,16,22,9,13,33,14,19,25,11,14,0,0,0,10,51,48,3,11,9,2,28,0,20,11,9,25,1,1,2,1,1,,,
"Oct 27, 2022 11:00 AM",65,43,22,22,9,13,34,20,14,24,15,9,0,0,0,8,41,37,4,17,9,8,22,0,15,9,6,22,1,5,3,2,1,,,
"Oct 27, 2022 12:00 PM",60,25,35,20,8,12,52,26,26,22,10,12,0,0,0,9,24,21,3,13,12,1,14,0,16,8,8,17,2,3,1,1,0,,,
"Oct 27, 2022 1:00 PM",91,47,44,31,23,8,61,38,23,33,21,12,0,0,0,14,34,32,2,15,15,0,20,0,23,10,13,30,3,0,0,0,0,,,
"Oct 27, 2022 2:00 PM",73,33,40,42,22,20,54,27,27,32,22,10,0,0,0,11,28,19,9,16,13,3,19,0,27,13,14,23,2,2,5,4,1,,,
"Oct 27, 2022 3:00 PM",100,32,68,25,14,11,44,24,20,27,14,13,0,0,0,19,38,30,8,38,31,7,24,0,29,15,14,27,2,3,4,3,1,,,
"Oct 27, 2022 4:00 PM",164,71,93,48,28,20,77,51,26,50,29,21,0,0,0,17,43,32,11,42,36,6,19,0,30,19,11,37,2,2,5,3,2,,,
"Oct 27, 2022 5:00 PM",227,51,176,50,33,17,71,43,28,68,40,28,0,0,0,24,50,37,13,88,84,4,36,0,61,49,12,46,6,5,6,4,2,,,
"Oct 27, 2022 6:00 PM",187,45,142,50,38,12,90,66,24,69,45,24,0,0,0,18,48,33,15,89,85,4,31,0,63,49,14,27,10,3,5,5,0,,,
"Oct 27, 2022 7:00 PM",148,36,112,38,29,9,46,31,15,41,29,12,0,0,0,14,30,18,12,51,49,2,16,0,20,13,7,26,2,1,14,8,6,,,
"Oct 27, 2022 8:00 PM",97,25,72,21,16,5,26,16,10,13,9,4,0,0,0,7,13,6,7,26,26,0,8,0,19,13,6,10,1,0,4,1,3,,,
"Oct 27, 2022 9:00 PM",58,15,43,11,10,1,22,17,5,13,10,3,0,0,0,6,19,14,5,16,13,3,14,0,9,7,2,12,2,0,8,3,5,,,
"Oct 27, 2022 10:00 PM",48,9,39,4,3,1,11,5,6,9,2,7,0,0,0,7,13,7,6,16,15,1,9,0,4,3,1,12,0,0,1,1,0,,,
"Oct 27, 2022 11:00 PM",15,4,11,2,1,1,9,4,5,4,1,3,0,0,0,3,3,1,2,12,12,0,0,0,6,2,4,4,0,0,0,0,0,,,
"Oct 28, 2022 12:00 AM",7,2,5,1,0,1,2,2,0,0,0,0,0,0,0,2,1,0,1,3,3,0,1,0,2,1,1,4,0,0,0,0,0,,,
"Oct 28, 2022 1:00 AM",8,1,7,1,0,1,4,3,1,2,1,1,0,0,0,0,1,0,1,2,2,0,0,0,0,0,0,0,1,0,0,0,0,,,
"Oct 28, 2022 2:00 AM",2,1,1,2,1,1,0,0,0,2,2,0,0,0,0,0,1,0,1,2,2,0,0,0,1,0,1,3,0,0,0,0,0,,,
"Oct 28, 2022 3:00 AM",2,0,2,0,0,0,0,0,0,0,0,0,0,0,0,0,0,0,0,0,0,0,0,0,0,0,0,0,0,0,0,0,0,,,
"Oct 28, 2022 4:00 AM",4,2,2,0,0,0,0,0,0,1,1,0,0,0,0,0,1,1,0,1,1,0,1,0,0,0,0,1,0,0,0,0,0,,,
"Oct 28, 2022 5:00 AM",7,4,3,2,1,1,2,1,1,2,1,1,0,0,0,1,3,3,0,1,0,1,2,0,1,1,0,5,0,0,0,0,0,,,
"Oct 28, 2022 6:00 AM",20,12,8,6,3,3,13,8,5,7,4,3,0,0,0,2,11,11,0,7,6,1,11,0,6,5,1,20,0,2,0,0,0,,,
"Oct 28, 2022 7:00 AM",75,51,24,26,8,18,45,9,36,31,12,19,0,0,0,11,37,35,2,12,10,2,36,0,17,6,11,66,2,2,9,9,0,,,
"Oct 28, 2022 8:00 AM",176,137,39,58,15,43,104,36,68,69,28,41,0,0,0,15,130,123,7,23,22,1,101,0,51,19,32,113,3,4,12,11,1,,,
"Oct 28, 2022 9:00 AM",98,77,21,44,18,26,87,49,38,63,41,22,0,0,0,22,67,65,2,12,10,2,47,0,43,20,23,54,3,5,5,5,0,,,
"Oct 28, 2022 10:00 AM",72,51,21,67,37,30,72,37,35,64,40,24,0,0,0,14,47,44,3,11,6,5,37,0,33,21,12,24,2,4,2,2,0,,,
"Oct 28, 2022 11:00 AM",65,37,28,67,30,37,81,46,35,51,32,19,0,0,0,10,27,23,4,6,6,0,18,0,38,19,19,19,3,4,2,0,2,,,
"Oct 28, 2022 12:00 PM",82,37,45,65,34,31,76,35,41,67,35,32,0,0,0,12,30,25,5,21,19,2,18,0,35,18,17,32,3,1,4,3,1,,,
"Oct 28, 2022 1:00 PM",114,51,63,45,22,23,95,51,44,45,20,25,0,0,0,16,42,38,4,27,23,4,30,0,45,26,19,36,2,5,6,3,3,,,
"Oct 28, 2022 2:00 PM",71,25,46,50,20,30,85,41,44,52,28,24,0,0,0,21,18,16,2,24,19,5,14,0,39,26,13,24,2,0,3,3,0,,,
"Oct 28, 2022 3:00 PM",88,30,58,65,38,27,84,56,28,58,34,24,0,0,0,18,25,21,4,30,28,2,16,0,45,26,19,30,2,2,9,6,3,,,
"Oct 28, 2022 4:00 PM",135,46,89,78,44,34,107,58,49,76,40,36,0,0,0,20,30,22,8,41,37,4,18,0,44,22,22,45,5,4,8,6,2,,,
"Oct 28, 2022 5:00 PM",152,46,106,82,50,32,115,68,47,96,60,36,0,0,0,18,36,29,7,54,51,3,21,0,62,45,17,38,6,3,4,1,3,,,
"Oct 28, 2022 6:00 PM",126,44,82,58,39,19,78,47,31,64,34,30,0,0,0,22,25,20,5,54,52,2,15,0,31,22,9,25,5,1,6,4,2,,,
"Oct 28, 2022 7:00 PM",84,28,56,28,14,14,47,25,22,32,20,12,0,0,0,7,20,13,7,24,21,3,12,0,29,22,7,26,5,2,4,3,1,,,
"Oct 28, 2022 8:00 PM",59,17,42,16,7,9,17,7,10,13,6,7,0,0,0,4,16,14,2,17,16,1,13,0,12,9,3,15,3,0,5,5,0,,,
"Oct 28, 2022 9:00 PM",39,13,26,11,7,4,9,6,3,8,4,4,0,0,0,7,9,8,1,11,11,0,8,0,4,3,1,6,1,2,4,1,3,,,
"Oct 28, 2022 10:00 PM",35,13,22,5,3,2,9,5,4,8,5,3,0,0,0,1,6,4,2,8,7,1,4,0,3,3,0,6,0,1,2,0,2,,,
"Oct 28, 2022 11:00 PM",26,3,23,6,5,1,8,4,4,6,3,3,0,0,0,5,7,6,1,6,6,0,8,0,8,5,3,6,0,0,2,1,1,,,
"Oct 29, 2022 12:00 AM",9,1,8,1,1,0,2,1,1,3,0,3,0,0,0,3,2,1,1,2,2,0,2,0,2,0,2,3,3,1,0,0,0,,,
"Oct 29, 2022 1:00 AM",12,3,9,0,0,0,2,1,1,1,0,1,0,0,0,4,2,2,0,7,7,0,1,0,1,1,0,2,0,0,0,0,0,,,
"Oct 29, 2022 2:00 AM",6,1,5,3,2,1,1,0,1,2,1,1,0,0,0,0,1,1,0,4,4,0,1,0,4,3,1,2,0,0,0,0,0,,,
"Oct 29, 2022 3:00 AM",6,0,6,5,3,2,2,2,0,4,3,1,0,0,0,0,0,0,0,3,3,0,0,0,1,1,0,3,0,0,0,0,0,,,
"Oct 29, 2022 4:00 AM",3,1,2,1,0,1,2,1,1,1,0,1,0,0,0,0,0,0,0,0,0,0,0,0,1,1,0,0,0,0,0,0,0,,,
"Oct 29, 2022 5:00 AM",3,0,3,0,0,0,0,0,0,1,0,1,0,0,0,1,2,2,0,2,2,0,1,0,1,1,0,1,0,0,0,0,0,,,
"Oct 29, 2022 6:00 AM",8,6,2,1,0,1,4,1,3,1,0,1,0,0,0,1,1,1,0,2,2,0,2,0,0,0,0,7,0,2,0,0,0,,,
"Oct 29, 2022 7:00 AM",14,6,8,7,5,2,8,6,2,6,5,1,0,0,0,1,4,3,1,1,1,0,1,0,1,1,0,4,0,0,0,0,0,,,
"Oct 29, 2022 8:00 AM",17,7,10,5,2,3,7,4,3,7,5,2,0,0,0,4,5,5,0,4,3,1,7,0,2,1,1,7,0,1,1,1,0,,,
"Oct 29, 2022 9:00 AM",20,10,10,9,4,5,16,12,4,14,11,3,0,0,0,0,7,7,0,4,2,2,7,0,7,7,0,8,1,0,1,1,0,,,
"Oct 29, 2022 10:00 AM",28,13,15,11,6,5,15,8,7,16,10,6,0,0,0,2,4,4,0,6,3,3,2,0,7,4,3,5,0,0,2,2,0,,,
"Oct 29, 2022 11:00 AM",20,14,6,7,2,5,13,5,8,12,7,5,0,0,0,13,5,4,1,4,3,1,2,0,8,5,3,11,0,0,0,0,0,,,
"Oct 29, 2022 12:00 PM",36,21,15,30,16,14,26,16,10,20,12,8,0,0,0,13,16,16,0,7,5,2,9,0,12,10,2,9,0,1,3,2,1,,,
"Oct 29, 2022 1:00 PM",44,20,24,15,9,6,46,22,24,26,15,11,0,0,0,9,16,14,2,5,5,0,11,0,24,14,10,16,2,2,6,2,4,,,
"Oct 29, 2022 2:00 PM",38,22,16,37,19,18,45,28,17,27,17,10,0,0,0,10,14,14,0,9,7,2,11,0,16,13,3,16,3,1,1,1,0,,,
"Oct 29, 2022 3:00 PM",32,17,15,34,17,17,54,32,22,41,23,18,0,0,0,14,13,13,0,7,4,3,12,0,16,12,4,14,4,2,6,4,2,,,
"Oct 29, 2022 4:00 PM",46,16,30,60,33,27,69,29,40,40,26,14,0,0,0,21,12,11,1,10,7,3,10,0,21,11,10,20,3,4,5,3,2,,,
"Oct 29, 2022 5:00 PM",51,24,27,37,17,20,45,17,28,34,12,22,0,0,0,16,22,17,5,8,6,2,16,0,12,4,8,25,4,3,5,2,3,,,
"Oct 29, 2022 6:00 PM",41,15,26,26,15,11,30,17,13,21,10,11,0,0,0,15,7,4,3,10,9,1,7,0,10,7,3,17,5,4,3,1,2,,,
"Oct 29, 2022 7:00 PM",37,19,18,9,4,5,15,4,11,12,4,8,0,0,0,7,5,4,1,10,8,2,3,0,5,1,4,22,1,0,5,2,3,,,
"Oct 29, 2022 8:00 PM",29,11,18,11,6,5,10,6,4,4,2,2,0,0,0,3,20,20,0,6,5,1,21,0,5,2,3,5,0,0,0,0,0,,,
"Oct 29, 2022 9:00 PM",19,5,14,3,2,1,4,1,3,2,1,1,0,0,0,3,1,1,0,4,4,0,1,0,3,1,2,6,2,0,0,0,0,,,
"Oct 29, 2022 10:00 PM",13,6,7,2,1,1,5,4,1,4,3,1,0,0,0,0,5,5,0,4,4,0,5,0,2,1,1,5,0,3,3,1,2,,,
"Oct 29, 2022 11:00 PM",16,4,12,1,1,0,6,3,3,1,0,1,0,0,0,0,8,7,1,5,5,0,7,0,2,2,0,2,0,0,0,0,0,,,
"Oct 30, 2022 12:00 AM",10,6,4,0,0,0,3,1,2,4,2,2,0,0,0,0,1,1,0,2,2,0,1,0,0,0,0,4,1,0,0,0,0,,,
"Oct 30, 2022 1:00 AM",17,5,12,3,2,1,3,2,1,4,3,1,0,0,0,2,4,4,0,2,2,0,3,0,3,3,0,2,3,1,2,1,1,,,
"Oct 30, 2022 2:00 AM",2,1,1,2,1,1,5,1,4,1,1,0,0,0,0,0,0,0,0,2,2,0,1,0,1,0,1,1,0,0,0,0,0,,,
"Oct 30, 2022 3:00 AM",3,1,2,0,0,0,0,0,0,0,0,0,0,0,0,0,0,0,0,0,0,0,0,0,1,1,0,1,0,0,0,0,0,,,
"Oct 30, 2022 4:00 AM",2,0,2,0,0,0,0,0,0,0,0,0,0,0,0,0,0,0,0,1,1,0,0,0,0,0,0,0,0,0,0,0,0,,,
"Oct 30, 2022 5:00 AM",4,1,3,0,0,0,1,0,1,0,0,0,0,0,0,0,1,1,0,1,0,1,1,0,0,0,0,2,0,0,1,1,0,,,
"Oct 30, 2022 6:00 AM",6,5,1,2,0,2,3,1,2,2,0,2,0,0,0,4,3,3,0,1,1,0,3,0,1,1,0,7,0,1,0,0,0,,,
"Oct 30, 2022 7:00 AM",12,5,7,17,10,7,17,13,4,13,10,3,0,0,0,2,9,9,0,7,4,3,11,0,4,2,2,16,0,3,0,0,0,,,
"Oct 30, 2022 8:00 AM",27,12,15,36,22,14,43,29,14,40,29,11,0,0,0,9,15,13,2,4,4,0,13,0,16,5,11,22,1,5,3,3,0,,,
"Oct 30, 2022 9:00 AM",52,24,28,109,68,41,108,68,40,97,66,31,0,0,0,17,21,20,1,10,7,3,25,0,37,28,9,32,3,6,5,4,1,,,
"Oct 30, 2022 10:00 AM",38,16,22,135,60,75,131,61,70,120,59,61,0,0,0,13,6,3,3,15,8,7,2,0,53,34,19,44,6,4,12,11,1,,,
"Oct 30, 2022 11:00 AM",10,2,8,112,61,51,112,62,50,111,63,48,0,0,0,20,21,12,9,30,15,15,15,0,48,31,17,51,5,4,5,4,1,,,
"Oct 30, 2022 12:00 PM",12,7,5,110,53,57,108,56,52,86,40,46,0,0,0,19,28,14,14,52,31,21,8,0,57,37,20,36,11,4,3,2,1,,,
"Oct 30, 2022 1:00 PM",49,39,10,83,42,41,100,54,46,67,38,29,0,0,0,22,28,27,1,33,18,15,10,0,59,37,22,26,0,6,3,2,1,,,
"Oct 30, 2022 2:00 PM",43,22,21,127,67,60,144,79,65,88,50,38,0,0,0,15,30,24,6,41,16,25,17,0,66,34,32,20,4,1,6,3,3,,,
"Oct 30, 2022 3:00 PM",45,24,21,89,43,46,144,62,82,83,40,43,0,0,0,12,8,5,3,24,11,13,5,0,70,36,34,30,11,1,8,6,2,,,
"Oct 30, 2022 4:00 PM",72,28,44,94,57,37,105,37,68,66,31,35,0,0,0,10,24,18,6,14,12,2,16,0,61,17,44,29,5,1,4,3,1,,,
"Oct 30, 2022 5:00 PM",68,26,42,48,19,29,50,20,30,45,16,29,0,0,0,12,21,17,4,17,16,1,16,0,21,14,7,18,3,2,3,3,0,,,
"Oct 30, 2022 6:00 PM",51,21,30,22,10,12,14,8,6,18,12,6,0,0,0,8,11,10,1,12,11,1,11,0,9,5,4,11,4,0,3,2,1,,,
"Oct 30, 2022 7:00 PM",40,17,23,14,10,4,18,8,10,13,5,8,0,0,0,8,13,11,2,6,5,1,10,0,4,3,1,9,2,1,0,0,0,,,
"Oct 30, 2022 8:00 PM",28,8,20,13,7,6,12,7,5,10,6,4,0,0,0,7,10,7,3,6,5,1,8,0,5,1,4,16,1,1,0,0,0,,,
"Oct 30, 2022 9:00 PM",19,7,12,3,2,1,8,5,3,3,1,2,0,0,0,2,4,4,0,5,5,0,4,0,4,3,1,10,1,1,4,0,4,,,
"Oct 30, 2022 10:00 PM",15,7,8,2,2,0,8,4,4,5,2,3,0,0,0,1,9,9,0,1,1,0,9,0,3,1,2,5,0,0,3,1,2,,,
"Oct 30, 2022 11:00 PM",14,3,11,0,0,0,0,0,0,5,4,1,0,0,0,1,3,2,1,1,1,0,2,0,3,1,2,1,0,0,0,0,0,,,
"Oct 31, 2022 12:00 AM",9,3,6,4,2,2,7,3,4,3,2,1,0,0,0,0,2,2,0,7,6,1,1,0,2,2,0,2,0,0,1,1,0,,,
"Oct 31, 2022 1:00 AM",5,3,2,0,0,0,3,3,0,0,0,0,0,0,0,1,2,2,0,0,0,0,2,0,1,0,1,1,0,0,0,0,0,,,
"Oct 31, 2022 2:00 AM",11,5,6,2,2,0,1,1,0,1,1,0,0,0,0,0,1,0,1,2,2,0,3,0,1,1,0,4,0,0,0,0,0,,,
"Oct 31, 2022 3:00 AM",4,2,2,0,0,0,1,0,1,1,0,1,0,0,0,0,1,0,1,3,3,0,0,0,1,1,0,1,0,0,0,0,0,,,
"Oct 31, 2022 4:00 AM",4,0,4,0,0,0,1,1,0,0,0,0,0,0,0,4,0,0,0,0,0,0,0,0,0,0,0,0,0,0,0,0,0,,,
"Oct 31, 2022 5:00 AM",1,0,1,0,0,0,1,0,1,1,0,1,0,0,0,1,0,0,0,2,2,0,0,0,0,0,0,3,0,0,0,0,0,,,
"Oct 31, 2022 6:00 AM",16,9,7,3,1,2,6,4,2,5,3,2,0,0,0,0,5,4,1,2,2,0,4,0,4,2,2,11,0,2,0,0,0,,,
"Oct 31, 2022 7:00 AM",25,12,13,9,3,6,11,7,4,9,5,4,0,0,0,2,8,7,1,9,7,2,6,0,5,3,2,13,1,2,0,0,0,,,
"Oct 31, 2022 8:00 AM",19,9,10,27,16,11,29,16,13,35,26,9,0,0,0,7,12,12,0,4,4,0,13,0,13,7,6,20,1,3,6,5,1,,,
"Oct 31, 2022 9:00 AM",30,15,15,53,33,20,52,39,13,53,41,12,0,0,0,8,12,12,0,4,1,3,11,0,23,13,10,7,2,0,3,2,1,,,
"Oct 31, 2022 10:00 AM",42,23,19,57,27,30,60,31,29,60,29,31,0,0,0,14,14,14,0,7,6,1,11,0,32,22,10,21,1,2,1,1,0,,,
"Oct 31, 2022 11:00 AM",45,22,23,71,33,38,85,41,44,73,33,40,0,0,0,15,16,16,0,7,6,1,15,0,34,23,11,28,2,1,6,4,2,,,
"Oct 31, 2022 12:00 PM",35,19,16,58,40,18,80,36,44,53,27,26,0,0,0,11,14,13,1,12,12,0,14,0,33,10,23,28,2,4,3,2,1,,,
"Oct 31, 2022 1:00 PM",35,15,20,35,16,19,49,18,31,40,20,20,0,0,0,4,13,11,2,10,9,1,8,0,21,8,13,17,3,3,4,1,3,,,
"Oct 31, 2022 2:00 PM",34,11,23,23,17,6,36,23,13,18,11,7,0,0,0,12,7,7,0,8,7,1,6,0,11,4,7,20,3,3,7,3,4,,,
"Oct 31, 2022 3:00 PM",28,19,9,16,5,11,27,14,13,15,6,9,0,0,0,3,6,6,0,10,10,0,4,0,11,6,5,8,3,2,4,3,1,,,
"Oct 31, 2022 4:00 PM",30,12,18,9,4,5,15,6,9,15,5,10,0,0,0,8,9,8,1,3,3,0,7,0,7,4,3,8,1,1,2,1,1,,,
"Oct 31, 2022 5:00 PM",45,20,25,12,6,6,9,4,5,10,4,6,0,0,0,4,3,1,2,8,8,0,1,0,6,2,4,9,2,0,4,4,0,,,
"Oct 31, 2022 6:00 PM",28,8,20,3,3,0,8,3,5,4,1,3,0,0,0,1,5,4,1,2,1,1,3,0,2,1,1,5,2,1,3,2,1,,,
"Oct 31, 2022 7:00 PM",34,12,22,2,2,0,10,5,5,5,3,2,0,0,0,9,2,1,1,10,7,3,0,0,4,4,0,5,1,0,3,2,1,,,
"Oct 31, 2022 8:00 PM",18,7,11,7,5,2,3,2,1,2,0,2,0,0,0,1,5,5,0,4,4,0,5,0,3,3,0,6,2,0,6,3,3,,,
"Oct 31, 2022 9:00 PM",11,4,7,0,0,0,1,0,1,3,0,3,0,0,0,1,2,1,1,1,1,0,1,0,1,0,1,2,0,1,3,2,1,,,
"Oct 31, 2022 10:00 PM",7,3,4,0,0,0,2,0,2,2,0,2,0,0,0,0,2,2,0,3,3,0,2,0,0,0,0,1,2,0,2,0,2,,,
"Oct 31, 2022 11:00 PM",9,4,5,0,0,0,0,0,0,0,0,0,0,0,0,4,3,3,0,1,1,0,3,0,0,0,0,0,1,0,3,2,1,,,
"Nov 1, 2022 12:00 AM",6,1,5,0,0,0,0,0,0,0,0,0,0,0,0,0,1,1,0,0,0,0,1,0,1,0,1,0,0,0,0,0,0,,,
"Nov 1, 2022 1:00 AM",4,1,3,0,0,0,0,0,0,0,0,0,0,0,0,2,0,0,0,0,0,0,0,0,0,0,0,0,0,0,1,0,1,,,
"Nov 1, 2022 2:00 AM",5,4,1,2,2,0,2,2,0,2,2,0,0,0,0,0,2,2,0,3,3,0,1,0,2,2,0,0,0,1,0,0,0,,,
"Nov 1, 2022 3:00 AM",1,0,1,0,0,0,0,0,0,0,0,0,0,0,0,0,0,0,0,1,1,0,1,0,0,0,0,0,0,0,0,0,0,,,
"Nov 1, 2022 4:00 AM",2,2,0,1,1,0,0,0,0,0,0,0,0,0,0,1,3,2,1,2,2,0,2,0,0,0,0,1,1,0,0,0,0,,,
"Nov 1, 2022 5:00 AM",4,2,2,2,1,1,2,1,1,5,2,3,0,0,0,0,6,6,0,3,1,2,5,0,1,0,1,7,0,0,0,0,0,,,
"Nov 1, 2022 6:00 AM",50,38,12,4,2,2,19,9,10,7,4,3,0,0,0,4,19,18,1,11,10,1,17,0,5,0,5,31,0,2,0,0,0,,,
"Nov 1, 2022 7:00 AM",118,77,41,42,10,32,56,15,41,42,13,29,0,0,0,12,60,60,0,15,11,4,58,0,28,11,17,105,0,3,7,5,2,,,
"Nov 1, 2022 8:00 AM",200,155,45,56,13,43,121,37,84,86,41,45,0,0,0,21,148,146,2,25,18,7,126,0,71,22,49,185,7,4,5,4,1,,,
"Nov 1, 2022 9:00 AM",104,85,19,43,14,29,69,33,36,56,32,24,0,0,0,8,86,85,1,15,11,4,65,0,38,19,19,57,3,8,4,4,0,,,
"Nov 1, 2022 10:00 AM",52,41,11,37,11,26,41,19,22,27,11,16,0,0,0,14,37,37,0,8,4,4,24,0,15,6,9,28,2,1,7,7,0,,,
"Nov 1, 2022 11:00 AM",56,37,19,40,18,22,39,21,18,36,17,19,0,0,0,16,32,31,1,8,6,2,25,0,20,15,5,21,6,2,7,5,2,,,
"Nov 1, 2022 12:00 PM",66,33,33,50,29,21,46,23,23,36,20,16,0,0,0,13,31,27,4,17,16,1,19,0,29,17,12,18,2,3,5,3,2,,,
"Nov 1, 2022 1:00 PM",86,40,46,64,31,33,74,43,31,58,34,24,0,0,0,16,28,26,2,15,12,3,22,0,40,16,24,27,2,7,3,1,2,,,
"Nov 1, 2022 2:00 PM",67,33,34,55,27,28,62,29,33,33,15,18,0,0,0,16,29,21,8,31,28,3,15,0,20,13,7,17,1,2,7,6,1,,,
"Nov 1, 2022 3:00 PM",75,30,45,47,28,19,65,36,29,35,20,15,0,0,0,20,38,32,6,28,26,2,25,0,30,19,11,20,7,4,4,2,2,,,
"Nov 1, 2022 4:00 PM",128,33,95,58,34,24,70,43,27,58,28,30,0,0,0,22,21,14,7,47,47,0,17,0,40,29,11,39,3,3,9,6,3,,,
"Nov 1, 2022 5:00 PM",202,49,153,54,43,11,96,54,42,63,31,32,0,0,0,26,39,30,9,95,92,3,26,0,50,35,15,49,9,4,18,12,6,,,
"Nov 1, 2022 6:00 PM",196,38,158,44,36,8,97,70,27,64,47,17,0,0,0,12,38,28,10,81,77,4,23,0,46,34,12,21,5,3,8,7,1,,,
"Nov 1, 2022 7:00 PM",91,24,67,10,8,2,29,22,7,14,11,3,0,0,0,11,24,21,3,39,36,3,19,0,11,8,3,20,7,1,6,3,3,,,
"Nov 1, 2022 8:00 PM",70,17,53,9,5,4,11,6,5,8,5,3,0,0,0,9,15,8,7,34,33,1,9,0,4,3,1,10,5,2,5,2,3,,,
"Nov 1, 2022 9:00 PM",44,13,31,4,4,0,8,3,5,8,3,5,0,0,0,3,8,7,1,23,23,0,7,0,10,5,5,8,0,3,0,0,0,,,
"Nov 1, 2022 10:00 PM",35,8,27,3,2,1,4,3,1,4,2,2,0,0,0,3,8,4,4,13,10,3,4,0,9,7,2,6,1,1,4,2,2,,,
"Nov 1, 2022 11:00 PM",12,4,8,3,2,1,4,3,1,3,2,1,0,0,0,3,0,0,0,2,2,0,0,0,3,0,3,2,0,1,0,0,0,,,
"Nov 2, 2022 12:00 AM",5,0,5,0,0,0,0,0,0,1,1,0,0,0,0,0,1,1,0,2,2,0,1,0,1,1,0,2,0,0,0,0,0,,,
"Nov 2, 2022 1:00 AM",4,0,4,0,0,0,0,0,0,0,0,0,0,0,0,0,3,0,3,0,0,0,2,0,0,0,0,0,0,0,0,0,0,,,
"Nov 2, 2022 2:00 AM",3,3,0,0,0,0,1,1,0,0,0,0,0,0,0,0,0,0,0,2,2,0,0,0,0,0,0,0,0,0,0,0,0,,,
"Nov 2, 2022 3:00 AM",0,0,0,0,0,0,0,0,0,0,0,0,0,0,0,0,0,0,0,0,0,0,0,0,0,0,0,0,0,0,0,0,0,,,
"Nov 2, 2022 4:00 AM",2,1,1,0,0,0,0,0,0,0,0,0,0,0,0,0,1,1,0,0,0,0,1,0,0,0,0,1,0,0,0,0,0,,,
"Nov 2, 2022 5:00 AM",6,4,2,2,0,2,2,0,2,3,0,3,0,0,0,1,9,9,0,3,1,2,10,0,0,0,0,10,0,0,0,0,0,,,
"Nov 2, 2022 6:00 AM",45,30,15,6,2,4,12,5,7,7,1,6,0,0,0,4,13,13,0,12,11,1,12,0,3,0,3,26,0,1,0,0,0,,,
"Nov 2, 2022 7:00 AM",104,69,35,32,10,22,52,21,31,27,8,19,0,0,0,6,65,65,0,14,11,3,53,18,22,5,17,86,3,2,5,4,1,,,
"Nov 2, 2022 8:00 AM",179,139,40,30,4,26,67,17,50,44,18,26,0,0,0,15,108,108,0,22,18,4,90,0,32,9,23,112,1,2,7,5,2,,,
"Nov 2, 2022 9:00 AM",96,81,15,19,5,14,28,11,17,28,18,10,0,0,0,4,54,54,0,12,6,6,36,0,21,7,14,45,1,4,3,2,1,,,
"Nov 2, 2022 10:00 AM",48,38,10,11,1,10,20,7,13,12,2,10,0,0,0,11,22,21,1,15,8,7,13,0,10,4,6,10,2,2,3,3,0,,,
"Nov 2, 2022 11:00 AM",22,11,11,5,2,3,3,1,2,4,1,3,0,0,0,2,13,11,2,1,1,0,6,0,1,0,1,11,0,2,1,0,1,,,
"Nov 2, 2022 12:00 PM",25,15,10,6,4,2,3,3,0,3,3,0,0,0,0,1,8,7,1,8,7,1,5,0,0,0,0,2,1,0,5,4,1,,,
"Nov 2, 2022 1:00 PM",37,19,18,11,9,2,13,7,6,6,4,2,0,0,0,3,11,8,3,12,11,1,5,0,9,6,3,3,1,2,3,1,2,,,
"Nov 2, 2022 2:00 PM",29,15,14,21,11,10,19,11,8,15,8,7,0,0,0,6,15,12,3,15,12,3,8,0,5,4,1,10,0,2,2,0,2,,,
"Nov 2, 2022 3:00 PM",47,20,27,13,3,10,19,10,9,15,6,9,0,0,0,11,24,16,8,10,10,0,13,0,18,11,7,7,1,0,3,3,0,,,
"Nov 2, 2022 4:00 PM",85,20,65,18,9,9,23,16,7,20,10,10,0,0,0,22,27,17,10,23,22,1,15,0,31,22,9,31,2,2,2,2,0,,,
"Nov 2, 2022 5:00 PM",171,43,128,33,22,11,49,33,16,34,21,13,0,0,0,20,34,26,8,63,60,3,21,0,37,25,12,33,3,2,14,6,8,,,
"Nov 2, 2022 6:00 PM",156,27,129,24,21,3,48,39,9,37,27,10,0,0,0,7,18,16,2,50,49,1,15,0,28,25,3,21,1,3,3,1,2,,,
"Nov 2, 2022 7:00 PM",67,18,49,9,9,0,21,17,4,11,9,2,0,0,0,3,14,9,5,26,26,0,8,0,11,9,2,14,1,5,4,3,1,,,
"Nov 2, 2022 8:00 PM",48,9,39,10,6,4,16,12,4,13,10,3,0,0,0,6,12,6,6,21,19,2,7,0,13,12,1,8,1,3,2,2,0,,,
"Nov 2, 2022 9:00 PM",27,5,22,6,5,1,7,6,1,4,1,3,0,0,0,3,1,1,0,11,11,0,2,0,5,4,1,8,5,0,4,3,1,,,
"Nov 2, 2022 10:00 PM",27,7,20,7,5,2,2,1,1,1,1,0,0,0,0,4,6,3,3,15,12,3,3,0,0,0,0,5,1,0,1,0,1,,,
"Nov 2, 2022 11:00 PM",6,2,4,1,0,1,3,2,1,2,1,1,0,0,0,0,5,4,1,3,3,0,4,0,0,0,0,2,0,0,0,0,0,,,
"Nov 3, 2022 12:00 AM",7,2,5,0,0,0,0,0,0,1,1,0,0,0,0,0,0,0,0,4,4,0,0,0,1,0,1,0,2,0,0,0,0,,,
"Nov 3, 2022 1:00 AM",2,0,2,0,0,0,3,1,2,0,0,0,0,0,0,0,0,0,0,0,0,0,0,0,1,1,0,0,0,0,0,0,0,,,
"Nov 3, 2022 2:00 AM",2,2,0,0,0,0,1,0,1,0,0,0,0,0,0,0,0,0,0,0,0,0,0,0,1,0,1,1,0,0,0,0,0,,,
"Nov 3, 2022 3:00 AM",0,0,0,0,0,0,0,0,0,0,0,0,0,0,0,0,0,0,0,0,0,0,0,0,0,0,0,0,0,0,0,0,0,,,
"Nov 3, 2022 4:00 AM",1,1,0,0,0,0,0,0,0,0,0,0,0,0,0,0,1,1,0,0,0,0,1,0,0,0,0,0,0,0,0,0,0,,,
"Nov 3, 2022 5:00 AM",7,6,1,0,0,0,1,0,1,2,0,2,0,0,0,3,6,6,0,4,2,2,6,0,1,1,0,7,1,0,0,0,0,,,
"Nov 3, 2022 6:00 AM",51,32,19,8,2,6,16,9,7,12,6,6,0,0,0,6,19,19,0,9,8,1,18,0,5,0,5,25,0,3,0,0,0,,,
"Nov 3, 2022 7:00 AM",109,75,34,30,9,21,64,23,41,35,16,19,0,0,0,4,59,59,0,13,8,5,50,0,26,7,19,82,2,2,8,7,1,,,
"Nov 3, 2022 8:00 AM",236,193,43,64,12,52,115,37,78,78,30,48,0,0,0,15,144,143,1,22,13,9,115,0,68,18,50,159,3,5,10,7,3,,,
"Nov 3, 2022 9:00 AM",113,96,17,53,18,35,76,30,46,51,33,18,0,0,0,14,79,78,1,19,14,5,48,0,37,20,17,63,1,10,0,0,0,,,
"Nov 3, 2022 10:00 AM",82,66,16,55,26,29,98,55,43,71,43,28,0,0,0,10,51,48,3,9,8,1,39,0,37,17,20,36,3,2,2,2,0,,,
"Nov 3, 2022 11:00 AM",65,46,19,62,27,35,73,36,37,49,28,21,0,0,0,15,28,22,6,10,8,2,16,0,32,17,15,25,2,7,7,4,3,,,
"Nov 3, 2022 12:00 PM",74,39,35,67,30,37,75,35,40,55,28,27,0,0,0,24,30,28,2,13,9,4,16,0,36,21,15,27,6,6,9,7,2,,,
"Nov 3, 2022 1:00 PM",79,36,43,64,39,25,49,24,25,54,23,31,0,0,0,10,21,18,3,17,14,3,12,0,19,10,9,29,4,2,2,2,0,,,
"Nov 3, 2022 2:00 PM",86,38,48,35,15,20,49,22,27,34,12,22,0,0,0,8,21,20,1,11,11,0,12,0,15,7,8,22,4,4,6,4,2,,,
"Nov 3, 2022 3:00 PM",78,27,51,22,10,12,31,13,18,23,10,13,0,0,0,10,17,11,6,24,24,0,8,0,22,9,13,21,3,2,6,5,1,,,
"Nov 3, 2022 4:00 PM",114,21,93,26,16,10,55,33,22,35,18,17,0,0,0,20,27,18,9,33,30,3,19,0,29,22,7,31,6,4,5,3,2,,,
"Nov 3, 2022 5:00 PM",191,45,146,45,30,15,80,52,28,53,33,20,0,0,0,10,50,30,20,75,74,1,26,0,43,28,15,43,7,5,9,6,3,,,
"Nov 3, 2022 6:00 PM",185,39,146,38,34,4,79,64,15,60,48,12,0,0,0,10,24,15,9,67,66,1,15,0,39,32,7,23,2,1,3,2,1,,,
"Nov 3, 2022 7:00 PM",98,19,79,30,22,8,34,25,9,23,17,6,0,0,0,10,22,15,7,45,43,2,13,0,15,14,1,13,3,3,9,6,3,,,
"Nov 3, 2022 8:00 PM",66,12,54,11,9,2,11,5,6,8,2,6,0,0,0,6,13,6,7,28,26,2,7,0,4,3,1,11,2,0,2,1,1,,,
"Nov 3, 2022 9:00 PM",52,15,37,9,8,1,12,7,5,10,7,3,0,0,0,5,13,8,5,18,18,0,8,0,6,6,0,8,2,3,2,0,2,,,
"Nov 3, 2022 10:00 PM",41,9,32,5,5,0,9,5,4,8,3,5,0,0,0,4,9,7,2,18,15,3,6,0,3,3,0,5,0,1,0,0,0,,,
"Nov 3, 2022 11:00 PM",26,7,19,2,2,0,3,1,2,1,0,1,0,0,0,2,3,1,2,5,5,0,1,0,1,1,0,4,0,1,0,0,0,,,
"Nov 4, 2022 12:00 AM",11,2,9,0,0,0,0,0,0,3,3,0,0,0,0,0,0,0,0,5,5,0,0,0,3,1,2,2,1,0,0,0,0,,,
"Nov 4, 2022 1:00 AM",4,0,4,0,0,0,1,1,0,1,1,0,0,0,0,0,0,0,0,1,1,0,0,0,0,0,0,2,1,0,1,1,0,,,
"Nov 4, 2022 2:00 AM",3,2,1,2,1,1,1,1,0,3,3,0,0,0,0,0,0,0,0,0,0,0,0,0,0,0,0,0,0,0,1,1,0,,,
"Nov 4, 2022 3:00 AM",1,0,1,0,0,0,0,0,0,0,0,0,0,0,0,0,0,0,0,0,0,0,0,0,0,0,0,2,0,0,0,0,0,,,
"Nov 4, 2022 4:00 AM",3,1,2,0,0,0,1,1,0,1,1,0,0,0,0,0,1,1,0,0,0,0,1,0,1,1,0,2,0,0,0,0,0,,,
"Nov 4, 2022 5:00 AM",4,3,1,4,2,2,4,2,2,2,1,1,0,0,0,1,6,6,0,2,1,1,5,0,2,1,1,5,1,0,0,0,0,,,
"Nov 4, 2022 6:00 AM",48,29,19,10,5,5,19,9,10,11,5,6,0,0,0,4,16,15,1,5,4,1,16,0,13,8,5,21,0,2,0,0,0,,,
"Nov 4, 2022 7:00 AM",75,47,28,50,17,33,62,24,38,40,20,20,0,0,0,11,57,57,0,9,7,2,50,0,20,8,12,59,0,1,4,4,0,,,
"Nov 4, 2022 8:00 AM",164,123,41,61,24,37,105,45,60,62,26,36,0,0,0,7,111,111,0,18,13,5,91,0,45,18,27,109,7,2,8,6,2,,,
"Nov 4, 2022 9:00 AM",113,93,20,54,17,37,86,41,45,53,27,26,0,0,0,18,70,68,2,24,13,11,47,0,45,20,25,50,1,3,2,2,0,,,
"Nov 4, 2022 10:00 AM",62,42,20,35,23,12,83,39,44,50,25,25,0,0,0,17,41,38,3,15,12,3,28,0,27,14,13,33,3,5,3,2,1,,,
"Nov 4, 2022 11:00 AM",61,32,29,44,24,20,63,32,31,46,30,16,0,0,0,9,27,24,3,13,10,3,19,0,34,15,19,29,5,0,4,3,1,,,
"Nov 4, 2022 12:00 PM",70,33,37,65,26,39,65,35,30,55,25,30,0,0,0,16,38,36,2,23,16,7,28,0,33,13,20,23,3,1,4,1,3,,,
"Nov 4, 2022 1:00 PM",84,43,41,64,28,36,55,20,35,56,22,34,0,0,0,11,31,26,5,17,16,1,22,0,26,17,9,17,6,0,5,5,0,,,
"Nov 4, 2022 2:00 PM",83,41,42,49,19,30,49,23,26,52,23,29,0,0,0,15,24,20,4,16,15,1,15,0,17,13,4,21,3,2,4,3,1,,,
"Nov 4, 2022 3:00 PM",91,32,59,52,31,21,59,40,19,45,26,19,0,0,0,22,25,18,7,25,23,2,11,0,33,24,9,23,4,4,10,8,2,,,
"Nov 4, 2022 4:00 PM",114,38,76,50,34,16,59,32,27,54,33,21,0,0,0,15,33,22,11,49,47,2,17,0,30,21,9,43,3,2,6,4,2,,,
"Nov 4, 2022 5:00 PM",162,47,115,63,36,27,67,47,20,65,35,30,0,0,0,21,27,21,6,54,51,3,20,0,32,22,10,32,10,2,11,6,5,,,
"Nov 4, 2022 6:00 PM",125,39,86,36,18,18,52,35,17,39,24,15,0,0,0,18,29,24,5,49,47,2,22,0,22,19,3,20,1,1,8,4,4,,,
"Nov 4, 2022 7:00 PM",71,23,48,22,14,8,37,18,19,24,13,11,0,0,0,14,15,12,3,21,20,1,13,0,12,8,4,21,4,2,5,5,0,,,
"Nov 4, 2022 8:00 PM",46,16,30,6,4,2,18,10,8,17,10,7,0,0,0,11,12,7,5,6,6,0,7,0,8,6,2,9,2,0,3,3,0,,,
"Nov 4, 2022 9:00 PM",41,11,30,14,9,5,18,12,6,12,6,6,0,0,0,9,14,10,4,15,15,0,7,0,6,4,2,9,0,0,1,1,0,,,
"Nov 4, 2022 10:00 PM",37,9,28,7,5,2,6,3,3,11,5,6,0,0,0,2,8,7,1,14,13,1,6,0,3,2,1,7,0,1,2,0,2,,,
"Nov 4, 2022 11:00 PM",26,6,20,3,3,0,12,6,6,6,3,3,0,0,0,5,5,4,1,8,8,0,4,0,2,2,0,9,0,0,1,1,0,,,
"Nov 5, 2022 12:00 AM",12,2,10,2,2,0,5,4,1,1,1,0,0,0,0,2,1,0,1,10,9,1,0,0,2,2,0,6,0,0,0,0,0,,,
"Nov 5, 2022 1:00 AM",6,2,4,2,2,0,4,3,1,4,3,1,0,0,0,0,0,0,0,1,1,0,1,0,2,0,2,4,2,0,0,0,0,,,
"Nov 5, 2022 2:00 AM",9,2,7,0,0,0,0,0,0,0,0,0,0,0,0,0,2,2,0,3,3,0,2,0,0,0,0,2,0,0,0,0,0,,,
"Nov 5, 2022 3:00 AM",3,0,3,0,0,0,0,0,0,0,0,0,0,0,0,1,0,0,0,3,3,0,0,0,1,1,0,1,0,0,0,0,0,,,
"Nov 5, 2022 4:00 AM",4,1,3,0,0,0,0,0,0,0,0,0,0,0,0,2,1,1,0,0,0,0,0,0,0,0,0,0,0,0,0,0,0,,,
"Nov 5, 2022 5:00 AM",2,1,1,0,0,0,1,0,1,1,0,1,0,0,0,3,1,1,0,1,1,0,1,0,1,1,0,0,0,0,0,0,0,,,
"Nov 5, 2022 6:00 AM",13,8,5,0,0,0,3,2,1,1,0,1,0,0,0,3,4,4,0,2,2,0,4,0,1,1,0,1,0,4,0,0,0,,,
"Nov 5, 2022 7:00 AM",21,11,10,12,8,4,21,14,7,14,11,3,0,0,0,4,4,3,1,7,7,0,2,0,0,0,0,7,0,2,1,0,1,,,
"Nov 5, 2022 8:00 AM",35,18,17,22,14,8,30,21,9,21,15,6,0,0,0,8,10,8,2,5,5,0,7,0,13,10,3,14,1,3,0,0,0,,,
"Nov 5, 2022 9:00 AM",41,23,18,67,38,29,89,57,32,68,47,21,0,0,0,11,23,22,1,16,10,6,23,0,29,18,11,27,4,5,2,1,1,,,
"Nov 5, 2022 10:00 AM",45,27,18,81,38,43,89,53,36,73,43,30,0,0,0,8,18,17,1,5,5,0,15,0,29,17,12,34,0,6,4,3,1,,,
"Nov 5, 2022 11:00 AM",47,26,21,91,41,50,92,48,44,84,50,34,0,0,0,11,19,18,1,20,13,7,14,0,41,25,16,24,4,5,0,0,0,,,
"Nov 5, 2022 12:00 PM",59,27,32,83,33,50,100,45,55,85,37,48,0,0,0,13,13,13,0,15,11,4,12,0,45,24,21,24,8,5,7,6,1,,,
"Nov 5, 2022 1:00 PM",59,34,25,104,47,57,92,38,54,91,47,44,0,0,0,16,21,21,0,13,11,2,11,0,32,14,18,30,2,4,6,3,3,,,
"Nov 5, 2022 2:00 PM",68,40,28,100,50,50,68,39,29,71,43,28,0,0,0,33,29,26,3,9,7,2,24,0,35,25,10,25,5,3,7,5,2,,,
"Nov 5, 2022 3:00 PM",49,25,24,98,54,44,93,48,45,83,49,34,0,0,0,28,22,22,0,11,10,1,16,0,48,21,27,28,8,0,4,2,2,,,
"Nov 5, 2022 4:00 PM",81,49,32,76,34,42,71,30,41,70,30,40,0,0,0,29,28,24,4,8,8,0,18,0,38,11,27,46,5,3,7,4,3,,,
"Nov 5, 2022 5:00 PM",97,48,49,37,17,20,60,22,38,50,18,32,0,0,0,12,20,12,8,9,8,1,15,0,27,9,18,28,4,2,6,1,5,,,
"Nov 5, 2022 6:00 PM",42,16,26,17,10,7,21,10,11,17,8,9,0,0,0,18,13,12,1,19,17,2,12,0,11,5,6,11,0,0,1,1,0,,,
"Nov 5, 2022 7:00 PM",43,18,25,14,5,9,18,9,9,17,8,9,0,0,0,6,15,12,3,7,7,0,12,0,11,7,4,7,3,2,2,2,0,,,
"Nov 5, 2022 8:00 PM",35,10,25,23,11,12,20,10,10,20,10,10,0,0,0,9,11,11,0,12,12,0,10,0,4,2,2,8,1,1,5,3,2,,,
"Nov 5, 2022 9:00 PM",17,7,10,11,6,5,13,6,7,8,3,5,0,0,0,7,3,3,0,4,3,1,3,0,3,2,1,6,2,0,0,0,0,,,
"Nov 5, 2022 10:00 PM",21,9,12,3,1,2,3,1,2,4,1,3,0,0,0,1,4,4,0,7,6,1,4,0,1,1,0,6,0,1,1,0,1,,,
"Nov 5, 2022 11:00 PM",18,6,12,11,11,0,6,4,2,1,1,0,0,0,0,4,3,3,0,3,3,0,4,0,4,4,0,3,0,0,0,0,0,,,
"Nov 6, 2022 12:00 AM",11,2,9,0,0,0,3,1,2,4,2,2,0,0,0,2,2,2,0,5,5,0,2,0,3,1,2,4,0,0,0,0,0,,,
"Nov 6, 2022 1:00 AM",6,1,5,1,1,0,2,2,0,0,0,0,0,0,0,0,1,1,0,4,3,1,1,0,5,3,2,0,0,0,2,1,1,,,
"Nov 6, 2022 2:00 AM",8,2,6,0,0,0,1,1,0,0,0,0,0,0,0,0,0,0,0,3,3,0,1,0,2,2,0,4,0,1,0,0,0,,,
"Nov 6, 2022 3:00 AM",0,0,0,0,0,0,1,1,0,1,1,0,0,0,0,2,0,0,0,0,0,0,0,0,0,0,0,0,0,0,0,0,0,,,
"Nov 6, 2022 4:00 AM",5,1,4,0,0,0,0,0,0,0,0,0,0,0,0,0,0,0,0,2,2,0,0,0,2,2,0,1,0,0,0,0,0,,,
"Nov 6, 2022 5:00 AM",0,0,0,0,0,0,0,0,0,0,0,0,0,0,0,0,2,2,0,2,1,1,2,0,0,0,0,2,0,0,0,0,0,,,
"Nov 6, 2022 6:00 AM",14,12,2,0,0,0,1,1,0,0,0,0,0,0,0,3,1,1,0,1,1,0,1,0,2,2,0,4,0,1,0,0,0,,,
"Nov 6, 2022 7:00 AM",7,4,3,17,8,9,19,13,6,15,11,4,0,0,0,3,8,8,0,8,5,3,7,0,4,3,1,14,0,1,0,0,0,,,
"Nov 6, 2022 8:00 AM",33,19,14,64,39,25,70,53,17,71,51,20,0,0,0,3,21,21,0,3,3,0,22,0,17,12,5,19,2,1,3,2,1,,,
"Nov 6, 2022 9:00 AM",48,34,14,128,75,53,120,85,35,95,75,20,0,0,0,11,18,17,1,2,2,0,18,0,24,15,9,35,2,10,7,5,2,,,
"Nov 6, 2022 10:00 AM",47,25,22,154,72,82,170,92,78,130,79,51,0,0,0,19,21,19,2,17,16,1,15,0,67,46,21,36,5,4,6,4,2,,,
"Nov 6, 2022 11:00 AM",61,42,19,167,84,83,187,109,78,168,81,87,0,0,0,25,18,17,1,10,9,1,14,0,74,31,43,43,8,7,13,7,6,,,
"Nov 6, 2022 12:00 PM",73,35,38,147,62,85,192,73,119,125,63,62,0,0,0,31,26,26,0,15,15,0,24,0,80,46,34,47,8,2,2,2,0,,,
"Nov 6, 2022 1:00 PM",68,33,35,135,74,61,145,57,88,115,57,58,0,0,0,14,16,14,2,33,30,3,14,0,62,35,27,35,4,3,11,4,7,,,
"Nov 6, 2022 2:00 PM",55,24,31,105,46,59,113,62,51,93,45,48,0,0,0,18,31,26,5,11,9,2,21,0,48,21,27,31,3,1,3,2,1,,,
"Nov 6, 2022 3:00 PM",59,30,29,119,61,58,101,49,52,91,54,37,0,0,0,27,17,16,1,10,10,0,16,0,57,33,24,23,3,3,9,6,3,,,
"Nov 6, 2022 4:00 PM",60,18,42,79,48,31,83,35,48,80,36,44,0,0,0,17,26,20,6,17,16,1,14,0,46,21,25,28,5,4,8,6,2,,,
"Nov 6, 2022 5:00 PM",44,20,24,54,37,17,49,26,23,42,21,21,0,0,0,8,11,8,3,7,7,0,6,0,19,11,8,15,3,0,5,4,1,,,
"Nov 6, 2022 6:00 PM",56,28,28,17,6,11,24,9,15,18,7,11,0,0,0,8,23,15,8,10,9,1,16,0,11,7,4,16,1,2,5,5,0,,,
"Nov 6, 2022 7:00 PM",27,13,14,6,2,4,16,3,13,12,3,9,0,0,0,5,7,7,0,8,7,1,5,0,5,2,3,14,0,0,4,2,2,,,
"Nov 6, 2022 8:00 PM",34,14,20,15,9,6,13,7,6,15,10,5,0,0,0,5,5,5,0,4,4,0,4,0,5,2,3,6,0,0,1,0,1,,,
"Nov 6, 2022 9:00 PM",28,8,20,2,2,0,6,2,4,3,1,2,0,0,0,5,4,4,0,8,8,0,5,0,1,0,1,7,1,1,0,0,0,,,
"Nov 6, 2022 10:00 PM",12,7,5,3,2,1,5,1,4,1,0,1,0,0,0,3,4,4,0,5,5,0,5,0,0,0,0,4,1,0,3,2,1,,,
"Nov 6, 2022 11:00 PM",10,1,9,1,0,1,2,1,1,1,0,1,0,0,0,0,0,0,0,2,2,0,0,0,2,1,1,7,0,2,0,0,0,,,
"Nov 7, 2022 12:00 AM",4,0,4,0,0,0,0,0,0,3,3,0,0,0,0,0,0,0,0,0,0,0,0,,1,1,0,1,1,0,1,1,0,,,
"Nov 7, 2022 1:00 AM",4,0,4,0,0,0,0,0,0,0,0,0,0,0,0,0,1,1,0,1,1,0,1,,0,0,0,1,0,0,0,0,0,,,
"Nov 7, 2022 2:00 AM",1,1,0,0,0,0,1,1,0,0,0,0,0,0,0,0,1,1,0,1,1,0,0,,0,0,0,0,0,0,0,0,0,,,
"Nov 7, 2022 3:00 AM",1,0,1,0,0,0,0,0,0,0,0,0,0,0,0,0,0,0,0,0,0,0,0,,0,0,0,0,0,0,0,0,0,,,
"Nov 7, 2022 4:00 AM",1,0,1,0,0,0,0,0,0,0,0,0,0,0,0,0,2,2,0,0,0,0,2,,0,0,0,1,0,0,0,0,0,,,
"Nov 7, 2022 5:00 AM",8,4,4,1,1,0,2,1,1,2,1,1,0,0,0,1,9,9,0,3,2,1,9,,0,0,0,8,0,0,1,1,0,,,
"Nov 7, 2022 6:00 AM",47,30,17,10,4,6,15,6,9,13,6,7,0,0,0,11,15,15,0,7,6,1,15,,8,3,5,33,0,3,1,1,0,,,
"Nov 7, 2022 7:00 AM",114,80,34,49,15,34,64,18,46,38,13,25,0,0,0,9,69,68,1,18,14,4,68,,20,7,13,102,1,4,5,5,0,,,
"Nov 7, 2022 8:00 AM",240,188,52,75,17,58,121,37,84,82,26,56,0,0,0,36,189,185,4,43,28,15,146,,73,23,50,180,6,6,18,18,0,,,
"Nov 7, 2022 9:00 AM",134,114,20,48,19,29,77,37,40,61,33,28,0,0,0,14,106,105,1,21,14,7,63,,31,17,14,45,1,3,5,3,2,,,
"Nov 7, 2022 10:00 AM",80,59,21,34,13,21,42,20,22,26,12,14,0,0,0,19,44,40,4,13,9,4,22,,20,7,13,16,0,0,0,0,0,,,
"Nov 7, 2022 11:00 AM",56,38,18,39,24,15,30,15,15,20,11,9,0,0,0,5,16,11,5,9,5,4,7,,18,10,8,20,0,1,2,2,0,,,
"Nov 7, 2022 12:00 PM",68,38,30,33,9,24,39,16,23,31,11,20,0,0,0,6,18,17,1,9,5,4,13,,22,9,13,12,1,1,2,1,1,,,
"Nov 7, 2022 1:00 PM",76,27,49,14,6,8,30,13,17,16,9,7,0,0,0,12,23,17,6,20,19,1,13,,11,4,7,21,0,0,1,1,0,,,
"Nov 7, 2022 2:00 PM",93,34,59,15,9,6,19,12,7,14,8,6,0,0,0,25,22,21,1,17,15,2,9,,12,8,4,16,2,1,3,1,2,,,
"Nov 7, 2022 3:00 PM",75,29,46,18,13,5,35,27,8,22,15,7,0,0,0,11,30,24,6,25,19,6,12,,24,20,4,27,0,0,5,1,4,,,
"Nov 7, 2022 4:00 PM",133,33,100,35,25,10,42,33,9,43,33,10,0,0,0,24,23,18,5,65,55,10,18,,18,15,3,29,3,3,8,5,3,,,
"Nov 7, 2022 5:00 PM",193,42,151,36,28,8,77,48,29,50,30,20,0,0,0,17,44,26,18,99,96,3,25,,42,39,3,48,4,3,10,6,4,,,
"Nov 7, 2022 6:00 PM",146,19,127,29,25,4,56,43,13,32,24,8,0,0,0,9,37,25,12,84,81,3,24,,31,24,7,19,2,1,8,4,4,,,
"Nov 7, 2022 7:00 PM",82,17,65,11,10,1,22,18,4,14,10,4,0,0,0,8,25,13,12,28,27,1,10,,17,13,4,17,1,1,6,4,2,,,
"Nov 7, 2022 8:00 PM",44,10,34,5,5,0,13,8,5,5,3,2,0,0,0,5,12,5,7,21,21,0,8,,8,7,1,4,1,0,1,0,1,,,
"Nov 7, 2022 9:00 PM",40,10,30,5,5,0,11,8,3,7,6,1,0,0,0,7,12,5,7,13,13,0,4,,4,2,2,12,4,0,1,1,0,,,
"Nov 7, 2022 10:00 PM",29,3,26,1,1,0,4,3,1,2,1,1,0,0,0,2,7,4,3,9,9,0,4,,2,2,0,5,0,0,0,0,0,,,
"Nov 7, 2022 11:00 PM",10,2,8,2,1,1,6,2,4,0,0,0,0,0,0,2,3,2,1,4,4,0,2,,0,0,0,3,0,0,0,0,0,,,
"Nov 8, 2022 12:00 AM",5,0,5,1,1,0,1,1,0,1,1,0,0,0,0,1,0,0,0,2,2,0,0,,1,1,0,1,0,0,1,0,1,,,
"Nov 8, 2022 1:00 AM",0,0,0,0,0,0,0,0,0,0,0,0,0,0,0,0,0,0,0,1,1,0,0,0,1,1,0,0,0,0,0,0,0,,,
"Nov 8, 2022 2:00 AM",3,1,2,0,0,0,1,1,0,2,1,1,0,0,0,1,0,0,0,0,0,0,0,0,1,0,1,0,0,0,0,0,0,,,
"Nov 8, 2022 3:00 AM",1,0,1,0,0,0,0,0,0,0,0,0,0,0,0,0,0,0,0,0,0,0,0,,0,0,0,0,0,0,0,0,0,,,
"Nov 8, 2022 4:00 AM",3,1,2,0,0,0,0,0,0,0,0,0,0,0,0,0,3,3,0,0,0,0,3,,0,0,0,1,0,1,1,1,0,,,
"Nov 8, 2022 5:00 AM",7,6,1,1,0,1,0,0,0,0,0,0,0,0,0,1,9,9,0,2,0,2,10,,0,0,0,6,0,0,0,0,0,,,
"Nov 8, 2022 6:00 AM",44,28,16,8,2,6,24,8,16,19,8,11,0,0,0,8,16,16,0,11,8,3,12,,7,1,6,33,0,3,0,0,0,,,
"Nov 8, 2022 7:00 AM",155,103,52,37,9,28,63,17,46,38,15,23,0,0,0,15,83,81,2,25,23,2,73,,33,11,22,126,2,4,8,8,0,,,
"Nov 8, 2022 8:00 AM",317,260,57,91,16,75,143,45,98,114,41,73,0,0,0,48,224,223,1,49,33,16,180,,76,19,57,215,8,9,16,14,2,,,
"Nov 8, 2022 9:00 AM",174,148,26,58,20,38,82,37,45,64,35,29,0,0,0,14,108,106,2,20,13,7,77,,43,21,22,89,3,4,5,4,1,,,
"Nov 8, 2022 10:00 AM",91,72,19,40,22,18,65,38,27,43,26,17,0,0,0,14,57,56,1,15,9,6,39,,23,12,11,35,1,3,3,2,1,,,
"Nov 8, 2022 11:00 AM",57,37,20,44,17,27,68,33,35,44,18,26,0,0,0,7,32,29,3,16,12,4,16,,25,8,17,24,4,5,5,3,2,,,
"Nov 8, 2022 12:00 PM",68,37,31,47,22,25,60,26,34,44,25,19,0,0,0,11,33,30,3,10,10,0,19,,29,17,12,25,6,5,6,4,2,,,
"Nov 8, 2022 1:00 PM",96,45,51,48,22,26,85,46,39,52,27,25,0,0,0,17,38,32,6,29,27,2,17,0,33,16,17,26,3,4,9,5,4,,,
"Nov 8, 2022 2:00 PM",75,33,42,44,19,25,49,21,28,36,18,18,0,0,0,11,30,24,6,28,27,1,21,16,21,9,12,21,3,1,9,6,3,,,
"Nov 8, 2022 3:00 PM",103,35,68,38,21,17,56,30,26,38,20,18,0,0,0,20,41,28,13,31,24,7,19,35,27,18,9,22,5,5,9,5,4,,,
"Nov 8, 2022 4:00 PM",169,45,124,63,49,14,82,52,30,72,44,28,0,0,0,27,49,33,16,73,64,9,25,73,53,42,11,50,4,1,12,6,6,,,
"Nov 8, 2022 5:00 PM",256,55,201,63,45,18,101,64,37,72,43,29,0,0,0,29,60,45,15,108,102,6,33,115,51,34,17,51,6,7,10,7,3,,,
"Nov 8, 2022 6:00 PM",237,52,185,62,43,19,107,73,34,79,54,25,0,0,0,26,53,42,11,110,107,3,34,118,67,56,11,41,6,1,11,6,5,,,
"Nov 8, 2022 7:00 PM",127,34,93,22,19,3,43,35,8,31,22,9,0,0,0,15,31,19,12,58,55,3,18,54,25,19,6,25,4,1,6,5,1,,,
"Nov 8, 2022 8:00 PM",95,27,68,27,19,8,36,24,12,30,21,9,0,0,0,12,12,4,8,33,32,1,7,20,19,13,6,19,4,4,4,1,3,,,
"Nov 8, 2022 9:00 PM",51,7,44,10,6,4,21,12,9,14,8,6,0,0,0,5,12,9,3,17,17,0,7,19,7,4,3,8,2,3,2,1,1,,,
"Nov 8, 2022 10:00 PM",42,6,36,8,8,0,12,5,7,9,5,4,0,0,0,8,5,2,3,19,16,3,3,10,2,2,0,8,1,2,2,0,2,,,
"Nov 8, 2022 11:00 PM",22,7,15,1,1,0,5,2,3,5,0,5,0,0,0,6,6,2,4,2,2,0,3,7,4,3,1,3,0,2,1,1,0,,,
"Nov 9, 2022 12:00 AM",6,0,6,1,0,1,2,1,1,1,0,1,0,0,0,0,1,1,0,3,3,0,1,7,0,0,0,2,2,0,0,0,0,,,
"Nov 9, 2022 1:00 AM",6,1,5,0,0,0,1,1,0,0,0,0,0,0,0,0,0,0,0,0,0,0,0,4,2,1,1,1,0,0,0,0,0,,,
"Nov 9, 2022 2:00 AM",3,2,1,0,0,0,1,1,0,1,1,0,0,0,0,0,0,0,0,0,0,0,0,0,0,0,0,0,0,0,0,0,0,,,
"Nov 9, 2022 3:00 AM",1,0,1,0,0,0,0,0,0,0,0,0,0,0,0,0,0,0,0,1,1,0,0,2,0,0,0,1,0,0,0,0,0,,,
"Nov 9, 2022 4:00 AM",3,1,2,0,0,0,1,1,0,1,1,0,0,0,0,0,2,2,0,2,2,0,2,0,0,0,0,0,0,1,0,0,0,,,
"Nov 9, 2022 5:00 AM",11,9,2,2,0,2,3,1,2,3,1,2,0,0,0,2,8,8,0,1,0,1,8,3,1,0,1,8,0,0,0,0,0,,,
"Nov 9, 2022 6:00 AM",43,31,12,11,3,8,15,3,12,15,6,9,0,0,0,6,18,18,0,11,9,2,17,14,6,1,5,38,0,1,2,2,0,,,
"Nov 9, 2022 7:00 AM",153,106,47,52,19,33,81,27,54,53,19,34,0,0,0,13,97,96,1,30,26,4,82,43,30,5,25,126,1,3,7,6,1,,,
"Nov 9, 2022 8:00 AM",321,257,64,103,22,81,165,45,120,117,40,77,0,0,0,34,234,231,3,40,30,10,182,55,88,21,67,237,4,8,16,14,2,,,
"Nov 9, 2022 9:00 AM",146,123,23,40,17,23,73,33,40,63,35,28,0,0,0,17,95,92,3,14,10,4,62,25,31,11,20,75,5,5,5,4,1,,,
"Nov 9, 2022 10:00 AM",73,55,18,27,11,16,30,17,13,21,11,10,0,0,0,16,52,51,1,12,6,6,31,9,13,4,9,31,2,3,5,5,0,,,
"Nov 9, 2022 11:00 AM",57,42,15,30,12,18,46,22,24,31,16,15,0,0,0,8,35,32,3,15,10,5,23,12,20,10,10,21,1,4,2,1,1,,,
"Nov 9, 2022 12:00 PM",58,31,27,47,20,27,55,30,25,42,22,20,0,0,0,9,30,26,4,12,11,1,18,18,37,23,14,24,1,3,6,4,2,,,
"Nov 9, 2022 1:00 PM",83,31,52,45,27,18,72,42,30,41,27,14,0,0,0,10,37,30,7,33,31,2,16,28,30,19,11,32,4,5,3,1,2,,,
"Nov 9, 2022 2:00 PM",86,36,50,47,19,28,53,26,27,40,15,25,0,0,0,16,27,22,5,26,24,2,12,25,36,21,15,28,4,4,8,5,3,,,
"Nov 9, 2022 3:00 PM",105,44,61,37,21,16,48,27,21,35,20,15,0,0,0,11,36,25,11,30,27,3,11,22,32,18,14,22,3,2,10,6,4,,,
"Nov 9, 2022 4:00 PM",157,49,108,48,29,19,63,37,26,49,26,23,0,0,0,18,44,30,14,60,54,6,26,67,40,30,10,44,8,5,8,5,3,,,
"Nov 9, 2022 5:00 PM",260,55,205,55,44,11,94,66,28,74,49,25,0,0,0,23,65,40,25,127,123,4,35,111,62,42,20,47,14,9,13,9,4,,,
"Nov 9, 2022 6:00 PM",233,59,174,55,46,9,90,70,20,72,53,19,0,0,0,20,47,33,14,98,96,2,26,114,57,45,12,40,4,1,5,3,2,,,
"Nov 9, 2022 7:00 PM",129,35,94,30,20,10,48,32,16,41,24,17,0,0,0,7,24,15,9,48,45,3,14,52,18,12,6,18,3,4,3,2,1,,,
"Nov 9, 2022 8:00 PM",91,25,66,22,19,3,27,21,6,20,14,6,0,0,0,8,20,14,6,31,29,2,12,29,15,11,4,14,5,3,8,5,3,,,
"Nov 9, 2022 9:00 PM",51,11,40,21,16,5,19,15,4,16,11,5,0,0,0,1,13,11,2,20,18,2,9,35,12,7,5,12,5,1,3,0,3,,,
"Nov 9, 2022 10:00 PM",59,7,52,10,6,4,15,7,8,11,6,5,0,0,0,2,12,6,6,14,14,0,7,10,4,3,1,7,2,1,2,1,1,,,
"Nov 9, 2022 11:00 PM",21,5,16,1,1,0,10,5,5,4,1,3,0,0,0,1,6,3,3,3,3,0,3,11,4,3,1,5,0,1,1,0,1,,,
"Nov 10, 2022 12:00 AM",11,4,7,0,0,0,0,0,0,1,0,1,0,0,0,1,2,1,1,3,3,0,2,4,1,1,0,2,0,0,1,1,0,,,
"Nov 10, 2022 1:00 AM",3,1,2,0,0,0,0,0,0,0,0,0,0,0,0,4,2,0,2,0,0,0,1,2,1,1,0,0,0,0,0,0,0,,,
"Nov 10, 2022 2:00 AM",3,2,1,0,0,0,2,2,0,1,1,0,0,0,0,0,0,0,0,1,1,0,0,0,1,1,0,0,0,0,0,0,0,,,
"Nov 10, 2022 3:00 AM",3,0,3,0,0,0,0,0,0,0,0,0,0,0,0,0,0,0,0,0,0,0,0,1,0,0,0,1,0,0,0,0,0,,,
"Nov 10, 2022 4:00 AM",2,1,1,1,0,1,4,2,2,0,0,0,0,0,0,0,1,1,0,1,1,0,1,0,1,1,0,0,0,0,0,0,0,,,
"Nov 10, 2022 5:00 AM",4,3,1,3,0,3,5,1,4,6,3,3,0,0,0,3,5,5,0,4,3,1,4,4,0,0,0,7,1,0,0,0,0,,,
"Nov 10, 2022 6:00 AM",42,29,13,10,3,7,14,3,11,10,3,7,0,0,0,7,17,17,0,12,11,1,17,14,6,1,5,28,0,6,1,1,0,,,
"Nov 10, 2022 7:00 AM",105,73,32,30,8,22,61,17,44,40,12,28,0,0,0,10,86,83,3,30,25,5,75,24,26,8,18,100,1,0,6,5,1,,,
"Nov 10, 2022 8:00 AM",324,255,69,96,23,73,144,48,96,122,42,80,0,0,0,36,196,194,2,38,27,11,160,53,72,16,56,226,8,6,22,18,4,,,
"Nov 10, 2022 9:00 AM",167,133,34,51,13,38,81,30,51,54,22,32,0,0,0,11,82,80,2,15,11,4,60,20,38,18,20,68,3,5,8,7,1,,,
"Nov 10, 2022 10:00 AM",72,58,14,35,11,24,51,25,26,38,22,16,0,0,0,7,59,54,5,16,13,3,34,10,20,10,10,25,1,5,3,1,2,,,
"Nov 10, 2022 11:00 AM",46,29,17,44,22,22,49,27,22,44,21,23,0,0,0,5,30,29,1,10,8,2,17,14,21,15,6,27,4,6,5,2,3,,,
"Nov 10, 2022 12:00 PM",54,27,27,40,22,18,45,28,17,26,15,11,0,0,0,6,27,24,3,16,14,2,19,20,33,18,15,12,2,4,7,3,4,,,
"Nov 10, 2022 1:00 PM",79,35,44,44,25,19,83,41,42,36,20,16,0,0,0,10,37,30,7,19,17,2,21,26,32,15,17,32,3,1,7,6,1,,,
"Nov 10, 2022 2:00 PM",74,33,41,36,19,17,43,22,21,24,17,7,0,0,0,10,34,28,6,19,18,1,13,22,20,11,9,24,0,2,3,2,1,,,
"Nov 10, 2022 3:00 PM",98,37,61,30,15,15,43,25,18,29,15,14,0,0,0,12,33,26,7,39,33,6,15,29,16,12,4,34,4,3,5,4,1,,,
"Nov 10, 2022 4:00 PM",165,43,122,30,24,6,72,49,23,46,30,16,0,0,0,18,39,20,19,49,47,2,19,67,34,21,13,54,1,1,4,1,3,,,
"Nov 10, 2022 5:00 PM",232,51,181,48,34,14,79,48,31,52,30,22,0,0,0,21,50,32,18,92,90,2,32,88,48,38,10,48,4,5,4,2,2,,,
"Nov 10, 2022 6:00 PM",211,43,168,50,47,3,101,79,22,70,59,11,0,0,0,19,46,39,7,107,100,7,34,103,50,36,14,40,1,1,11,9,2,,,
"Nov 10, 2022 7:00 PM",121,34,87,27,17,10,43,25,18,39,23,16,0,0,0,7,19,15,4,46,44,2,16,48,25,24,1,20,3,4,8,3,5,,,
"Nov 10, 2022 8:00 PM",83,27,56,18,13,5,32,21,11,22,14,8,0,0,0,10,10,6,4,32,32,0,5,20,10,8,2,6,5,2,5,2,3,,,
"Nov 10, 2022 9:00 PM",36,11,25,13,10,3,18,10,8,12,7,5,0,0,0,3,11,11,0,13,13,0,9,23,9,7,2,22,2,1,1,1,0,,,
"Nov 10, 2022 10:00 PM",47,10,37,9,6,3,11,5,6,11,4,7,0,0,0,6,9,5,4,24,22,2,5,19,5,2,3,12,0,0,2,2,0,,,
"Nov 10, 2022 11:00 PM",20,3,17,9,4,5,3,1,2,4,1,3,0,0,0,2,6,3,3,8,8,0,4,6,2,2,0,3,1,1,0,0,0,,,
"Nov 11, 2022 12:00 AM",12,1,11,0,0,0,3,2,1,4,3,1,0,0,0,3,3,2,1,4,4,0,2,7,4,3,1,4,0,0,2,1,1,,,
"Nov 11, 2022 1:00 AM",4,0,4,0,0,0,2,2,0,1,0,1,0,0,0,0,0,0,0,4,4,0,0,4,2,2,0,4,0,0,0,0,0,,,
"Nov 11, 2022 2:00 AM",3,1,2,2,2,0,3,1,2,3,3,0,0,0,0,0,1,0,1,2,2,0,0,2,1,0,1,0,0,0,0,0,0,,,
"Nov 11, 2022 3:00 AM",6,1,5,0,0,0,0,0,0,0,0,0,0,0,0,0,0,0,0,1,0,1,0,0,1,1,0,0,0,0,0,0,0,,,
"Nov 11, 2022 4:00 AM",5,1,4,1,1,0,1,1,0,1,1,0,0,0,0,0,0,0,0,0,0,0,0,0,1,1,0,0,0,0,0,0,0,,,
"Nov 11, 2022 5:00 AM",9,7,2,1,1,0,5,2,3,3,2,1,0,0,0,0,7,7,0,5,4,1,6,4,0,0,0,6,0,0,0,0,0,,,
"Nov 11, 2022 6:00 AM",38,20,18,9,1,8,14,5,9,7,2,5,0,0,0,3,16,16,0,11,8,3,16,8,2,1,1,27,0,2,0,0,0,,,
"Nov 11, 2022 7:00 AM",93,66,27,52,26,26,49,18,31,37,23,14,0,0,0,10,53,53,0,16,14,2,45,19,24,13,11,68,0,2,9,9,0,,,
"Nov 11, 2022 8:00 AM",200,149,51,94,18,76,125,30,95,100,26,74,0,0,0,24,121,114,7,31,23,8,103,41,67,24,43,131,5,4,17,13,4,,,
"Nov 11, 2022 9:00 AM",88,66,22,40,16,24,62,24,38,53,25,28,0,0,0,9,67,65,2,19,14,5,48,17,30,11,19,59,1,3,3,2,1,,,
"Nov 11, 2022 10:00 AM",43,31,12,37,10,27,38,23,15,39,19,20,0,0,0,12,44,43,1,15,11,4,28,14,14,8,6,20,2,2,2,0,2,,,
"Nov 11, 2022 11:00 AM",57,38,19,23,14,9,40,21,19,15,7,8,0,0,0,4,35,27,8,15,12,3,18,13,15,11,4,19,3,1,2,1,1,,,
"Nov 11, 2022 12:00 PM",66,29,37,31,19,12,50,32,18,33,26,7,0,0,0,4,28,24,4,18,15,3,18,20,29,24,5,15,2,0,4,3,1,,,
"Nov 11, 2022 1:00 PM",79,36,43,48,28,20,71,33,38,45,25,20,0,0,0,12,37,31,6,23,20,3,27,21,33,14,19,19,2,2,5,2,3,,,
"Nov 11, 2022 2:00 PM",93,46,47,38,20,18,67,36,31,36,21,15,0,0,0,14,17,15,2,21,17,4,14,32,31,19,12,22,1,0,7,4,3,,,
"Nov 11, 2022 3:00 PM",82,31,51,36,19,17,60,35,25,51,30,21,0,0,0,11,35,29,6,18,17,1,26,36,19,12,7,36,1,1,5,1,4,,,
"Nov 11, 2022 4:00 PM",113,33,80,67,43,24,77,51,26,53,36,17,0,0,0,9,27,25,2,68,64,4,14,57,42,29,13,36,7,3,11,10,1,,,
"Nov 11, 2022 5:00 PM",169,50,119,46,35,11,62,40,22,54,35,19,0,0,0,23,32,26,6,65,61,4,21,60,36,27,9,44,5,2,8,5,3,,,
"Nov 11, 2022 6:00 PM",124,39,85,33,22,11,57,44,13,41,28,13,0,0,0,10,27,21,6,57,55,2,17,56,34,31,3,28,2,1,7,5,2,,,
"Nov 11, 2022 7:00 PM",88,34,54,20,14,6,30,21,9,28,17,11,0,0,0,5,13,12,1,22,21,1,13,22,12,12,0,38,7,1,2,1,1,,,
"Nov 11, 2022 8:00 PM",59,26,33,23,10,13,32,19,13,26,14,12,0,0,0,7,9,5,4,8,7,1,8,23,19,10,9,16,0,2,3,1,2,,,
"Nov 11, 2022 9:00 PM",36,9,27,14,11,3,20,15,5,17,12,5,0,0,0,1,14,12,2,10,10,0,11,8,9,4,5,7,1,0,1,0,1,,,
"Nov 11, 2022 10:00 PM",34,8,26,8,6,2,18,10,8,12,6,6,0,0,0,3,2,2,0,8,7,1,3,7,8,6,2,12,1,1,2,1,1,,,
"Nov 11, 2022 11:00 PM",29,12,17,8,7,1,5,2,3,3,2,1,0,0,0,2,6,4,2,5,5,0,4,9,2,1,1,5,0,0,1,1,0,,,
"Nov 12, 2022 12:00 AM",14,3,11,2,2,0,4,2,2,5,2,3,0,0,0,3,3,2,1,9,9,0,3,6,5,3,2,2,0,1,0,0,0,,,
"Nov 12, 2022 1:00 AM",4,0,4,4,4,0,4,1,3,2,1,1,0,0,0,1,0,0,0,3,3,0,0,5,3,2,1,3,0,0,0,0,0,,,
"Nov 12, 2022 2:00 AM",8,0,8,1,1,0,3,2,1,1,0,1,0,0,0,0,1,1,0,4,4,0,1,2,0,0,0,3,1,0,0,0,0,,,
"Nov 12, 2022 3:00 AM",4,2,2,0,0,0,1,1,0,2,2,0,0,0,0,0,0,0,0,1,1,0,1,3,2,2,0,2,0,0,0,0,0,,,
"Nov 12, 2022 4:00 AM",5,0,5,1,0,1,1,0,1,1,0,1,0,0,0,0,0,0,0,1,1,0,0,3,0,0,0,1,0,0,1,0,1,,,
"Nov 12, 2022 5:00 AM",3,0,3,0,0,0,4,2,2,1,0,1,0,0,0,1,0,0,0,0,0,0,0,3,0,0,0,2,0,0,1,1,0,,,
"Nov 12, 2022 6:00 AM",5,4,1,1,1,0,9,6,3,2,1,1,0,0,0,1,1,1,0,4,4,0,0,3,2,1,1,3,0,1,0,0,0,,,
"Nov 12, 2022 7:00 AM",19,11,8,26,14,12,19,15,4,21,16,5,0,0,0,3,13,13,0,6,6,0,10,9,9,6,3,14,0,3,3,1,2,,,
"Nov 12, 2022 8:00 AM",39,18,21,47,26,21,52,29,23,36,26,10,0,0,0,6,24,23,1,4,3,1,21,15,11,6,5,16,4,1,6,4,2,,,
"Nov 12, 2022 9:00 AM",65,39,26,74,38,36,75,47,28,69,48,21,0,0,0,10,20,20,0,11,9,2,14,30,32,18,14,27,0,8,4,3,1,,,
"Nov 12, 2022 10:00 AM",60,39,21,79,37,42,78,48,30,88,48,40,0,0,0,12,43,40,3,22,18,4,34,25,34,20,14,30,4,5,3,1,2,,,
"Nov 12, 2022 11:00 AM",67,43,24,88,42,46,109,55,54,85,43,42,0,0,0,9,32,28,4,18,14,4,24,23,40,20,20,47,6,10,4,2,2,,,
"Nov 12, 2022 12:00 PM",72,43,29,77,32,45,113,55,58,69,28,41,0,0,0,9,34,33,1,15,13,2,28,37,41,23,18,52,6,7,10,6,4,,,
"Nov 12, 2022 1:00 PM",86,51,35,64,35,29,113,70,43,84,59,25,0,0,0,12,40,35,5,21,19,2,30,29,64,42,22,23,6,4,5,3,2,,,
"Nov 12, 2022 2:00 PM",63,30,33,69,46,23,60,31,29,49,19,30,0,0,0,19,27,21,6,15,13,2,17,22,32,17,15,24,3,2,5,3,2,,,
"Nov 12, 2022 3:00 PM",81,28,53,42,24,18,87,41,46,51,28,23,0,0,0,29,18,13,5,11,9,2,11,27,52,22,30,34,4,3,10,7,3,,,
"Nov 12, 2022 4:00 PM",69,20,49,37,20,17,59,22,37,34,16,18,0,0,0,21,17,14,3,22,21,1,11,22,39,9,30,28,4,3,8,5,3,,,
"Nov 12, 2022 5:00 PM",71,25,46,29,19,10,38,17,21,31,13,18,0,0,0,18,15,13,2,13,12,1,16,21,16,7,9,15,4,2,8,4,4,,,
"Nov 12, 2022 6:00 PM",69,29,40,9,6,3,24,13,11,21,12,9,0,0,0,6,8,8,0,13,12,1,7,11,9,3,6,13,4,2,5,3,2,,,
"Nov 12, 2022 7:00 PM",53,25,28,7,6,1,14,10,4,9,4,5,0,0,0,9,11,9,2,9,8,1,11,3,6,6,0,14,1,0,2,0,2,,,
"Nov 12, 2022 8:00 PM",55,28,27,5,2,3,12,7,5,5,4,1,0,0,0,3,7,5,2,8,7,1,4,8,10,7,3,7,1,0,1,1,0,,,
"Nov 12, 2022 9:00 PM",28,12,16,6,5,1,4,3,1,6,4,2,0,0,0,4,4,4,0,2,2,0,3,3,3,2,1,7,0,1,1,0,1,,,
"Nov 12, 2022 10:00 PM",18,4,14,5,2,3,6,2,4,3,3,0,0,0,0,2,5,5,0,6,5,1,7,4,1,1,0,4,0,1,6,3,3,,,
"Nov 12, 2022 11:00 PM",15,4,11,2,0,2,10,1,9,3,0,3,0,0,0,2,2,2,0,1,1,0,2,7,2,1,1,8,1,0,0,0,0,,,
"Nov 13, 2022 12:00 AM",9,2,7,0,0,0,0,0,0,1,1,0,0,0,0,2,0,0,0,2,2,0,0,2,2,2,0,3,2,2,1,1,0,,,
"Nov 13, 2022 1:00 AM",8,2,6,2,1,1,4,2,2,4,2,2,0,0,0,2,1,0,1,7,7,0,0,4,1,0,1,5,0,0,0,0,0,,,
"Nov 13, 2022 2:00 AM",10,4,6,1,1,0,1,1,0,1,1,0,0,0,0,1,2,2,0,4,4,0,2,2,1,1,0,3,0,0,0,0,0,,,
"Nov 13, 2022 3:00 AM",4,1,3,0,0,0,1,1,0,0,0,0,0,0,0,1,0,0,0,1,1,0,0,2,1,1,0,3,0,0,0,0,0,,,
"Nov 13, 2022 4:00 AM",5,1,4,0,0,0,0,0,0,0,0,0,0,0,0,0,0,0,0,3,3,0,0,1,1,1,0,0,0,0,0,0,0,,,
"Nov 13, 2022 5:00 AM",3,0,3,0,0,0,0,0,0,0,0,0,0,0,0,1,1,1,0,1,0,1,1,1,0,0,0,0,0,0,1,0,1,,,
"Nov 13, 2022 6:00 AM",7,5,2,6,3,3,4,1,3,3,1,2,0,0,0,1,2,2,0,3,3,0,2,4,2,1,1,7,0,1,2,2,0,,,
"Nov 13, 2022 7:00 AM",14,9,5,2,0,2,6,3,3,7,4,3,0,0,0,2,10,10,0,3,2,1,9,3,5,3,2,16,0,3,0,0,0,,,
"Nov 13, 2022 8:00 AM",29,15,14,45,17,28,39,29,10,35,27,8,0,0,0,4,9,8,1,9,7,2,5,12,8,7,1,14,0,2,2,1,1,,,
"Nov 13, 2022 9:00 AM",29,12,17,111,61,50,96,62,34,95,67,28,0,0,0,14,18,17,1,11,11,0,17,18,46,32,14,20,8,16,7,6,1,,,
"Nov 13, 2022 10:00 AM",29,19,10,118,55,63,116,59,57,103,49,54,0,0,0,21,23,20,3,14,11,3,18,28,53,29,24,22,5,2,5,3,2,,,
"Nov 13, 2022 11:00 AM",52,33,19,139,78,61,121,80,41,105,62,43,0,0,0,16,12,12,0,15,12,3,10,33,56,37,19,24,7,0,8,8,0,,,
"Nov 13, 2022 12:00 PM",71,37,34,139,65,74,148,76,72,111,61,50,0,0,0,32,16,15,1,16,14,2,16,24,73,37,36,31,6,2,8,5,3,,,
"Nov 13, 2022 1:00 PM",64,29,35,103,53,50,145,68,77,86,38,48,0,0,0,30,21,19,2,25,23,2,17,28,61,36,25,48,6,10,6,3,3,,,
"Nov 13, 2022 2:00 PM",68,35,33,98,42,56,131,54,77,88,36,52,0,0,0,33,35,35,0,7,5,2,32,25,63,33,30,35,10,2,5,4,1,,,
"Nov 13, 2022 3:00 PM",51,31,20,74,38,36,101,41,60,62,30,32,0,0,0,36,20,17,3,8,8,0,12,18,42,21,21,33,6,3,6,2,4,,,
"Nov 13, 2022 4:00 PM",60,23,37,48,24,24,58,26,32,49,19,30,0,0,0,20,22,20,2,17,16,1,22,22,31,18,13,31,3,1,6,5,1,,,
"Nov 13, 2022 5:00 PM",56,18,38,23,12,11,36,11,25,25,11,14,0,0,0,14,14,13,1,15,13,2,13,15,22,11,11,32,1,0,3,2,1,,,
"Nov 13, 2022 6:00 PM",42,13,29,11,6,5,28,14,14,18,10,8,0,0,0,5,6,5,1,11,10,1,4,14,11,5,6,15,0,1,5,2,3,,,
"Nov 13, 2022 7:00 PM",40,17,23,11,8,3,11,7,4,14,7,7,0,0,0,12,11,10,1,6,6,0,8,10,8,5,3,10,1,1,2,1,1,,,
"Nov 13, 2022 8:00 PM",26,6,20,5,2,3,10,1,9,7,2,5,0,0,0,5,9,9,0,9,9,0,9,9,3,2,1,7,1,0,2,2,0,,,
"Nov 13, 2022 9:00 PM",19,8,11,5,5,0,6,4,2,4,3,1,0,0,0,5,4,4,0,2,2,0,5,5,4,2,2,5,2,0,3,1,2,,,
"Nov 13, 2022 10:00 PM",12,3,9,6,3,3,4,1,3,2,1,1,0,0,0,3,6,6,0,2,2,0,5,4,1,1,0,3,0,0,0,0,0,,,
"Nov 13, 2022 11:00 PM",9,3,6,0,0,0,1,1,0,1,0,1,0,0,0,1,0,0,0,2,2,0,0,3,1,1,0,3,0,0,1,1,0,,,
"Nov 14, 2022 12:00 AM",9,1,8,0,0,0,1,1,0,0,0,0,0,0,0,2,0,0,0,2,2,0,0,1,0,0,0,2,1,0,1,1,0,,,
"Nov 14, 2022 1:00 AM",6,1,5,0,0,0,0,0,0,0,0,0,0,0,0,0,1,0,1,2,1,1,0,2,0,0,0,0,1,0,0,0,0,,,
"Nov 14, 2022 2:00 AM",1,1,0,0,0,0,0,0,0,0,0,0,0,0,0,0,0,0,0,1,1,0,0,0,0,0,0,2,0,0,0,0,0,,,
"Nov 14, 2022 3:00 AM",0,0,0,0,0,0,0,0,0,0,0,0,0,0,0,0,0,0,0,2,2,0,0,0,2,2,0,0,0,0,0,0,0,,,
"Nov 14, 2022 4:00 AM",3,1,2,1,0,1,1,0,1,1,0,1,0,0,0,1,1,1,0,0,0,0,1,1,2,1,1,0,0,0,1,1,0,,,
"Nov 14, 2022 5:00 AM",6,3,3,0,0,0,3,0,3,2,0,2,0,0,0,1,8,8,0,2,1,1,7,3,1,0,1,7,0,0,0,0,0,,,
"Nov 14, 2022 6:00 AM",46,27,19,6,2,4,11,3,8,10,2,8,0,0,0,5,16,16,0,6,6,0,17,7,5,0,5,27,0,2,1,1,0,,,
"Nov 14, 2022 7:00 AM",125,88,37,33,8,25,61,16,45,37,15,22,0,0,0,12,88,87,1,22,20,2,75,31,28,7,21,103,3,2,5,4,1,,,
"Nov 14, 2022 8:00 AM",290,223,67,91,17,74,146,40,106,102,32,70,0,0,0,30,194,190,4,42,27,15,158,44,89,24,65,189,3,9,21,16,5,,,
"Nov 14, 2022 9:00 AM",159,142,17,42,16,26,79,40,39,63,39,24,0,0,0,15,103,101,2,24,11,13,73,29,42,15,27,63,6,1,10,7,3,,,
"Nov 14, 2022 10:00 AM",67,52,15,37,15,22,42,22,20,35,22,13,0,0,0,15,49,42,7,11,6,5,19,13,27,16,11,22,1,3,3,2,1,,,
"Nov 14, 2022 11:00 AM",61,39,22,20,12,8,31,17,14,21,12,9,0,0,0,4,31,28,3,12,8,4,17,5,23,13,10,18,5,4,5,3,2,,,
"Nov 14, 2022 12:00 PM",66,33,33,53,23,30,43,22,21,38,13,25,0,0,0,15,33,27,6,9,7,2,19,16,26,15,11,19,2,1,4,3,1,,,
"Nov 14, 2022 1:00 PM",95,50,45,58,31,27,76,43,33,46,23,23,0,0,0,14,33,27,6,18,16,2,21,25,32,15,17,26,3,2,2,2,0,,,
"Nov 14, 2022 2:00 PM",72,30,42,43,25,18,65,33,32,43,26,17,0,0,0,19,25,17,8,28,26,2,14,22,26,14,12,11,2,7,6,3,3,,,
"Nov 14, 2022 3:00 PM",96,42,54,37,20,17,71,41,30,44,25,19,0,0,0,17,33,24,9,25,23,2,14,33,42,27,15,28,2,3,4,2,2,,,
"Nov 14, 2022 4:00 PM",143,38,105,75,47,28,89,62,27,68,45,23,0,0,0,25,26,19,7,62,59,3,19,74,43,31,12,35,6,3,5,3,2,,,
"Nov 14, 2022 5:00 PM",236,57,179,51,34,17,96,59,37,71,45,26,0,0,0,22,45,29,16,107,104,3,27,93,48,29,19,50,6,4,14,8,6,,,
"Nov 14, 2022 6:00 PM",215,45,170,40,33,7,98,73,25,58,39,19,0,0,0,17,53,39,14,103,100,3,33,96,49,35,14,40,3,3,12,7,5,,,
"Nov 14, 2022 7:00 PM",121,21,100,23,19,4,42,30,12,21,13,8,0,0,0,6,25,17,8,40,37,3,15,51,32,26,6,16,3,4,4,3,1,,,
"Nov 14, 2022 8:00 PM",72,18,54,8,8,0,26,13,13,26,12,14,0,0,0,4,18,13,5,30,29,1,13,15,8,7,1,14,1,0,3,1,2,,,
"Nov 14, 2022 9:00 PM",38,9,29,7,7,0,12,8,4,10,8,2,0,0,0,7,17,9,8,17,16,1,7,13,12,10,2,10,4,0,1,1,0,,,
"Nov 14, 2022 10:00 PM",31,7,24,2,2,0,5,3,2,2,0,2,0,0,0,1,11,4,7,11,11,0,3,6,1,1,0,8,0,0,1,1,0,,,
"Nov 14, 2022 11:00 PM",14,3,11,0,0,0,4,3,1,1,1,0,0,0,0,4,5,2,3,2,2,0,2,5,0,0,0,0,0,0,0,0,0,,,
"Nov 15, 2022 12:00 AM",5,0,5,0,0,0,0,0,0,1,1,0,0,0,0,1,0,0,0,0,0,0,0,0,0,0,0,2,1,0,1,1,0,,,
"Nov 15, 2022 1:00 AM",1,0,1,0,0,0,0,0,0,0,0,0,0,0,0,0,0,0,0,0,0,0,0,0,0,0,0,1,0,0,0,0,0,,,
"Nov 15, 2022 2:00 AM",1,1,0,0,0,0,0,0,0,0,0,0,0,0,0,0,0,0,0,0,0,0,0,0,0,0,0,0,0,0,0,0,0,,,
"Nov 15, 2022 3:00 AM",1,1,0,0,0,0,0,0,0,0,0,0,0,0,0,0,0,0,0,0,0,0,0,1,1,1,0,0,0,1,0,0,0,,,
"Nov 15, 2022 4:00 AM",3,1,2,2,1,1,2,1,1,2,1,1,0,0,0,0,1,1,0,0,0,0,1,0,2,1,1,1,0,0,0,0,0,,,
"Nov 15, 2022 5:00 AM",9,6,3,5,1,4,4,1,3,3,1,2,0,0,0,1,8,8,0,1,0,1,8,2,1,0,1,9,0,2,0,0,0,,,
"Nov 15, 2022 6:00 AM",61,36,25,8,1,7,16,2,14,11,1,10,0,0,0,7,22,22,0,7,6,1,20,13,5,1,4,37,1,4,0,0,0,,,
"Nov 15, 2022 7:00 AM",148,104,44,35,7,28,68,19,49,43,14,29,0,0,0,18,91,88,3,28,25,3,83,23,34,9,25,130,1,3,9,9,0,,,
"Nov 15, 2022 8:00 AM",391,316,75,94,21,73,157,46,111,120,40,80,0,0,0,40,230,227,3,50,33,17,188,59,83,23,60,231,10,10,26,23,3,,,
"Nov 15, 2022 9:00 AM",157,134,23,57,21,36,91,45,46,74,39,35,0,0,0,19,92,89,3,25,22,3,67,32,52,21,31,85,2,5,6,3,3,,,
"Nov 15, 2022 10:00 AM",96,69,27,53,22,31,61,29,32,49,22,27,0,0,0,12,56,53,3,14,12,2,36,18,23,9,14,37,1,3,4,4,0,,,
"Nov 15, 2022 11:00 AM",74,42,32,43,22,21,41,23,18,45,26,19,0,0,0,19,41,40,1,18,15,3,24,8,25,12,13,36,5,3,9,6,3,,,
"Nov 15, 2022 12:00 PM",61,30,31,52,31,21,71,40,31,49,26,23,0,0,0,14,43,39,4,16,15,1,21,14,31,23,8,21,4,4,7,6,1,,,
"Nov 15, 2022 1:00 PM",100,43,57,59,29,30,84,41,43,66,36,30,0,0,0,10,36,32,4,24,24,0,27,19,37,20,17,38,5,6,3,2,1,,,
"Nov 15, 2022 2:00 PM",92,43,49,48,23,25,76,35,41,35,21,14,0,0,0,28,32,21,11,33,32,1,18,34,33,14,19,30,5,1,7,6,1,,,
"Nov 15, 2022 3:00 PM",109,42,67,53,30,23,65,35,30,42,23,19,0,0,0,19,42,36,6,31,27,4,27,36,37,16,21,34,5,1,7,6,1,,,
"Nov 15, 2022 4:00 PM",134,37,97,49,33,16,72,41,31,70,44,26,0,0,0,28,41,31,10,79,75,4,25,77,50,34,16,35,11,4,9,4,5,,,
"Nov 15, 2022 5:00 PM",255,55,200,56,42,14,116,71,45,85,51,34,0,0,0,23,59,37,22,101,99,2,41,123,66,48,18,56,11,5,15,7,8,,,
"Nov 15, 2022 6:00 PM",233,49,184,74,59,15,113,89,24,76,58,18,0,0,0,21,48,39,9,99,93,6,35,107,70,58,12,45,3,5,5,3,2,,,
"Nov 15, 2022 7:00 PM",157,31,126,33,28,5,54,41,13,42,34,8,0,0,0,9,30,20,10,57,53,4,18,69,34,28,6,24,4,0,13,9,4,,,
"Nov 15, 2022 8:00 PM",80,19,61,19,13,6,39,23,16,24,15,9,0,0,0,8,23,15,8,50,46,4,11,21,10,6,4,13,3,3,8,2,6,,,
"Nov 15, 2022 9:00 PM",59,16,43,14,9,5,16,7,9,11,5,6,0,0,0,7,10,9,1,19,19,0,8,9,9,6,3,16,2,2,4,2,2,,,
"Nov 15, 2022 10:00 PM",38,8,30,2,2,0,3,3,0,1,1,0,0,0,0,3,10,6,4,19,17,2,4,10,5,5,0,6,2,1,1,0,1,,,
"Nov 15, 2022 11:00 PM",17,2,15,5,4,1,7,4,3,7,5,2,0,0,0,0,4,0,4,6,6,0,1,3,1,0,1,3,0,0,0,0,0,,,
"Nov 16, 2022 12:00 AM",5,1,4,0,0,0,2,2,0,2,2,0,0,0,0,0,0,0,0,4,4,0,0,1,2,2,0,2,0,0,1,1,0,,,
"Nov 16, 2022 1:00 AM",6,3,3,0,0,0,0,0,0,0,0,0,0,0,0,0,1,0,1,2,2,0,0,0,0,0,0,0,0,0,0,0,0,,,
"Nov 16, 2022 2:00 AM",6,3,3,0,0,0,0,0,0,0,0,0,0,0,0,0,3,1,2,1,1,0,1,0,0,0,0,0,0,0,0,0,0,,,
"Nov 16, 2022 3:00 AM",1,0,1,0,0,0,0,0,0,0,0,0,0,0,0,0,0,0,0,1,1,0,0,0,1,1,0,0,0,0,1,1,0,,,
"Nov 16, 2022 4:00 AM",3,1,2,3,1,2,2,1,1,3,1,2,0,0,0,0,2,2,0,0,0,0,2,0,1,0,1,1,0,0,0,0,0,,,
"Nov 16, 2022 5:00 AM",14,10,4,3,1,2,4,0,4,2,0,2,0,0,0,1,8,8,0,2,1,1,9,2,4,1,3,11,1,0,0,0,0,,,
"Nov 16, 2022 6:00 AM",48,31,17,15,4,11,20,9,11,14,5,9,0,0,0,9,14,14,0,11,11,0,14,13,7,3,4,41,0,0,1,1,0,,,
"Nov 16, 2022 7:00 AM",135,92,43,50,15,35,83,20,63,48,17,31,0,0,0,12,94,94,0,32,24,8,79,32,30,6,24,130,1,4,6,6,0,,,
"Nov 16, 2022 8:00 AM",329,261,68,98,18,80,153,45,108,109,39,70,0,0,0,30,201,198,3,47,35,12,179,53,85,15,70,242,11,12,19,18,1,,,
"Nov 16, 2022 9:00 AM",164,131,33,55,19,36,67,33,34,71,35,36,0,0,0,13,98,93,5,30,19,11,66,36,46,20,26,78,1,1,3,2,1,,,
"Nov 16, 2022 10:00 AM",82,71,11,43,23,20,50,26,24,48,28,20,0,0,0,6,60,55,5,8,4,4,35,13,21,9,12,27,5,3,5,3,2,,,
"Nov 16, 2022 11:00 AM",57,43,14,61,18,43,72,27,45,49,19,30,0,0,0,11,35,31,4,14,12,2,25,12,23,10,13,29,1,5,7,5,2,,,
"Nov 16, 2022 12:00 PM",70,30,40,49,29,20,59,33,26,42,23,19,0,0,0,9,51,46,5,13,13,0,34,19,31,20,11,30,3,2,4,3,1,,,
"Nov 16, 2022 1:00 PM",103,49,54,59,32,27,95,53,42,55,31,24,0,0,0,12,39,28,11,36,32,4,20,28,40,19,21,32,3,3,6,3,3,,,
"Nov 16, 2022 2:00 PM",86,35,51,38,19,19,78,42,36,41,21,20,0,0,0,18,30,25,5,27,24,3,15,29,32,12,20,29,3,8,10,6,4,,,
"Nov 16, 2022 3:00 PM",97,45,52,42,29,13,69,45,24,34,24,10,0,0,0,20,32,26,6,32,30,2,16,45,33,21,12,30,6,2,7,4,3,,,
"Nov 16, 2022 4:00 PM",160,45,115,57,32,25,69,44,25,59,35,24,0,0,0,22,39,22,17,61,53,8,17,69,38,26,12,48,13,5,12,2,10,,,
"Nov 16, 2022 5:00 PM",262,66,196,44,35,9,101,58,43,63,38,25,0,0,0,28,55,36,19,103,98,5,25,115,66,45,21,58,5,6,10,5,5,,,
"Nov 16, 2022 6:00 PM",233,63,170,45,36,9,90,64,26,58,41,17,0,0,0,18,41,34,7,84,82,2,26,100,61,44,17,46,3,4,3,1,2,,,
"Nov 16, 2022 7:00 PM",121,29,92,22,20,2,30,23,7,28,23,5,0,0,0,11,18,13,5,51,49,2,8,62,23,11,12,19,2,2,6,4,2,,,
"Nov 16, 2022 8:00 PM",77,13,64,10,10,0,18,11,7,9,6,3,0,0,0,7,12,8,4,30,29,1,10,26,8,5,3,9,7,2,12,7,5,,,
"Nov 16, 2022 9:00 PM",43,12,31,4,3,1,16,11,5,6,5,1,0,0,0,4,8,7,1,27,25,2,4,20,10,9,1,8,7,2,7,5,2,,,
"Nov 16, 2022 10:00 PM",36,6,30,5,4,1,10,8,2,6,4,2,0,0,0,3,8,4,4,11,11,0,4,12,7,3,4,6,1,1,0,0,0,,,
"Nov 16, 2022 11:00 PM",25,6,19,1,1,0,7,4,3,4,2,2,0,0,0,3,5,3,2,5,5,0,3,6,4,3,1,2,0,0,0,0,0,,,
"Nov 17, 2022 12:00 AM",8,1,7,0,0,0,2,1,1,3,2,1,0,0,0,4,1,1,0,7,6,1,1,1,0,0,0,1,0,0,0,0,0,,,
"Nov 17, 2022 1:00 AM",2,1,1,1,1,0,2,2,0,1,1,0,0,0,0,1,2,0,2,3,2,1,0,2,3,2,1,1,0,0,0,0,0,,,
"Nov 17, 2022 2:00 AM",5,4,1,0,0,0,0,0,0,0,0,0,0,0,0,0,2,2,0,0,0,0,1,1,0,0,0,0,0,0,0,0,0,,,
"Nov 17, 2022 3:00 AM",1,1,0,0,0,0,0,0,0,0,0,0,0,0,0,0,0,0,0,1,1,0,0,0,0,0,0,0,0,0,2,1,1,,,
"Nov 17, 2022 4:00 AM",1,0,1,3,1,2,3,1,2,2,1,1,0,0,0,1,1,1,0,1,1,0,1,1,2,0,2,3,0,0,0,0,0,,,
"Nov 17, 2022 5:00 AM",10,5,5,1,0,1,1,0,1,1,0,1,0,0,0,0,7,7,0,3,2,1,8,3,1,0,1,9,1,0,0,0,0,,,
"Nov 17, 2022 6:00 AM",38,19,19,8,2,6,16,6,10,15,7,8,0,0,0,6,15,15,0,8,8,0,11,7,3,0,3,30,0,1,1,1,0,,,
"Nov 17, 2022 7:00 AM",120,89,31,41,10,31,66,19,47,40,12,28,0,0,0,7,73,72,1,18,16,2,64,33,29,7,22,112,2,0,4,3,1,,,
"Nov 17, 2022 8:00 AM",302,227,75,91,24,67,150,51,99,106,38,68,0,0,0,39,186,181,5,39,25,14,163,43,67,16,51,233,8,8,22,17,5,,,
"Nov 17, 2022 9:00 AM",141,119,22,51,17,34,76,31,45,63,36,27,0,0,0,15,100,99,1,28,23,5,72,29,40,15,25,77,1,5,4,3,1,,,
"Nov 17, 2022 10:00 AM",80,69,11,38,15,23,46,21,25,34,18,16,0,0,0,17,51,47,4,11,9,2,28,13,22,9,13,49,0,2,5,2,3,,,
"Nov 17, 2022 11:00 AM",59,40,19,44,15,29,33,18,15,30,16,14,0,0,0,7,40,37,3,10,7,3,22,20,19,5,14,22,4,2,6,4,2,,,
"Nov 17, 2022 12:00 PM",69,42,27,34,15,19,42,22,20,28,18,10,0,0,0,14,20,19,1,20,16,4,12,18,23,15,8,23,1,2,5,4,1,,,
"Nov 17, 2022 1:00 PM",72,31,41,32,20,12,60,32,28,43,25,18,0,0,0,11,28,24,4,21,16,5,16,28,28,16,12,29,2,6,6,3,3,,,
"Nov 17, 2022 2:00 PM",81,32,49,32,23,9,39,26,13,28,17,11,0,0,0,14,24,20,4,24,24,0,12,25,25,16,9,25,2,5,4,3,1,,,
"Nov 17, 2022 3:00 PM",97,33,64,29,17,12,66,38,28,33,23,10,0,0,0,19,42,30,12,35,30,5,22,34,27,17,10,28,6,3,4,3,1,,,
"Nov 17, 2022 4:00 PM",143,40,103,45,34,11,75,40,35,57,33,24,0,0,0,23,37,26,11,48,43,5,21,64,28,18,10,41,5,1,9,5,4,,,
"Nov 17, 2022 5:00 PM",224,66,158,40,35,5,89,62,27,65,45,20,0,0,0,25,48,37,11,99,90,9,35,111,53,32,21,51,8,3,8,7,1,,,
"Nov 17, 2022 6:00 PM",209,58,151,42,32,10,75,59,16,57,43,14,0,0,0,17,47,37,10,100,98,2,35,90,49,31,18,46,5,2,8,5,3,,,
"Nov 17, 2022 7:00 PM",129,41,88,19,13,6,40,30,10,35,22,13,0,0,0,8,19,14,5,38,36,2,11,49,18,13,5,23,5,1,10,10,0,,,
"Nov 17, 2022 8:00 PM",81,22,59,11,10,1,22,10,12,18,11,7,0,0,0,6,20,13,7,31,31,0,14,25,9,5,4,17,5,1,4,1,3,,,
"Nov 17, 2022 9:00 PM",63,16,47,7,6,1,18,14,4,7,5,2,0,0,0,15,10,6,4,15,15,0,7,12,8,6,2,10,2,3,0,0,0,,,
"Nov 17, 2022 10:00 PM",56,8,48,4,3,1,11,3,8,8,2,6,0,0,0,4,3,1,2,21,18,3,2,16,5,3,2,7,1,0,2,0,2,,,
"Nov 17, 2022 11:00 PM",31,6,25,5,4,1,5,3,2,3,2,1,0,0,0,1,4,3,1,12,12,0,5,9,4,3,1,3,1,1,1,1,0,,,
"Nov 18, 2022 12:00 AM",14,2,12,0,0,0,1,1,0,7,5,2,0,0,0,2,3,3,0,2,2,0,2,12,3,2,1,4,0,0,3,2,1,,,
"Nov 18, 2022 1:00 AM",11,2,9,2,0,2,3,3,0,1,0,1,0,0,0,0,2,1,1,2,2,0,1,1,0,0,0,2,0,0,0,0,0,,,
"Nov 18, 2022 2:00 AM",6,4,2,0,0,0,3,2,1,0,0,0,0,0,0,0,0,0,0,1,1,0,0,3,1,0,1,1,0,0,0,0,0,,,
"Nov 18, 2022 3:00 AM",1,0,1,0,0,0,0,0,0,0,0,0,0,0,0,0,0,0,0,1,1,0,0,1,0,0,0,2,0,0,0,0,0,,,
"Nov 18, 2022 4:00 AM",6,1,5,3,2,1,3,2,1,4,2,2,0,0,0,0,1,1,0,0,0,0,1,2,1,0,1,1,0,0,0,0,0,,,
"Nov 18, 2022 5:00 AM",8,6,2,1,1,0,5,2,3,2,2,0,0,0,0,2,7,7,0,1,0,1,8,3,1,1,0,11,0,0,0,0,0,,,
"Nov 18, 2022 6:00 AM",37,18,19,14,6,8,21,11,10,12,6,6,0,0,0,6,8,8,0,10,9,1,9,8,5,1,4,30,0,2,1,1,0,,,
"Nov 18, 2022 7:00 AM",101,68,33,50,20,30,63,22,41,46,21,25,0,0,0,14,52,52,0,15,12,3,49,30,22,8,14,89,2,3,5,5,0,,,
"Nov 18, 2022 8:00 AM",205,149,56,61,14,47,136,44,92,70,22,48,0,0,0,28,134,130,4,31,21,10,114,27,56,20,36,132,5,3,9,7,2,,,
"Nov 18, 2022 9:00 AM",112,89,23,48,22,26,78,38,40,43,28,15,0,0,0,14,68,67,1,17,13,4,43,25,36,16,20,61,2,6,5,2,3,,,
"Nov 18, 2022 10:00 AM",61,39,22,44,21,23,43,23,20,34,18,16,0,0,0,12,43,40,3,16,12,4,30,10,26,12,14,27,0,2,4,4,0,,,
"Nov 18, 2022 11:00 AM",69,44,25,33,20,13,49,31,18,37,21,16,0,0,0,7,29,27,2,17,12,5,17,21,28,17,11,26,2,2,4,4,0,,,
"Nov 18, 2022 12:00 PM",61,28,33,44,15,29,58,20,38,42,19,23,0,0,0,12,26,23,3,17,14,3,18,18,20,11,9,32,1,1,4,2,2,,,
"Nov 18, 2022 1:00 PM",135,60,75,42,27,15,52,33,19,41,26,15,0,0,0,14,31,27,4,35,31,4,23,23,31,22,9,32,2,2,5,3,2,,,
"Nov 18, 2022 2:00 PM",81,36,45,53,21,32,65,32,33,46,22,24,0,0,0,22,28,23,5,28,27,1,18,23,29,15,14,26,2,1,6,4,2,,,
"Nov 18, 2022 3:00 PM",94,48,46,47,30,17,57,35,22,49,27,22,0,0,0,13,29,20,9,43,39,4,16,33,26,19,7,30,4,1,4,2,2,,,
"Nov 18, 2022 4:00 PM",130,34,96,41,25,16,63,40,23,50,28,22,0,0,0,23,35,24,11,52,51,1,25,60,27,22,5,38,6,7,8,5,3,,,
"Nov 18, 2022 5:00 PM",172,50,122,38,24,14,72,49,23,50,36,14,0,0,0,17,34,31,3,81,73,8,32,77,33,24,9,37,4,4,4,3,1,,,
"Nov 18, 2022 6:00 PM",127,25,102,26,20,6,39,21,18,29,15,14,0,0,0,11,26,23,3,57,57,0,16,47,24,16,8,25,3,1,3,2,1,,,
"Nov 18, 2022 7:00 PM",100,36,64,22,15,7,50,41,9,40,31,9,0,0,0,8,19,16,3,26,22,4,17,31,24,16,8,19,3,1,4,4,0,,,
"Nov 18, 2022 8:00 PM",70,23,47,13,11,2,23,14,9,20,13,7,0,0,0,8,11,8,3,13,10,3,9,10,10,6,4,19,3,2,5,3,2,,,
"Nov 18, 2022 9:00 PM",49,21,28,8,6,2,9,3,6,6,4,2,0,0,0,4,5,4,1,15,13,2,2,9,4,2,2,9,2,1,1,1,0,,,
"Nov 18, 2022 10:00 PM",31,11,20,8,4,4,6,1,5,9,3,6,0,0,0,2,11,7,4,9,7,2,6,7,5,2,3,6,0,1,2,1,1,,,
"Nov 18, 2022 11:00 PM",22,2,20,3,3,0,4,1,3,5,1,4,0,0,0,1,4,4,0,13,12,1,5,7,5,1,4,6,0,1,2,1,1,,,
"Nov 19, 2022 12:00 AM",18,4,14,0,0,0,2,2,0,6,4,2,0,0,0,0,3,1,2,7,6,1,1,4,5,4,1,10,1,0,1,1,0,,,
"Nov 19, 2022 1:00 AM",12,5,7,2,2,0,3,1,2,3,2,1,0,0,0,0,0,0,0,3,3,0,0,5,3,2,1,2,0,0,0,0,0,,,
"Nov 19, 2022 2:00 AM",7,4,3,2,0,2,0,0,0,0,0,0,0,0,0,0,4,4,0,3,3,0,4,1,0,0,0,0,0,0,0,0,0,,,
"Nov 19, 2022 3:00 AM",1,0,1,0,0,0,1,0,1,1,0,1,0,0,0,0,0,0,0,0,0,0,0,3,0,0,0,3,0,0,0,0,0,,,
"Nov 19, 2022 4:00 AM",2,1,1,1,1,0,1,1,0,1,1,0,0,0,0,0,2,1,1,0,0,0,1,2,2,2,0,1,0,0,0,0,0,,,
"Nov 19, 2022 5:00 AM",0,0,0,0,0,0,2,0,2,2,0,2,0,0,0,1,1,1,0,0,0,0,1,4,0,0,0,2,0,0,0,0,0,,,
"Nov 19, 2022 6:00 AM",10,7,3,0,0,0,3,2,1,3,2,1,0,0,0,3,2,2,0,1,1,0,1,3,0,0,0,6,0,1,0,0,0,,,
"Nov 19, 2022 7:00 AM",19,9,10,13,10,3,19,16,3,15,12,3,0,0,0,4,12,11,1,4,4,0,8,3,4,2,2,5,0,1,2,2,0,,,
"Nov 19, 2022 8:00 AM",38,25,13,40,22,18,54,33,21,26,18,8,0,0,0,10,9,9,0,4,4,0,11,13,20,11,9,18,1,2,2,1,1,,,
"Nov 19, 2022 9:00 AM",59,36,23,73,44,29,94,60,34,60,49,11,0,0,0,9,22,19,3,9,8,1,20,30,27,20,7,24,4,5,4,3,1,,,
"Nov 19, 2022 10:00 AM",50,26,24,73,41,32,99,56,43,65,35,30,0,0,0,3,22,21,1,13,9,4,17,24,45,24,21,23,3,3,7,4,3,,,
"Nov 19, 2022 11:00 AM",60,25,35,96,53,43,99,61,38,77,55,22,0,0,0,15,19,18,1,20,17,3,18,19,22,17,5,32,3,4,4,4,0,,,
"Nov 19, 2022 12:00 PM",71,37,34,106,47,59,77,36,41,75,35,40,0,0,0,15,15,14,1,21,17,4,17,18,30,17,13,24,4,7,7,2,5,,,
"Nov 19, 2022 1:00 PM",56,30,26,78,35,43,87,36,51,72,26,46,0,0,0,10,20,18,2,19,16,3,17,20,25,12,13,27,2,4,10,6,4,,,
"Nov 19, 2022 2:00 PM",48,20,28,52,28,24,55,30,25,45,22,23,0,0,0,30,22,20,2,11,8,3,10,16,31,16,15,29,6,2,8,5,3,,,
"Nov 19, 2022 3:00 PM",46,19,27,33,17,16,39,18,21,30,15,15,0,0,0,27,15,11,4,15,11,4,9,14,16,9,7,20,4,1,5,3,2,,,
"Nov 19, 2022 4:00 PM",46,24,22,37,23,14,40,17,23,38,15,23,0,0,0,16,11,7,4,13,12,1,6,15,25,11,14,14,5,0,1,1,0,,,
"Nov 19, 2022 5:00 PM",38,22,16,18,12,6,32,16,16,22,10,12,0,0,0,10,8,7,1,13,9,4,5,10,13,6,7,11,0,2,6,3,3,,,
"Nov 19, 2022 6:00 PM",47,21,26,4,3,1,9,3,6,11,7,4,0,0,0,11,12,11,1,10,10,0,13,8,5,2,3,11,1,1,0,0,0,,,
"Nov 19, 2022 7:00 PM",52,26,26,5,4,1,6,4,2,7,4,3,0,0,0,7,8,8,0,6,5,1,8,5,5,2,3,7,0,1,0,0,0,,,
"Nov 19, 2022 8:00 PM",38,10,28,6,6,0,4,2,2,4,2,2,0,0,0,6,6,6,0,6,6,0,7,7,1,1,0,5,0,0,0,0,0,,,
"Nov 19, 2022 9:00 PM",12,4,8,4,1,3,5,1,4,5,1,4,0,0,0,7,2,2,0,1,1,0,2,4,2,1,1,6,1,0,0,0,0,,,
"Nov 19, 2022 10:00 PM",24,8,16,5,3,2,6,3,3,6,3,3,0,0,0,2,3,3,0,3,3,0,5,4,4,4,0,4,0,1,0,0,0,,,
"Nov 19, 2022 11:00 PM",14,3,11,4,3,1,5,2,3,6,2,4,0,0,0,2,4,3,1,5,4,1,2,5,1,1,0,1,1,0,0,0,0,,,
"Nov 20, 2022 12:00 AM",21,3,18,0,0,0,1,1,0,0,0,0,0,0,0,0,1,1,0,5,4,1,1,5,0,0,0,3,0,0,0,0,0,,,
"Nov 20, 2022 1:00 AM",7,1,6,1,1,0,0,0,0,0,0,0,0,0,0,1,1,1,0,6,5,1,1,0,0,0,0,1,0,0,1,1,0,,,
"Nov 20, 2022 2:00 AM",5,2,3,2,2,0,5,5,0,2,2,0,0,0,0,0,1,1,0,3,3,0,1,4,1,1,0,2,0,0,1,1,0,,,
"Nov 20, 2022 3:00 AM",4,0,4,0,0,0,0,0,0,0,0,0,0,0,0,1,0,0,0,4,4,0,0,0,1,1,0,0,0,0,0,0,0,,,
"Nov 20, 2022 4:00 AM",0,0,0,0,0,0,0,0,0,0,0,0,0,0,0,1,0,0,0,0,0,0,0,2,1,1,0,1,0,0,0,0,0,,,
"Nov 20, 2022 5:00 AM",2,0,2,1,1,0,2,1,1,1,1,0,0,0,0,1,1,1,0,1,0,1,1,0,1,1,0,3,0,0,0,0,0,,,
"Nov 20, 2022 6:00 AM",8,8,0,0,0,0,3,2,1,1,0,1,0,0,0,2,1,1,0,1,1,0,1,3,1,1,0,11,0,1,0,0,0,,,
"Nov 20, 2022 7:00 AM",15,9,6,8,4,4,14,9,5,7,4,3,0,0,0,1,9,9,0,3,2,1,8,4,4,2,2,7,0,1,1,0,1,,,
"Nov 20, 2022 8:00 AM",31,17,14,32,17,15,46,35,11,33,26,7,0,0,0,2,10,9,1,10,9,1,6,15,10,5,5,12,1,2,2,1,1,,,
"Nov 20, 2022 9:00 AM",31,16,15,54,26,28,61,40,21,54,39,15,0,0,0,5,16,16,0,10,8,2,17,15,22,11,11,17,2,8,1,1,0,,,
"Nov 20, 2022 10:00 AM",33,19,14,85,50,35,95,56,39,79,53,26,0,0,0,14,13,12,1,5,2,3,11,19,37,20,17,29,6,4,7,3,4,,,
"Nov 20, 2022 11:00 AM",45,29,16,73,33,40,71,39,32,66,37,29,0,0,0,4,10,8,2,14,12,2,11,20,25,19,6,35,2,6,12,9,3,,,
"Nov 20, 2022 12:00 PM",41,22,19,87,52,35,86,41,45,83,41,42,0,0,0,11,26,23,3,12,10,2,16,22,23,16,7,28,9,2,8,3,5,,,
"Nov 20, 2022 1:00 PM",44,23,21,86,48,38,73,32,41,73,34,39,0,0,0,20,19,18,1,27,24,3,14,17,36,20,16,26,1,3,8,3,5,,,
"Nov 20, 2022 2:00 PM",51,37,14,82,36,46,66,33,33,73,38,35,0,0,0,9,14,13,1,12,12,0,20,19,39,23,16,34,6,2,11,9,2,,,
"Nov 20, 2022 3:00 PM",51,25,26,80,43,37,73,31,42,68,32,36,0,0,0,25,20,17,3,14,10,4,16,23,22,15,7,16,3,2,6,4,2,,,
"Nov 20, 2022 4:00 PM",54,25,29,41,18,23,41,10,31,38,12,26,0,0,0,12,14,13,1,11,9,2,9,7,24,9,15,19,3,1,4,2,2,,,
"Nov 20, 2022 5:00 PM",36,15,21,23,10,13,24,13,11,22,11,11,0,0,0,5,11,8,3,25,18,7,5,14,11,6,5,13,1,0,3,2,1,,,
"Nov 20, 2022 6:00 PM",51,19,32,15,5,10,17,9,8,10,6,4,0,0,0,4,7,5,2,12,11,1,5,7,1,1,0,7,0,1,0,0,0,,,
"Nov 20, 2022 7:00 PM",25,9,16,2,1,1,7,2,5,5,2,3,0,0,0,8,6,6,0,7,7,0,6,7,4,2,2,9,0,0,0,0,0,,,
"Nov 20, 2022 8:00 PM",28,6,22,3,3,0,7,1,6,6,1,5,0,0,0,0,8,8,0,7,5,2,8,5,2,2,0,9,3,2,3,2,1,,,
"Nov 20, 2022 9:00 PM",22,8,14,2,2,0,5,4,1,1,0,1,0,0,0,6,3,2,1,5,5,0,4,5,2,1,1,5,2,0,1,0,1,,,
"Nov 20, 2022 10:00 PM",10,4,6,4,3,1,10,3,7,2,2,0,0,0,0,3,3,3,0,3,2,1,3,8,1,0,1,3,1,0,4,3,1,,,
"Nov 20, 2022 11:00 PM",5,2,3,2,1,1,2,1,1,0,0,0,0,0,0,1,1,1,0,0,0,0,1,3,0,0,0,1,0,0,0,0,0,,,
"Nov 21, 2022 12:00 AM",2,1,1,0,0,0,0,0,0,0,0,0,0,0,0,2,1,1,0,5,4,1,1,2,2,1,1,3,0,0,1,1,0,,,
"Nov 21, 2022 1:00 AM",3,1,2,0,0,0,0,0,0,1,0,1,0,0,0,0,0,0,0,0,0,0,0,0,1,0,1,1,0,0,1,1,0,,,
"Nov 21, 2022 2:00 AM",3,2,1,0,0,0,0,0,0,0,0,0,0,0,0,0,0,0,0,0,0,0,0,0,0,0,0,0,0,0,0,0,0,,,
"Nov 21, 2022 3:00 AM",4,2,2,0,0,0,0,0,0,0,0,0,0,0,0,0,0,0,0,0,0,0,0,0,0,0,0,2,0,0,0,0,0,,,
"Nov 21, 2022 4:00 AM",2,0,2,0,0,0,0,0,0,0,0,0,0,0,0,0,1,1,0,0,0,0,1,0,0,0,0,0,0,0,0,0,0,,,
"Nov 21, 2022 5:00 AM",7,5,2,0,0,0,3,0,3,2,0,2,0,0,0,2,4,4,0,1,1,0,4,3,1,0,1,2,0,0,0,0,0,,,
"Nov 21, 2022 6:00 AM",27,13,14,3,1,2,6,1,5,6,2,4,0,0,0,2,12,12,0,5,4,1,12,3,2,1,1,20,0,2,0,0,0,,,
"Nov 21, 2022 7:00 AM",64,48,16,6,2,4,14,4,10,7,2,5,0,0,0,6,31,31,0,4,4,0,27,14,3,0,3,38,0,1,1,1,0,,,
"Nov 21, 2022 8:00 AM",130,101,29,14,3,11,30,5,25,17,6,11,0,0,0,18,75,75,0,17,8,9,59,23,23,8,15,76,1,0,6,6,0,,,
"Nov 21, 2022 9:00 AM",63,57,6,5,2,3,21,10,11,10,6,4,0,0,0,9,30,28,2,11,7,4,24,7,9,4,5,31,0,2,2,2,0,,,
"Nov 21, 2022 10:00 AM",24,20,4,8,1,7,10,6,4,4,2,2,0,0,0,3,16,12,4,3,2,1,8,6,5,3,2,5,0,0,1,0,1,,,
"Nov 21, 2022 11:00 AM",28,20,8,3,1,2,10,4,6,2,2,0,0,0,0,0,11,10,1,5,1,4,8,3,7,2,5,2,0,0,2,2,0,,,
"Nov 21, 2022 12:00 PM",34,23,11,10,7,3,15,8,7,8,5,3,0,0,0,5,16,16,0,5,5,0,10,1,2,1,1,3,1,2,0,0,0,,,
"Nov 21, 2022 1:00 PM",53,31,22,21,6,15,20,9,11,18,9,9,0,0,0,7,22,18,4,10,9,1,14,0,7,3,4,20,0,0,4,3,1,,,
"Nov 21, 2022 2:00 PM",42,24,18,24,15,9,22,14,8,21,14,7,0,0,0,7,21,17,4,8,6,2,12,0,10,9,1,14,1,1,2,2,0,,,
"Nov 21, 2022 3:00 PM",58,19,39,24,10,14,26,13,13,24,14,10,0,0,0,9,21,16,5,13,9,4,8,6,9,4,5,16,2,0,5,2,3,,,
"Nov 21, 2022 4:00 PM",90,29,61,30,17,13,23,14,9,24,17,7,0,0,0,20,15,12,3,21,20,1,12,33,13,9,4,26,2,1,6,3,3,,,
"Nov 21, 2022 5:00 PM",125,29,96,18,11,7,38,24,14,23,15,8,0,0,0,19,26,16,10,60,59,1,16,42,17,10,7,32,1,1,6,3,3,,,
"Nov 21, 2022 6:00 PM",131,31,100,21,15,6,38,31,7,30,20,10,0,0,0,17,35,26,9,40,37,3,27,47,23,16,7,15,1,5,10,3,7,,,
"Nov 21, 2022 7:00 PM",72,20,52,11,10,1,24,18,6,13,10,3,0,0,0,3,17,12,5,21,21,0,10,24,13,10,3,10,4,1,4,3,1,,,
"Nov 21, 2022 8:00 PM",52,10,42,9,6,3,14,8,6,11,6,5,0,0,0,6,12,9,3,18,15,3,6,12,3,2,1,13,1,3,6,3,3,,,
"Nov 21, 2022 9:00 PM",48,14,34,7,6,1,11,6,5,5,3,2,0,0,0,9,10,5,5,14,14,0,4,10,6,5,1,10,5,1,2,1,1,,,
"Nov 21, 2022 10:00 PM",25,7,18,1,1,0,4,2,2,2,1,1,0,0,0,3,6,2,4,8,7,1,2,6,2,2,0,7,2,0,1,0,1,,,
"Nov 21, 2022 11:00 PM",14,3,11,1,1,0,4,2,2,7,4,3,0,0,0,1,1,1,0,5,5,0,0,3,0,0,0,2,0,0,1,0,1,,,
"Nov 22, 2022 12:00 AM",2,0,2,0,0,0,0,0,0,1,0,1,0,0,0,0,1,0,1,5,4,1,0,1,3,3,0,0,0,0,0,0,0,,,
"Nov 22, 2022 1:00 AM",0,0,0,0,0,0,0,0,0,0,0,0,0,0,0,1,0,0,0,0,0,0,0,0,0,0,0,0,1,0,0,0,0,,,
"Nov 22, 2022 2:00 AM",2,1,1,0,0,0,0,0,0,0,0,0,0,0,0,0,0,0,0,0,0,0,0,0,0,0,0,0,0,0,0,0,0,,,
"Nov 22, 2022 3:00 AM",1,0,1,0,0,0,4,0,4,0,0,0,0,0,0,0,0,0,0,1,1,0,0,1,0,0,0,0,0,0,0,0,0,,,
"Nov 22, 2022 4:00 AM",2,1,1,0,0,0,0,0,0,0,0,0,0,0,0,0,2,2,0,0,0,0,2,0,0,0,0,1,0,0,0,0,0,,,
"Nov 22, 2022 5:00 AM",7,3,4,1,0,1,4,0,4,3,0,3,0,0,0,2,6,6,0,0,0,0,6,3,2,0,2,6,0,0,0,0,0,,,
"Nov 22, 2022 6:00 AM",49,29,20,12,4,8,16,5,11,10,3,7,0,0,0,8,18,18,0,12,10,2,17,17,5,1,4,36,0,3,1,1,0,,,
"Nov 22, 2022 7:00 AM",146,108,38,32,6,26,57,11,46,34,10,24,0,0,0,8,72,69,3,16,14,2,61,30,29,7,22,113,3,4,13,12,1,,,
"Nov 22, 2022 8:00 AM",312,251,61,81,12,69,141,45,96,112,39,73,0,0,0,31,176,170,6,37,25,12,161,43,76,23,53,225,10,8,18,11,7,,,
"Nov 22, 2022 9:00 AM",143,120,23,50,15,35,62,24,38,45,25,20,0,0,0,21,97,93,4,24,19,5,68,17,42,22,20,70,2,5,10,7,3,,,
"Nov 22, 2022 10:00 AM",74,65,9,42,14,28,58,28,30,36,19,17,0,0,0,11,61,60,1,13,9,4,39,2,30,16,14,24,2,4,6,5,1,,,
"Nov 22, 2022 11:00 AM",63,47,16,38,15,23,58,21,37,44,17,27,0,0,0,11,36,34,2,9,6,3,17,0,14,7,7,32,5,5,4,4,0,,,
"Nov 22, 2022 12:00 PM",67,36,31,23,10,13,55,27,28,32,17,15,0,0,0,4,34,28,6,19,16,3,17,1,14,7,7,17,2,6,4,4,0,,,
"Nov 22, 2022 1:00 PM",88,38,50,32,16,16,50,22,28,36,14,22,0,0,0,16,32,24,8,19,15,4,19,0,26,11,15,22,4,6,5,4,1,,,
"Nov 22, 2022 2:00 PM",77,30,47,30,16,14,54,33,21,46,34,12,0,0,0,7,30,25,5,24,22,2,20,0,48,28,20,17,3,7,9,5,4,,,
"Nov 22, 2022 3:00 PM",83,40,43,37,21,16,53,33,20,33,21,12,0,0,0,19,40,30,10,32,30,2,19,11,23,20,3,21,2,1,7,4,3,,,
"Nov 22, 2022 4:00 PM",144,42,102,57,34,23,65,44,21,60,37,23,0,0,0,18,39,29,10,50,46,4,27,73,31,18,13,30,7,0,10,4,6,,,
"Nov 22, 2022 5:00 PM",235,44,191,50,38,12,108,68,40,71,44,27,0,0,0,26,43,31,12,97,92,5,28,120,48,35,13,47,8,3,12,8,4,,,
"Nov 22, 2022 6:00 PM",210,44,166,53,40,13,91,62,29,77,50,27,0,0,0,16,53,40,13,99,95,4,32,102,40,35,5,39,5,6,6,4,2,,,
"Nov 22, 2022 7:00 PM",125,31,94,28,20,8,48,30,18,41,26,15,0,0,0,11,17,11,6,44,42,2,12,53,28,22,6,24,2,4,2,2,0,,,
"Nov 22, 2022 8:00 PM",85,16,69,13,13,0,31,25,6,21,17,4,0,0,0,8,15,10,5,39,37,2,11,30,13,9,4,19,4,2,4,2,2,,,
"Nov 22, 2022 9:00 PM",62,13,49,10,8,2,16,10,6,14,10,4,0,0,0,4,17,13,4,13,13,0,11,25,5,4,1,15,2,1,3,2,1,,,
"Nov 22, 2022 10:00 PM",41,10,31,5,5,0,14,10,4,6,4,2,0,0,0,6,6,6,0,24,18,6,5,10,4,4,0,8,2,1,1,1,0,,,
"Nov 22, 2022 11:00 PM",20,5,15,1,1,0,1,0,1,2,1,1,0,0,0,2,6,2,4,2,2,0,2,5,1,1,0,1,0,1,1,0,1,,,
"Nov 23, 2022 12:00 AM",4,0,4,0,0,0,0,0,0,4,3,1,0,0,0,0,2,0,2,2,2,0,0,5,1,0,1,1,0,0,1,1,0,,,
"Nov 23, 2022 1:00 AM",4,2,2,0,0,0,1,1,0,0,0,0,0,0,0,1,0,0,0,1,1,0,0,3,1,1,0,0,0,0,0,0,0,,,
"Nov 23, 2022 2:00 AM",3,3,0,0,0,0,0,0,0,0,0,0,0,0,0,0,0,0,0,1,0,1,0,0,0,0,0,0,0,0,0,0,0,,,
"Nov 23, 2022 3:00 AM",0,0,0,0,0,0,0,0,0,0,0,0,0,0,0,0,0,0,0,0,0,0,0,0,0,0,0,0,0,0,0,0,0,,,
"Nov 23, 2022 4:00 AM",0,0,0,0,0,0,2,2,0,0,0,0,0,0,0,0,2,2,0,0,0,0,2,0,2,2,0,0,0,0,0,0,0,,,
"Nov 23, 2022 5:00 AM",4,3,1,1,0,1,4,0,4,3,0,3,0,0,0,1,7,7,0,3,2,1,7,1,2,0,2,4,0,1,1,1,0,,,
"Nov 23, 2022 6:00 AM",44,28,16,11,3,8,9,3,6,8,3,5,0,0,0,5,16,16,0,15,11,4,15,8,3,1,2,31,0,1,1,1,0,,,
"Nov 23, 2022 7:00 AM",124,88,36,36,14,22,46,12,34,35,12,23,0,0,0,9,65,64,1,21,15,6,52,34,15,3,12,96,1,4,7,5,2,,,
"Nov 23, 2022 8:00 AM",283,225,58,89,20,69,146,39,107,106,34,72,0,0,0,31,195,190,5,38,30,8,154,49,68,18,50,234,4,7,21,20,1,,,
"Nov 23, 2022 9:00 AM",154,130,24,44,15,29,87,42,45,57,32,25,0,0,0,22,89,88,1,26,17,9,57,29,40,25,15,70,3,4,8,6,2,,,
"Nov 23, 2022 10:00 AM",84,68,16,40,14,26,44,27,17,41,22,19,0,0,0,15,49,48,1,10,5,5,35,11,19,11,8,35,1,1,4,2,2,,,
"Nov 23, 2022 11:00 AM",67,45,22,40,18,22,50,19,31,32,17,15,0,0,0,18,36,33,3,11,9,2,19,14,23,11,12,30,4,1,6,4,2,,,
"Nov 23, 2022 12:00 PM",63,31,32,34,21,13,47,21,26,35,20,15,0,0,0,12,33,29,4,14,12,2,17,20,14,9,5,29,2,2,5,2,3,,,
"Nov 23, 2022 1:00 PM",82,36,46,48,28,20,59,37,22,50,29,21,0,0,0,13,32,28,4,29,23,6,20,32,32,20,12,26,0,2,6,4,2,,,
"Nov 23, 2022 2:00 PM",65,27,38,43,20,23,39,20,19,29,15,14,0,0,0,7,22,18,4,22,17,5,12,14,22,15,7,29,4,4,3,1,2,,,
"Nov 23, 2022 3:00 PM",96,41,55,39,25,14,43,25,18,41,26,15,0,0,0,8,32,28,4,25,21,4,19,30,29,14,15,22,3,1,4,2,2,,,
"Nov 23, 2022 4:00 PM",106,36,70,42,31,11,52,31,21,42,27,15,0,0,0,19,18,12,6,52,45,7,8,43,28,23,5,41,3,1,4,2,2,,,
"Nov 23, 2022 5:00 PM",207,39,168,39,31,8,73,53,20,64,43,21,0,0,0,16,46,27,19,82,78,4,25,112,48,30,18,42,6,3,5,4,1,,,
"Nov 23, 2022 6:00 PM",196,37,159,36,29,7,70,51,19,41,31,10,0,0,0,15,45,30,15,85,80,5,25,96,44,40,4,42,1,4,5,4,1,,,
"Nov 23, 2022 7:00 PM",102,23,79,23,17,6,36,26,10,27,22,5,0,0,0,9,24,14,10,43,41,2,16,48,12,11,1,18,2,2,3,2,1,,,
"Nov 23, 2022 8:00 PM",64,14,50,10,8,2,16,12,4,16,12,4,0,0,0,0,6,5,1,24,24,0,5,32,9,8,1,9,3,3,9,5,4,,,
"Nov 23, 2022 9:00 PM",57,12,45,8,7,1,11,8,3,5,2,3,0,0,0,7,10,7,3,23,22,1,6,12,9,9,0,10,5,1,2,2,0,,,
"Nov 23, 2022 10:00 PM",38,9,29,8,7,1,9,8,1,9,6,3,0,0,0,5,9,5,4,18,18,0,5,7,2,2,0,9,0,0,2,0,2,,,
"Nov 23, 2022 11:00 PM",12,4,8,2,1,1,4,3,1,2,1,1,0,0,0,0,4,3,1,8,6,2,3,3,1,1,0,2,0,0,1,1,0,,,
"Nov 24, 2022 12:00 AM",10,2,8,0,0,0,0,0,0,2,1,1,0,0,0,2,2,1,1,3,1,2,1,3,0,0,0,1,0,0,0,0,0,,,
"Nov 24, 2022 1:00 AM",3,2,1,0,0,0,0,0,0,0,0,0,0,0,0,0,2,1,1,2,2,0,0,0,0,0,0,1,0,0,0,0,0,,,
"Nov 24, 2022 2:00 AM",4,4,0,0,0,0,0,0,0,0,0,0,0,0,0,0,0,0,0,0,0,0,0,0,0,0,0,0,0,0,0,0,0,,,
"Nov 24, 2022 3:00 AM",0,0,0,0,0,0,0,0,0,0,0,0,0,0,0,1,0,0,0,0,0,0,0,0,0,0,0,0,0,0,0,0,0,,,
"Nov 24, 2022 4:00 AM",3,1,2,0,0,0,0,0,0,0,0,0,0,0,0,0,1,1,0,0,0,0,1,0,0,0,0,1,0,0,0,0,0,,,
"Nov 24, 2022 5:00 AM",8,8,0,1,0,1,3,0,3,3,0,3,0,0,0,2,7,7,0,3,2,1,6,3,1,0,1,2,1,0,0,0,0,,,
"Nov 24, 2022 6:00 AM",39,26,13,10,4,6,10,3,7,8,4,4,0,0,0,5,16,16,0,9,7,2,17,7,3,0,3,28,0,3,0,0,0,,,
"Nov 24, 2022 7:00 AM",103,72,31,22,4,18,38,9,29,24,6,18,0,0,0,10,56,54,2,17,15,2,52,27,17,3,14,85,3,1,11,11,0,,,
"Nov 24, 2022 8:00 AM",195,150,45,43,5,38,78,20,58,57,18,39,0,0,0,18,118,117,1,32,23,9,102,34,44,10,34,139,0,3,9,8,1,,,
"Nov 24, 2022 9:00 AM",70,58,12,12,4,8,28,12,16,17,11,6,0,0,0,11,46,44,2,6,3,3,35,8,10,3,7,26,1,1,4,4,0,,,
"Nov 24, 2022 10:00 AM",74,63,11,10,3,7,22,7,15,12,5,7,0,0,0,7,34,33,1,11,9,2,14,6,6,1,5,22,0,1,0,0,0,,,
"Nov 24, 2022 11:00 AM",51,37,14,19,8,11,23,14,9,19,11,8,0,0,0,8,27,24,3,9,5,4,16,9,9,5,4,15,0,1,3,1,2,,,
"Nov 24, 2022 12:00 PM",59,37,22,26,10,16,43,21,22,15,7,8,0,0,0,9,31,27,4,11,8,3,12,16,13,6,7,1,0,0,4,4,0,,,
"Nov 24, 2022 1:00 PM",81,36,45,27,16,11,46,23,23,28,18,10,0,0,0,5,33,28,5,23,21,2,21,15,20,10,10,17,1,1,1,1,0,,,
"Nov 24, 2022 2:00 PM",76,36,40,21,7,14,29,20,9,20,12,8,0,0,0,41,31,23,8,16,16,0,15,17,18,6,12,20,0,0,2,1,1,,,
"Nov 24, 2022 3:00 PM",89,30,59,30,20,10,39,24,15,40,28,12,0,0,0,11,21,14,7,25,22,3,8,18,18,11,7,24,2,2,6,5,1,,,
"Nov 24, 2022 4:00 PM",95,30,65,22,14,8,28,16,12,25,16,9,0,0,0,13,31,23,8,31,26,5,20,51,13,9,4,22,2,1,3,2,1,,,
"Nov 24, 2022 5:00 PM",173,46,127,19,10,9,52,30,22,36,19,17,0,0,0,15,29,20,9,69,68,1,22,78,24,18,6,41,1,1,5,1,4,,,
"Nov 24, 2022 6:00 PM",162,42,120,29,28,1,55,48,7,30,28,2,0,0,0,18,33,27,6,54,48,6,19,76,35,26,9,20,5,3,7,6,1,,,
"Nov 24, 2022 7:00 PM",83,24,59,17,14,3,31,21,10,22,17,5,0,0,0,14,13,8,5,45,43,2,7,31,11,9,2,14,2,0,2,1,1,,,
"Nov 24, 2022 8:00 PM",73,21,52,12,11,1,15,8,7,20,14,6,0,0,0,5,10,9,1,18,16,2,9,16,5,2,3,15,5,0,12,7,5,,,
"Nov 24, 2022 9:00 PM",50,6,44,7,6,1,9,7,2,3,2,1,0,0,0,1,13,10,3,19,17,2,10,11,9,6,3,8,2,1,0,0,0,,,
"Nov 24, 2022 10:00 PM",38,8,30,3,3,0,7,4,3,4,2,2,0,0,0,2,13,9,4,13,11,2,10,8,5,5,0,5,0,0,1,0,1,,,
"Nov 24, 2022 11:00 PM",24,7,17,5,4,1,8,6,2,3,2,1,0,0,0,0,3,2,1,8,8,0,1,8,3,2,1,1,0,1,0,0,0,,,
"Nov 25, 2022 12:00 AM",13,3,10,0,0,0,2,1,1,2,1,1,0,0,0,1,4,3,1,5,5,0,3,6,1,1,0,0,1,0,0,0,0,,,
"Nov 25, 2022 1:00 AM",4,2,2,0,0,0,0,0,0,0,0,0,0,0,0,1,0,0,0,2,2,0,0,0,0,0,0,0,0,0,1,1,0,,,
"Nov 25, 2022 2:00 AM",6,3,3,0,0,0,2,2,0,0,0,0,0,0,0,0,0,0,0,2,2,0,0,0,1,1,0,2,0,0,0,0,0,,,
"Nov 25, 2022 3:00 AM",3,0,3,0,0,0,2,2,0,2,2,0,0,0,0,0,1,1,0,1,1,0,1,2,1,1,0,1,0,0,1,0,1,,,
"Nov 25, 2022 4:00 AM",2,1,1,0,0,0,1,0,1,1,0,1,0,0,0,0,2,1,1,0,0,0,1,0,1,1,0,2,0,0,1,1,0,,,
"Nov 25, 2022 5:00 AM",6,4,2,1,1,0,5,2,3,4,2,2,0,0,0,1,6,6,0,3,2,1,6,2,0,0,0,8,0,0,0,0,0,,,
"Nov 25, 2022 6:00 AM",42,24,18,9,2,7,6,2,4,8,3,5,0,0,0,7,19,19,0,8,6,2,15,9,0,0,0,23,0,1,0,0,0,,,
"Nov 25, 2022 7:00 AM",88,60,28,39,19,20,47,19,28,35,16,19,0,0,0,7,42,42,0,15,12,3,37,24,16,5,11,76,2,5,9,6,3,,,
"Nov 25, 2022 8:00 AM",184,144,40,63,20,43,97,24,73,62,28,34,0,0,0,22,120,117,3,41,31,10,94,30,46,13,33,121,3,3,17,12,5,,,
"Nov 25, 2022 9:00 AM",100,75,25,61,23,38,89,53,36,69,46,23,0,0,0,18,57,54,3,14,10,4,36,23,38,19,19,61,2,5,2,2,0,,,
"Nov 25, 2022 10:00 AM",72,50,22,56,24,32,68,31,37,61,22,39,0,0,0,11,38,37,1,16,11,5,26,14,24,10,14,23,0,3,2,1,1,,,
"Nov 25, 2022 11:00 AM",48,34,14,45,19,26,76,35,41,35,19,16,0,0,0,9,25,23,2,13,10,3,13,11,28,15,13,28,3,3,1,1,0,,,
"Nov 25, 2022 12:00 PM",69,33,36,45,27,18,58,36,22,57,41,16,0,0,0,10,26,21,5,17,16,1,14,19,25,13,12,24,5,3,11,6,5,,,
"Nov 25, 2022 1:00 PM",94,34,60,83,36,47,74,32,42,51,22,29,0,0,0,6,29,25,4,17,14,3,17,31,27,18,9,25,3,3,3,2,1,,,
"Nov 25, 2022 2:00 PM",63,30,33,47,23,24,70,24,46,30,11,19,0,0,0,11,37,29,8,22,20,2,21,30,29,21,8,32,2,2,8,5,3,,,
"Nov 25, 2022 3:00 PM",80,33,47,41,15,26,45,27,18,36,17,19,0,0,0,16,18,14,4,27,24,3,15,33,31,16,15,32,5,0,8,6,2,,,
"Nov 25, 2022 4:00 PM",130,40,90,49,34,15,52,33,19,43,31,12,0,0,0,17,47,38,9,53,50,3,28,52,22,14,8,42,1,2,7,4,3,,,
"Nov 25, 2022 5:00 PM",164,44,120,28,15,13,57,35,22,45,19,26,0,0,0,17,24,21,3,50,50,0,22,72,34,26,8,41,3,5,13,7,6,,,
"Nov 25, 2022 6:00 PM",123,39,84,40,23,17,60,39,21,45,28,17,0,0,0,18,32,25,7,49,48,1,24,60,18,12,6,23,6,3,11,4,7,,,
"Nov 25, 2022 7:00 PM",69,28,41,12,9,3,25,14,11,15,9,6,0,0,0,11,16,14,2,31,28,3,15,35,11,8,3,19,5,2,6,3,3,,,
"Nov 25, 2022 8:00 PM",38,12,26,15,9,6,16,11,5,11,7,4,0,0,0,8,21,12,9,11,10,1,16,22,6,4,2,15,1,0,2,0,2,,,
"Nov 25, 2022 9:00 PM",53,21,32,9,6,3,15,9,6,12,6,6,0,0,0,3,9,6,3,13,12,1,6,14,8,4,4,14,0,1,0,0,0,,,
"Nov 25, 2022 10:00 PM",41,9,32,5,5,0,10,4,6,7,2,5,0,0,0,4,8,5,3,12,12,0,5,4,5,5,0,6,1,1,1,0,1,,,
"Nov 25, 2022 11:00 PM",19,6,13,2,2,0,7,3,4,4,1,3,0,0,0,0,5,4,1,9,9,0,3,6,2,2,0,7,0,0,3,2,1,,,
"Nov 26, 2022 12:00 AM",11,3,8,0,0,0,1,1,0,2,2,0,0,0,0,1,5,2,3,3,3,0,3,1,3,3,0,4,0,0,4,2,2,,,
"Nov 26, 2022 1:00 AM",10,1,9,2,1,1,5,3,2,1,0,1,0,0,0,2,2,2,0,3,3,0,3,10,2,2,0,5,1,0,0,0,0,,,
"Nov 26, 2022 2:00 AM",7,5,2,2,2,0,4,2,2,0,0,0,0,0,0,1,1,0,1,3,3,0,0,2,0,0,0,3,0,0,0,0,0,,,
"Nov 26, 2022 3:00 AM",5,0,5,0,0,0,2,2,0,0,0,0,0,0,0,0,0,0,0,1,1,0,0,2,0,0,0,1,0,0,0,0,0,,,
"Nov 26, 2022 4:00 AM",4,2,2,0,0,0,1,1,0,1,0,1,0,0,0,0,0,0,0,1,1,0,0,0,1,1,0,1,0,0,0,0,0,,,
"Nov 26, 2022 5:00 AM",0,0,0,0,0,0,0,0,0,1,1,0,0,0,0,1,0,0,0,0,0,0,0,2,1,1,0,2,0,0,0,0,0,,,
"Nov 26, 2022 6:00 AM",9,6,3,3,1,2,4,3,1,4,1,3,0,0,0,1,4,4,0,2,2,0,3,4,0,0,0,5,0,1,1,1,0,,,
"Nov 26, 2022 7:00 AM",11,8,3,11,9,2,12,8,4,13,11,2,0,0,0,3,5,5,0,6,6,0,5,2,2,1,1,11,2,1,3,3,0,,,
"Nov 26, 2022 8:00 AM",30,19,11,19,10,9,17,10,7,17,13,4,0,0,0,8,13,12,1,3,2,1,9,12,14,7,7,12,1,0,1,0,1,,,
"Nov 26, 2022 9:00 AM",47,29,18,29,10,19,43,30,13,32,19,13,0,0,0,6,10,10,0,7,6,1,10,10,18,6,12,12,2,5,1,1,0,,,
"Nov 26, 2022 10:00 AM",34,20,14,44,21,23,60,34,26,51,31,20,0,0,0,12,15,15,0,5,3,2,10,8,14,7,7,15,0,0,3,3,0,,,
"Nov 26, 2022 11:00 AM",44,21,23,39,18,21,56,34,22,40,27,13,0,0,0,10,19,17,2,10,9,1,15,14,29,22,7,18,0,5,9,5,4,,,
"Nov 26, 2022 12:00 PM",61,37,24,53,26,27,72,35,37,46,22,24,0,0,0,15,16,15,1,8,6,2,12,11,31,15,16,24,7,2,0,0,0,,,
"Nov 26, 2022 1:00 PM",41,17,24,29,14,15,57,24,33,42,15,27,0,0,0,17,16,15,1,15,15,0,9,21,21,13,8,24,0,2,4,2,2,,,
"Nov 26, 2022 2:00 PM",63,31,32,21,8,13,34,17,17,19,9,10,0,0,0,20,18,15,3,9,9,0,9,10,27,12,15,25,0,0,1,0,1,,,
"Nov 26, 2022 3:00 PM",57,25,32,13,7,6,24,7,17,18,8,10,0,0,0,26,22,21,1,5,4,1,16,17,20,11,9,11,2,1,4,2,2,,,
"Nov 26, 2022 4:00 PM",40,21,19,15,8,7,23,13,10,18,9,9,0,0,0,9,9,9,0,14,12,2,6,9,13,8,5,13,2,1,4,2,2,,,
"Nov 26, 2022 5:00 PM",47,13,34,10,6,4,16,8,8,13,4,9,0,0,0,18,7,5,2,16,15,1,5,13,1,1,0,16,0,0,2,1,1,,,
"Nov 26, 2022 6:00 PM",56,31,25,15,8,7,14,7,7,12,7,5,0,0,0,4,13,11,2,12,12,0,12,7,3,1,2,9,0,2,3,2,1,,,
"Nov 26, 2022 7:00 PM",36,16,20,14,7,7,16,11,5,11,9,2,0,0,0,3,6,6,0,5,5,0,4,10,4,4,0,8,1,0,3,0,3,,,
"Nov 26, 2022 8:00 PM",20,11,9,9,8,1,10,8,2,10,8,2,0,0,0,4,9,6,3,8,8,0,6,10,3,2,1,5,0,2,5,2,3,,,
"Nov 26, 2022 9:00 PM",18,5,13,8,8,0,10,4,6,4,1,3,0,0,0,8,6,5,1,5,4,1,4,3,3,2,1,5,1,0,3,1,2,,,
"Nov 26, 2022 10:00 PM",16,10,6,6,5,1,6,2,4,5,2,3,0,0,0,5,3,2,1,5,5,0,2,3,2,1,1,4,0,0,1,1,0,,,
"Nov 26, 2022 11:00 PM",22,6,16,4,3,1,2,0,2,3,1,2,0,0,0,1,1,1,0,3,3,0,1,6,1,1,0,5,0,0,0,0,0,,,
"Nov 27, 2022 12:00 AM",8,1,7,0,0,0,2,1,1,1,0,1,0,0,0,0,2,2,0,4,4,0,2,4,2,1,1,3,0,1,1,1,0,,,
"Nov 27, 2022 1:00 AM",7,1,6,3,1,2,6,3,3,3,1,2,0,0,0,1,2,2,0,4,4,0,1,2,3,3,0,1,1,0,1,0,1,,,
"Nov 27, 2022 2:00 AM",10,3,7,1,1,0,5,4,1,2,0,2,0,0,0,1,0,0,0,1,1,0,1,3,0,0,0,3,0,0,0,0,0,,,
"Nov 27, 2022 3:00 AM",1,0,1,0,0,0,1,0,1,0,0,0,0,0,0,0,0,0,0,1,1,0,0,0,0,0,0,0,0,0,1,0,1,,,
"Nov 27, 2022 4:00 AM",3,0,3,2,1,1,1,1,0,1,1,0,0,0,0,0,0,0,0,0,0,0,0,2,1,1,0,0,0,0,0,0,0,,,
"Nov 27, 2022 5:00 AM",1,0,1,0,0,0,1,0,1,1,0,1,0,0,0,0,0,0,0,1,1,0,0,0,0,0,0,6,0,0,0,0,0,,,
"Nov 27, 2022 6:00 AM",5,2,3,3,2,1,1,1,0,4,2,2,0,0,0,2,5,5,0,3,3,0,4,1,1,1,0,10,0,1,0,0,0,,,
"Nov 27, 2022 7:00 AM",15,8,7,14,9,5,21,17,4,20,16,4,0,0,0,1,5,5,0,3,1,2,5,7,7,7,0,15,1,1,0,0,0,,,
"Nov 27, 2022 8:00 AM",24,15,9,42,25,17,39,30,9,39,34,5,0,0,0,4,12,11,1,2,2,0,9,22,18,14,4,7,1,2,2,0,2,,,
"Nov 27, 2022 9:00 AM",39,22,17,128,74,54,96,68,28,98,76,22,0,0,0,16,18,18,0,5,5,0,18,20,29,21,8,26,2,10,2,1,1,,,
"Nov 27, 2022 10:00 AM",52,28,24,118,55,63,111,61,50,105,51,54,0,0,0,37,22,22,0,19,13,6,20,21,58,43,15,51,3,7,3,2,1,,,
"Nov 27, 2022 11:00 AM",46,28,18,139,67,72,143,72,71,101,52,49,0,0,0,15,21,19,2,11,8,3,15,35,61,30,31,38,4,7,7,5,2,,,
"Nov 27, 2022 12:00 PM",61,26,35,78,22,56,91,29,62,63,22,41,0,0,0,14,32,31,1,12,11,1,19,21,34,15,19,36,9,4,8,6,2,,,
"Nov 27, 2022 1:00 PM",51,20,31,86,47,39,91,49,42,64,33,31,0,0,0,16,16,15,1,14,12,2,18,39,36,25,11,25,5,1,10,8,2,,,
"Nov 27, 2022 2:00 PM",67,42,25,97,50,47,116,61,55,77,40,37,0,0,0,17,21,19,2,8,5,3,17,21,55,31,24,32,4,5,9,7,2,,,
"Nov 27, 2022 3:00 PM",56,26,30,94,40,54,89,40,49,54,24,30,0,0,0,17,10,10,0,16,10,6,8,20,36,19,17,28,3,4,6,3,3,,,
"Nov 27, 2022 4:00 PM",33,14,19,41,15,26,75,21,54,50,14,36,0,0,0,8,17,15,2,4,2,2,12,18,28,7,21,34,2,3,6,5,1,,,
"Nov 27, 2022 5:00 PM",40,25,15,24,16,8,31,12,19,16,6,10,0,0,0,10,11,9,2,10,7,3,5,6,13,5,8,17,2,1,4,2,2,,,
"Nov 27, 2022 6:00 PM",45,20,25,20,15,5,22,6,16,14,5,9,0,0,0,6,9,6,3,11,11,0,5,6,3,1,2,15,1,2,0,0,0,,,
"Nov 27, 2022 7:00 PM",27,12,15,3,1,2,6,4,2,6,4,2,0,0,0,7,2,1,1,9,6,3,1,9,2,1,1,8,0,0,1,0,1,,,
"Nov 27, 2022 8:00 PM",27,11,16,3,3,0,11,5,6,6,2,4,0,0,0,1,4,2,2,1,1,0,3,3,4,3,1,9,1,0,1,1,0,,,
"Nov 27, 2022 9:00 PM",22,6,16,9,7,2,5,5,0,6,4,2,0,0,0,7,4,3,1,10,9,1,4,4,3,3,0,2,1,1,2,0,2,,,
"Nov 27, 2022 10:00 PM",17,3,14,3,3,0,5,2,3,5,2,3,0,0,0,0,2,2,0,4,4,0,3,8,2,2,0,6,1,0,0,0,0,,,
"Nov 27, 2022 11:00 PM",13,2,11,0,0,0,2,1,1,1,0,1,0,0,0,0,2,2,0,1,1,0,1,1,1,0,1,4,0,0,1,1,0,,,
"Nov 28, 2022 12:00 AM",1,0,1,0,0,0,2,0,2,6,3,3,0,0,0,0,2,1,1,0,0,0,1,3,0,0,0,1,0,0,1,1,0,,,
"Nov 28, 2022 1:00 AM",2,1,1,0,0,0,0,0,0,0,0,0,0,0,0,1,0,0,0,3,3,0,0,1,1,0,1,2,0,0,0,0,0,,,
"Nov 28, 2022 2:00 AM",6,1,5,0,0,0,1,1,0,0,0,0,0,0,0,0,0,0,0,1,1,0,0,2,1,1,0,0,0,0,0,0,0,,,
"Nov 28, 2022 3:00 AM",0,0,0,0,0,0,0,0,0,0,0,0,0,0,0,0,0,0,0,1,1,0,0,0,0,0,0,0,0,0,0,0,0,,,
"Nov 28, 2022 4:00 AM",0,0,0,1,0,1,1,0,1,2,0,2,0,0,0,1,1,1,0,0,0,0,1,0,1,1,0,0,0,0,0,0,0,,,
"Nov 28, 2022 5:00 AM",6,3,3,1,1,0,6,3,3,3,2,1,0,0,0,0,7,7,0,3,2,1,6,3,0,0,0,7,1,1,0,0,0,,,
"Nov 28, 2022 6:00 AM",50,30,20,9,4,5,14,4,10,10,4,6,0,0,0,5,25,25,0,13,9,4,26,10,7,2,5,30,1,1,1,0,1,,,
"Nov 28, 2022 7:00 AM",133,93,40,43,13,30,70,16,54,41,13,28,0,0,0,11,69,69,0,24,19,5,64,29,29,4,25,92,2,3,6,5,1,,,
"Nov 28, 2022 8:00 AM",247,192,55,83,14,69,131,40,91,89,30,59,0,0,0,32,178,177,1,43,31,12,152,42,76,24,52,196,4,3,17,14,3,,,
"Nov 28, 2022 9:00 AM",140,122,18,52,19,33,76,37,39,61,29,32,0,0,0,17,88,87,1,22,14,8,66,21,38,13,25,63,1,4,5,5,0,,,
"Nov 28, 2022 10:00 AM",60,43,17,37,16,21,37,19,18,32,18,14,0,0,0,15,39,35,4,11,7,4,18,9,13,10,3,22,2,4,4,3,1,,,
"Nov 28, 2022 11:00 AM",38,23,15,26,13,13,35,17,18,31,17,14,0,0,0,10,37,34,3,13,11,2,13,7,11,7,4,21,1,2,1,0,1,,,
"Nov 28, 2022 12:00 PM",59,29,30,36,17,19,44,24,20,35,20,15,0,0,0,4,29,27,2,19,17,2,16,9,17,9,8,17,5,1,5,2,3,,,
"Nov 28, 2022 1:00 PM",83,32,51,35,16,19,54,26,28,28,15,13,0,0,0,10,19,17,2,13,12,1,12,18,17,11,6,22,1,1,1,1,0,,,
"Nov 28, 2022 2:00 PM",67,31,36,29,19,10,31,18,13,21,12,9,0,0,0,8,26,20,6,20,15,5,11,21,21,11,10,18,1,2,1,1,0,,,
"Nov 28, 2022 3:00 PM",89,35,54,34,20,14,41,27,14,31,21,10,0,0,0,15,35,27,8,23,19,4,16,32,23,14,9,26,3,1,6,4,2,,,
"Nov 28, 2022 4:00 PM",135,38,97,39,26,13,61,39,22,48,33,15,0,0,0,17,26,16,10,53,48,5,19,52,33,24,9,37,1,4,6,2,4,,,
"Nov 28, 2022 5:00 PM",206,56,150,47,34,13,92,57,35,71,45,26,0,0,0,25,36,29,7,113,107,6,32,103,45,36,9,50,3,6,5,4,1,,,
"Nov 28, 2022 6:00 PM",190,35,155,54,46,8,88,71,17,62,44,18,0,0,0,13,42,31,11,105,105,0,30,102,48,33,15,26,3,3,5,4,1,,,
"Nov 28, 2022 7:00 PM",89,23,66,21,18,3,35,24,11,24,18,6,0,0,0,11,19,15,4,40,39,1,9,37,18,12,6,22,3,2,8,3,5,,,
"Nov 28, 2022 8:00 PM",82,18,64,9,5,4,20,8,12,12,4,8,0,0,0,5,15,7,8,25,24,1,6,13,4,4,0,12,3,2,3,1,2,,,
"Nov 28, 2022 9:00 PM",41,6,35,10,8,2,15,10,5,8,6,2,0,0,0,7,10,5,5,22,21,1,5,14,11,7,4,11,3,1,3,2,1,,,
"Nov 28, 2022 10:00 PM",30,9,21,3,2,1,8,3,5,4,1,3,0,0,0,3,5,1,4,14,13,1,1,6,5,3,2,8,1,1,4,2,2,,,
"Nov 28, 2022 11:00 PM",26,6,20,1,0,1,3,2,1,3,1,2,0,0,0,0,7,4,3,9,9,0,4,7,1,1,0,0,0,0,1,1,0,,,
"Nov 29, 2022 12:00 AM",10,3,7,0,0,0,3,3,0,1,1,0,0,0,0,1,2,0,2,0,0,0,0,4,0,0,0,1,0,0,0,0,0,,,
"Nov 29, 2022 1:00 AM",2,0,2,2,2,0,0,0,0,0,0,0,0,0,0,0,1,1,0,1,1,0,1,0,0,0,0,0,0,0,0,0,0,,,
"Nov 29, 2022 2:00 AM",3,3,0,0,0,0,1,1,0,1,1,0,0,0,0,0,0,0,0,0,0,0,0,0,0,0,0,0,0,0,0,0,0,,,
"Nov 29, 2022 3:00 AM",0,0,0,0,0,0,0,0,0,0,0,0,0,0,0,0,0,0,0,1,1,0,0,0,0,0,0,0,0,0,0,0,0,,,
"Nov 29, 2022 4:00 AM",3,2,1,0,0,0,0,0,0,0,0,0,0,0,0,0,1,1,0,0,0,0,1,1,0,0,0,2,0,0,1,1,0,,,
"Nov 29, 2022 5:00 AM",5,2,3,3,0,3,4,0,4,3,0,3,0,0,0,1,5,5,0,0,0,0,5,3,1,0,1,8,0,1,0,0,0,,,
"Nov 29, 2022 6:00 AM",66,42,24,4,2,2,13,3,10,8,2,6,0,0,0,9,21,21,0,14,12,2,20,12,3,0,3,36,0,2,1,1,0,,,
"Nov 29, 2022 7:00 AM",137,92,45,40,8,32,65,18,47,37,15,22,0,0,0,18,81,80,1,22,18,4,77,31,36,10,26,105,3,5,7,7,0,,,
"Nov 29, 2022 8:00 AM",303,234,69,94,18,76,163,44,119,113,35,78,0,0,0,34,205,204,1,46,37,9,178,54,95,26,69,242,5,14,16,15,1,,,
"Nov 29, 2022 9:00 AM",149,121,28,45,9,36,80,30,50,56,26,30,0,0,0,22,98,98,0,25,18,7,73,19,42,14,28,74,1,4,4,3,1,,,
"Nov 29, 2022 10:00 AM",79,68,11,50,28,22,55,31,24,50,31,19,0,0,0,13,42,40,2,13,7,6,25,21,28,13,15,32,2,0,4,4,0,,,
"Nov 29, 2022 11:00 AM",56,43,13,41,22,19,40,20,20,36,17,19,0,0,0,5,22,18,4,13,6,7,17,12,12,10,2,29,4,1,4,3,1,,,
"Nov 29, 2022 12:00 PM",67,38,29,31,11,20,46,29,17,38,21,17,0,0,0,8,32,31,1,17,13,4,19,17,15,11,4,22,3,6,3,2,1,,,
"Nov 29, 2022 1:00 PM",96,32,64,37,21,16,59,33,26,34,24,10,0,0,0,14,40,36,4,14,12,2,26,29,20,8,12,20,5,7,6,2,4,,,
"Nov 29, 2022 2:00 PM",56,20,36,37,15,22,59,30,29,34,13,21,0,0,0,15,25,17,8,19,15,4,12,23,30,15,15,20,1,3,7,5,2,,,
"Nov 29, 2022 3:00 PM",107,53,54,40,22,18,45,24,21,34,20,14,0,0,0,15,30,23,7,26,23,3,15,33,29,14,15,33,1,2,4,2,2,,,
"Nov 29, 2022 4:00 PM",155,38,117,38,27,11,69,47,22,41,29,12,0,0,0,17,39,28,11,61,54,7,27,50,35,27,8,38,7,1,8,2,6,,,
"Nov 29, 2022 5:00 PM",249,49,200,46,34,12,91,56,35,55,35,20,0,0,0,26,57,44,13,96,93,3,46,88,59,37,22,52,8,4,10,7,3,,,
"Nov 29, 2022 6:00 PM",212,54,158,65,50,15,99,78,21,83,65,18,0,0,0,17,44,32,12,120,111,9,26,127,60,48,12,38,5,3,11,6,5,,,
"Nov 29, 2022 7:00 PM",116,26,90,40,31,9,55,39,16,40,29,11,0,0,0,8,29,23,6,49,47,2,20,57,25,19,6,22,1,1,3,1,2,,,
"Nov 29, 2022 8:00 PM",73,15,58,11,6,5,26,16,10,19,10,9,0,0,0,2,13,9,4,41,40,1,10,24,9,6,3,10,5,0,2,1,1,,,
"Nov 29, 2022 9:00 PM",50,9,41,13,12,1,11,8,3,11,8,3,0,0,0,6,10,5,5,27,26,1,6,13,5,3,2,8,2,1,9,5,4,,,
"Nov 29, 2022 10:00 PM",53,12,41,2,2,0,6,5,1,3,2,1,0,0,0,1,4,3,1,18,16,2,2,7,5,5,0,8,1,1,1,0,1,,,
"Nov 29, 2022 11:00 PM",16,4,12,2,0,2,5,2,3,3,1,2,0,0,0,1,2,1,1,2,2,0,1,8,2,0,2,0,0,0,0,0,0,,,
"Nov 30, 2022 12:00 AM",12,3,9,0,0,0,2,2,0,2,1,1,0,0,0,1,1,1,0,1,1,0,0,5,4,3,1,3,0,0,0,0,0,,,
"Nov 30, 2022 1:00 AM",3,0,3,2,2,0,1,1,0,0,0,0,0,0,0,1,1,0,1,1,1,0,0,2,0,0,0,0,0,0,0,0,0,,,
"Nov 30, 2022 2:00 AM",2,2,0,2,2,0,2,0,2,1,0,1,0,0,0,0,0,0,0,2,2,0,0,1,1,0,1,1,0,0,0,0,0,,,
"Nov 30, 2022 3:00 AM",0,0,0,0,0,0,0,0,0,0,0,0,0,0,0,0,0,0,0,0,0,0,1,0,2,2,0,0,0,0,0,0,0,,,
"Nov 30, 2022 4:00 AM",2,1,1,0,0,0,1,0,1,1,0,1,0,0,0,0,2,2,0,2,2,0,2,0,0,0,0,1,0,0,0,0,0,,,
"Nov 30, 2022 5:00 AM",7,5,2,3,2,1,6,2,4,5,2,3,0,0,0,1,7,7,0,2,1,1,6,2,1,0,1,11,0,0,0,0,0,,,
"Nov 30, 2022 6:00 AM",60,33,27,8,1,7,14,1,13,8,1,7,0,0,0,5,15,15,0,10,7,3,15,14,5,0,5,33,0,1,1,1,0,,,
"Nov 30, 2022 7:00 AM",102,74,28,48,12,36,75,23,52,45,12,33,0,0,0,13,78,76,2,24,18,6,75,35,27,5,22,128,2,4,16,15,1,,,
"Nov 30, 2022 8:00 AM",271,213,58,81,19,62,139,41,98,97,34,63,0,0,0,50,197,192,5,54,42,12,166,51,73,15,58,205,5,11,22,19,3,,,
"Nov 30, 2022 9:00 AM",147,125,22,42,12,30,63,27,36,48,29,19,0,0,0,12,100,98,2,22,18,4,63,19,35,15,20,68,3,5,9,8,1,,,
"Nov 30, 2022 10:00 AM",72,55,17,37,14,23,61,27,34,45,24,21,0,0,0,14,47,44,3,7,7,0,25,13,30,10,20,32,4,1,6,3,3,,,
"Nov 30, 2022 11:00 AM",59,41,18,34,12,22,38,22,16,21,11,10,0,0,0,8,34,30,4,14,8,6,23,12,21,15,6,19,4,3,7,4,3,,,
"Nov 30, 2022 12:00 PM",72,34,38,40,16,24,36,15,21,33,16,17,0,0,0,10,29,25,4,12,10,2,20,15,10,6,4,25,1,3,1,1,0,,,
"Nov 30, 2022 1:00 PM",92,44,48,41,22,19,67,42,25,46,25,21,0,0,0,13,34,27,7,34,27,7,15,23,23,17,6,28,4,3,6,4,2,,,
"Nov 30, 2022 2:00 PM",101,37,64,31,19,12,50,34,16,34,22,12,0,0,0,12,35,29,6,27,24,3,19,22,20,10,10,26,3,1,4,4,0,,,
"Nov 30, 2022 3:00 PM",113,44,69,33,16,17,50,29,21,31,14,17,0,0,0,20,39,29,10,27,24,3,16,25,23,15,8,23,2,0,5,2,3,,,
"Nov 30, 2022 4:00 PM",145,33,112,43,29,14,78,43,35,53,33,20,0,0,0,19,31,21,10,49,43,6,18,57,34,23,11,46,5,2,11,7,4,,,
"Nov 30, 2022 5:00 PM",245,52,193,43,37,6,88,58,30,65,49,16,0,0,0,32,50,36,14,102,97,5,34,101,55,32,23,46,6,6,5,3,2,,,
"Nov 30, 2022 6:00 PM",199,49,150,46,36,10,96,76,20,68,47,21,0,0,0,19,36,31,5,100,95,5,29,120,55,43,12,40,3,5,7,4,3,,,
"Nov 30, 2022 7:00 PM",122,30,92,29,23,6,44,36,8,36,28,8,0,0,0,9,25,15,10,42,40,2,13,51,25,20,5,33,2,0,7,5,2,,,
"Nov 30, 2022 8:00 PM",75,18,57,9,5,4,17,9,8,9,2,7,0,0,0,3,18,13,5,29,27,2,12,26,8,5,3,16,2,1,4,2,2,,,
"Nov 30, 2022 9:00 PM",55,13,42,11,9,2,15,9,6,10,6,4,0,0,0,7,16,14,2,30,29,1,14,20,9,7,2,13,4,1,2,0,2,,,
"Nov 30, 2022 10:00 PM",49,9,40,6,4,2,9,6,3,7,2,5,0,0,0,3,8,5,3,21,21,0,5,12,9,8,1,9,0,1,2,0,2,,,
"Nov 30, 2022 11:00 PM",21,4,17,0,0,0,5,4,1,3,1,2,0,0,0,0,4,2,2,12,10,2,4,3,4,3,1,6,0,1,0,0,0,,,
