Time,Clonskeagh Totem,Clonskeagh Totem IN,Clonskeagh Totem OUT,Dun Laoghaire @ Peoples Park Cyclist,Dun Laoghaire @ Peoples Park Cyclists IN,Dun Laoghaire @ Peoples Park Cyclists OUT,Dun Laoghaire @ Seapoint Beach Cyclist,Dun Laoghaire @ Seapoint Beach Cyclists IN,Dun Laoghaire @ Seapoint Beach Cyclists OUT,Dun Laoghaire @ York Road Cyclist,Dun Laoghaire @ York Road Cyclists IN,Dun Laoghaire @ York Road Cyclists OUT,Glenageary Cyclist,Glenageary Bikes IN,Glenageary Bikes OUT,Grange Road Totem,N11 Before UCD,N11 Before UCD Cyclist IN,N11 Before UCD Cyclist OUT,N11 Outbound (Montrose),N11 Outbound (Montrose) OUT-Away From City Centre,N11 Outbound (Montrose) IN- Towards City Centre,N11 Totem Inbound,Rock Road Park,Rock_Road_Park_IN,Rock_Road_Park_OUT,Rock Road Bus Lane,Rock Road Totem Inbound,Wyattville Rd - Bicycles From N11,Wyattville Rd - Bicycles Towards N11,Wyattville Rd At Park Gates Cyclist,Wyattville Rd At Park Gates Bikes IN,Wyattville Rd At Park Gates Bikes OUT,Wyattville Road At Steps Cyclist,Wyattville Road At Steps Bikes IN,Wyattville Road At Steps Bikes OUT
"Jan 1, 2021 12:00 AM",1,1,0,0,0,0,0,0,0,1,1,0,,,,17,,,,2,2,0,0,,,,1,0,0,0,1,0,1,0,0,0
"Jan 1, 2021 1:00 AM",2,0,2,0,0,0,0,0,0,0,0,0,,,,6,,,,0,0,0,1,,,,0,0,0,0,0,0,0,0,0,0
"Jan 1, 2021 2:00 AM",3,2,1,0,0,0,0,0,0,0,0,0,,,,0,,,,1,1,0,1,,,,0,1,0,0,0,0,0,0,0,0
"Jan 1, 2021 3:00 AM",0,0,0,0,0,0,0,0,0,2,2,0,,,,0,,,,0,0,0,0,,,,0,0,0,0,0,0,0,0,0,0
"Jan 1, 2021 4:00 AM",2,1,1,2,0,2,2,0,2,2,0,2,,,,3,,,,1,1,0,1,,,,0,1,0,0,0,0,0,0,0,0
"Jan 1, 2021 5:00 AM",3,2,1,0,0,0,0,0,0,0,0,0,,,,0,,,,1,1,0,0,,,,0,0,0,0,1,1,0,0,0,0
"Jan 1, 2021 6:00 AM",1,1,0,2,1,1,4,4,0,4,4,0,,,,0,,,,1,1,0,2,,,,1,3,0,0,0,0,0,0,0,0
"Jan 1, 2021 7:00 AM",8,3,5,3,1,2,4,1,3,2,1,1,,,,0,,,,3,2,1,2,,,,9,5,0,0,1,0,1,0,0,0
"Jan 1, 2021 8:00 AM",4,2,2,24,18,6,18,13,5,20,17,3,,,,1,,,,1,1,0,4,,,,4,6,0,0,0,0,0,0,0,0
"Jan 1, 2021 9:00 AM",12,5,7,27,15,12,25,17,8,20,13,7,,,,2,,,,7,6,1,5,,,,9,13,0,0,2,1,1,0,0,0
"Jan 1, 2021 10:00 AM",29,19,10,96,58,38,100,63,37,82,59,23,,,,4,,,,6,4,2,5,,,,24,20,4,9,3,0,3,0,0,0
"Jan 1, 2021 11:00 AM",27,16,11,215,114,101,198,116,82,186,110,76,,,,28,,,,16,15,1,23,,,,38,34,9,12,8,3,5,0,0,0
"Jan 1, 2021 12:00 PM",59,26,33,338,219,119,384,240,144,305,196,109,,,,26,,,,19,18,1,19,,,,49,53,8,10,20,7,13,0,0,0
"Jan 1, 2021 1:00 PM",83,47,36,358,166,192,373,171,202,332,151,181,,,,24,,,,14,14,0,23,,,,66,65,12,6,14,7,7,0,0,0
"Jan 1, 2021 2:00 PM",66,37,29,324,154,170,334,147,187,310,154,156,,,,33,,,,23,18,5,46,,,,61,79,14,7,27,18,9,0,0,0
"Jan 1, 2021 3:00 PM",53,22,31,257,129,128,298,154,144,251,133,118,,,,41,,,,32,20,12,21,,,,37,57,13,5,14,5,9,0,0,0
"Jan 1, 2021 4:00 PM",38,22,16,135,64,71,169,56,113,148,50,98,,,,19,,,,10,8,2,15,,,,27,53,7,4,8,6,2,0,0,0
"Jan 1, 2021 5:00 PM",40,17,23,22,11,11,37,12,25,23,6,17,,,,5,,,,9,9,0,6,,,,6,19,3,0,3,2,1,0,0,0
"Jan 1, 2021 6:00 PM",17,9,8,18,8,10,17,8,9,16,7,9,,,,4,,,,3,3,0,3,,,,6,6,1,1,5,4,1,0,0,0
"Jan 1, 2021 7:00 PM",11,6,5,15,6,9,11,6,5,15,7,8,,,,4,,,,3,3,0,4,,,,7,5,3,0,5,2,3,0,0,0
"Jan 1, 2021 8:00 PM",15,6,9,15,6,9,12,4,8,17,6,11,,,,0,,,,6,4,2,4,,,,5,6,0,0,3,1,2,0,0,0
"Jan 1, 2021 9:00 PM",3,2,1,4,3,1,5,3,2,4,3,1,,,,1,,,,4,3,1,0,,,,2,7,1,0,1,1,0,0,0,0
"Jan 1, 2021 10:00 PM",3,1,2,10,6,4,9,4,5,9,5,4,,,,0,,,,3,3,0,0,,,,1,1,0,0,2,1,1,0,0,0
"Jan 1, 2021 11:00 PM",1,1,0,0,0,0,0,0,0,0,0,0,,,,1,,,,0,0,0,0,,,,2,1,1,0,1,0,1,0,0,0
"Jan 2, 2021 12:00 AM",2,0,2,0,0,0,0,0,0,0,0,0,,,,0,,,,0,0,0,0,,,,1,1,0,0,0,0,0,0,0,0
"Jan 2, 2021 1:00 AM",0,0,0,0,0,0,0,0,0,0,0,0,,,,0,,,,0,0,0,0,,,,0,0,1,1,0,0,0,0,0,0
"Jan 2, 2021 2:00 AM",0,0,0,0,0,0,0,0,0,0,0,0,,,,0,,,,0,0,0,0,,,,0,0,0,0,0,0,0,0,0,0
"Jan 2, 2021 3:00 AM",0,0,0,0,0,0,0,0,0,0,0,0,,,,0,,,,0,0,0,1,,,,0,0,0,0,0,0,0,0,0,0
"Jan 2, 2021 4:00 AM",2,1,1,0,0,0,0,0,0,0,0,0,,,,0,,,,0,0,0,0,,,,0,0,0,0,0,0,0,0,0,0
"Jan 2, 2021 5:00 AM",0,0,0,0,0,0,1,0,1,1,0,1,,,,0,,,,0,0,0,1,,,,1,1,0,0,0,0,0,0,0,0
"Jan 2, 2021 6:00 AM",2,2,0,2,1,1,3,1,2,4,2,2,,,,1,,,,4,3,1,2,,,,4,5,0,0,0,0,0,0,0,0
"Jan 2, 2021 7:00 AM",6,2,4,5,5,0,4,3,1,4,3,1,,,,1,,,,1,1,0,2,,,,7,5,0,0,0,0,0,0,0,0
"Jan 2, 2021 8:00 AM",5,2,3,14,9,5,12,8,4,9,6,3,,,,2,,,,2,2,0,0,,,,4,3,0,1,0,0,0,0,0,0
"Jan 2, 2021 9:00 AM",11,5,6,46,31,15,38,23,15,37,29,8,,,,3,,,,4,3,1,6,,,,11,22,3,6,4,3,1,0,0,0
"Jan 2, 2021 10:00 AM",25,8,17,110,58,52,90,51,39,98,59,39,,,,8,,,,7,4,3,13,,,,23,33,4,2,4,3,1,0,0,0
"Jan 2, 2021 11:00 AM",33,20,13,169,95,74,153,87,66,163,87,76,,,,17,,,,18,14,4,8,,,,51,34,7,12,8,5,3,0,0,0
"Jan 2, 2021 12:00 PM",57,32,25,201,98,103,217,127,90,187,105,82,,,,27,,,,14,13,1,16,,,,55,56,9,7,14,10,4,0,0,0
"Jan 2, 2021 1:00 PM",64,39,25,246,140,106,220,108,112,206,113,93,,,,33,,,,24,18,6,15,,,,48,54,8,3,9,5,4,0,0,0
"Jan 2, 2021 2:00 PM",83,40,43,236,125,111,307,154,153,266,153,113,,,,46,,,,26,20,6,12,,,,41,77,6,4,10,5,5,0,0,0
"Jan 2, 2021 3:00 PM",65,33,32,243,110,133,315,157,158,277,124,153,,,,45,,,,27,23,4,16,,,,46,75,9,1,14,5,9,0,0,0
"Jan 2, 2021 4:00 PM",47,19,28,145,78,67,159,65,94,130,63,67,,,,42,,,,19,17,2,5,,,,30,44,6,6,10,8,2,0,0,0
"Jan 2, 2021 5:00 PM",20,6,14,38,15,23,51,20,31,44,15,29,,,,10,,,,4,3,1,9,,,,18,26,2,2,8,2,6,0,0,0
"Jan 2, 2021 6:00 PM",17,5,12,13,8,5,20,8,12,22,9,13,,,,6,,,,2,2,0,3,,,,8,13,3,0,1,1,0,0,0,0
"Jan 2, 2021 7:00 PM",12,7,5,8,4,4,22,13,9,16,11,5,,,,6,,,,7,6,1,3,,,,3,8,2,2,9,3,6,0,0,0
"Jan 2, 2021 8:00 PM",7,3,4,11,5,6,12,1,11,9,2,7,,,,3,,,,3,3,0,3,,,,4,9,3,0,2,1,1,0,0,0
"Jan 2, 2021 9:00 PM",7,2,5,5,2,3,8,5,3,6,3,3,,,,1,,,,1,1,0,2,,,,3,6,1,1,2,1,1,0,0,0
"Jan 2, 2021 10:00 PM",2,0,2,3,2,1,4,1,3,2,2,0,,,,0,,,,1,1,0,0,,,,2,7,0,1,2,2,0,0,0,0
"Jan 2, 2021 11:00 PM",2,1,1,0,0,0,2,0,2,1,0,1,,,,1,,,,1,1,0,1,,,,2,1,0,1,3,2,1,0,0,0
"Jan 3, 2021 12:00 AM",1,0,1,0,0,0,0,0,0,0,0,0,,,,0,,,,0,0,0,1,,,,0,0,0,0,0,0,0,0,0,0
"Jan 3, 2021 1:00 AM",0,0,0,1,0,1,1,0,1,1,0,1,,,,1,,,,1,1,0,0,,,,0,1,1,0,0,0,0,0,0,0
"Jan 3, 2021 2:00 AM",0,0,0,0,0,0,0,0,0,0,0,0,,,,0,,,,0,0,0,0,,,,1,1,0,0,0,0,0,0,0,0
"Jan 3, 2021 3:00 AM",1,0,1,0,0,0,0,0,0,0,0,0,,,,0,,,,0,0,0,0,,,,0,0,0,0,0,0,0,0,0,0
"Jan 3, 2021 4:00 AM",1,0,1,0,0,0,1,1,0,0,0,0,,,,0,,,,1,1,0,1,,,,1,0,0,0,0,0,0,0,0,0
"Jan 3, 2021 5:00 AM",1,1,0,0,0,0,0,0,0,0,0,0,,,,0,,,,0,0,0,1,,,,0,0,0,0,1,1,0,0,0,0
"Jan 3, 2021 6:00 AM",1,1,0,2,2,0,6,5,1,5,3,2,,,,0,,,,1,1,0,1,,,,8,7,0,0,0,0,0,0,0,0
"Jan 3, 2021 7:00 AM",8,4,4,4,2,2,5,2,3,5,4,1,,,,0,,,,3,3,0,1,,,,8,7,0,0,0,0,0,0,0,0
"Jan 3, 2021 8:00 AM",3,2,1,8,6,2,12,6,6,10,6,4,,,,0,,,,4,3,1,2,,,,3,5,1,0,1,0,1,0,0,0
"Jan 3, 2021 9:00 AM",19,9,10,40,30,10,31,20,11,32,26,6,,,,1,,,,5,5,0,5,,,,8,14,2,0,3,1,2,0,0,0
"Jan 3, 2021 10:00 AM",9,8,1,111,49,62,94,50,44,86,43,43,,,,5,,,,14,12,2,7,,,,21,39,4,5,5,4,1,0,0,0
"Jan 3, 2021 11:00 AM",25,17,8,163,102,61,171,104,67,150,103,47,,,,20,,,,16,13,3,23,,,,31,38,9,12,9,4,5,0,0,0
"Jan 3, 2021 12:00 PM",37,17,20,162,80,82,204,110,94,184,104,80,,,,28,,,,21,18,3,21,,,,53,53,10,7,18,10,8,0,0,0
"Jan 3, 2021 1:00 PM",41,19,22,139,72,67,177,82,95,144,75,69,,,,14,,,,14,14,0,19,,,,42,36,1,9,11,7,4,0,0,0
"Jan 3, 2021 2:00 PM",35,19,16,76,34,42,125,52,73,95,43,52,,,,18,,,,12,10,2,17,,,,27,51,7,4,12,9,3,0,0,0
"Jan 3, 2021 3:00 PM",29,11,18,83,40,43,85,36,49,69,33,36,,,,15,,,,13,12,1,15,,,,26,25,3,1,6,4,2,0,0,0
"Jan 3, 2021 4:00 PM",24,10,14,34,21,13,64,30,34,37,23,14,,,,16,,,,9,8,1,9,,,,10,19,4,3,4,1,3,0,0,0
"Jan 3, 2021 5:00 PM",12,4,8,12,4,8,15,6,9,17,4,13,,,,3,,,,8,8,0,5,,,,8,8,3,4,11,5,6,0,0,0
"Jan 3, 2021 6:00 PM",6,3,3,6,5,1,12,7,5,12,8,4,,,,2,,,,2,2,0,3,,,,7,9,1,0,3,1,2,0,0,0
"Jan 3, 2021 7:00 PM",8,3,5,2,1,1,4,1,3,0,0,0,,,,0,,,,4,4,0,8,,,,0,2,1,0,4,3,1,0,0,0
"Jan 3, 2021 8:00 PM",10,7,3,1,1,0,6,4,2,2,0,2,,,,3,,,,2,2,0,3,,,,4,10,2,0,2,1,1,0,0,0
"Jan 3, 2021 9:00 PM",3,0,3,2,0,2,4,1,3,2,1,1,,,,1,,,,5,5,0,3,,,,1,2,0,0,4,1,3,0,0,0
"Jan 3, 2021 10:00 PM",3,1,2,0,0,0,2,0,2,0,0,0,,,,3,,,,1,1,0,2,,,,1,2,0,1,1,0,1,0,0,0
"Jan 3, 2021 11:00 PM",3,1,2,1,0,1,1,0,1,0,0,0,,,,0,,,,0,0,0,1,,,,1,4,0,0,0,0,0,0,0,0
"Jan 4, 2021 12:00 AM",1,1,0,1,1,0,1,1,0,1,1,0,,,,0,,,,3,3,0,0,,,,1,0,0,0,1,1,0,0,0,0
"Jan 4, 2021 1:00 AM",0,0,0,0,0,0,0,0,0,0,0,0,,,,0,,,,1,1,0,0,,,,0,1,0,0,0,0,0,0,0,0
"Jan 4, 2021 2:00 AM",0,0,0,0,0,0,0,0,0,0,0,0,,,,0,,,,0,0,0,0,,,,0,0,0,0,0,0,0,0,0,0
"Jan 4, 2021 3:00 AM",0,0,0,0,0,0,0,0,0,0,0,0,,,,1,,,,2,0,2,0,,,,0,1,0,0,0,0,0,0,0,0
"Jan 4, 2021 4:00 AM",1,0,1,0,0,0,0,0,0,0,0,0,,,,0,,,,0,0,0,0,,,,0,0,0,0,0,0,0,0,0,0
"Jan 4, 2021 5:00 AM",3,2,1,0,0,0,2,2,0,2,2,0,,,,1,,,,2,2,0,2,,,,1,7,0,0,0,0,0,0,0,0
"Jan 4, 2021 6:00 AM",16,13,3,2,1,1,6,2,4,5,2,3,,,,2,,,,5,4,1,10,,,,8,28,0,1,1,1,0,0,0,0
"Jan 4, 2021 7:00 AM",36,22,14,16,7,9,29,11,18,19,7,12,,,,3,,,,10,8,2,18,,,,17,38,0,1,1,0,1,0,0,0
"Jan 4, 2021 8:00 AM",51,40,11,23,12,11,26,12,14,18,11,7,,,,4,,,,8,7,1,39,,,,15,42,2,2,4,3,1,0,0,0
"Jan 4, 2021 9:00 AM",39,29,10,21,11,10,17,9,8,15,9,6,,,,4,,,,3,3,0,12,,,,5,19,0,2,1,1,0,0,0,0
"Jan 4, 2021 10:00 AM",21,16,5,23,7,16,21,10,11,15,7,8,,,,4,,,,4,2,2,9,,,,8,14,2,0,3,2,1,0,0,0
"Jan 4, 2021 11:00 AM",17,9,8,12,5,7,22,9,13,21,10,11,,,,4,,,,2,1,1,4,,,,8,11,2,1,1,1,0,0,0,0
"Jan 4, 2021 12:00 PM",23,13,10,23,15,8,29,20,9,26,18,8,,,,5,,,,3,2,1,3,,,,17,10,3,1,1,0,1,0,0,0
"Jan 4, 2021 1:00 PM",31,16,15,25,18,7,32,17,15,26,16,10,,,,10,,,,7,7,0,6,,,,9,14,0,0,3,1,2,0,0,0
"Jan 4, 2021 2:00 PM",28,14,14,21,8,13,28,15,13,21,9,12,,,,6,,,,9,9,0,9,,,,5,13,0,1,10,5,5,0,0,0
"Jan 4, 2021 3:00 PM",28,15,13,23,13,10,33,22,11,23,16,7,,,,7,,,,15,15,0,8,,,,14,10,4,1,6,5,1,0,0,0
"Jan 4, 2021 4:00 PM",37,8,29,47,20,27,41,19,22,29,10,19,,,,19,,,,14,14,0,4,,,,28,18,2,0,8,5,3,0,0,0
"Jan 4, 2021 5:00 PM",71,16,55,19,14,5,29,17,12,24,16,8,,,,9,,,,21,20,1,6,,,,25,23,1,0,5,2,3,0,0,0
"Jan 4, 2021 6:00 PM",36,10,26,16,10,6,16,12,4,19,15,4,,,,5,,,,25,24,1,7,,,,30,12,3,2,9,6,3,0,0,0
"Jan 4, 2021 7:00 PM",27,5,22,12,7,5,13,10,3,10,7,3,,,,9,,,,13,12,1,6,,,,15,5,1,0,1,0,1,0,0,0
"Jan 4, 2021 8:00 PM",14,6,8,3,2,1,10,4,6,8,4,4,,,,2,,,,5,5,0,2,,,,7,8,1,0,1,0,1,0,0,0
"Jan 4, 2021 9:00 PM",12,4,8,4,2,2,4,2,2,5,3,2,,,,0,,,,5,5,0,1,,,,2,6,0,0,0,0,0,0,0,0
"Jan 4, 2021 10:00 PM",4,1,3,1,0,1,1,0,1,1,0,1,,,,0,,,,1,1,0,1,,,,4,6,0,0,1,1,0,0,0,0
"Jan 4, 2021 11:00 PM",3,2,1,1,1,0,4,4,0,1,1,0,,,,1,,,,2,2,0,1,,,,2,0,0,0,0,0,0,0,0,0
"Jan 5, 2021 12:00 AM",0,0,0,0,0,0,0,0,0,1,0,1,,,,0,,,,0,0,0,1,,,,0,1,0,0,0,0,0,0,0,0
"Jan 5, 2021 1:00 AM",0,0,0,0,0,0,1,1,0,0,0,0,,,,0,,,,1,1,0,0,,,,0,0,0,0,1,1,0,0,0,0
"Jan 5, 2021 2:00 AM",2,2,0,0,0,0,0,0,0,0,0,0,,,,1,,,,0,0,0,0,,,,0,0,0,0,0,0,0,0,0,0
"Jan 5, 2021 3:00 AM",0,0,0,0,0,0,0,0,0,0,0,0,,,,0,,,,0,0,0,0,,,,0,1,0,0,1,1,0,0,0,0
"Jan 5, 2021 4:00 AM",2,1,1,0,0,0,1,1,0,0,0,0,,,,0,,,,0,0,0,0,,,,1,0,0,0,0,0,0,0,0,0
"Jan 5, 2021 5:00 AM",1,1,0,0,0,0,4,4,0,2,1,1,,,,0,,,,1,1,0,0,,,,1,7,1,0,0,0,0,0,0,0
"Jan 5, 2021 6:00 AM",15,11,4,5,4,1,11,4,7,5,4,1,,,,3,,,,7,6,1,5,,,,3,26,0,1,1,1,0,0,0,0
"Jan 5, 2021 7:00 AM",38,19,19,18,11,7,23,7,16,19,9,10,,,,4,,,,12,11,1,19,,,,14,35,0,0,0,0,0,0,0,0
"Jan 5, 2021 8:00 AM",51,37,14,35,15,20,33,19,14,29,17,12,,,,4,,,,6,4,2,31,,,,18,32,3,1,5,3,2,0,0,0
"Jan 5, 2021 9:00 AM",41,30,11,41,10,31,48,16,32,35,9,26,,,,3,,,,5,4,1,20,,,,8,18,0,0,2,0,2,0,0,0
"Jan 5, 2021 10:00 AM",36,19,17,32,17,15,39,20,19,43,20,23,,,,9,,,,9,7,2,10,,,,13,21,1,5,5,3,2,0,0,0
"Jan 5, 2021 11:00 AM",26,15,11,66,35,31,64,36,28,55,37,18,,,,6,,,,6,5,1,3,,,,10,21,7,2,7,4,3,0,0,0
"Jan 5, 2021 12:00 PM",45,20,25,86,43,43,73,35,38,81,38,43,,,,21,,,,11,10,1,6,,,,21,16,2,0,6,4,2,0,0,0
"Jan 5, 2021 1:00 PM",32,18,14,83,46,37,76,39,37,68,33,35,,,,17,,,,14,12,2,7,,,,24,24,9,1,19,10,9,0,0,0
"Jan 5, 2021 2:00 PM",69,28,41,112,63,49,145,80,65,117,74,43,,,,32,,,,17,13,4,11,,,,28,36,4,4,29,22,7,0,0,0
"Jan 5, 2021 3:00 PM",43,14,29,120,57,63,108,50,58,99,50,49,,,,39,,,,24,23,1,14,,,,33,40,7,0,22,11,11,0,0,0
"Jan 5, 2021 4:00 PM",47,22,25,79,32,47,98,43,55,65,27,38,,,,8,,,,22,20,2,15,,,,35,26,2,6,12,3,9,0,0,0
"Jan 5, 2021 5:00 PM",81,22,59,37,22,15,55,30,25,43,28,15,,,,21,,,,24,24,0,9,,,,39,34,4,3,9,3,6,0,0,0
"Jan 5, 2021 6:00 PM",56,17,39,24,14,10,33,19,14,33,21,12,,,,11,,,,23,23,0,9,,,,30,14,1,2,4,4,0,0,0,0
"Jan 5, 2021 7:00 PM",25,11,14,18,14,4,21,16,5,18,11,7,,,,2,,,,12,11,1,6,,,,14,16,3,1,8,4,4,0,0,0
"Jan 5, 2021 8:00 PM",22,12,10,15,5,10,17,8,9,15,9,6,,,,4,,,,5,5,0,5,,,,14,10,2,0,0,0,0,0,0,0
"Jan 5, 2021 9:00 PM",10,3,7,12,6,6,10,6,4,12,7,5,,,,0,,,,3,3,0,1,,,,6,10,0,0,1,0,1,0,0,0
"Jan 5, 2021 10:00 PM",3,1,2,3,2,1,3,2,1,3,2,1,,,,0,,,,3,1,2,3,,,,2,6,0,0,1,1,0,0,0,0
"Jan 5, 2021 11:00 PM",3,1,2,0,0,0,0,0,0,0,0,0,,,,0,,,,0,0,0,1,,,,0,1,0,0,0,0,0,0,0,0
"Jan 6, 2021 12:00 AM",1,0,1,0,0,0,0,0,0,0,0,0,,,,0,,,,1,1,0,3,,,,0,0,0,0,0,0,0,0,0,0
"Jan 6, 2021 1:00 AM",1,1,0,0,0,0,0,0,0,0,0,0,,,,0,,,,0,0,0,0,,,,0,1,0,0,1,1,0,0,0,0
"Jan 6, 2021 2:00 AM",1,1,0,0,0,0,0,0,0,0,0,0,,,,0,,,,0,0,0,0,,,,0,0,0,0,0,0,0,0,0,0
"Jan 6, 2021 3:00 AM",1,1,0,0,0,0,0,0,0,0,0,0,,,,0,,,,0,0,0,0,,,,1,0,0,0,0,0,0,0,0,0
"Jan 6, 2021 4:00 AM",0,0,0,0,0,0,1,1,0,0,0,0,,,,0,,,,0,0,0,0,,,,1,0,0,0,0,0,0,0,0,0
"Jan 6, 2021 5:00 AM",1,1,0,0,0,0,2,2,0,3,2,1,,,,0,,,,1,1,0,2,,,,0,10,0,0,0,0,0,0,0,0
"Jan 6, 2021 6:00 AM",15,11,4,6,4,2,5,2,3,3,2,1,,,,4,,,,4,4,0,5,,,,6,20,0,0,1,1,0,0,0,0
"Jan 6, 2021 7:00 AM",29,15,14,26,9,17,27,6,21,22,6,16,,,,3,,,,5,5,0,27,,,,18,48,2,1,1,1,0,0,0,0
"Jan 6, 2021 8:00 AM",46,31,15,23,6,17,34,14,20,27,11,16,,,,3,,,,10,7,3,30,,,,17,33,3,2,4,3,1,0,0,0
"Jan 6, 2021 9:00 AM",36,24,12,43,18,25,39,15,24,33,13,20,,,,5,,,,8,5,3,17,,,,13,22,4,2,5,1,4,0,0,0
"Jan 6, 2021 10:00 AM",39,26,13,60,35,25,48,37,11,44,31,13,,,,7,,,,7,6,1,16,,,,9,21,3,3,1,1,0,0,0,0
"Jan 6, 2021 11:00 AM",28,14,14,85,50,35,69,45,24,78,54,24,,,,14,,,,7,5,2,10,,,,17,14,4,1,1,1,0,0,0,0
"Jan 6, 2021 12:00 PM",38,15,23,116,51,65,113,47,66,107,44,63,,,,17,,,,8,8,0,12,,,,22,35,4,4,9,6,3,0,0,0
"Jan 6, 2021 1:00 PM",32,15,17,116,47,69,119,56,63,81,36,45,,,,9,,,,11,10,1,12,,,,21,27,11,5,16,6,10,0,0,0
"Jan 6, 2021 2:00 PM",36,17,19,94,50,44,102,53,49,86,48,38,,,,9,,,,12,12,0,16,,,,24,18,4,2,24,11,13,0,0,0
"Jan 6, 2021 3:00 PM",31,14,17,131,63,68,116,60,56,100,53,47,,,,15,,,,12,11,1,15,,,,28,16,4,1,9,7,2,0,0,0
"Jan 6, 2021 4:00 PM",54,18,36,84,42,42,79,39,40,82,42,40,,,,14,,,,25,21,4,20,,,,32,31,1,2,9,3,6,0,0,0
"Jan 6, 2021 5:00 PM",65,13,52,41,21,20,57,32,25,41,24,17,,,,6,,,,32,32,0,18,,,,47,42,3,3,6,2,4,0,0,0
"Jan 6, 2021 6:00 PM",48,17,31,28,24,4,30,24,6,32,26,6,,,,8,,,,26,23,3,9,,,,31,19,2,0,6,3,3,0,0,0
"Jan 6, 2021 7:00 PM",32,11,21,17,14,3,26,19,7,15,13,2,,,,2,,,,17,17,0,7,,,,15,11,1,1,4,2,2,0,0,0
"Jan 6, 2021 8:00 PM",20,7,13,10,3,7,15,4,11,12,3,9,,,,0,,,,6,5,1,3,,,,12,8,1,0,6,3,3,0,0,0
"Jan 6, 2021 9:00 PM",11,5,6,1,1,0,4,3,1,3,2,1,,,,3,,,,4,4,0,0,,,,2,4,0,3,0,0,0,0,0,0
"Jan 6, 2021 10:00 PM",6,1,5,3,0,3,1,1,0,0,0,0,,,,2,,,,0,0,0,0,,,,2,3,1,0,4,2,2,0,0,0
"Jan 6, 2021 11:00 PM",3,2,1,0,0,0,2,0,2,2,0,2,,,,1,,,,2,2,0,1,,,,2,2,0,0,1,0,1,0,0,0
"Jan 7, 2021 12:00 AM",2,1,1,1,1,0,2,1,1,1,1,0,,,,0,,,,0,0,0,1,,,,1,0,0,0,0,0,0,0,0,0
"Jan 7, 2021 1:00 AM",0,0,0,1,1,0,0,0,0,0,0,0,,,,0,,,,1,1,0,0,,,,0,0,0,0,0,0,0,0,0,0
"Jan 7, 2021 2:00 AM",1,1,0,0,0,0,0,0,0,0,0,0,,,,0,,,,0,0,0,0,,,,0,1,0,0,0,0,0,0,0,0
"Jan 7, 2021 3:00 AM",0,0,0,0,0,0,0,0,0,0,0,0,,,,0,,,,0,0,0,0,,,,0,0,0,0,1,1,0,0,0,0
"Jan 7, 2021 4:00 AM",0,0,0,0,0,0,1,1,0,0,0,0,,,,0,,,,0,0,0,0,,,,1,0,0,0,0,0,0,0,0,0
"Jan 7, 2021 5:00 AM",2,2,0,0,0,0,1,1,0,0,0,0,,,,0,,,,0,0,0,2,,,,1,7,1,0,0,0,0,0,0,0
"Jan 7, 2021 6:00 AM",10,8,2,0,0,0,7,4,3,1,1,0,,,,2,,,,5,5,0,2,,,,8,15,0,0,2,1,1,0,0,0
"Jan 7, 2021 7:00 AM",28,17,11,12,6,6,27,10,17,20,8,12,,,,5,,,,7,6,1,11,,,,19,32,0,1,1,0,1,0,0,0
"Jan 7, 2021 8:00 AM",24,12,12,12,3,9,18,8,10,12,4,8,,,,3,,,,4,3,1,12,,,,14,22,0,1,1,1,0,0,0,0
"Jan 7, 2021 9:00 AM",12,7,5,12,4,8,15,5,10,13,6,7,,,,3,,,,6,4,2,15,,,,5,12,0,2,4,2,2,0,0,0
"Jan 7, 2021 10:00 AM",11,7,4,16,12,4,22,13,9,15,10,5,,,,4,,,,7,7,0,4,,,,7,11,0,0,3,1,2,0,0,0
"Jan 7, 2021 11:00 AM",17,10,7,29,17,12,22,10,12,34,19,15,,,,4,,,,5,2,3,10,,,,9,10,1,2,0,0,0,0,0,0
"Jan 7, 2021 12:00 PM",26,10,16,51,26,25,53,31,22,40,20,20,,,,4,,,,10,10,0,7,,,,12,16,4,2,7,4,3,0,0,0
"Jan 7, 2021 1:00 PM",28,10,18,60,31,29,40,22,18,49,30,19,,,,7,,,,14,12,2,7,,,,16,31,4,1,6,3,3,0,0,0
"Jan 7, 2021 2:00 PM",28,14,14,51,27,24,57,29,28,54,25,29,,,,11,,,,9,7,2,10,,,,17,17,6,2,6,4,2,0,0,0
"Jan 7, 2021 3:00 PM",20,9,11,54,32,22,71,46,25,59,40,19,,,,10,,,,12,12,0,10,,,,15,21,7,2,10,8,2,0,0,0
"Jan 7, 2021 4:00 PM",46,18,28,56,25,31,77,35,42,53,23,30,,,,22,,,,14,13,1,10,,,,28,16,4,1,14,8,6,0,0,0
"Jan 7, 2021 5:00 PM",54,14,40,32,18,14,43,23,20,33,20,13,,,,8,,,,16,15,1,11,,,,21,23,2,0,8,2,6,0,0,0
"Jan 7, 2021 6:00 PM",46,25,21,19,13,6,30,23,7,22,15,7,,,,11,,,,14,14,0,7,,,,25,14,3,1,6,2,4,0,0,0
"Jan 7, 2021 7:00 PM",29,11,18,17,13,4,42,28,14,28,17,11,,,,5,,,,10,10,0,4,,,,26,9,0,3,0,0,0,0,0,0
"Jan 7, 2021 8:00 PM",16,6,10,17,7,10,15,5,10,14,8,6,,,,1,,,,1,1,0,5,,,,6,10,3,0,3,2,1,0,0,0
"Jan 7, 2021 9:00 PM",15,5,10,13,7,6,13,9,4,14,8,6,,,,5,,,,6,6,0,1,,,,5,6,0,0,0,0,0,0,0,0
"Jan 7, 2021 10:00 PM",10,3,7,1,1,0,4,1,3,3,0,3,,,,1,,,,2,0,2,1,,,,2,9,0,0,2,1,1,0,0,0
"Jan 7, 2021 11:00 PM",6,3,3,1,0,1,3,0,3,1,0,1,,,,0,,,,2,2,0,0,,,,1,2,0,0,1,1,0,0,0,0
"Jan 8, 2021 12:00 AM",7,3,4,0,0,0,0,0,0,1,1,0,,,,0,,,,1,1,0,0,,,,1,0,0,0,1,0,1,0,0,0
"Jan 8, 2021 1:00 AM",0,0,0,0,0,0,0,0,0,0,0,0,,,,0,,,,0,0,0,0,,,,0,0,0,0,0,0,0,0,0,0
"Jan 8, 2021 2:00 AM",0,0,0,0,0,0,0,0,0,0,0,0,,,,0,,,,0,0,0,0,,,,0,0,0,0,0,0,0,0,0,0
"Jan 8, 2021 3:00 AM",0,0,0,0,0,0,0,0,0,0,0,0,,,,0,,,,0,0,0,0,,,,0,0,0,0,0,0,0,0,0,0
"Jan 8, 2021 4:00 AM",1,1,0,0,0,0,0,0,0,0,0,0,,,,0,,,,0,0,0,0,,,,0,0,0,0,0,0,0,0,0,0
"Jan 8, 2021 5:00 AM",1,1,0,1,0,1,4,4,0,2,1,1,,,,0,,,,1,1,0,2,,,,0,3,1,0,0,0,0,0,0,0
"Jan 8, 2021 6:00 AM",12,9,3,6,3,3,3,1,2,7,3,4,,,,1,,,,5,5,0,3,,,,6,18,0,0,0,0,0,0,0,0
"Jan 8, 2021 7:00 AM",25,16,9,16,8,8,21,10,11,11,6,5,,,,5,,,,8,7,1,17,,,,13,21,2,1,1,1,0,0,0,0
"Jan 8, 2021 8:00 AM",31,23,8,11,5,6,24,8,16,15,6,9,,,,5,,,,4,3,1,17,,,,15,24,0,3,1,1,0,0,0,0
"Jan 8, 2021 9:00 AM",23,17,6,19,10,9,27,17,10,14,8,6,,,,7,,,,7,6,1,10,,,,12,16,0,1,2,1,1,0,0,0
"Jan 8, 2021 10:00 AM",21,14,7,22,15,7,23,10,13,19,13,6,,,,5,,,,6,5,1,2,,,,8,14,1,0,2,0,2,0,0,0
"Jan 8, 2021 11:00 AM",18,9,9,16,8,8,27,15,12,13,11,2,,,,13,,,,8,5,3,7,,,,9,11,2,1,2,2,0,0,0,0
"Jan 8, 2021 12:00 PM",46,21,25,54,36,18,60,39,21,56,36,20,,,,8,,,,3,3,0,8,,,,14,21,2,1,8,4,4,0,0,0
"Jan 8, 2021 1:00 PM",49,26,23,59,26,33,72,34,38,63,31,32,,,,12,,,,7,5,2,12,,,,28,25,1,3,3,3,0,0,0,0
"Jan 8, 2021 2:00 PM",49,23,26,62,34,28,87,52,35,64,35,29,,,,18,,,,11,9,2,5,,,,18,34,6,0,7,3,4,0,0,0
"Jan 8, 2021 3:00 PM",53,21,32,77,39,38,105,60,45,59,36,23,,,,18,,,,10,10,0,13,,,,32,27,5,3,8,7,1,0,0,0
"Jan 8, 2021 4:00 PM",55,24,31,58,29,29,93,39,54,69,29,40,,,,19,,,,20,15,5,13,,,,30,44,3,1,13,5,8,0,0,0
"Jan 8, 2021 5:00 PM",47,14,33,32,16,16,52,29,23,38,18,20,,,,8,,,,16,15,1,13,,,,23,22,0,1,8,4,4,0,0,0
"Jan 8, 2021 6:00 PM",39,12,27,18,10,8,28,14,14,16,7,9,,,,11,,,,20,19,1,5,,,,21,15,1,2,5,3,2,0,0,0
"Jan 8, 2021 7:00 PM",19,7,12,21,15,6,20,14,6,18,12,6,,,,5,,,,10,8,2,8,,,,13,11,1,0,1,0,1,0,0,0
"Jan 8, 2021 8:00 PM",16,6,10,8,2,6,14,5,9,12,5,7,,,,0,,,,5,3,2,8,,,,5,6,0,0,3,1,2,0,0,0
"Jan 8, 2021 9:00 PM",14,4,10,0,0,0,3,0,3,1,0,1,,,,7,,,,5,5,0,0,,,,2,6,1,1,5,4,1,0,0,0
"Jan 8, 2021 10:00 PM",8,1,7,0,0,0,2,0,2,0,0,0,,,,1,,,,0,0,0,2,,,,4,3,0,0,3,0,3,0,0,0
"Jan 8, 2021 11:00 PM",4,3,1,0,0,0,2,1,1,2,0,2,,,,0,,,,0,0,0,1,,,,0,2,0,0,2,1,1,0,0,0
"Jan 9, 2021 12:00 AM",7,5,2,0,0,0,0,0,0,0,0,0,,,,0,,,,2,2,0,0,,,,1,0,0,0,0,0,0,0,0,0
"Jan 9, 2021 1:00 AM",0,0,0,0,0,0,0,0,0,0,0,0,,,,0,,,,1,1,0,1,,,,0,0,0,0,3,1,2,0,0,0
"Jan 9, 2021 2:00 AM",3,3,0,0,0,0,0,0,0,0,0,0,,,,0,,,,0,0,0,0,,,,0,0,0,0,0,0,0,0,0,0
"Jan 9, 2021 3:00 AM",0,0,0,0,0,0,0,0,0,0,0,0,,,,0,,,,0,0,0,0,,,,0,0,0,0,1,0,1,0,0,0
"Jan 9, 2021 4:00 AM",1,1,0,0,0,0,0,0,0,0,0,0,,,,0,,,,0,0,0,0,,,,0,0,0,0,0,0,0,0,0,0
"Jan 9, 2021 5:00 AM",1,0,1,0,0,0,0,0,0,0,0,0,,,,0,,,,0,0,0,0,,,,1,0,0,0,0,0,0,0,0,0
"Jan 9, 2021 6:00 AM",5,2,3,6,3,3,8,4,4,5,2,3,,,,1,,,,1,1,0,0,,,,5,3,0,0,0,0,0,0,0,0
"Jan 9, 2021 7:00 AM",5,1,4,1,1,0,4,2,2,2,1,1,,,,1,,,,3,2,1,2,,,,4,6,0,0,0,0,0,0,0,0
"Jan 9, 2021 8:00 AM",5,3,2,18,13,5,19,17,2,14,12,2,,,,1,,,,4,4,0,0,,,,7,3,1,2,2,1,1,0,0,0
"Jan 9, 2021 9:00 AM",16,9,7,22,13,9,48,27,21,16,9,7,,,,2,,,,4,3,1,4,,,,8,13,0,1,2,1,1,0,0,0
"Jan 9, 2021 10:00 AM",16,7,9,34,24,10,65,39,26,33,23,10,,,,3,,,,4,3,1,8,,,,7,14,1,1,2,1,1,0,0,0
"Jan 9, 2021 11:00 AM",29,14,15,75,45,30,91,61,30,87,60,27,,,,4,,,,3,3,0,11,,,,22,24,2,6,6,0,6,0,0,0
"Jan 9, 2021 12:00 PM",39,23,16,156,84,72,172,96,76,141,72,69,,,,4,,,,9,8,1,19,,,,31,29,2,1,7,5,2,0,0,0
"Jan 9, 2021 1:00 PM",59,30,29,194,106,88,209,129,80,191,120,71,,,,17,,,,19,16,3,20,,,,75,31,6,3,5,1,4,0,0,0
"Jan 9, 2021 2:00 PM",65,30,35,241,130,111,253,128,125,229,130,99,,,,32,,,,24,21,3,22,,,,63,65,4,1,18,12,6,0,0,0
"Jan 9, 2021 3:00 PM",59,29,30,261,131,130,242,116,126,252,128,124,,,,25,,,,26,22,4,13,,,,57,57,3,5,12,8,4,0,0,0
"Jan 9, 2021 4:00 PM",35,19,16,151,68,83,161,61,100,161,61,100,,,,26,,,,21,19,2,25,,,,37,63,3,2,14,10,4,0,0,0
"Jan 9, 2021 5:00 PM",25,12,13,38,20,18,52,18,34,45,15,30,,,,7,,,,10,9,1,5,,,,18,40,3,1,2,0,2,0,0,0
"Jan 9, 2021 6:00 PM",27,14,13,10,7,3,19,11,8,20,11,9,,,,5,,,,6,4,2,11,,,,9,9,0,1,0,0,0,0,0,0
"Jan 9, 2021 7:00 PM",19,9,10,7,4,3,11,6,5,9,5,4,,,,7,,,,3,3,0,4,,,,3,7,0,0,4,4,0,0,0,0
"Jan 9, 2021 8:00 PM",14,6,8,7,2,5,10,3,7,10,1,9,,,,7,,,,1,1,0,3,,,,4,8,0,0,3,2,1,0,0,0
"Jan 9, 2021 9:00 PM",7,3,4,3,1,2,4,2,2,1,0,1,,,,5,,,,1,1,0,1,,,,1,5,1,0,0,0,0,0,0,0
"Jan 9, 2021 10:00 PM",10,1,9,3,2,1,1,0,1,2,1,1,,,,2,,,,1,1,0,1,,,,1,4,0,0,2,2,0,0,0,0
"Jan 9, 2021 11:00 PM",3,1,2,1,1,0,0,0,0,0,0,0,,,,0,,,,1,1,0,1,,,,1,0,1,1,0,0,0,0,0,0
"Jan 10, 2021 12:00 AM",5,2,3,0,0,0,1,0,1,0,0,0,,,,2,,,,0,0,0,1,,,,0,0,0,0,4,2,2,0,0,0
"Jan 10, 2021 1:00 AM",2,1,1,0,0,0,1,1,0,0,0,0,,,,0,,,,1,1,0,0,,,,0,1,0,0,0,0,0,0,0,0
"Jan 10, 2021 2:00 AM",2,0,2,3,2,1,0,0,0,0,0,0,,,,0,,,,1,1,0,0,,,,0,0,0,0,0,0,0,0,0,0
"Jan 10, 2021 3:00 AM",0,0,0,0,0,0,0,0,0,0,0,0,,,,1,,,,0,0,0,0,,,,0,0,0,0,0,0,0,0,0,0
"Jan 10, 2021 4:00 AM",0,0,0,0,0,0,1,1,0,0,0,0,,,,0,,,,1,1,0,1,,,,1,0,0,0,1,1,0,0,0,0
"Jan 10, 2021 5:00 AM",1,0,1,0,0,0,0,0,0,1,0,1,,,,0,,,,0,0,0,0,,,,0,0,0,0,0,0,0,0,0,0
"Jan 10, 2021 6:00 AM",5,3,2,1,0,1,5,4,1,2,2,0,,,,0,,,,1,1,0,2,,,,6,3,0,0,0,0,0,0,0,0
"Jan 10, 2021 7:00 AM",6,2,4,11,8,3,11,7,4,15,11,4,,,,0,,,,3,2,1,2,,,,10,7,0,1,1,1,0,0,0,0
"Jan 10, 2021 8:00 AM",4,2,2,22,10,12,26,13,13,19,11,8,,,,0,,,,2,2,0,3,,,,5,9,0,3,0,0,0,0,0,0
"Jan 10, 2021 9:00 AM",13,6,7,65,34,31,98,57,41,66,35,31,,,,5,,,,9,8,1,2,,,,18,17,1,1,5,2,3,0,0,0
"Jan 10, 2021 10:00 AM",37,15,22,203,131,72,220,147,73,187,134,53,,,,13,,,,6,3,3,5,,,,45,49,8,5,4,1,3,0,0,0
"Jan 10, 2021 11:00 AM",39,20,19,292,146,146,318,158,160,298,160,138,,,,24,,,,11,10,1,18,,,,71,93,12,11,19,9,10,0,0,0
"Jan 10, 2021 12:00 PM",84,41,43,344,185,159,337,165,172,308,159,149,,,,44,,,,21,19,2,34,,,,57,96,16,6,10,4,6,0,0,0
"Jan 10, 2021 1:00 PM",78,42,36,328,164,164,313,137,176,301,135,166,,,,29,,,,18,16,2,14,,,,69,63,12,13,18,12,6,0,0,0
"Jan 10, 2021 2:00 PM",82,51,31,294,149,145,318,162,156,295,165,130,,,,36,,,,30,26,4,28,,,,55,65,11,15,28,21,7,0,0,0
"Jan 10, 2021 3:00 PM",62,32,30,234,105,129,200,100,100,241,113,128,,,,32,,,,23,17,6,36,,,,37,50,8,9,18,14,4,0,0,0
"Jan 10, 2021 4:00 PM",30,11,19,153,78,75,148,63,85,147,61,86,,,,33,,,,10,9,1,13,,,,24,38,6,2,16,8,8,0,0,0
"Jan 10, 2021 5:00 PM",25,10,15,37,18,19,60,22,38,53,22,31,,,,16,,,,13,13,0,14,,,,11,25,7,1,13,9,4,0,0,0
"Jan 10, 2021 6:00 PM",20,9,11,11,8,3,20,14,6,22,16,6,,,,5,,,,3,2,1,2,,,,4,14,5,0,9,5,4,0,0,0
"Jan 10, 2021 7:00 PM",13,9,4,10,6,4,11,5,6,9,5,4,,,,3,,,,0,0,0,6,,,,12,10,1,1,2,1,1,0,0,0
"Jan 10, 2021 8:00 PM",9,5,4,1,1,0,6,5,1,5,5,0,,,,3,,,,3,3,0,5,,,,4,11,0,0,3,2,1,0,0,0
"Jan 10, 2021 9:00 PM",4,1,3,2,1,1,6,1,5,7,0,7,,,,3,,,,5,4,1,2,,,,2,9,1,0,5,3,2,0,0,0
"Jan 10, 2021 10:00 PM",5,2,3,2,2,0,3,3,0,3,3,0,,,,1,,,,1,1,0,1,,,,3,4,1,0,6,5,1,0,0,0
"Jan 10, 2021 11:00 PM",3,1,2,0,0,0,1,0,1,0,0,0,,,,1,,,,1,1,0,0,,,,0,0,0,1,0,0,0,0,0,0
"Jan 11, 2021 12:00 AM",0,0,0,0,0,0,0,0,0,0,0,0,,,,0,,,,0,0,0,0,,,,0,0,0,0,1,0,1,0,0,0
"Jan 11, 2021 1:00 AM",1,1,0,0,0,0,1,0,1,1,0,1,,,,0,,,,0,0,0,0,,,,0,0,0,0,0,0,0,0,0,0
"Jan 11, 2021 2:00 AM",4,2,2,0,0,0,2,0,2,2,0,2,,,,0,,,,0,0,0,0,,,,1,0,0,0,0,0,0,0,0,0
"Jan 11, 2021 3:00 AM",0,0,0,0,0,0,0,0,0,0,0,0,,,,0,,,,0,0,0,0,,,,0,0,0,0,0,0,0,0,0,0
"Jan 11, 2021 4:00 AM",0,0,0,0,0,0,0,0,0,0,0,0,,,,0,,,,1,1,0,0,,,,0,0,0,0,0,0,0,0,0,0
"Jan 11, 2021 5:00 AM",3,2,1,0,0,0,3,2,1,4,2,2,,,,0,,,,3,3,0,2,,,,2,6,1,0,0,0,0,0,0,0
"Jan 11, 2021 6:00 AM",15,11,4,9,4,5,13,5,8,11,5,6,,,,1,,,,4,4,0,11,,,,8,21,0,0,2,1,1,0,0,0
"Jan 11, 2021 7:00 AM",45,30,15,34,16,18,37,13,24,30,13,17,,,,5,,,,5,5,0,24,,,,18,52,0,1,4,2,2,0,0,0
"Jan 11, 2021 8:00 AM",56,41,15,37,16,21,37,18,19,33,17,16,,,,8,,,,8,6,2,37,,,,16,42,1,3,2,1,1,0,0,0
"Jan 11, 2021 9:00 AM",28,22,6,27,13,14,49,24,25,26,13,13,,,,6,,,,11,10,1,16,,,,13,24,1,3,3,2,1,0,0,0
"Jan 11, 2021 10:00 AM",36,20,16,32,16,16,42,18,24,30,18,12,,,,16,,,,9,6,3,9,,,,6,20,2,0,2,1,1,0,0,0
"Jan 11, 2021 11:00 AM",25,10,15,43,25,18,59,25,34,35,22,13,,,,6,,,,4,3,1,7,,,,12,17,2,2,4,3,1,0,0,0
"Jan 11, 2021 12:00 PM",39,16,23,48,26,22,43,22,21,33,18,15,,,,19,,,,10,9,1,10,,,,20,28,1,1,4,3,1,0,0,0
"Jan 11, 2021 1:00 PM",28,14,14,36,18,18,38,16,22,36,20,16,,,,7,,,,10,8,2,11,,,,21,24,5,3,8,4,4,0,0,0
"Jan 11, 2021 2:00 PM",28,15,13,25,12,13,46,22,24,30,15,15,,,,7,,,,11,11,0,4,,,,16,18,2,1,8,4,4,0,0,0
"Jan 11, 2021 3:00 PM",23,8,15,43,25,18,41,26,15,35,20,15,,,,10,,,,13,11,2,10,,,,22,10,1,0,2,0,2,0,0,0
"Jan 11, 2021 4:00 PM",48,12,36,44,24,20,52,26,26,41,27,14,,,,20,,,,13,12,1,12,,,,34,19,0,1,10,5,5,0,0,0
"Jan 11, 2021 5:00 PM",68,16,52,30,20,10,50,32,18,27,15,12,,,,7,,,,33,33,0,7,,,,32,19,2,1,5,3,2,0,0,0
"Jan 11, 2021 6:00 PM",43,10,33,24,14,10,38,24,14,34,21,13,,,,5,,,,30,28,2,6,,,,37,20,2,2,4,3,1,0,0,0
"Jan 11, 2021 7:00 PM",26,10,16,28,21,7,18,15,3,16,14,2,,,,4,,,,13,13,0,6,,,,13,8,0,0,1,1,0,0,0,0
"Jan 11, 2021 8:00 PM",17,4,13,15,11,4,18,10,8,16,12,4,,,,2,,,,3,3,0,2,,,,14,4,0,0,1,0,1,0,0,0
"Jan 11, 2021 9:00 PM",13,4,9,7,3,4,8,5,3,4,1,3,,,,0,,,,3,2,1,1,,,,4,1,0,0,4,1,3,0,0,0
"Jan 11, 2021 10:00 PM",3,0,3,1,0,1,3,3,0,2,2,0,,,,0,,,,2,2,0,1,,,,2,4,0,0,0,0,0,0,0,0
"Jan 11, 2021 11:00 PM",5,1,4,0,0,0,0,0,0,2,0,2,,,,0,,,,0,0,0,0,,,,0,1,0,0,0,0,0,0,0,0
"Jan 12, 2021 12:00 AM",1,0,1,0,0,0,0,0,0,0,0,0,,,,0,,,,0,0,0,0,,,,0,1,0,0,0,0,0,0,0,0
"Jan 12, 2021 1:00 AM",1,0,1,0,0,0,0,0,0,0,0,0,,,,0,,,,1,1,0,0,,,,0,0,0,0,1,1,0,0,0,0
"Jan 12, 2021 2:00 AM",1,0,1,0,0,0,0,0,0,0,0,0,,,,0,,,,0,0,0,0,,,,0,0,0,0,0,0,0,0,0,0
"Jan 12, 2021 3:00 AM",0,0,0,0,0,0,0,0,0,0,0,0,,,,0,,,,0,0,0,0,,,,0,1,0,0,0,0,0,0,0,0
"Jan 12, 2021 4:00 AM",1,1,0,0,0,0,0,0,0,0,0,0,,,,0,,,,0,0,0,0,,,,0,0,0,0,0,0,0,0,0,0
"Jan 12, 2021 5:00 AM",4,2,2,0,0,0,3,3,0,2,2,0,,,,0,,,,2,2,0,1,,,,1,5,1,0,0,0,0,0,0,0
"Jan 12, 2021 6:00 AM",15,12,3,2,2,0,3,3,0,1,1,0,,,,0,,,,5,5,0,3,,,,13,12,0,0,0,0,0,0,0,0
"Jan 12, 2021 7:00 AM",38,24,14,18,5,13,24,7,17,18,5,13,,,,3,,,,6,5,1,19,,,,17,33,0,2,0,0,0,0,0,0
"Jan 12, 2021 8:00 AM",53,32,21,19,9,10,28,13,15,19,11,8,,,,6,,,,8,6,2,29,,,,14,35,1,3,5,4,1,0,0,0
"Jan 12, 2021 9:00 AM",31,23,8,29,14,15,56,32,24,34,19,15,,,,5,,,,7,5,2,13,,,,12,20,3,2,2,0,2,0,0,0
"Jan 12, 2021 10:00 AM",31,18,13,49,20,29,51,24,27,32,20,12,,,,3,,,,10,4,6,18,,,,11,18,1,2,2,0,2,0,0,0
"Jan 12, 2021 11:00 AM",22,11,11,42,28,14,42,22,20,41,22,19,,,,18,,,,6,5,1,9,,,,10,19,3,2,1,0,1,0,0,0
"Jan 12, 2021 12:00 PM",36,20,16,78,39,39,96,46,50,67,33,34,,,,28,,,,16,15,1,16,,,,25,17,4,2,7,3,4,0,0,0
"Jan 12, 2021 1:00 PM",39,19,20,86,47,39,103,56,47,77,43,34,,,,16,,,,8,8,0,10,,,,31,32,3,3,8,6,2,0,0,0
"Jan 12, 2021 2:00 PM",54,31,23,78,44,34,106,63,43,70,40,30,,,,18,,,,13,13,0,10,,,,24,32,5,4,18,10,8,0,0,0
"Jan 12, 2021 3:00 PM",51,25,26,102,49,53,86,46,40,84,44,40,,,,35,,,,16,14,2,16,,,,26,37,3,1,19,9,10,0,0,0
"Jan 12, 2021 4:00 PM",55,15,40,87,37,50,56,25,31,56,24,32,,,,22,,,,25,23,2,17,,,,33,29,3,0,17,8,9,0,0,0
"Jan 12, 2021 5:00 PM",65,20,45,46,27,19,56,34,22,37,20,17,,,,16,,,,37,36,1,16,,,,36,28,2,2,9,4,5,0,0,0
"Jan 12, 2021 6:00 PM",42,14,28,45,28,17,46,32,14,38,23,15,,,,10,,,,15,13,2,5,,,,32,20,1,2,1,1,0,0,0,0
"Jan 12, 2021 7:00 PM",29,14,15,19,13,6,29,19,10,23,16,7,,,,2,,,,14,14,0,6,,,,21,10,1,0,8,4,4,0,0,0
"Jan 12, 2021 8:00 PM",16,6,10,6,3,3,13,7,6,7,4,3,,,,3,,,,9,8,1,4,,,,8,14,0,0,2,0,2,0,0,0
"Jan 12, 2021 9:00 PM",15,3,12,2,1,1,6,1,5,3,1,2,,,,0,,,,6,6,0,1,,,,7,5,0,0,2,1,1,0,0,0
"Jan 12, 2021 10:00 PM",6,1,5,2,0,2,2,1,1,1,1,0,,,,0,,,,4,3,1,2,,,,1,4,0,0,0,0,0,0,0,0
"Jan 12, 2021 11:00 PM",4,0,4,2,2,0,1,0,1,1,0,1,,,,1,,,,1,1,0,0,,,,1,3,0,0,1,1,0,0,0,0
"Jan 13, 2021 12:00 AM",3,1,2,0,0,0,0,0,0,0,0,0,,,,3,,,,1,1,0,0,,,,1,1,0,0,1,1,0,0,0,0
"Jan 13, 2021 1:00 AM",1,0,1,0,0,0,0,0,0,1,0,1,,,,0,,,,1,1,0,0,,,,0,0,0,0,0,0,0,0,0,0
"Jan 13, 2021 2:00 AM",3,2,1,0,0,0,2,2,0,1,1,0,,,,0,,,,0,0,0,0,,,,1,0,0,0,0,0,0,0,0,0
"Jan 13, 2021 3:00 AM",0,0,0,0,0,0,0,0,0,0,0,0,,,,0,,,,0,0,0,0,,,,0,0,0,0,0,0,0,0,0,0
"Jan 13, 2021 4:00 AM",1,0,1,0,0,0,0,0,0,0,0,0,,,,0,,,,0,0,0,0,,,,0,0,0,0,0,0,0,0,0,0
"Jan 13, 2021 5:00 AM",3,2,1,0,0,0,1,1,0,2,1,1,,,,0,,,,3,3,0,0,,,,1,9,1,0,0,0,0,0,0,0
"Jan 13, 2021 6:00 AM",12,9,3,5,1,4,10,4,6,8,4,4,,,,1,,,,2,2,0,6,,,,14,15,0,0,1,1,0,0,0,0
"Jan 13, 2021 7:00 AM",36,25,11,22,9,13,30,9,21,26,10,16,,,,7,,,,6,5,1,24,,,,20,49,1,1,1,0,1,0,0,0
"Jan 13, 2021 8:00 AM",56,36,20,45,18,27,40,17,23,43,19,24,,,,9,,,,7,4,3,33,,,,22,40,2,2,2,2,0,0,0,0
"Jan 13, 2021 9:00 AM",38,26,12,53,19,34,54,31,23,51,24,27,,,,10,,,,11,11,0,16,,,,13,33,0,2,1,0,1,0,0,0
"Jan 13, 2021 10:00 AM",25,15,10,43,27,16,49,22,27,39,24,15,,,,10,,,,4,2,2,20,,,,14,23,2,6,3,2,1,0,0,0
"Jan 13, 2021 11:00 AM",25,17,8,64,35,29,69,42,27,64,37,27,,,,16,,,,15,12,3,11,,,,19,20,10,4,6,6,0,0,0,0
"Jan 13, 2021 12:00 PM",29,19,10,120,56,64,126,69,57,95,55,40,,,,29,,,,21,15,6,9,,,,28,24,8,3,17,10,7,0,0,0
"Jan 13, 2021 1:00 PM",45,24,21,130,71,59,174,90,84,123,67,56,,,,22,,,,23,20,3,17,,,,33,36,7,4,18,9,9,0,0,0
"Jan 13, 2021 2:00 PM",64,28,36,88,41,47,118,64,54,90,53,37,,,,28,,,,12,12,0,13,,,,24,35,10,7,31,16,15,0,0,0
"Jan 13, 2021 3:00 PM",48,22,26,104,51,53,113,59,54,94,52,42,,,,33,,,,22,16,6,8,,,,29,25,6,2,12,7,5,0,0,0
"Jan 13, 2021 4:00 PM",53,15,38,80,36,44,62,30,32,75,32,43,,,,18,,,,13,13,0,9,,,,24,26,7,1,11,5,6,0,0,0
"Jan 13, 2021 5:00 PM",83,24,59,51,29,22,52,29,23,51,32,19,,,,14,,,,36,35,1,11,,,,44,27,1,2,5,2,3,0,0,0
"Jan 13, 2021 6:00 PM",51,10,41,58,39,19,59,38,21,55,35,20,,,,10,,,,18,18,0,9,,,,41,30,2,1,9,2,7,0,0,0
"Jan 13, 2021 7:00 PM",40,17,23,29,16,13,33,21,12,30,17,13,,,,4,,,,21,20,1,9,,,,16,18,2,1,5,3,2,0,0,0
"Jan 13, 2021 8:00 PM",15,7,8,21,12,9,23,17,6,25,18,7,,,,4,,,,13,13,0,8,,,,14,7,0,3,4,3,1,0,0,0
"Jan 13, 2021 9:00 PM",10,5,5,13,3,10,18,4,14,16,1,15,,,,2,,,,3,3,0,1,,,,9,15,0,1,1,1,0,0,0,0
"Jan 13, 2021 10:00 PM",9,2,7,6,2,4,8,2,6,4,1,3,,,,5,,,,2,2,0,2,,,,2,3,1,1,1,1,0,0,0,0
"Jan 13, 2021 11:00 PM",5,1,4,5,3,2,1,1,0,3,1,2,,,,1,,,,3,2,1,2,,,,1,1,0,0,5,4,1,0,0,0
"Jan 14, 2021 12:00 AM",3,1,2,0,0,0,0,0,0,0,0,0,,,,0,,,,0,0,0,0,,,,1,2,0,0,0,0,0,0,0,0
"Jan 14, 2021 1:00 AM",3,1,2,0,0,0,0,0,0,0,0,0,,,,0,,,,0,0,0,0,,,,0,0,0,0,0,0,0,0,0,0
"Jan 14, 2021 2:00 AM",2,2,0,0,0,0,0,0,0,0,0,0,,,,0,,,,1,1,0,0,,,,0,0,0,0,0,0,0,0,0,0
"Jan 14, 2021 3:00 AM",0,0,0,0,0,0,0,0,0,0,0,0,,,,0,,,,0,0,0,0,,,,0,0,0,0,0,0,0,0,0,0
"Jan 14, 2021 4:00 AM",2,2,0,0,0,0,1,1,0,0,0,0,,,,0,,,,2,2,0,0,,,,1,0,0,0,0,0,0,0,0,0
"Jan 14, 2021 5:00 AM",1,0,1,0,0,0,6,5,1,1,0,1,,,,0,,,,4,4,0,1,,,,0,5,2,0,1,1,0,0,0,0
"Jan 14, 2021 6:00 AM",17,12,5,8,5,3,11,8,3,11,9,2,,,,1,,,,3,3,0,7,,,,12,15,0,0,3,3,0,0,0,0
"Jan 14, 2021 7:00 AM",51,37,14,42,21,21,51,20,31,46,21,25,,,,6,,,,9,8,1,18,,,,21,42,0,1,1,0,1,0,0,0
"Jan 14, 2021 8:00 AM",63,41,22,70,26,44,47,22,25,55,25,30,,,,8,,,,14,11,3,39,,,,18,49,1,3,3,2,1,0,0,0
"Jan 14, 2021 9:00 AM",41,28,13,43,15,28,58,29,29,37,18,19,,,,11,,,,11,9,2,10,,,,12,27,0,2,5,4,1,0,0,0
"Jan 14, 2021 10:00 AM",30,16,14,65,45,20,68,47,21,53,39,14,,,,8,,,,13,10,3,7,,,,15,22,3,2,4,2,2,0,0,0
"Jan 14, 2021 11:00 AM",41,19,22,95,49,46,90,52,38,74,42,32,,,,7,,,,12,8,4,6,,,,27,29,4,7,2,1,1,0,0,0
"Jan 14, 2021 12:00 PM",63,32,31,127,68,59,165,94,71,122,77,45,,,,24,,,,22,21,1,4,,,,31,41,6,8,16,7,9,0,0,0
"Jan 14, 2021 1:00 PM",62,24,38,140,71,69,175,85,90,118,62,56,,,,20,,,,21,21,0,3,,,,31,46,4,5,19,15,4,0,0,0
"Jan 14, 2021 2:00 PM",61,36,25,130,64,66,132,64,68,116,60,56,,,,18,,,,15,12,3,3,,,,34,45,3,7,19,8,11,0,0,0
"Jan 14, 2021 3:00 PM",58,30,28,109,63,46,139,76,63,102,67,35,,,,39,,,,16,12,4,9,,,,30,26,10,6,16,8,8,0,0,0
"Jan 14, 2021 4:00 PM",71,26,45,115,56,59,123,57,66,109,51,58,,,,35,,,,16,14,2,7,,,,47,55,5,1,4,3,1,0,0,0
"Jan 14, 2021 5:00 PM",93,31,62,51,27,24,75,32,43,48,27,21,,,,13,,,,31,31,0,16,,,,44,36,11,6,5,3,2,0,0,0
"Jan 14, 2021 6:00 PM",52,19,33,57,32,25,63,44,19,45,31,14,,,,13,,,,28,25,3,7,,,,35,31,2,1,2,1,1,0,0,0
"Jan 14, 2021 7:00 PM",37,16,21,47,29,18,46,25,21,41,23,18,,,,11,,,,29,25,4,5,,,,21,23,2,1,4,2,2,0,0,0
"Jan 14, 2021 8:00 PM",20,6,14,33,16,17,50,24,26,39,20,19,,,,11,,,,11,10,1,10,,,,17,17,2,1,2,1,1,0,0,0
"Jan 14, 2021 9:00 PM",12,4,8,11,8,3,16,12,4,16,11,5,,,,4,,,,7,7,0,5,,,,13,6,0,0,6,3,3,0,0,0
"Jan 14, 2021 10:00 PM",9,3,6,9,7,2,13,8,5,9,6,3,,,,1,,,,7,7,0,1,,,,5,6,0,0,1,1,0,0,0,0
"Jan 14, 2021 11:00 PM",3,0,3,4,0,4,2,0,2,4,1,3,,,,1,,,,1,1,0,2,,,,1,3,1,0,1,0,1,0,0,0
"Jan 15, 2021 12:00 AM",3,2,1,0,0,0,1,0,1,0,0,0,,,,1,,,,1,1,0,0,,,,0,1,0,0,0,0,0,0,0,0
"Jan 15, 2021 1:00 AM",0,0,0,0,0,0,0,0,0,0,0,0,,,,0,,,,1,1,0,0,,,,0,0,0,1,0,0,0,0,0,0
"Jan 15, 2021 2:00 AM",3,1,2,0,0,0,0,0,0,0,0,0,,,,0,,,,1,1,0,0,,,,0,0,0,0,0,0,0,0,0,0
"Jan 15, 2021 3:00 AM",1,0,1,0,0,0,0,0,0,0,0,0,,,,0,,,,0,0,0,0,,,,0,1,0,0,0,0,0,0,0,0
"Jan 15, 2021 4:00 AM",1,1,0,0,0,0,0,0,0,0,0,0,,,,0,,,,0,0,0,0,,,,0,0,0,0,0,0,0,0,0,0
"Jan 15, 2021 5:00 AM",0,0,0,3,1,2,4,3,1,3,2,1,,,,0,,,,4,4,0,1,,,,1,8,0,0,0,0,0,0,0,0
"Jan 15, 2021 6:00 AM",13,9,4,11,6,5,14,9,5,13,9,4,,,,0,,,,4,4,0,7,,,,11,20,0,0,1,1,0,0,0,0
"Jan 15, 2021 7:00 AM",38,24,14,43,20,23,41,17,24,38,20,18,,,,8,,,,10,7,3,25,,,,23,50,0,4,2,0,2,0,0,0
"Jan 15, 2021 8:00 AM",57,34,23,64,26,38,74,38,36,62,34,28,,,,10,,,,8,7,1,37,,,,22,50,1,4,4,3,1,0,0,0
"Jan 15, 2021 9:00 AM",44,29,15,64,32,32,76,39,37,63,29,34,,,,4,,,,11,8,3,20,,,,25,31,2,3,7,4,3,0,0,0
"Jan 15, 2021 10:00 AM",27,17,10,58,30,28,77,45,32,56,33,23,,,,8,,,,11,8,3,17,,,,16,29,2,7,2,0,2,0,0,0
"Jan 15, 2021 11:00 AM",31,16,15,90,53,37,82,51,31,76,52,24,,,,11,,,,9,8,1,11,,,,21,37,9,2,5,4,1,0,0,0
"Jan 15, 2021 12:00 PM",44,18,26,129,62,67,149,78,71,120,52,68,,,,29,,,,22,19,3,18,,,,28,38,5,2,5,4,1,0,0,0
"Jan 15, 2021 1:00 PM",62,29,33,125,67,58,181,91,90,120,74,46,,,,23,,,,18,15,3,22,,,,36,33,7,8,2,0,2,0,0,0
"Jan 15, 2021 2:00 PM",52,30,22,105,48,57,122,66,56,100,46,54,,,,15,,,,20,15,5,17,,,,44,35,4,4,7,4,3,0,0,0
"Jan 15, 2021 3:00 PM",51,22,29,98,46,52,121,58,63,108,52,56,,,,34,,,,12,11,1,18,,,,34,22,6,4,5,3,2,0,0,0
"Jan 15, 2021 4:00 PM",73,23,50,132,74,58,155,81,74,137,71,66,,,,23,,,,23,19,4,18,,,,43,52,4,7,10,6,4,0,0,0
"Jan 15, 2021 5:00 PM",75,21,54,32,11,21,71,44,27,52,19,33,,,,18,,,,32,30,2,13,,,,38,42,1,2,5,3,2,0,0,0
"Jan 15, 2021 6:00 PM",58,19,39,47,37,10,53,31,22,34,17,17,,,,7,,,,28,26,2,10,,,,44,24,1,0,7,5,2,0,0,0
"Jan 15, 2021 7:00 PM",49,26,23,24,15,9,29,17,12,25,14,11,,,,3,,,,16,15,1,5,,,,30,17,0,1,5,3,2,0,0,0
"Jan 15, 2021 8:00 PM",23,10,13,14,7,7,15,8,7,12,9,3,,,,8,,,,4,4,0,2,,,,11,22,0,0,1,1,0,0,0,0
"Jan 15, 2021 9:00 PM",15,5,10,1,0,1,3,1,2,3,0,3,,,,2,,,,7,5,2,2,,,,3,5,2,0,2,1,1,0,0,0
"Jan 15, 2021 10:00 PM",2,0,2,2,1,1,5,2,3,4,3,1,,,,0,,,,4,3,1,2,,,,0,7,0,0,0,0,0,0,0,0
"Jan 15, 2021 11:00 PM",5,2,3,0,0,0,0,0,0,0,0,0,,,,0,,,,0,0,0,3,,,,1,1,0,1,1,1,0,0,0,0
"Jan 16, 2021 12:00 AM",0,0,0,0,0,0,0,0,0,0,0,0,,,,0,,,,0,0,0,0,,,,2,1,0,0,0,0,0,0,0,0
"Jan 16, 2021 1:00 AM",1,0,1,0,0,0,0,0,0,0,0,0,,,,2,,,,2,1,1,2,,,,1,0,0,1,0,0,0,0,0,0
"Jan 16, 2021 2:00 AM",4,2,2,0,0,0,1,1,0,0,0,0,,,,0,,,,2,2,0,0,,,,2,0,0,0,1,0,1,0,0,0
"Jan 16, 2021 3:00 AM",0,0,0,0,0,0,0,0,0,0,0,0,,,,1,,,,2,1,1,0,,,,1,0,0,0,0,0,0,0,0,0
"Jan 16, 2021 4:00 AM",1,0,1,0,0,0,0,0,0,0,0,0,,,,0,,,,0,0,0,0,,,,0,0,0,0,0,0,0,0,0,0
"Jan 16, 2021 5:00 AM",0,0,0,0,0,0,1,1,0,1,1,0,,,,2,,,,3,3,0,2,,,,3,1,0,0,0,0,0,0,0,0
"Jan 16, 2021 6:00 AM",6,4,2,1,1,0,2,1,1,3,2,1,,,,1,,,,0,0,0,1,,,,6,7,0,0,0,0,0,0,0,0
"Jan 16, 2021 7:00 AM",8,3,5,13,7,6,16,11,5,12,8,4,,,,1,,,,3,2,1,4,,,,9,11,0,0,0,0,0,0,0,0
"Jan 16, 2021 8:00 AM",18,8,10,39,30,9,37,28,9,42,31,11,,,,2,,,,12,12,0,7,,,,13,10,0,3,0,0,0,0,0,0
"Jan 16, 2021 9:00 AM",24,12,12,124,75,49,102,63,39,100,67,33,,,,2,,,,13,10,3,10,,,,30,31,6,4,2,0,2,0,0,0
"Jan 16, 2021 10:00 AM",44,28,16,163,89,74,161,100,61,163,109,54,,,,10,,,,16,15,1,9,,,,43,37,5,11,4,3,1,0,0,0
"Jan 16, 2021 11:00 AM",65,32,33,235,132,103,284,172,112,238,131,107,,,,29,,,,15,10,5,22,,,,77,81,12,4,8,5,3,0,0,0
"Jan 16, 2021 12:00 PM",66,41,25,259,140,119,334,182,152,282,152,130,,,,26,,,,30,26,4,24,,,,78,67,13,6,11,7,4,0,0,0
"Jan 16, 2021 1:00 PM",85,41,44,295,168,127,357,188,169,269,162,107,,,,27,,,,26,19,7,22,,,,89,89,5,6,11,4,7,0,0,0
"Jan 16, 2021 2:00 PM",98,50,48,304,128,176,376,173,203,313,163,150,,,,50,,,,19,17,2,29,,,,76,82,17,10,11,10,1,0,0,0
"Jan 16, 2021 3:00 PM",96,46,50,306,152,154,312,138,174,277,137,140,,,,64,,,,31,26,5,23,,,,49,88,13,18,18,9,9,0,0,0
"Jan 16, 2021 4:00 PM",58,26,32,157,84,73,215,85,130,166,76,90,,,,42,,,,28,24,4,19,,,,30,83,8,3,16,14,2,0,0,0
"Jan 16, 2021 5:00 PM",48,20,28,65,34,31,79,40,39,55,28,27,,,,23,,,,12,11,1,10,,,,19,23,5,2,7,3,4,0,0,0
"Jan 16, 2021 6:00 PM",36,20,16,22,7,15,28,8,20,32,8,24,,,,10,,,,12,8,4,11,,,,13,20,2,1,1,0,1,0,0,0
"Jan 16, 2021 7:00 PM",41,24,17,15,10,5,18,11,7,16,10,6,,,,9,,,,9,7,2,10,,,,9,11,0,0,4,3,1,0,0,0
"Jan 16, 2021 8:00 PM",19,7,12,10,4,6,13,7,6,11,4,7,,,,4,,,,5,5,0,5,,,,10,14,0,0,2,2,0,0,0,0
"Jan 16, 2021 9:00 PM",12,3,9,8,5,3,9,6,3,9,6,3,,,,7,,,,3,3,0,3,,,,3,9,2,0,0,0,0,0,0,0
"Jan 16, 2021 10:00 PM",6,4,2,3,1,2,2,0,2,3,2,1,,,,1,,,,2,2,0,2,,,,2,4,0,0,0,0,0,0,0,0
"Jan 16, 2021 11:00 PM",5,1,4,0,0,0,0,0,0,1,0,1,,,,1,,,,1,1,0,2,,,,3,4,0,0,0,0,0,0,0,0
"Jan 17, 2021 12:00 AM",7,4,3,0,0,0,1,0,1,1,0,1,,,,0,,,,0,0,0,0,,,,1,2,1,0,0,0,0,0,0,0
"Jan 17, 2021 1:00 AM",0,0,0,2,2,0,2,1,1,1,1,0,,,,1,,,,1,1,0,0,,,,0,0,0,0,0,0,0,0,0,0
"Jan 17, 2021 2:00 AM",0,0,0,0,0,0,0,0,0,0,0,0,,,,0,,,,1,1,0,2,,,,1,0,0,0,0,0,0,0,0,0
"Jan 17, 2021 3:00 AM",0,0,0,1,1,0,4,0,4,2,0,2,,,,1,,,,1,1,0,1,,,,1,0,0,1,0,0,0,0,0,0
"Jan 17, 2021 4:00 AM",0,0,0,0,0,0,1,1,0,0,0,0,,,,0,,,,1,1,0,0,,,,1,0,0,0,0,0,0,0,0,0
"Jan 17, 2021 5:00 AM",2,2,0,0,0,0,0,0,0,0,0,0,,,,0,,,,0,0,0,2,,,,1,2,0,0,0,0,0,0,0,0
"Jan 17, 2021 6:00 AM",3,2,1,7,3,4,5,5,0,4,4,0,,,,0,,,,2,2,0,4,,,,9,2,0,0,0,0,0,0,0,0
"Jan 17, 2021 7:00 AM",10,6,4,12,7,5,16,13,3,21,17,4,,,,1,,,,3,3,0,2,,,,9,7,0,0,1,1,0,0,0,0
"Jan 17, 2021 8:00 AM",11,6,5,57,32,25,49,28,21,48,30,18,,,,3,,,,7,4,3,4,,,,10,21,0,4,1,1,0,0,0,0
"Jan 17, 2021 9:00 AM",37,22,15,153,88,65,128,75,53,130,81,49,,,,7,,,,11,8,3,9,,,,28,40,8,8,5,4,1,0,0,0
"Jan 17, 2021 10:00 AM",51,22,29,286,188,98,246,159,87,260,170,90,,,,23,,,,22,19,3,14,,,,44,52,9,7,7,6,1,0,0,0
"Jan 17, 2021 11:00 AM",100,50,50,346,152,194,316,155,161,298,138,160,,,,44,,,,23,18,5,16,,,,64,98,11,15,9,3,6,0,0,0
"Jan 17, 2021 12:00 PM",103,51,52,358,193,165,366,184,182,332,186,146,,,,47,,,,25,19,6,30,,,,78,73,15,8,11,6,5,0,0,0
"Jan 17, 2021 1:00 PM",91,48,43,264,139,125,342,176,166,243,137,106,,,,21,,,,25,20,5,13,,,,71,88,10,8,15,11,4,0,0,0
"Jan 17, 2021 2:00 PM",116,59,57,305,174,131,311,167,144,299,159,140,,,,45,,,,27,23,4,15,,,,59,78,9,3,14,11,3,0,0,0
"Jan 17, 2021 3:00 PM",81,34,47,251,122,129,279,132,147,216,103,113,,,,50,,,,26,23,3,21,,,,63,86,9,8,14,9,5,0,0,0
"Jan 17, 2021 4:00 PM",62,27,35,159,89,70,178,74,104,137,55,82,,,,21,,,,19,17,2,6,,,,30,48,5,4,7,4,3,0,0,0
"Jan 17, 2021 5:00 PM",28,12,16,41,21,20,51,22,29,42,20,22,,,,16,,,,11,8,3,3,,,,14,15,2,1,1,1,0,0,0,0
"Jan 17, 2021 6:00 PM",20,7,13,22,11,11,26,12,14,18,8,10,,,,10,,,,3,3,0,4,,,,6,15,4,0,3,3,0,0,0,0
"Jan 17, 2021 7:00 PM",28,13,15,10,5,5,17,9,8,15,6,9,,,,4,,,,4,4,0,4,,,,11,14,0,0,3,3,0,0,0,0
"Jan 17, 2021 8:00 PM",9,4,5,11,7,4,7,3,4,11,4,7,,,,5,,,,4,4,0,4,,,,9,6,2,1,0,0,0,0,0,0
"Jan 17, 2021 9:00 PM",8,2,6,5,3,2,11,7,4,9,6,3,,,,1,,,,1,1,0,0,,,,7,10,0,0,4,3,1,0,0,0
"Jan 17, 2021 10:00 PM",6,1,5,4,2,2,4,1,3,2,2,0,,,,3,,,,1,1,0,1,,,,2,6,1,0,1,0,1,0,0,0
"Jan 17, 2021 11:00 PM",1,1,0,0,0,0,1,0,1,0,0,0,,,,1,,,,1,1,0,0,,,,1,2,0,0,3,3,0,0,0,0
"Jan 18, 2021 12:00 AM",1,0,1,0,0,0,0,0,0,0,0,0,,,,0,,,,3,3,0,0,,,,1,2,0,2,0,0,0,0,0,0
"Jan 18, 2021 1:00 AM",1,1,0,1,0,1,0,0,0,0,0,0,,,,0,,,,2,2,0,0,,,,0,0,0,0,0,0,0,0,0,0
"Jan 18, 2021 2:00 AM",2,2,0,0,0,0,0,0,0,0,0,0,,,,1,,,,0,0,0,0,,,,0,0,0,0,0,0,0,0,0,0
"Jan 18, 2021 3:00 AM",0,0,0,0,0,0,0,0,0,0,0,0,,,,0,,,,0,0,0,0,,,,0,0,0,0,0,0,0,0,0,0
"Jan 18, 2021 4:00 AM",0,0,0,0,0,0,1,1,0,1,1,0,,,,0,,,,1,1,0,0,,,,0,0,0,0,0,0,0,0,0,0
"Jan 18, 2021 5:00 AM",2,2,0,1,1,0,3,2,1,1,1,0,,,,2,,,,2,2,0,0,,,,2,7,1,0,0,0,0,0,0,0
"Jan 18, 2021 6:00 AM",15,10,5,10,5,5,14,8,6,11,6,5,,,,2,,,,4,4,0,8,,,,12,21,0,0,2,1,1,0,0,0
"Jan 18, 2021 7:00 AM",41,29,12,32,14,18,44,17,27,36,19,17,,,,6,,,,11,10,1,16,,,,26,60,2,1,0,0,0,0,0,0
"Jan 18, 2021 8:00 AM",77,48,29,68,30,38,71,35,36,68,33,35,,,,10,,,,17,11,6,39,,,,30,52,3,3,6,4,2,0,0,0
"Jan 18, 2021 9:00 AM",35,28,7,39,18,21,42,21,21,35,20,15,,,,6,,,,14,10,4,24,,,,13,23,5,3,0,0,0,0,0,0
"Jan 18, 2021 10:00 AM",36,19,17,76,35,41,64,34,30,55,30,25,,,,7,,,,8,5,3,13,,,,20,18,4,2,6,3,3,0,0,0
"Jan 18, 2021 11:00 AM",40,20,20,75,37,38,78,36,42,62,32,30,,,,13,,,,12,10,2,12,,,,21,26,12,5,5,3,2,0,0,0
"Jan 18, 2021 12:00 PM",54,23,31,85,44,41,111,64,47,84,47,37,,,,17,,,,24,19,5,6,,,,25,29,3,6,12,10,2,0,0,0
"Jan 18, 2021 1:00 PM",49,31,18,101,41,60,100,43,57,88,42,46,,,,18,,,,19,16,3,12,,,,14,37,4,6,4,1,3,0,0,0
"Jan 18, 2021 2:00 PM",54,26,28,64,29,35,93,46,47,57,23,34,,,,21,,,,21,14,7,14,,,,19,24,4,5,7,6,1,0,0,0
"Jan 18, 2021 3:00 PM",39,19,20,70,38,32,89,49,40,78,51,27,,,,40,,,,15,14,1,13,,,,25,25,6,2,18,12,6,0,0,0
"Jan 18, 2021 4:00 PM",66,20,46,79,36,43,97,37,60,70,27,43,,,,23,,,,19,17,2,24,,,,33,35,5,2,9,5,4,0,0,0
"Jan 18, 2021 5:00 PM",90,25,65,53,29,24,75,39,36,53,29,24,,,,23,,,,30,28,2,14,,,,46,32,5,6,5,5,0,0,0,0
"Jan 18, 2021 6:00 PM",48,16,32,50,36,14,65,46,19,54,41,13,,,,16,,,,35,34,1,14,,,,52,32,1,1,1,1,0,0,0,0
"Jan 18, 2021 7:00 PM",31,11,20,35,20,15,35,22,13,34,22,12,,,,6,,,,12,11,1,4,,,,25,14,3,2,3,1,2,0,0,0
"Jan 18, 2021 8:00 PM",14,4,10,12,9,3,15,9,6,15,11,4,,,,3,,,,12,11,1,3,,,,8,12,2,1,2,1,1,0,0,0
"Jan 18, 2021 9:00 PM",9,2,7,6,3,3,6,4,2,5,3,2,,,,0,,,,4,4,0,2,,,,4,9,1,0,1,0,1,0,0,0
"Jan 18, 2021 10:00 PM",3,0,3,1,0,1,1,1,0,3,1,2,,,,1,,,,2,2,0,3,,,,6,2,0,0,1,1,0,0,0,0
"Jan 18, 2021 11:00 PM",5,3,2,4,1,3,1,0,1,1,0,1,,,,0,,,,2,2,0,0,,,,3,1,1,0,1,1,0,0,0,0
"Jan 19, 2021 12:00 AM",0,0,0,0,0,0,0,0,0,3,1,2,,,,1,,,,2,1,1,1,,,,0,2,0,0,1,0,1,0,0,0
"Jan 19, 2021 1:00 AM",0,0,0,1,1,0,1,0,1,1,0,1,,,,0,,,,1,1,0,1,,,,0,0,0,0,0,0,0,0,0,0
"Jan 19, 2021 2:00 AM",2,1,1,0,0,0,0,0,0,1,0,1,,,,1,,,,0,0,0,0,,,,0,0,0,0,0,0,0,0,0,0
"Jan 19, 2021 3:00 AM",0,0,0,0,0,0,1,0,1,1,0,1,,,,0,,,,0,0,0,0,,,,0,1,0,0,0,0,0,0,0,0
"Jan 19, 2021 4:00 AM",1,1,0,0,0,0,1,1,0,1,1,0,,,,0,,,,0,0,0,0,,,,0,0,0,0,0,0,0,0,0,0
"Jan 19, 2021 5:00 AM",0,0,0,2,2,0,3,3,0,4,3,1,,,,3,,,,2,2,0,0,,,,1,5,1,1,0,0,0,0,0,0
"Jan 19, 2021 6:00 AM",13,10,3,3,1,2,5,2,3,2,1,1,,,,1,,,,1,1,0,5,,,,4,15,0,0,1,1,0,0,0,0
"Jan 19, 2021 7:00 AM",32,24,8,24,11,13,29,13,16,24,11,13,,,,3,,,,8,8,0,26,,,,18,41,0,1,0,0,0,0,0,0
"Jan 19, 2021 8:00 AM",46,36,10,37,13,24,34,12,22,35,15,20,,,,8,,,,11,6,5,27,,,,16,40,0,1,5,3,2,0,0,0
"Jan 19, 2021 9:00 AM",27,18,9,48,20,28,52,24,28,46,24,22,,,,10,,,,3,2,1,16,,,,11,17,1,4,4,2,2,0,0,0
"Jan 19, 2021 10:00 AM",19,9,10,28,13,15,28,15,13,24,13,11,,,,6,,,,6,4,2,17,,,,13,11,3,0,4,1,3,0,0,0
"Jan 19, 2021 11:00 AM",20,10,10,19,12,7,21,9,12,20,9,11,,,,9,,,,6,3,3,7,,,,6,17,0,0,0,0,0,0,0,0
"Jan 19, 2021 12:00 PM",26,10,16,18,8,10,36,13,23,20,10,10,,,,6,,,,5,5,0,5,,,,12,15,0,0,2,1,1,0,0,0
"Jan 19, 2021 1:00 PM",32,11,21,57,31,26,63,34,29,59,37,22,,,,11,,,,10,8,2,11,,,,23,19,3,2,2,2,0,0,0,0
"Jan 19, 2021 2:00 PM",34,18,16,37,17,20,90,52,38,43,23,20,,,,13,,,,15,14,1,6,,,,22,23,0,1,6,4,2,0,0,0
"Jan 19, 2021 3:00 PM",31,13,18,63,41,22,100,53,47,77,47,30,,,,14,,,,9,9,0,10,,,,24,21,5,1,6,6,0,0,0,0
"Jan 19, 2021 4:00 PM",64,21,43,95,50,45,111,55,56,69,37,32,,,,29,,,,31,24,7,10,,,,40,30,4,4,6,3,3,0,0,0
"Jan 19, 2021 5:00 PM",75,15,60,53,29,24,47,21,26,49,27,22,,,,11,,,,23,23,0,16,,,,27,23,3,1,4,2,2,0,0,0
"Jan 19, 2021 6:00 PM",35,11,24,33,18,15,44,32,12,35,24,11,,,,5,,,,28,27,1,6,,,,27,15,1,2,1,1,0,0,0,0
"Jan 19, 2021 7:00 PM",21,7,14,25,16,9,29,20,9,31,22,9,,,,3,,,,11,11,0,3,,,,18,11,0,2,5,2,3,0,0,0
"Jan 19, 2021 8:00 PM",15,2,13,22,11,11,19,9,10,15,8,7,,,,2,,,,11,10,1,4,,,,6,7,3,1,7,5,2,0,0,0
"Jan 19, 2021 9:00 PM",14,4,10,6,1,5,5,3,2,3,3,0,,,,0,,,,6,6,0,2,,,,3,7,0,0,4,2,2,0,0,0
"Jan 19, 2021 10:00 PM",9,1,8,10,5,5,7,5,2,10,4,6,,,,0,,,,3,2,1,7,,,,2,2,0,2,4,2,2,0,0,0
"Jan 19, 2021 11:00 PM",4,1,3,1,0,1,3,1,2,2,1,1,,,,1,,,,2,1,1,2,,,,3,3,0,0,1,1,0,0,0,0
"Jan 20, 2021 12:00 AM",1,0,1,0,0,0,0,0,0,0,0,0,,,,0,,,,1,1,0,0,,,,0,0,0,0,0,0,0,0,0,0
"Jan 20, 2021 1:00 AM",0,0,0,0,0,0,1,1,0,0,0,0,,,,0,,,,0,0,0,0,,,,0,0,0,0,0,0,0,0,0,0
"Jan 20, 2021 2:00 AM",3,1,2,0,0,0,0,0,0,0,0,0,,,,1,,,,0,0,0,0,,,,0,1,0,0,0,0,0,0,0,0
"Jan 20, 2021 3:00 AM",0,0,0,0,0,0,1,1,0,0,0,0,,,,0,,,,0,0,0,0,,,,0,0,0,0,0,0,0,0,0,0
"Jan 20, 2021 4:00 AM",1,1,0,0,0,0,1,1,0,1,1,0,,,,0,,,,2,2,0,0,,,,0,0,0,0,0,0,0,0,0,0
"Jan 20, 2021 5:00 AM",2,2,0,0,0,0,3,3,0,1,1,0,,,,0,,,,1,1,0,1,,,,0,7,1,0,0,0,0,0,0,0
"Jan 20, 2021 6:00 AM",13,9,4,3,2,1,5,4,1,3,3,0,,,,3,,,,6,6,0,8,,,,13,18,0,0,1,1,0,0,0,0
"Jan 20, 2021 7:00 AM",39,24,15,28,13,15,29,9,20,30,12,18,,,,2,,,,10,9,1,28,,,,15,44,0,1,1,0,1,0,0,0
"Jan 20, 2021 8:00 AM",50,35,15,50,21,29,37,13,24,39,15,24,,,,4,,,,14,7,7,35,,,,25,44,0,2,5,4,1,0,0,0
"Jan 20, 2021 9:00 AM",34,27,7,50,21,29,47,17,30,47,24,23,,,,8,,,,10,5,5,18,,,,13,20,5,1,6,2,4,0,0,0
"Jan 20, 2021 10:00 AM",18,9,9,27,13,14,32,19,13,21,13,8,,,,4,,,,8,6,2,10,,,,9,10,1,2,2,1,1,0,0,0
"Jan 20, 2021 11:00 AM",16,10,6,7,4,3,19,10,9,15,6,9,,,,6,,,,7,3,4,9,,,,5,8,1,0,5,4,1,0,0,0
"Jan 20, 2021 12:00 PM",23,7,16,5,3,2,16,4,12,8,2,6,,,,8,,,,6,3,3,3,,,,1,9,0,3,1,1,0,0,0,0
"Jan 20, 2021 1:00 PM",22,9,13,20,12,8,21,14,7,15,10,5,,,,2,,,,13,9,4,5,,,,11,10,0,0,2,1,1,0,0,0
"Jan 20, 2021 2:00 PM",17,8,9,12,8,4,19,13,6,9,8,1,,,,7,,,,18,1,17,7,,,,7,9,3,0,1,0,1,0,0,0
"Jan 20, 2021 3:00 PM",25,8,17,14,8,6,22,13,9,13,9,4,,,,5,,,,10,7,3,3,,,,14,7,1,0,5,3,2,0,0,0
"Jan 20, 2021 4:00 PM",46,20,26,29,18,11,29,17,12,23,15,8,,,,9,,,,21,18,3,7,,,,22,18,3,2,4,3,1,0,0,0
"Jan 20, 2021 5:00 PM",63,18,45,16,12,4,40,26,14,29,20,9,,,,9,,,,31,28,3,15,,,,22,21,3,3,3,2,1,0,0,0
"Jan 20, 2021 6:00 PM",46,15,31,41,29,12,55,40,15,50,36,14,,,,14,,,,23,21,2,12,,,,39,28,6,2,3,3,0,0,0,0
"Jan 20, 2021 7:00 PM",35,14,21,19,13,6,32,16,16,19,9,10,,,,2,,,,21,18,3,3,,,,21,24,2,0,2,1,1,0,0,0
"Jan 20, 2021 8:00 PM",15,1,14,18,10,8,25,17,8,24,15,9,,,,8,,,,8,8,0,1,,,,8,16,1,0,6,4,2,0,0,0
"Jan 20, 2021 9:00 PM",11,4,7,4,3,1,12,8,4,7,5,2,,,,1,,,,6,6,0,3,,,,4,6,0,1,2,2,0,0,0,0
"Jan 20, 2021 10:00 PM",7,5,2,4,4,0,5,1,4,2,1,1,,,,2,,,,4,3,1,1,,,,4,4,0,0,0,0,0,0,0,0
"Jan 20, 2021 11:00 PM",4,1,3,0,0,0,2,0,2,1,0,1,,,,0,,,,4,2,2,0,,,,2,1,0,0,0,0,0,0,0,0
"Jan 21, 2021 12:00 AM",0,0,0,0,0,0,0,0,0,0,0,0,,,,1,,,,1,1,0,1,,,,2,1,0,0,0,0,0,0,0,0
"Jan 21, 2021 1:00 AM",2,1,1,0,0,0,0,0,0,0,0,0,,,,0,,,,1,1,0,0,,,,0,0,0,0,0,0,0,0,0,0
"Jan 21, 2021 2:00 AM",3,2,1,0,0,0,0,0,0,0,0,0,,,,0,,,,0,0,0,0,,,,0,0,0,0,0,0,0,0,0,0
"Jan 21, 2021 3:00 AM",1,0,1,0,0,0,0,0,0,0,0,0,,,,0,,,,0,0,0,0,,,,0,2,0,0,0,0,0,0,0,0
"Jan 21, 2021 4:00 AM",0,0,0,0,0,0,2,2,0,1,1,0,,,,0,,,,1,1,0,0,,,,2,1,0,0,0,0,0,0,0,0
"Jan 21, 2021 5:00 AM",2,2,0,0,0,0,1,1,0,1,0,1,,,,0,,,,3,3,0,2,,,,1,6,2,0,0,0,0,0,0,0
"Jan 21, 2021 6:00 AM",17,10,7,9,3,6,11,6,5,9,5,4,,,,5,,,,5,5,0,8,,,,8,14,0,0,1,1,0,0,0,0
"Jan 21, 2021 7:00 AM",48,31,17,27,16,11,48,20,28,39,20,19,,,,11,,,,12,10,2,27,,,,21,45,2,1,2,1,1,0,0,0
"Jan 21, 2021 8:00 AM",51,36,15,43,18,25,49,27,22,52,24,28,,,,11,,,,14,9,5,32,,,,21,48,0,0,0,0,0,0,0,0
"Jan 21, 2021 9:00 AM",46,30,16,33,13,20,53,24,29,39,20,19,,,,7,,,,14,9,5,24,,,,10,24,3,2,1,1,0,0,0,0
"Jan 21, 2021 10:00 AM",40,29,11,50,29,21,52,26,26,37,19,18,,,,9,,,,4,2,2,14,,,,12,20,5,0,2,0,2,0,0,0
"Jan 21, 2021 11:00 AM",30,17,13,83,49,34,96,57,39,81,49,32,,,,13,,,,14,11,3,13,,,,20,22,4,1,3,2,1,0,0,0
"Jan 21, 2021 12:00 PM",51,19,32,104,61,43,117,68,49,113,68,45,,,,21,,,,19,17,2,10,,,,24,39,4,1,4,2,2,0,0,0
"Jan 21, 2021 1:00 PM",65,39,26,133,67,66,115,58,57,94,49,45,,,,20,,,,22,16,6,15,,,,26,40,10,7,11,9,2,0,0,0
"Jan 21, 2021 2:00 PM",56,31,25,132,61,71,120,66,54,109,60,49,,,,17,,,,18,14,4,17,,,,33,35,4,0,10,3,7,0,0,0
"Jan 21, 2021 3:00 PM",54,25,29,128,62,66,154,83,71,112,67,45,,,,32,,,,30,26,4,10,,,,43,39,7,2,17,10,7,0,0,0
"Jan 21, 2021 4:00 PM",73,23,50,127,65,62,173,86,87,140,66,74,,,,32,,,,27,23,4,13,,,,36,40,12,7,13,10,3,0,0,0
"Jan 21, 2021 5:00 PM",87,32,55,87,41,46,100,44,56,84,46,38,,,,14,,,,32,30,2,18,,,,27,41,3,8,9,3,6,0,0,0
"Jan 21, 2021 6:00 PM",52,19,33,63,41,22,59,37,22,51,35,16,,,,15,,,,31,30,1,18,,,,38,32,2,2,0,0,0,0,0,0
"Jan 21, 2021 7:00 PM",37,12,25,40,22,18,44,25,19,32,15,17,,,,8,,,,16,13,3,8,,,,37,20,3,3,1,1,0,0,0,0
"Jan 21, 2021 8:00 PM",28,10,18,19,9,10,18,9,9,17,7,10,,,,1,,,,8,7,1,8,,,,19,15,2,1,3,3,0,0,0,0
"Jan 21, 2021 9:00 PM",13,6,7,6,3,3,13,9,4,6,5,1,,,,3,,,,7,7,0,6,,,,5,14,0,1,0,0,0,0,0,0
"Jan 21, 2021 10:00 PM",7,1,6,8,4,4,13,5,8,6,3,3,,,,4,,,,4,4,0,3,,,,5,4,1,1,3,1,2,0,0,0
"Jan 21, 2021 11:00 PM",4,2,2,2,1,1,3,2,1,3,1,2,,,,2,,,,1,1,0,3,,,,2,3,1,0,3,1,2,0,0,0
"Jan 22, 2021 12:00 AM",2,2,0,0,0,0,0,0,0,0,0,0,,,,0,,,,2,2,0,0,,,,0,1,0,0,0,0,0,0,0,0
"Jan 22, 2021 1:00 AM",2,1,1,0,0,0,0,0,0,0,0,0,,,,0,,,,1,1,0,1,,,,1,0,0,1,0,0,0,0,0,0
"Jan 22, 2021 2:00 AM",3,1,2,0,0,0,0,0,0,1,1,0,,,,0,,,,0,0,0,0,,,,0,0,0,0,0,0,0,0,0,0
"Jan 22, 2021 3:00 AM",1,0,1,0,0,0,0,0,0,0,0,0,,,,0,,,,0,0,0,0,,,,1,0,0,0,0,0,0,0,0,0
"Jan 22, 2021 4:00 AM",0,0,0,0,0,0,1,1,0,1,1,0,,,,0,,,,0,0,0,0,,,,0,0,0,0,0,0,0,0,0,0
"Jan 22, 2021 5:00 AM",0,0,0,0,0,0,3,3,0,2,1,1,,,,0,,,,3,3,0,1,,,,1,7,2,0,0,0,0,0,0,0
"Jan 22, 2021 6:00 AM",18,12,6,17,9,8,14,7,7,14,8,6,,,,2,,,,5,5,0,6,,,,12,18,0,0,1,1,0,0,0,0
"Jan 22, 2021 7:00 AM",43,28,15,41,21,20,62,30,32,47,24,23,,,,8,,,,9,8,1,23,,,,22,47,2,2,0,0,0,0,0,0
"Jan 22, 2021 8:00 AM",45,33,12,84,36,48,79,37,42,65,30,35,,,,4,,,,12,7,5,35,,,,17,53,2,3,5,4,1,0,0,0
"Jan 22, 2021 9:00 AM",40,24,16,53,18,35,72,27,45,59,26,33,,,,8,,,,11,10,1,27,,,,12,40,2,4,3,2,1,0,0,0
"Jan 22, 2021 10:00 AM",27,22,5,72,34,38,75,44,31,60,32,28,,,,13,,,,7,7,0,11,,,,13,31,4,4,7,3,4,0,0,0
"Jan 22, 2021 11:00 AM",41,20,21,74,41,33,67,35,32,68,40,28,,,,10,,,,13,9,4,12,,,,19,25,13,5,3,2,1,0,0,0
"Jan 22, 2021 12:00 PM",57,27,30,96,52,44,106,57,49,99,53,46,,,,23,,,,17,11,6,12,,,,25,25,6,10,6,6,0,0,0,0
"Jan 22, 2021 1:00 PM",63,26,37,123,62,61,162,87,75,118,71,47,,,,26,,,,13,12,1,17,,,,32,46,5,5,4,4,0,0,0,0
"Jan 22, 2021 2:00 PM",52,31,21,150,83,67,181,95,86,147,81,66,,,,37,,,,22,19,3,18,,,,35,43,10,12,10,7,3,0,0,0
"Jan 22, 2021 3:00 PM",80,46,34,165,93,72,194,102,92,156,88,68,,,,19,,,,22,19,3,27,,,,35,32,9,3,9,6,3,0,0,0
"Jan 22, 2021 4:00 PM",71,26,45,154,79,75,176,94,82,159,78,81,,,,19,,,,17,14,3,16,,,,53,43,7,2,7,3,4,0,0,0
"Jan 22, 2021 5:00 PM",80,21,59,93,53,40,114,48,66,82,39,43,,,,17,,,,41,35,6,12,,,,42,61,6,2,4,4,0,0,0,0
"Jan 22, 2021 6:00 PM",58,21,37,43,30,13,48,28,20,37,25,12,,,,9,,,,34,31,3,13,,,,35,29,1,1,2,2,0,0,0,0
"Jan 22, 2021 7:00 PM",41,20,21,24,15,9,34,21,13,25,16,9,,,,5,,,,15,12,3,1,,,,22,20,2,3,2,1,1,0,0,0
"Jan 22, 2021 8:00 PM",21,9,12,9,5,4,22,10,12,15,6,9,,,,16,,,,10,9,1,6,,,,11,15,2,3,0,0,0,0,0,0
"Jan 22, 2021 9:00 PM",15,6,9,9,2,7,10,3,7,5,1,4,,,,1,,,,4,4,0,2,,,,5,9,2,1,0,0,0,0,0,0
"Jan 22, 2021 10:00 PM",8,4,4,4,1,3,10,4,6,5,2,3,,,,1,,,,7,7,0,2,,,,5,6,1,1,0,0,0,0,0,0
"Jan 22, 2021 11:00 PM",5,1,4,4,1,3,1,0,1,3,0,3,,,,1,,,,0,0,0,1,,,,2,3,0,0,0,0,0,0,0,0
"Jan 23, 2021 12:00 AM",4,1,3,0,0,0,0,0,0,0,0,0,,,,1,,,,0,0,0,0,,,,1,0,0,1,0,0,0,0,0,0
"Jan 23, 2021 1:00 AM",5,1,4,0,0,0,2,0,2,2,0,2,,,,1,,,,2,2,0,0,,,,0,0,1,0,0,0,0,0,0,0
"Jan 23, 2021 2:00 AM",1,1,0,1,1,0,4,4,0,3,3,0,,,,1,,,,1,1,0,1,,,,2,0,0,0,0,0,0,0,0,0
"Jan 23, 2021 3:00 AM",1,0,1,0,0,0,2,1,1,0,0,0,,,,0,,,,1,1,0,0,,,,0,0,0,0,0,0,0,0,0,0
"Jan 23, 2021 4:00 AM",1,1,0,0,0,0,2,1,1,1,0,1,,,,0,,,,0,0,0,0,,,,1,2,0,0,0,0,0,0,0,0
"Jan 23, 2021 5:00 AM",1,0,1,0,0,0,0,0,0,0,0,0,,,,2,,,,0,0,0,0,,,,2,1,1,0,0,0,0,0,0,0
"Jan 23, 2021 6:00 AM",3,2,1,5,0,5,4,3,1,3,1,2,,,,1,,,,1,1,0,3,,,,4,3,0,0,0,0,0,0,0,0
"Jan 23, 2021 7:00 AM",7,4,3,6,3,3,13,9,4,6,3,3,,,,2,,,,1,1,0,4,,,,9,6,0,1,0,0,0,0,0,0
"Jan 23, 2021 8:00 AM",10,5,5,33,28,5,42,31,11,28,23,5,,,,3,,,,4,4,0,2,,,,11,15,1,3,0,0,0,0,0,0
"Jan 23, 2021 9:00 AM",20,10,10,73,39,34,110,65,45,63,35,28,,,,3,,,,6,5,1,8,,,,32,20,2,2,4,4,0,0,0,0
"Jan 23, 2021 10:00 AM",42,27,15,136,86,50,176,111,65,133,93,40,,,,7,,,,12,7,5,18,,,,45,35,8,4,5,2,3,0,0,0
"Jan 23, 2021 11:00 AM",52,24,28,226,120,106,240,126,114,194,114,80,,,,23,,,,17,11,6,19,,,,68,56,10,14,12,4,8,0,0,0
"Jan 23, 2021 12:00 PM",88,51,37,358,199,159,350,202,148,350,210,140,,,,32,,,,22,19,3,31,,,,89,91,14,7,15,5,10,0,0,0
"Jan 23, 2021 1:00 PM",96,46,50,412,200,212,380,180,200,378,181,197,,,,57,,,,26,24,2,32,,,,78,94,10,8,18,10,8,0,0,0
"Jan 23, 2021 2:00 PM",116,62,54,372,186,186,361,169,192,318,174,144,,,,50,,,,26,22,4,37,,,,67,109,19,4,11,9,2,0,0,0
"Jan 23, 2021 3:00 PM",106,47,59,327,163,164,354,146,208,312,145,167,,,,50,,,,35,28,7,48,,,,61,81,17,14,21,12,9,0,0,0
"Jan 23, 2021 4:00 PM",96,35,61,189,85,104,216,101,115,150,71,79,,,,37,,,,34,27,7,35,,,,43,65,13,2,10,7,3,0,0,0
"Jan 23, 2021 5:00 PM",39,13,26,79,39,40,109,52,57,77,37,40,,,,19,,,,18,14,4,20,,,,27,41,6,0,9,6,3,0,0,0
"Jan 23, 2021 6:00 PM",33,14,19,25,11,14,42,14,28,35,15,20,,,,7,,,,19,16,3,12,,,,13,31,2,2,5,0,5,0,0,0
"Jan 23, 2021 7:00 PM",30,14,16,11,7,4,18,11,7,23,11,12,,,,8,,,,4,4,0,1,,,,6,19,0,0,0,0,0,0,0,0
"Jan 23, 2021 8:00 PM",24,9,15,7,5,2,7,3,4,8,4,4,,,,2,,,,4,3,1,3,,,,5,11,4,0,1,0,1,0,0,0
"Jan 23, 2021 9:00 PM",8,4,4,5,4,1,12,10,2,13,11,2,,,,9,,,,1,1,0,3,,,,5,11,1,0,1,0,1,0,0,0
"Jan 23, 2021 10:00 PM",15,7,8,10,6,4,5,2,3,7,2,5,,,,7,,,,4,3,1,1,,,,5,7,0,0,0,0,0,0,0,0
"Jan 23, 2021 11:00 PM",3,1,2,1,1,0,3,1,2,3,1,2,,,,1,,,,2,2,0,1,,,,2,2,0,0,0,0,0,0,0,0
"Jan 24, 2021 12:00 AM",6,4,2,0,0,0,0,0,0,1,1,0,,,,0,,,,0,0,0,0,,,,3,2,0,1,0,0,0,0,0,0
"Jan 24, 2021 1:00 AM",1,1,0,2,0,2,1,1,0,2,1,1,,,,0,,,,0,0,0,0,,,,0,1,0,0,0,0,0,0,0,0
"Jan 24, 2021 2:00 AM",3,2,1,2,2,0,1,1,0,1,1,0,,,,0,,,,1,1,0,1,,,,0,0,0,0,0,0,0,0,0,0
"Jan 24, 2021 3:00 AM",2,1,1,0,0,0,0,0,0,2,1,1,,,,0,,,,0,0,0,0,,,,0,1,0,0,0,0,0,0,0,0
"Jan 24, 2021 4:00 AM",2,1,1,0,0,0,0,0,0,1,1,0,,,,1,,,,0,0,0,0,,,,0,0,0,0,0,0,0,0,0,0
"Jan 24, 2021 5:00 AM",0,0,0,0,0,0,0,0,0,1,0,1,,,,0,,,,1,1,0,0,,,,0,0,0,0,0,0,0,0,0,0
"Jan 24, 2021 6:00 AM",4,3,1,0,0,0,3,1,2,0,0,0,,,,0,,,,0,0,0,0,,,,6,5,0,0,0,0,0,0,0,0
"Jan 24, 2021 7:00 AM",8,3,5,11,6,5,10,4,6,11,5,6,,,,1,,,,3,3,0,3,,,,5,12,0,1,0,0,0,0,0,0
"Jan 24, 2021 8:00 AM",7,4,3,30,17,13,26,19,7,23,15,8,,,,1,,,,4,4,0,1,,,,7,6,0,1,2,1,1,0,0,0
"Jan 24, 2021 9:00 AM",12,3,9,39,20,19,77,48,29,26,13,13,,,,2,,,,5,4,1,2,,,,13,12,1,3,3,2,1,0,0,0
"Jan 24, 2021 10:00 AM",14,8,6,36,29,7,82,44,38,46,37,9,,,,4,,,,6,5,1,3,,,,23,20,4,0,1,1,0,0,0,0
"Jan 24, 2021 11:00 AM",22,11,11,50,18,32,87,37,50,50,20,30,,,,10,,,,6,2,4,7,,,,17,19,1,3,2,1,1,0,0,0
"Jan 24, 2021 12:00 PM",33,17,16,48,23,25,75,37,38,44,25,19,,,,8,,,,9,7,2,9,,,,24,29,0,0,1,0,1,0,0,0
"Jan 24, 2021 1:00 PM",39,21,18,81,50,31,99,58,41,101,58,43,,,,14,,,,9,7,2,15,,,,38,25,1,7,4,1,3,0,0,0
"Jan 24, 2021 2:00 PM",29,9,20,57,27,30,58,25,33,52,25,27,,,,11,,,,13,11,2,6,,,,16,38,3,0,7,4,3,0,0,0
"Jan 24, 2021 3:00 PM",32,14,18,55,27,28,57,24,33,46,16,30,,,,19,,,,19,13,6,15,,,,9,26,1,0,4,3,1,0,0,0
"Jan 24, 2021 4:00 PM",32,13,19,39,18,21,45,20,25,38,19,19,,,,14,,,,14,9,5,8,,,,13,19,0,4,2,1,1,0,0,0
"Jan 24, 2021 5:00 PM",25,11,14,31,18,13,29,18,11,25,12,13,,,,9,,,,7,6,1,4,,,,8,13,2,1,3,3,0,0,0,0
"Jan 24, 2021 6:00 PM",11,5,6,5,1,4,13,3,10,15,5,10,,,,2,,,,1,1,0,4,,,,8,7,3,1,0,0,0,0,0,0
"Jan 24, 2021 7:00 PM",16,9,7,8,5,3,8,2,6,5,2,3,,,,6,,,,2,2,0,3,,,,4,9,0,0,7,5,2,0,0,0
"Jan 24, 2021 8:00 PM",10,5,5,0,0,0,3,2,1,0,0,0,,,,10,,,,2,2,0,0,,,,5,3,0,0,1,0,1,0,0,0
"Jan 24, 2021 9:00 PM",4,2,2,1,0,1,6,3,3,2,1,1,,,,7,,,,2,2,0,2,,,,1,5,0,0,1,0,1,0,0,0
"Jan 24, 2021 10:00 PM",6,3,3,1,1,0,0,0,0,1,1,0,,,,0,,,,1,0,1,0,,,,0,3,0,0,0,0,0,0,0,0
"Jan 24, 2021 11:00 PM",2,0,2,0,0,0,0,0,0,0,0,0,,,,2,,,,1,0,1,0,,,,0,0,0,1,1,0,1,0,0,0
"Jan 25, 2021 12:00 AM",1,1,0,0,0,0,0,0,0,0,0,0,,,,0,,,,0,0,0,0,,,,0,1,0,0,0,0,0,0,0,0
"Jan 25, 2021 1:00 AM",0,0,0,0,0,0,0,0,0,0,0,0,,,,0,,,,2,1,1,0,,,,0,0,0,0,0,0,0,0,0,0
"Jan 25, 2021 2:00 AM",1,1,0,0,0,0,0,0,0,0,0,0,,,,0,,,,0,0,0,0,,,,0,0,0,0,0,0,0,0,0,0
"Jan 25, 2021 3:00 AM",0,0,0,0,0,0,0,0,0,0,0,0,,,,0,,,,0,0,0,0,,,,0,0,0,0,0,0,0,0,0,0
"Jan 25, 2021 4:00 AM",0,0,0,0,0,0,1,1,0,0,0,0,,,,0,,,,0,0,0,0,,,,0,0,0,0,0,0,0,0,0,0
"Jan 25, 2021 5:00 AM",1,1,0,0,0,0,0,0,0,0,0,0,,,,0,,,,1,1,0,1,,,,2,5,1,1,0,0,0,0,0,0
"Jan 25, 2021 6:00 AM",11,4,7,3,0,3,8,4,4,6,3,3,,,,3,,,,2,2,0,4,,,,13,17,0,0,1,0,1,0,0,0
"Jan 25, 2021 7:00 AM",17,8,9,16,8,8,20,7,13,15,8,7,,,,2,,,,4,4,0,10,,,,19,27,0,1,3,3,0,0,0,0
"Jan 25, 2021 8:00 AM",30,19,11,24,7,17,23,10,13,25,11,14,,,,4,,,,6,3,3,11,,,,18,36,1,0,3,1,2,0,0,0
"Jan 25, 2021 9:00 AM",23,17,6,19,8,11,27,7,20,14,5,9,,,,1,,,,6,4,2,7,,,,4,17,0,1,0,0,0,0,0,0
"Jan 25, 2021 10:00 AM",17,10,7,22,12,10,22,15,7,25,16,9,,,,8,,,,9,6,3,7,,,,8,13,1,2,2,1,1,0,0,0
"Jan 25, 2021 11:00 AM",22,12,10,26,10,16,37,15,22,25,15,10,,,,1,,,,7,6,1,4,,,,10,16,3,0,1,0,1,0,0,0
"Jan 25, 2021 12:00 PM",28,11,17,47,29,18,70,37,33,47,31,16,,,,24,,,,8,6,2,10,,,,15,15,0,5,3,3,0,0,0,0
"Jan 25, 2021 1:00 PM",48,21,27,72,45,27,83,44,39,59,33,26,,,,12,,,,13,12,1,20,,,,24,21,8,5,9,6,3,0,0,0
"Jan 25, 2021 2:00 PM",34,19,15,61,34,27,62,32,30,55,32,23,,,,16,,,,14,12,2,9,,,,23,33,1,0,5,4,1,0,0,0
"Jan 25, 2021 3:00 PM",43,23,20,62,20,42,71,33,38,45,21,24,,,,25,,,,12,10,2,11,,,,23,32,5,0,13,11,2,0,0,0
"Jan 25, 2021 4:00 PM",58,27,31,80,43,37,92,49,43,71,41,30,,,,26,,,,17,14,3,11,,,,34,27,4,1,12,7,5,0,0,0
"Jan 25, 2021 5:00 PM",63,14,49,52,24,28,70,38,32,59,26,33,,,,13,,,,24,23,1,6,,,,28,39,2,6,9,4,5,0,0,0
"Jan 25, 2021 6:00 PM",41,19,22,41,23,18,47,32,15,42,25,17,,,,9,,,,25,21,4,10,,,,28,23,1,3,2,2,0,0,0,0
"Jan 25, 2021 7:00 PM",23,9,14,24,16,8,33,27,6,21,16,5,,,,5,,,,9,7,2,1,,,,11,9,3,1,2,1,1,0,0,0
"Jan 25, 2021 8:00 PM",12,3,9,13,6,7,18,9,9,16,11,5,,,,3,,,,4,4,0,3,,,,8,7,1,2,2,2,0,0,0,0
"Jan 25, 2021 9:00 PM",10,2,8,3,2,1,7,3,4,7,3,4,,,,6,,,,2,2,0,2,,,,1,3,0,0,2,1,1,0,0,0
"Jan 25, 2021 10:00 PM",4,1,3,1,0,1,4,2,2,3,2,1,,,,1,,,,1,0,1,1,,,,2,3,1,1,0,0,0,0,0,0
"Jan 25, 2021 11:00 PM",6,2,4,3,2,1,2,1,1,2,2,0,,,,0,,,,1,1,0,1,,,,1,1,0,0,0,0,0,0,0,0
"Jan 26, 2021 12:00 AM",1,0,1,0,0,0,0,0,0,1,0,1,,,,1,,,,1,1,0,1,,,,2,2,0,0,0,0,0,0,0,0
"Jan 26, 2021 1:00 AM",2,0,2,0,0,0,1,1,0,0,0,0,,,,0,,,,1,1,0,0,,,,1,0,0,0,0,0,0,0,0,0
"Jan 26, 2021 2:00 AM",3,2,1,0,0,0,3,3,0,0,0,0,,,,0,,,,0,0,0,0,,,,1,0,0,0,0,0,0,0,0,0
"Jan 26, 2021 3:00 AM",1,0,1,6,3,3,3,0,3,6,3,3,,,,0,,,,0,0,0,0,,,,0,0,0,0,0,0,0,0,0,0
"Jan 26, 2021 4:00 AM",0,0,0,0,0,0,1,1,0,1,1,0,,,,0,,,,0,0,0,0,,,,0,3,0,0,0,0,0,0,0,0
"Jan 26, 2021 5:00 AM",1,1,0,1,0,1,1,1,0,2,1,1,,,,1,,,,1,1,0,1,,,,4,8,1,0,0,0,0,0,0,0
"Jan 26, 2021 6:00 AM",15,9,6,2,1,1,11,6,5,3,2,1,,,,3,,,,4,4,0,5,,,,12,16,0,0,1,1,0,0,0,0
"Jan 26, 2021 7:00 AM",38,26,12,20,11,9,26,10,16,20,10,10,,,,6,,,,4,4,0,19,,,,20,39,2,1,3,3,0,0,0,0
"Jan 26, 2021 8:00 AM",58,39,19,26,6,20,45,22,23,41,19,22,,,,10,,,,6,3,3,25,,,,12,41,6,1,6,4,2,0,0,0
"Jan 26, 2021 9:00 AM",45,35,10,27,14,13,39,21,18,26,15,11,,,,10,,,,8,6,2,14,,,,6,21,1,2,2,1,1,0,0,0
"Jan 26, 2021 10:00 AM",30,25,5,19,8,11,32,13,19,17,7,10,,,,11,,,,6,6,0,17,,,,11,16,0,0,7,5,2,0,0,0
"Jan 26, 2021 11:00 AM",28,14,14,31,15,16,39,27,12,31,23,8,,,,18,,,,2,2,0,12,,,,15,22,0,5,1,1,0,0,0,0
"Jan 26, 2021 12:00 PM",57,29,28,55,30,25,86,44,42,65,30,35,,,,20,,,,15,13,2,12,,,,18,22,1,0,6,6,0,0,0,0
"Jan 26, 2021 1:00 PM",40,21,19,73,34,39,109,61,48,71,39,32,,,,13,,,,15,14,1,22,,,,26,37,3,4,9,4,5,0,0,0
"Jan 26, 2021 2:00 PM",37,18,19,77,43,34,81,43,38,76,42,34,,,,21,,,,15,10,5,19,,,,20,22,7,1,7,5,2,0,0,0
"Jan 26, 2021 3:00 PM",62,31,31,106,50,56,101,50,51,96,58,38,,,,23,,,,27,21,6,13,,,,24,36,7,2,9,6,3,0,0,0
"Jan 26, 2021 4:00 PM",76,32,44,90,46,44,83,41,42,74,38,36,,,,31,,,,27,24,3,17,,,,39,31,4,1,7,3,4,0,0,0
"Jan 26, 2021 5:00 PM",88,22,66,61,32,29,82,39,43,69,35,34,,,,14,,,,33,33,0,11,,,,24,43,7,4,7,4,3,0,0,0
"Jan 26, 2021 6:00 PM",59,18,41,44,27,17,66,39,27,52,32,20,,,,10,,,,28,27,1,12,,,,36,33,5,2,3,3,0,0,0,0
"Jan 26, 2021 7:00 PM",25,11,14,33,20,13,39,28,11,32,21,11,,,,4,,,,12,10,2,8,,,,29,15,1,0,5,2,3,0,0,0
"Jan 26, 2021 8:00 PM",26,6,20,22,11,11,29,10,19,29,12,17,,,,5,,,,12,11,1,5,,,,16,12,1,2,2,1,1,0,0,0
"Jan 26, 2021 9:00 PM",13,4,9,15,7,8,18,8,10,18,10,8,,,,13,,,,10,10,0,3,,,,7,11,1,2,1,1,0,0,0,0
"Jan 26, 2021 10:00 PM",15,5,10,1,0,1,4,2,2,1,0,1,,,,1,,,,4,2,2,4,,,,3,5,0,0,0,0,0,0,0,0
"Jan 26, 2021 11:00 PM",2,0,2,0,0,0,2,0,2,4,0,4,,,,1,,,,3,2,1,2,,,,0,2,0,0,0,0,0,0,0,0
"Jan 27, 2021 12:00 AM",3,2,1,0,0,0,0,0,0,0,0,0,,,,0,,,,2,2,0,0,,,,0,0,0,0,1,1,0,0,0,0
"Jan 27, 2021 1:00 AM",0,0,0,0,0,0,0,0,0,0,0,0,,,,0,,,,2,2,0,0,,,,0,0,0,0,1,0,1,0,0,0
"Jan 27, 2021 2:00 AM",3,3,0,0,0,0,1,1,0,0,0,0,,,,1,,,,0,0,0,0,,,,1,0,0,0,0,0,0,0,0,0
"Jan 27, 2021 3:00 AM",1,0,1,0,0,0,0,0,0,0,0,0,,,,0,,,,0,0,0,0,,,,1,0,0,0,0,0,0,0,0,0
"Jan 27, 2021 4:00 AM",1,1,0,0,0,0,1,1,0,1,1,0,,,,0,,,,0,0,0,0,,,,0,1,0,0,0,0,0,0,0,0
"Jan 27, 2021 5:00 AM",2,2,0,1,1,0,1,1,0,2,2,0,,,,2,,,,3,3,0,2,,,,2,7,1,1,0,0,0,0,0,0
"Jan 27, 2021 6:00 AM",18,14,4,13,3,10,16,9,7,15,7,8,,,,1,,,,6,5,1,6,,,,9,22,0,1,1,1,0,0,0,0
"Jan 27, 2021 7:00 AM",33,18,15,35,16,19,52,21,31,41,16,25,,,,4,,,,9,8,1,23,,,,27,48,1,1,3,3,0,0,0,0
"Jan 27, 2021 8:00 AM",61,43,18,68,28,40,63,24,39,57,31,26,,,,12,,,,11,4,7,42,,,,22,59,0,2,3,3,0,0,0,0
"Jan 27, 2021 9:00 AM",46,30,16,69,28,41,64,31,33,57,27,30,,,,8,,,,6,5,1,25,,,,10,27,4,4,5,2,3,0,0,0
"Jan 27, 2021 10:00 AM",41,27,14,76,39,37,66,36,30,58,32,26,,,,10,,,,13,10,3,21,,,,18,20,4,2,2,0,2,0,0,0
"Jan 27, 2021 11:00 AM",38,21,17,77,35,42,97,50,47,64,30,34,,,,15,,,,12,11,1,11,,,,16,25,9,5,1,0,1,0,0,0
"Jan 27, 2021 12:00 PM",49,29,20,82,45,37,125,66,59,90,48,42,,,,30,,,,26,18,8,15,,,,18,16,8,4,5,4,1,0,0,0
"Jan 27, 2021 1:00 PM",53,24,29,119,65,54,136,69,67,127,69,58,,,,33,,,,28,21,7,23,,,,34,23,10,5,14,7,7,0,0,0
"Jan 27, 2021 2:00 PM",53,29,24,101,55,46,108,46,62,88,42,46,,,,24,,,,20,11,9,23,,,,17,32,10,4,9,5,4,0,0,0
"Jan 27, 2021 3:00 PM",68,27,41,99,41,58,118,56,62,91,42,49,,,,30,,,,16,10,6,10,,,,32,33,4,6,10,6,4,0,0,0
"Jan 27, 2021 4:00 PM",57,16,41,60,41,19,63,41,22,54,36,18,,,,24,,,,15,13,2,11,,,,34,29,5,3,7,4,3,0,0,0
"Jan 27, 2021 5:00 PM",64,11,53,35,22,13,32,21,11,30,19,11,,,,10,,,,41,39,2,6,,,,32,19,2,2,8,2,6,0,0,0
"Jan 27, 2021 6:00 PM",41,12,29,29,18,11,42,27,15,33,23,10,,,,7,,,,26,25,1,5,,,,28,23,2,0,4,2,2,0,0,0
"Jan 27, 2021 7:00 PM",33,11,22,15,8,7,20,12,8,14,7,7,,,,4,,,,21,19,2,5,,,,16,19,1,1,3,2,1,0,0,0
"Jan 27, 2021 8:00 PM",13,2,11,7,5,2,14,7,7,9,5,4,,,,3,,,,6,5,1,2,,,,10,8,1,0,0,0,0,0,0,0
"Jan 27, 2021 9:00 PM",6,0,6,4,2,2,2,1,1,2,1,1,,,,1,,,,6,6,0,2,,,,4,4,0,0,1,1,0,0,0,0
"Jan 27, 2021 10:00 PM",5,4,1,2,1,1,3,0,3,2,0,2,,,,0,,,,3,2,1,0,,,,2,3,0,1,3,2,1,0,0,0
"Jan 27, 2021 11:00 PM",5,0,5,1,0,1,1,0,1,0,0,0,,,,0,,,,2,2,0,1,,,,1,1,0,0,0,0,0,0,0,0
"Jan 28, 2021 12:00 AM",1,0,1,0,0,0,0,0,0,0,0,0,,,,0,,,,0,0,0,1,,,,0,1,0,0,0,0,0,0,0,0
"Jan 28, 2021 1:00 AM",0,0,0,0,0,0,0,0,0,0,0,0,,,,0,,,,1,1,0,0,,,,0,0,0,0,0,0,0,0,0,0
"Jan 28, 2021 2:00 AM",3,2,1,0,0,0,1,1,0,0,0,0,,,,0,,,,0,0,0,0,,,,0,1,0,0,0,0,0,0,0,0
"Jan 28, 2021 3:00 AM",1,0,1,1,1,0,0,0,0,1,1,0,,,,0,,,,0,0,0,0,,,,1,0,0,0,0,0,0,0,0,0
"Jan 28, 2021 4:00 AM",0,0,0,0,0,0,1,1,0,1,1,0,,,,0,,,,2,2,0,0,,,,0,0,0,0,0,0,0,0,0,0
"Jan 28, 2021 5:00 AM",0,0,0,1,1,0,1,1,0,2,2,0,,,,2,,,,2,2,0,2,,,,1,7,1,0,0,0,0,0,0,0
"Jan 28, 2021 6:00 AM",19,13,6,7,5,2,18,11,7,11,8,3,,,,2,,,,6,5,1,8,,,,15,20,0,0,1,1,0,0,0,0
"Jan 28, 2021 7:00 AM",35,23,12,47,25,22,58,19,39,51,24,27,,,,8,,,,8,8,0,16,,,,26,48,4,2,4,4,0,0,0,0
"Jan 28, 2021 8:00 AM",54,36,18,91,29,62,87,41,46,81,36,45,,,,10,,,,10,5,5,43,,,,23,63,0,3,1,1,0,0,0,0
"Jan 28, 2021 9:00 AM",52,35,17,55,28,27,68,33,35,58,33,25,,,,13,,,,17,13,4,24,,,,12,21,2,1,1,1,0,0,0,0
"Jan 28, 2021 10:00 AM",37,23,14,81,41,40,91,51,40,62,33,29,,,,13,,,,11,11,0,22,,,,16,26,3,5,2,1,1,0,0,0
"Jan 28, 2021 11:00 AM",30,10,20,125,74,51,111,60,51,95,57,38,,,,16,,,,10,4,6,20,,,,28,29,5,3,2,1,1,0,0,0
"Jan 28, 2021 12:00 PM",49,23,26,106,44,62,126,52,74,86,39,47,,,,18,,,,16,15,1,15,,,,21,44,8,4,4,3,1,0,0,0
"Jan 28, 2021 1:00 PM",48,26,22,97,54,43,118,51,67,84,44,40,,,,22,,,,15,12,3,15,,,,31,32,6,6,5,3,2,0,0,0
"Jan 28, 2021 2:00 PM",54,34,20,74,27,47,104,54,50,71,36,35,,,,24,,,,25,23,2,23,,,,18,30,5,3,8,7,1,0,0,0
"Jan 28, 2021 3:00 PM",58,23,35,83,43,40,75,28,47,62,32,30,,,,19,,,,20,17,3,11,,,,20,28,2,1,5,2,3,0,0,0
"Jan 28, 2021 4:00 PM",48,17,31,58,33,25,63,36,27,58,35,23,,,,14,,,,16,13,3,12,,,,35,20,4,1,8,6,2,0,0,0
"Jan 28, 2021 5:00 PM",81,21,60,63,40,23,75,47,28,60,38,22,,,,16,,,,34,33,1,17,,,,40,32,0,4,3,1,2,0,0,0
"Jan 28, 2021 6:00 PM",69,25,44,48,32,16,59,40,19,57,34,23,,,,12,,,,47,42,5,12,,,,38,28,1,2,4,2,2,0,0,0
"Jan 28, 2021 7:00 PM",42,15,27,43,31,12,49,31,18,38,24,14,,,,9,,,,23,22,1,9,,,,36,20,1,2,5,2,3,0,0,0
"Jan 28, 2021 8:00 PM",19,7,12,32,14,18,38,20,18,30,14,16,,,,7,,,,7,7,0,5,,,,13,8,1,0,3,2,1,0,0,0
"Jan 28, 2021 9:00 PM",20,7,13,18,7,11,32,12,20,25,9,16,,,,2,,,,7,6,1,5,,,,0,9,0,0,2,2,0,0,0,0
"Jan 28, 2021 10:00 PM",7,2,5,7,3,4,12,6,6,13,7,6,,,,6,,,,0,0,0,2,,,,5,3,0,0,0,0,0,0,0,0
"Jan 28, 2021 11:00 PM",5,3,2,3,1,2,5,3,2,5,2,3,,,,1,,,,3,2,1,2,,,,2,3,1,3,0,0,0,0,0,0
"Jan 29, 2021 12:00 AM",12,3,9,0,0,0,1,1,0,2,1,1,,,,0,,,,3,3,0,4,,,,1,2,0,1,1,1,0,0,0,0
"Jan 29, 2021 1:00 AM",2,1,1,0,0,0,0,0,0,0,0,0,,,,0,,,,0,0,0,0,,,,0,0,0,0,0,0,0,0,0,0
"Jan 29, 2021 2:00 AM",2,1,1,0,0,0,0,0,0,1,1,0,,,,0,,,,0,0,0,0,,,,0,1,0,0,0,0,0,0,0,0
"Jan 29, 2021 3:00 AM",1,0,1,0,0,0,0,0,0,0,0,0,,,,0,,,,0,0,0,0,,,,1,1,0,0,0,0,0,0,0,0
"Jan 29, 2021 4:00 AM",0,0,0,0,0,0,2,2,0,1,1,0,,,,0,,,,2,2,0,0,,,,0,1,0,0,0,0,0,0,0,0
"Jan 29, 2021 5:00 AM",0,0,0,2,2,0,5,4,1,6,5,1,,,,0,,,,4,4,0,5,,,,1,6,2,0,0,0,0,0,0,0
"Jan 29, 2021 6:00 AM",17,9,8,20,12,8,24,16,8,22,15,7,,,,1,,,,8,8,0,4,,,,9,22,0,0,0,0,0,0,0,0
"Jan 29, 2021 7:00 AM",34,21,13,56,32,24,54,30,24,55,33,22,,,,7,,,,9,5,4,23,,,,25,43,0,3,2,2,0,0,0,0
"Jan 29, 2021 8:00 AM",46,32,14,73,29,44,78,33,45,68,37,31,,,,6,,,,14,8,6,40,,,,23,58,0,4,7,7,0,0,0,0
"Jan 29, 2021 9:00 AM",52,33,19,60,22,38,54,24,30,47,17,30,,,,9,,,,8,7,1,23,,,,10,25,1,1,1,1,0,0,0,0
"Jan 29, 2021 10:00 AM",25,15,10,48,28,20,55,39,16,47,33,14,,,,9,,,,7,5,2,13,,,,21,20,2,4,2,1,1,0,0,0
"Jan 29, 2021 11:00 AM",29,18,11,73,46,27,87,52,35,62,40,22,,,,9,,,,11,8,3,8,,,,16,25,8,2,1,0,1,0,0,0
"Jan 29, 2021 12:00 PM",38,14,24,65,35,30,69,40,29,58,30,28,,,,13,,,,8,8,0,11,,,,17,22,10,1,3,2,1,0,0,0
"Jan 29, 2021 1:00 PM",47,30,17,118,68,50,128,71,57,94,56,38,,,,14,,,,18,12,6,10,,,,28,21,3,4,2,2,0,0,0,0
"Jan 29, 2021 2:00 PM",48,25,23,118,63,55,171,97,74,103,66,37,,,,19,,,,25,24,1,27,,,,23,24,3,8,5,4,1,0,0,0
"Jan 29, 2021 3:00 PM",67,36,31,145,80,65,151,68,83,138,76,62,,,,13,,,,22,15,7,14,,,,34,38,7,4,16,12,4,0,0,0
"Jan 29, 2021 4:00 PM",65,25,40,106,47,59,124,52,72,83,39,44,,,,10,,,,25,23,2,14,,,,51,48,4,1,7,4,3,0,0,0
"Jan 29, 2021 5:00 PM",68,21,47,88,49,39,97,52,45,78,50,28,,,,13,,,,31,27,4,14,,,,48,38,7,2,10,9,1,0,0,0
"Jan 29, 2021 6:00 PM",61,22,39,44,20,24,38,19,19,34,14,20,,,,13,,,,34,31,3,7,,,,38,26,1,1,6,1,5,0,0,0
"Jan 29, 2021 7:00 PM",42,17,25,17,13,4,22,15,7,18,11,7,,,,10,,,,25,23,2,14,,,,20,14,3,1,2,0,2,0,0,0
"Jan 29, 2021 8:00 PM",21,7,14,10,5,5,18,9,9,16,7,9,,,,8,,,,10,10,0,8,,,,14,12,3,0,2,1,1,0,0,0
"Jan 29, 2021 9:00 PM",19,11,8,5,1,4,10,8,2,5,3,2,,,,4,,,,8,8,0,6,,,,5,10,3,0,2,2,0,0,0,0
"Jan 29, 2021 10:00 PM",10,4,6,0,0,0,8,2,6,3,2,1,,,,4,,,,3,3,0,1,,,,5,9,0,0,4,2,2,0,0,0
"Jan 29, 2021 11:00 PM",7,2,5,0,0,0,7,2,5,1,0,1,,,,4,,,,1,1,0,2,,,,2,3,0,0,0,0,0,0,0,0
"Jan 30, 2021 12:00 AM",5,2,3,0,0,0,0,0,0,0,0,0,,,,1,,,,1,1,0,0,,,,0,0,0,0,0,0,0,0,0,0
"Jan 30, 2021 1:00 AM",3,1,2,1,0,1,0,0,0,0,0,0,,,,0,,,,3,3,0,1,,,,1,0,0,0,0,0,0,0,0,0
"Jan 30, 2021 2:00 AM",1,0,1,0,0,0,0,0,0,0,0,0,,,,0,,,,1,1,0,1,,,,0,1,0,0,0,0,0,0,0,0
"Jan 30, 2021 3:00 AM",0,0,0,2,2,0,2,2,0,1,1,0,,,,0,,,,1,1,0,0,,,,1,0,0,0,0,0,0,0,0,0
"Jan 30, 2021 4:00 AM",1,0,1,0,0,0,0,0,0,0,0,0,,,,0,,,,0,0,0,0,,,,0,0,0,0,0,0,0,0,0,0
"Jan 30, 2021 5:00 AM",0,0,0,0,0,0,1,0,1,0,0,0,,,,1,,,,0,0,0,1,,,,0,0,0,0,0,0,0,0,0,0
"Jan 30, 2021 6:00 AM",3,1,2,0,0,0,1,0,1,0,0,0,,,,3,,,,0,0,0,0,,,,1,5,0,1,1,1,0,0,0,0
"Jan 30, 2021 7:00 AM",6,3,3,1,0,1,2,2,0,1,1,0,,,,2,,,,2,2,0,0,,,,8,2,0,0,0,0,0,0,0,0
"Jan 30, 2021 8:00 AM",6,3,3,8,7,1,7,6,1,9,7,2,,,,4,,,,1,1,0,1,,,,6,1,1,2,0,0,0,0,0,0
"Jan 30, 2021 9:00 AM",4,2,2,5,2,3,5,2,3,5,2,3,,,,1,,,,2,1,1,2,,,,2,8,0,0,0,0,0,0,0,0
"Jan 30, 2021 10:00 AM",11,4,7,4,1,3,15,7,8,11,6,5,,,,2,,,,1,1,0,1,,,,6,1,0,0,1,1,0,0,0,0
"Jan 30, 2021 11:00 AM",9,6,3,10,5,5,14,8,6,12,6,6,,,,0,,,,0,0,0,3,,,,10,8,0,0,0,0,0,0,0,0
"Jan 30, 2021 12:00 PM",14,6,8,12,5,7,11,3,8,10,5,5,,,,2,,,,0,0,0,0,,,,8,16,0,0,1,1,0,0,0,0
"Jan 30, 2021 1:00 PM",15,9,6,23,16,7,25,14,11,21,14,7,,,,7,,,,0,0,0,5,,,,8,14,1,0,0,0,0,0,0,0
"Jan 30, 2021 2:00 PM",23,13,10,26,12,14,39,23,16,33,18,15,,,,4,,,,12,10,2,9,,,,10,9,4,0,2,0,2,0,0,0
"Jan 30, 2021 3:00 PM",14,9,5,40,17,23,46,19,27,42,18,24,,,,3,,,,4,4,0,5,,,,18,9,0,1,5,2,3,0,0,0
"Jan 30, 2021 4:00 PM",20,11,9,31,9,22,37,20,17,38,18,20,,,,6,,,,6,6,0,4,,,,13,17,1,0,4,3,1,0,0,0
"Jan 30, 2021 5:00 PM",25,11,14,24,15,9,27,12,15,16,8,8,,,,5,,,,3,3,0,4,,,,5,5,2,0,1,1,0,0,0,0
"Jan 30, 2021 6:00 PM",20,8,12,11,6,5,12,6,6,10,4,6,,,,4,,,,3,2,1,5,,,,6,6,0,0,2,1,1,0,0,0
"Jan 30, 2021 7:00 PM",21,13,8,14,6,8,10,4,6,10,3,7,,,,3,,,,3,2,1,1,,,,4,5,1,0,0,0,0,0,0,0
"Jan 30, 2021 8:00 PM",14,7,7,4,2,2,7,3,4,8,3,5,,,,9,,,,4,4,0,3,,,,2,5,1,0,0,0,0,0,0,0
"Jan 30, 2021 9:00 PM",10,5,5,4,4,0,3,1,2,4,2,2,,,,3,,,,5,4,1,1,,,,0,3,2,1,3,2,1,0,0,0
"Jan 30, 2021 10:00 PM",11,4,7,2,1,1,3,1,2,2,1,1,,,,2,,,,1,1,0,0,,,,2,7,0,0,0,0,0,0,0,0
"Jan 30, 2021 11:00 PM",2,0,2,2,0,2,2,1,1,3,1,2,,,,4,,,,1,1,0,1,,,,1,1,0,2,0,0,0,0,0,0
"Jan 31, 2021 12:00 AM",1,1,0,1,0,1,0,0,0,0,0,0,,,,2,,,,1,1,0,4,,,,1,0,0,0,2,1,1,0,0,0
"Jan 31, 2021 1:00 AM",1,1,0,0,0,0,1,0,1,0,0,0,,,,0,,,,0,0,0,0,,,,0,1,0,0,0,0,0,0,0,0
"Jan 31, 2021 2:00 AM",1,0,1,0,0,0,0,0,0,0,0,0,,,,0,,,,1,1,0,0,,,,0,0,0,0,1,0,1,0,0,0
"Jan 31, 2021 3:00 AM",0,0,0,1,1,0,5,3,2,1,1,0,,,,0,,,,3,2,1,0,,,,1,2,0,0,0,0,0,0,0,0
"Jan 31, 2021 4:00 AM",1,1,0,0,0,0,0,0,0,0,0,0,,,,0,,,,1,1,0,0,,,,0,0,0,0,0,0,0,0,0,0
"Jan 31, 2021 5:00 AM",0,0,0,0,0,0,0,0,0,0,0,0,,,,0,,,,0,0,0,0,,,,0,2,0,1,0,0,0,0,0,0
"Jan 31, 2021 6:00 AM",3,3,0,0,0,0,3,2,1,2,1,1,,,,2,,,,1,0,1,1,,,,1,6,0,0,0,0,0,0,0,0
"Jan 31, 2021 7:00 AM",12,3,9,8,5,3,10,7,3,11,8,3,,,,1,,,,1,1,0,3,,,,10,3,1,1,1,1,0,0,0,0
"Jan 31, 2021 8:00 AM",11,3,8,17,11,6,20,11,9,26,13,13,,,,4,,,,1,1,0,2,,,,6,6,0,1,1,0,1,0,0,0
"Jan 31, 2021 9:00 AM",18,6,12,23,10,13,32,13,19,28,11,17,,,,2,,,,2,2,0,0,,,,2,16,1,0,2,2,0,0,0,0
"Jan 31, 2021 10:00 AM",8,4,4,25,14,11,27,15,12,24,16,8,,,,6,,,,3,2,1,4,,,,5,7,3,1,0,0,0,0,0,0
"Jan 31, 2021 11:00 AM",15,12,3,35,21,14,57,30,27,33,22,11,,,,3,,,,3,2,1,2,,,,11,14,1,2,2,2,0,0,0,0
"Jan 31, 2021 12:00 PM",18,7,11,35,14,21,33,16,17,22,8,14,,,,6,,,,6,6,0,3,,,,8,12,1,5,3,2,1,0,0,0
"Jan 31, 2021 1:00 PM",12,3,9,33,16,17,42,23,19,27,8,19,,,,6,,,,6,5,1,3,,,,15,9,0,0,1,0,1,0,0,0
"Jan 31, 2021 2:00 PM",24,10,14,24,12,12,49,28,21,26,16,10,,,,7,,,,12,11,1,2,,,,12,17,1,2,1,1,0,0,0,0
"Jan 31, 2021 3:00 PM",25,11,14,26,16,10,52,28,24,28,17,11,,,,11,,,,0,0,0,6,,,,13,13,0,2,2,2,0,0,0,0
"Jan 31, 2021 4:00 PM",25,11,14,29,13,16,37,19,18,24,10,14,,,,17,,,,7,6,1,4,,,,9,18,2,1,1,0,1,0,0,0
"Jan 31, 2021 5:00 PM",28,16,12,17,9,8,14,4,10,10,6,4,,,,9,,,,4,2,2,10,,,,4,9,0,1,1,0,1,0,0,0
"Jan 31, 2021 6:00 PM",23,8,15,4,3,1,6,5,1,5,4,1,,,,2,,,,4,4,0,2,,,,7,8,0,0,0,0,0,0,0,0
"Jan 31, 2021 7:00 PM",19,8,11,7,4,3,6,4,2,7,5,2,,,,6,,,,2,1,1,5,,,,3,5,1,0,4,3,1,0,0,0
"Jan 31, 2021 8:00 PM",8,6,2,3,2,1,3,1,2,2,1,1,,,,6,,,,3,3,0,1,,,,2,3,1,0,1,0,1,0,0,0
"Jan 31, 2021 9:00 PM",7,2,5,0,0,0,1,0,1,1,0,1,,,,1,,,,2,2,0,3,,,,2,4,1,0,4,2,2,0,0,0
"Jan 31, 2021 10:00 PM",4,3,1,1,1,0,0,0,0,0,0,0,,,,2,,,,2,2,0,1,,,,3,3,0,0,0,0,0,0,0,0
"Jan 31, 2021 11:00 PM",2,1,1,0,0,0,4,1,3,1,0,1,,,,1,,,,0,0,0,1,,,,0,2,0,0,0,0,0,0,0,0
"Feb 1, 2021 12:00 AM",1,1,0,0,0,0,0,0,0,0,0,0,,,,0,,,,0,0,0,0,,,,0,0,0,0,2,2,0,0,0,0
"Feb 1, 2021 1:00 AM",2,2,0,0,0,0,1,1,0,1,1,0,,,,0,,,,0,0,0,0,,,,1,0,0,0,0,0,0,0,0,0
"Feb 1, 2021 2:00 AM",2,1,1,0,0,0,0,0,0,0,0,0,,,,0,,,,0,0,0,0,,,,0,0,0,0,0,0,0,0,0,0
"Feb 1, 2021 3:00 AM",0,0,0,0,0,0,0,0,0,0,0,0,,,,0,,,,0,0,0,1,,,,0,0,0,0,0,0,0,0,0,0
"Feb 1, 2021 4:00 AM",0,0,0,0,0,0,1,1,0,0,0,0,,,,0,,,,0,0,0,0,,,,0,0,0,0,0,0,0,0,0,0
"Feb 1, 2021 5:00 AM",0,0,0,1,1,0,3,1,2,4,3,1,,,,1,,,,2,2,0,1,,,,3,8,0,0,1,0,1,0,0,0
"Feb 1, 2021 6:00 AM",12,6,6,10,3,7,16,8,8,12,6,6,,,,2,,,,3,3,0,10,,,,10,23,0,0,2,2,0,0,0,0
"Feb 1, 2021 7:00 AM",39,25,14,37,20,17,43,18,25,34,15,19,,,,5,,,,3,2,1,29,,,,24,50,4,1,2,2,0,0,0,0
"Feb 1, 2021 8:00 AM",59,40,19,48,24,24,65,37,28,58,30,28,,,,9,,,,14,8,6,42,,,,19,47,2,3,3,3,0,0,0,0
"Feb 1, 2021 9:00 AM",51,42,9,58,24,34,55,26,29,54,26,28,,,,15,,,,11,7,4,30,,,,11,29,3,0,2,1,1,0,0,0
"Feb 1, 2021 10:00 AM",36,23,13,72,38,34,83,50,33,65,39,26,,,,16,,,,13,9,4,12,,,,19,16,3,4,4,3,1,0,0,0
"Feb 1, 2021 11:00 AM",42,23,19,98,61,37,107,63,44,98,61,37,,,,21,,,,15,12,3,15,,,,22,29,6,2,4,1,3,0,0,0
"Feb 1, 2021 12:00 PM",53,22,31,102,51,51,161,86,75,109,53,56,,,,32,,,,19,17,2,13,,,,26,42,11,9,4,4,0,0,0,0
"Feb 1, 2021 1:00 PM",45,24,21,103,40,63,137,55,82,80,40,40,,,,15,,,,18,16,2,13,,,,30,40,8,6,5,2,3,0,0,0
"Feb 1, 2021 2:00 PM",48,27,21,64,32,32,78,45,33,60,35,25,,,,21,,,,15,12,3,11,,,,14,27,5,7,13,8,5,0,0,0
"Feb 1, 2021 3:00 PM",54,26,28,76,42,34,84,42,42,63,35,28,,,,23,,,,21,19,2,15,,,,27,24,9,3,9,8,1,0,0,0
"Feb 1, 2021 4:00 PM",70,26,44,62,39,23,77,39,38,61,34,27,,,,23,,,,21,17,4,9,,,,33,38,5,2,9,6,3,0,0,0
"Feb 1, 2021 5:00 PM",92,19,73,41,23,18,68,44,24,55,27,28,,,,12,,,,45,44,1,13,,,,35,26,2,5,4,1,3,0,0,0
"Feb 1, 2021 6:00 PM",43,15,28,32,22,10,46,25,21,34,23,11,,,,12,,,,30,28,2,10,,,,32,37,1,1,1,0,1,0,0,0
"Feb 1, 2021 7:00 PM",39,14,25,23,16,7,28,16,12,26,16,10,,,,7,,,,13,12,1,15,,,,19,22,1,2,3,2,1,0,0,0
"Feb 1, 2021 8:00 PM",25,9,16,12,7,5,19,10,9,16,10,6,,,,3,,,,12,12,0,6,,,,8,9,1,0,0,0,0,0,0,0
"Feb 1, 2021 9:00 PM",10,2,8,6,4,2,9,4,5,5,2,3,,,,2,,,,3,3,0,1,,,,5,4,3,0,3,3,0,0,0,0
"Feb 1, 2021 10:00 PM",4,1,3,4,1,3,4,2,2,4,1,3,,,,0,,,,2,2,0,4,,,,3,1,1,0,0,0,0,0,0,0
"Feb 1, 2021 11:00 PM",2,0,2,0,0,0,0,0,0,0,0,0,,,,1,,,,3,3,0,0,,,,1,1,1,0,1,1,0,0,0,0
"Feb 2, 2021 12:00 AM",3,1,2,0,0,0,0,0,0,0,0,0,,,,0,,,,1,1,0,0,,,,1,0,0,0,0,0,0,0,0,0
"Feb 2, 2021 1:00 AM",0,0,0,0,0,0,0,0,0,0,0,0,,,,0,,,,1,1,0,0,,,,0,0,0,0,0,0,0,0,0,0
"Feb 2, 2021 2:00 AM",0,0,0,0,0,0,0,0,0,0,0,0,,,,0,,,,0,0,0,0,,,,0,0,0,0,0,0,0,0,0,0
"Feb 2, 2021 3:00 AM",1,1,0,0,0,0,0,0,0,0,0,0,,,,0,,,,0,0,0,0,,,,0,0,0,0,0,0,0,0,0,0
"Feb 2, 2021 4:00 AM",1,1,0,0,0,0,2,2,0,1,1,0,,,,0,,,,0,0,0,0,,,,0,0,0,0,0,0,0,0,0,0
"Feb 2, 2021 5:00 AM",1,1,0,1,1,0,3,3,0,2,2,0,,,,1,,,,1,1,0,2,,,,1,4,0,0,0,0,0,0,0,0
"Feb 2, 2021 6:00 AM",14,8,6,8,5,3,10,7,3,5,3,2,,,,2,,,,3,2,1,9,,,,4,21,0,0,1,1,0,0,0,0
"Feb 2, 2021 7:00 AM",38,27,11,51,24,27,57,26,31,50,24,26,,,,9,,,,6,5,1,30,,,,23,57,4,1,2,1,1,0,0,0
"Feb 2, 2021 8:00 AM",74,48,26,76,25,51,72,34,38,71,34,37,,,,11,,,,14,6,8,43,,,,28,62,3,5,4,4,0,0,0,0
"Feb 2, 2021 9:00 AM",50,34,16,65,28,37,78,40,38,77,41,36,,,,12,,,,17,14,3,26,,,,20,26,5,3,1,0,1,0,0,0
"Feb 2, 2021 10:00 AM",34,20,14,71,39,32,72,40,32,63,45,18,,,,21,,,,7,7,0,18,,,,22,30,6,2,3,2,1,0,0,0
"Feb 2, 2021 11:00 AM",46,25,21,89,45,44,81,43,38,74,34,40,,,,17,,,,16,8,8,11,,,,22,29,9,2,8,7,1,0,0,0
"Feb 2, 2021 12:00 PM",43,19,24,58,26,32,77,28,49,46,19,27,,,,15,,,,13,10,3,7,,,,11,30,5,6,6,3,3,0,0,0
"Feb 2, 2021 1:00 PM",38,18,20,28,16,12,49,23,26,30,15,15,,,,9,,,,8,5,3,7,,,,8,11,1,0,3,2,1,0,0,0
"Feb 2, 2021 2:00 PM",36,17,19,39,20,19,39,23,16,29,16,13,,,,26,,,,13,11,2,10,,,,15,8,2,0,3,2,1,0,0,0
"Feb 2, 2021 3:00 PM",71,31,40,78,43,35,107,65,42,72,40,32,,,,29,,,,13,10,3,19,,,,22,22,3,4,6,5,1,0,0,0
"Feb 2, 2021 4:00 PM",75,23,52,98,49,49,111,54,57,100,53,47,,,,23,,,,34,32,2,19,,,,45,42,10,3,12,8,4,0,0,0
"Feb 2, 2021 5:00 PM",87,20,67,79,42,37,107,52,55,98,57,41,,,,20,,,,41,37,4,8,,,,43,36,5,6,9,5,4,0,0,0
"Feb 2, 2021 6:00 PM",57,21,36,60,40,20,56,43,13,50,39,11,,,,13,,,,31,31,0,15,,,,47,28,2,0,1,0,1,0,0,0
"Feb 2, 2021 7:00 PM",43,18,25,54,35,19,56,35,21,52,29,23,,,,8,,,,13,13,0,7,,,,26,26,5,1,2,1,1,0,0,0
"Feb 2, 2021 8:00 PM",13,2,11,24,12,12,33,15,18,35,17,18,,,,2,,,,14,13,1,8,,,,20,21,0,0,6,2,4,0,0,0
"Feb 2, 2021 9:00 PM",16,4,12,10,5,5,17,8,9,22,11,11,,,,4,,,,7,6,1,8,,,,13,23,1,1,1,0,1,0,0,0
"Feb 2, 2021 10:00 PM",7,4,3,5,2,3,6,3,3,5,1,4,,,,5,,,,1,1,0,1,,,,3,5,1,2,2,1,1,0,0,0
"Feb 2, 2021 11:00 PM",5,2,3,2,0,2,3,0,3,3,0,3,,,,3,,,,4,4,0,2,,,,0,4,0,0,0,0,0,0,0,0
"Feb 3, 2021 12:00 AM",2,1,1,1,0,1,1,1,0,2,1,1,,,,0,,,,1,1,0,0,,,,2,0,0,0,0,0,0,0,0,0
"Feb 3, 2021 1:00 AM",3,2,1,0,0,0,1,0,1,0,0,0,,,,0,,,,1,1,0,0,,,,0,0,0,0,0,0,0,0,0,0
"Feb 3, 2021 2:00 AM",5,4,1,0,0,0,3,3,0,1,1,0,,,,0,,,,1,1,0,0,,,,1,0,0,0,0,0,0,0,0,0
"Feb 3, 2021 3:00 AM",0,0,0,0,0,0,0,0,0,0,0,0,,,,0,,,,1,1,0,0,,,,0,0,0,0,0,0,0,0,0,0
"Feb 3, 2021 4:00 AM",1,1,0,0,0,0,1,1,0,1,1,0,,,,0,,,,0,0,0,0,,,,0,0,0,0,0,0,0,0,0,0
"Feb 3, 2021 5:00 AM",3,3,0,1,1,0,1,1,0,2,2,0,,,,0,,,,1,1,0,2,,,,1,9,0,0,0,0,0,0,0,0
"Feb 3, 2021 6:00 AM",8,5,3,12,5,7,13,10,3,14,9,5,,,,2,,,,5,5,0,13,,,,6,34,0,1,1,1,0,0,0,0
"Feb 3, 2021 7:00 AM",43,28,15,58,36,22,66,36,30,60,36,24,,,,5,,,,8,7,1,30,,,,31,60,2,4,2,2,0,0,0,0
"Feb 3, 2021 8:00 AM",59,42,17,96,32,64,89,36,53,86,38,48,,,,16,,,,8,5,3,30,,,,33,55,4,6,2,2,0,0,0,0
"Feb 3, 2021 9:00 AM",56,41,15,69,30,39,75,42,33,72,40,32,,,,9,,,,16,12,4,29,,,,20,43,5,1,0,0,0,0,0,0
"Feb 3, 2021 10:00 AM",41,19,22,98,50,48,82,47,35,72,46,26,,,,7,,,,16,9,7,27,,,,29,26,4,7,2,1,1,0,0,0
"Feb 3, 2021 11:00 AM",49,19,30,134,66,68,133,64,69,113,56,57,,,,22,,,,11,9,2,13,,,,22,32,6,1,3,2,1,0,0,0
"Feb 3, 2021 12:00 PM",61,32,29,156,91,65,157,85,72,139,83,56,,,,19,,,,15,12,3,14,,,,33,53,8,7,5,5,0,0,0,0
"Feb 3, 2021 1:00 PM",68,30,38,130,71,59,179,101,78,116,64,52,,,,27,,,,17,13,4,19,,,,47,48,8,5,10,6,4,0,0,0
"Feb 3, 2021 2:00 PM",56,32,24,127,61,66,134,52,82,113,51,62,,,,23,,,,24,18,6,9,,,,32,28,1,4,10,6,4,0,0,0
"Feb 3, 2021 3:00 PM",66,40,26,121,57,64,116,51,65,98,55,43,,,,16,,,,16,14,2,9,,,,35,49,6,2,11,3,8,0,0,0
"Feb 3, 2021 4:00 PM",81,26,55,66,41,25,90,38,52,70,34,36,,,,21,,,,28,24,4,16,,,,43,46,4,4,15,11,4,0,0,0
"Feb 3, 2021 5:00 PM",91,21,70,72,43,29,88,46,42,79,40,39,,,,11,,,,38,35,3,9,,,,36,29,6,4,10,6,4,0,0,0
"Feb 3, 2021 6:00 PM",61,16,45,62,46,16,73,51,22,63,43,20,,,,7,,,,32,31,1,6,,,,45,38,1,1,1,0,1,0,0,0
"Feb 3, 2021 7:00 PM",47,15,32,36,27,9,47,31,16,35,22,13,,,,6,,,,21,20,1,4,,,,32,24,5,1,3,3,0,0,0,0
"Feb 3, 2021 8:00 PM",37,8,29,37,17,20,34,17,17,30,15,15,,,,1,,,,12,11,1,9,,,,12,17,2,1,5,4,1,0,0,0
"Feb 3, 2021 9:00 PM",16,7,9,12,9,3,13,8,5,13,6,7,,,,2,,,,4,4,0,1,,,,7,9,0,1,2,1,1,0,0,0
"Feb 3, 2021 10:00 PM",12,6,6,8,2,6,7,5,2,5,1,4,,,,0,,,,5,5,0,3,,,,7,6,1,0,0,0,0,0,0,0
"Feb 3, 2021 11:00 PM",2,0,2,1,1,0,5,3,2,2,1,1,,,,1,,,,7,7,0,1,,,,1,2,0,0,1,1,0,0,0,0
"Feb 4, 2021 12:00 AM",2,1,1,0,0,0,0,0,0,1,0,1,,,,1,,,,0,0,0,0,,,,0,1,1,0,0,0,0,0,0,0
"Feb 4, 2021 1:00 AM",0,0,0,1,1,0,2,1,1,1,1,0,,,,0,,,,1,1,0,0,,,,4,0,0,0,0,0,0,0,0,0
"Feb 4, 2021 2:00 AM",3,2,1,0,0,0,0,0,0,2,0,2,,,,0,,,,1,1,0,1,,,,0,0,0,0,0,0,0,0,0,0
"Feb 4, 2021 3:00 AM",0,0,0,0,0,0,0,0,0,0,0,0,,,,0,,,,1,1,0,0,,,,1,0,0,0,0,0,0,0,0,0
"Feb 4, 2021 4:00 AM",0,0,0,0,0,0,1,1,0,0,0,0,,,,0,,,,1,1,0,0,,,,0,0,0,0,0,0,0,0,0,0
"Feb 4, 2021 5:00 AM",1,1,0,0,0,0,3,1,2,4,2,2,,,,0,,,,1,1,0,2,,,,1,5,1,0,0,0,0,0,0,0
"Feb 4, 2021 6:00 AM",15,10,5,10,4,6,16,10,6,9,6,3,,,,2,,,,7,6,1,4,,,,8,24,0,1,2,2,0,0,0,0
"Feb 4, 2021 7:00 AM",42,26,16,53,28,25,63,31,32,56,27,29,,,,9,,,,6,5,1,20,,,,20,46,3,2,1,0,1,0,0,0
"Feb 4, 2021 8:00 AM",61,39,22,81,34,47,69,32,37,65,36,29,,,,6,,,,14,9,5,30,,,,23,56,3,2,4,3,1,0,0,0
"Feb 4, 2021 9:00 AM",49,36,13,57,26,31,54,22,32,53,25,28,,,,10,,,,15,11,4,20,,,,16,25,1,0,2,1,1,0,0,0
"Feb 4, 2021 10:00 AM",39,21,18,60,35,25,67,47,20,60,35,25,,,,15,,,,11,8,3,11,,,,16,17,0,4,3,3,0,0,0,0
"Feb 4, 2021 11:00 AM",50,33,17,82,44,38,72,39,33,78,51,27,,,,18,,,,10,8,2,9,,,,23,22,5,4,2,1,1,0,0,0
"Feb 4, 2021 12:00 PM",59,33,26,81,41,40,101,57,44,85,48,37,,,,18,,,,14,13,1,15,,,,29,23,3,2,3,3,0,0,0,0
"Feb 4, 2021 1:00 PM",60,29,31,72,43,29,119,62,57,77,42,35,,,,13,,,,18,12,6,13,,,,25,31,9,4,6,3,3,0,0,0
"Feb 4, 2021 2:00 PM",47,21,26,66,35,31,88,44,44,65,36,29,,,,16,,,,14,10,4,7,,,,27,25,3,0,3,1,2,0,0,0
"Feb 4, 2021 3:00 PM",82,37,45,112,61,51,136,70,66,98,50,48,,,,27,,,,14,13,1,13,,,,39,48,9,5,8,6,2,0,0,0
"Feb 4, 2021 4:00 PM",100,37,63,150,83,67,177,93,84,121,67,54,,,,37,,,,22,21,1,12,,,,44,38,4,7,14,10,4,0,0,0
"Feb 4, 2021 5:00 PM",104,31,73,104,51,53,164,82,82,115,61,54,,,,26,,,,54,48,6,10,,,,55,66,2,7,8,1,7,0,0,0
"Feb 4, 2021 6:00 PM",71,23,48,60,36,24,67,31,36,57,25,32,,,,22,,,,36,34,2,7,,,,44,41,4,1,3,1,2,0,0,0
"Feb 4, 2021 7:00 PM",45,14,31,34,20,14,45,30,15,51,29,22,,,,8,,,,21,20,1,5,,,,25,21,3,0,2,2,0,0,0,0
"Feb 4, 2021 8:00 PM",34,11,23,26,15,11,32,16,16,31,15,16,,,,4,,,,6,6,0,6,,,,20,24,1,2,0,0,0,0,0,0
"Feb 4, 2021 9:00 PM",21,7,14,31,19,12,36,20,16,34,20,14,,,,4,,,,7,7,0,4,,,,13,14,1,0,3,1,2,0,0,0
"Feb 4, 2021 10:00 PM",10,3,7,3,2,1,6,3,3,5,1,4,,,,6,,,,6,6,0,3,,,,13,6,1,0,1,1,0,0,0,0
"Feb 4, 2021 11:00 PM",5,1,4,5,2,3,5,1,4,5,1,4,,,,5,,,,1,1,0,1,,,,3,2,1,0,1,1,0,0,0,0
"Feb 5, 2021 12:00 AM",4,1,3,0,0,0,0,0,0,3,0,3,,,,0,,,,0,0,0,1,,,,1,2,0,0,1,1,0,0,0,0
"Feb 5, 2021 1:00 AM",1,1,0,0,0,0,3,2,1,3,2,1,,,,0,,,,0,0,0,0,,,,1,1,0,0,0,0,0,0,0,0
"Feb 5, 2021 2:00 AM",5,2,3,0,0,0,3,1,2,0,0,0,,,,0,,,,0,0,0,0,,,,0,0,0,0,0,0,0,0,0,0
"Feb 5, 2021 3:00 AM",0,0,0,0,0,0,0,0,0,0,0,0,,,,0,,,,0,0,0,1,,,,0,0,0,0,0,0,0,0,0,0
"Feb 5, 2021 4:00 AM",1,1,0,0,0,0,0,0,0,0,0,0,,,,0,,,,0,0,0,0,,,,0,0,0,0,0,0,0,0,0,0
"Feb 5, 2021 5:00 AM",1,1,0,2,2,0,3,2,1,4,3,1,,,,0,,,,1,1,0,1,,,,1,4,1,0,0,0,0,0,0,0
"Feb 5, 2021 6:00 AM",17,11,6,18,7,11,21,9,12,22,9,13,,,,4,,,,4,4,0,6,,,,8,18,0,0,4,1,3,0,0,0
"Feb 5, 2021 7:00 AM",42,28,14,49,23,26,64,30,34,47,19,28,,,,10,,,,6,4,2,22,,,,36,50,4,1,0,0,0,0,0,0
"Feb 5, 2021 8:00 AM",70,48,22,107,53,54,103,50,53,102,63,39,,,,8,,,,9,7,2,35,,,,23,50,3,5,4,3,1,0,0,0
"Feb 5, 2021 9:00 AM",53,37,16,80,34,46,88,47,41,84,39,45,,,,6,,,,13,9,4,22,,,,22,41,5,4,1,1,0,0,0,0
"Feb 5, 2021 10:00 AM",40,25,15,96,47,49,79,37,42,76,44,32,,,,10,,,,10,6,4,7,,,,15,25,4,2,9,6,3,0,0,0
"Feb 5, 2021 11:00 AM",47,30,17,105,55,50,101,54,47,93,59,34,,,,7,,,,8,6,2,10,,,,20,24,5,7,8,5,3,0,0,0
"Feb 5, 2021 12:00 PM",69,34,35,140,68,72,132,70,62,107,63,44,,,,18,,,,18,15,3,9,,,,26,35,8,8,11,6,5,0,0,0
"Feb 5, 2021 1:00 PM",63,30,33,128,78,50,134,77,57,115,67,48,,,,10,,,,15,13,2,10,,,,26,34,5,5,8,6,2,0,0,0
"Feb 5, 2021 2:00 PM",59,36,23,80,41,39,135,75,60,103,69,34,,,,19,,,,21,17,4,17,,,,23,28,6,3,6,2,4,0,0,0
"Feb 5, 2021 3:00 PM",56,32,24,149,75,74,163,85,78,128,64,64,,,,25,,,,16,15,1,14,,,,39,28,5,2,4,3,1,0,0,0
"Feb 5, 2021 4:00 PM",68,28,40,115,69,46,167,81,86,106,61,45,,,,17,,,,24,18,6,13,,,,60,36,6,1,8,6,2,0,0,0
"Feb 5, 2021 5:00 PM",75,16,59,113,56,57,142,71,71,125,60,65,,,,14,,,,45,43,2,11,,,,39,49,8,3,11,8,3,0,0,0
"Feb 5, 2021 6:00 PM",74,34,40,59,34,25,73,45,28,58,33,25,,,,17,,,,39,38,1,10,,,,36,41,3,1,4,2,2,0,0,0
"Feb 5, 2021 7:00 PM",45,20,25,46,23,23,63,30,33,39,21,18,,,,9,,,,32,27,5,3,,,,18,24,2,0,4,2,2,0,0,0
"Feb 5, 2021 8:00 PM",25,12,13,10,6,4,13,5,8,10,6,4,,,,8,,,,13,11,2,1,,,,10,16,2,0,2,1,1,0,0,0
"Feb 5, 2021 9:00 PM",18,9,9,12,4,8,10,7,3,9,4,5,,,,4,,,,6,5,1,2,,,,4,9,0,0,0,0,0,0,0,0
"Feb 5, 2021 10:00 PM",6,1,5,12,3,9,9,2,7,5,2,3,,,,0,,,,6,5,1,3,,,,5,11,1,0,1,0,1,0,0,0
"Feb 5, 2021 11:00 PM",7,2,5,4,3,1,10,7,3,9,3,6,,,,1,,,,2,1,1,1,,,,3,3,1,1,1,1,0,0,0,0
"Feb 6, 2021 12:00 AM",7,2,5,0,0,0,0,0,0,3,1,2,,,,2,,,,2,1,1,1,,,,0,2,0,0,0,0,0,0,0,0
"Feb 6, 2021 1:00 AM",2,0,2,0,0,0,3,2,1,1,0,1,,,,3,,,,4,4,0,1,,,,1,1,0,0,0,0,0,0,0,0
"Feb 6, 2021 2:00 AM",1,0,1,0,0,0,2,1,1,0,0,0,,,,0,,,,0,0,0,0,,,,1,0,0,0,0,0,0,0,0,0
"Feb 6, 2021 3:00 AM",0,0,0,0,0,0,1,1,0,0,0,0,,,,0,,,,0,0,0,0,,,,0,0,0,0,0,0,0,0,0,0
"Feb 6, 2021 4:00 AM",4,1,3,0,0,0,0,0,0,0,0,0,,,,0,,,,1,1,0,1,,,,0,0,0,0,0,0,0,0,0,0
"Feb 6, 2021 5:00 AM",0,0,0,0,0,0,0,0,0,0,0,0,,,,2,,,,0,0,0,1,,,,2,1,1,0,0,0,0,0,0,0
"Feb 6, 2021 6:00 AM",2,1,1,6,3,3,5,2,3,4,2,2,,,,2,,,,1,1,0,1,,,,5,6,0,0,0,0,0,0,0,0
"Feb 6, 2021 7:00 AM",10,3,7,10,5,5,21,15,6,14,10,4,,,,2,,,,3,3,0,2,,,,11,10,2,1,0,0,0,0,0,0
"Feb 6, 2021 8:00 AM",10,5,5,25,19,6,39,23,16,31,17,14,,,,2,,,,4,3,1,2,,,,11,10,1,3,4,3,1,0,0,0
"Feb 6, 2021 9:00 AM",30,13,17,99,67,32,120,77,43,92,65,27,,,,4,,,,11,10,1,5,,,,22,21,3,2,0,0,0,0,0,0
"Feb 6, 2021 10:00 AM",32,19,13,172,99,73,155,81,74,133,81,52,,,,12,,,,7,7,0,13,,,,49,31,6,5,2,2,0,0,0,0
"Feb 6, 2021 11:00 AM",61,35,26,162,74,88,168,80,88,157,77,80,,,,30,,,,22,20,2,11,,,,37,53,5,7,7,6,1,0,0,0
"Feb 6, 2021 12:00 PM",57,26,31,159,69,90,145,61,84,136,60,76,,,,27,,,,12,11,1,7,,,,30,30,5,8,11,8,3,0,0,0
"Feb 6, 2021 1:00 PM",60,29,31,176,99,77,187,106,81,168,97,71,,,,31,,,,12,11,1,13,,,,47,48,14,4,7,4,3,0,0,0
"Feb 6, 2021 2:00 PM",74,35,39,183,83,100,179,95,84,163,84,79,,,,39,,,,18,18,0,14,,,,55,60,13,8,11,11,0,0,0,0
"Feb 6, 2021 3:00 PM",52,27,25,185,109,76,193,97,96,174,77,97,,,,24,,,,24,22,2,20,,,,38,54,14,3,15,10,5,0,0,0
"Feb 6, 2021 4:00 PM",57,22,35,107,43,64,147,77,70,119,60,59,,,,21,,,,9,8,1,12,,,,33,35,8,1,7,2,5,0,0,0
"Feb 6, 2021 5:00 PM",26,3,23,49,22,27,60,25,35,45,18,27,,,,7,,,,14,14,0,7,,,,13,28,1,1,12,9,3,0,0,0
"Feb 6, 2021 6:00 PM",30,14,16,15,4,11,36,16,20,22,8,14,,,,6,,,,7,7,0,1,,,,6,18,3,0,0,0,0,0,0,0
"Feb 6, 2021 7:00 PM",28,14,14,7,5,2,9,7,2,10,7,3,,,,7,,,,6,5,1,4,,,,11,12,0,1,1,1,0,0,0,0
"Feb 6, 2021 8:00 PM",29,14,15,5,4,1,19,13,6,10,9,1,,,,4,,,,5,5,0,4,,,,8,9,0,0,2,1,1,0,0,0
"Feb 6, 2021 9:00 PM",9,6,3,7,2,5,6,3,3,6,2,4,,,,2,,,,4,4,0,2,,,,3,7,0,0,1,1,0,0,0,0
"Feb 6, 2021 10:00 PM",7,4,3,2,2,0,4,1,3,3,2,1,,,,1,,,,3,3,0,0,,,,0,3,0,0,0,0,0,0,0,0
"Feb 6, 2021 11:00 PM",6,2,4,1,0,1,5,3,2,4,1,3,,,,0,,,,2,2,0,1,,,,2,6,0,1,2,1,1,0,0,0
"Feb 7, 2021 12:00 AM",4,1,3,0,0,0,1,1,0,1,1,0,,,,2,,,,1,0,1,2,,,,1,0,0,0,1,1,0,0,0,0
"Feb 7, 2021 1:00 AM",3,1,2,2,1,1,3,1,2,1,0,1,,,,0,,,,2,2,0,1,,,,1,2,0,0,0,0,0,0,0,0
"Feb 7, 2021 2:00 AM",0,0,0,0,0,0,0,0,0,0,0,0,,,,0,,,,0,0,0,1,,,,0,0,0,0,0,0,0,0,0,0
"Feb 7, 2021 3:00 AM",2,1,1,1,1,0,3,3,0,1,1,0,,,,0,,,,0,0,0,0,,,,2,1,0,0,0,0,0,0,0,0
"Feb 7, 2021 4:00 AM",0,0,0,0,0,0,2,0,2,0,0,0,,,,0,,,,1,1,0,0,,,,1,2,0,0,0,0,0,0,0,0
"Feb 7, 2021 5:00 AM",2,1,1,0,0,0,1,0,1,1,0,1,,,,0,,,,0,0,0,0,,,,1,0,0,0,1,1,0,0,0,0
"Feb 7, 2021 6:00 AM",0,0,0,0,0,0,3,2,1,3,2,1,,,,2,,,,1,1,0,0,,,,4,6,1,0,1,1,0,0,0,0
"Feb 7, 2021 7:00 AM",7,3,4,10,7,3,12,9,3,6,4,2,,,,1,,,,2,2,0,2,,,,11,9,2,2,0,0,0,0,0,0
"Feb 7, 2021 8:00 AM",10,2,8,20,16,4,23,14,9,22,13,9,,,,5,,,,2,2,0,2,,,,8,10,0,1,0,0,0,0,0,0
"Feb 7, 2021 9:00 AM",23,10,13,83,50,33,95,60,35,70,43,27,,,,5,,,,8,6,2,12,,,,17,22,5,2,5,5,0,0,0,0
"Feb 7, 2021 10:00 AM",37,22,15,134,76,58,157,100,57,129,80,49,,,,14,,,,9,8,1,15,,,,40,38,5,6,3,3,0,0,0,0
"Feb 7, 2021 11:00 AM",35,20,15,143,59,84,148,56,92,130,53,77,,,,16,,,,14,11,3,13,,,,36,41,3,9,6,3,3,0,0,0
"Feb 7, 2021 12:00 PM",49,25,24,147,78,69,183,95,88,141,85,56,,,,22,,,,17,16,1,20,,,,60,51,8,4,5,3,2,0,0,0
"Feb 7, 2021 1:00 PM",61,29,32,147,69,78,165,74,91,165,86,79,,,,27,,,,19,17,2,10,,,,19,45,8,12,6,4,2,0,0,0
"Feb 7, 2021 2:00 PM",59,24,35,109,47,62,112,52,60,84,47,37,,,,28,,,,15,15,0,12,,,,30,30,6,5,4,2,2,0,0,0
"Feb 7, 2021 3:00 PM",32,11,21,48,22,26,65,37,28,48,21,27,,,,11,,,,10,7,3,9,,,,26,23,3,2,2,1,1,0,0,0
"Feb 7, 2021 4:00 PM",16,8,8,27,12,15,36,12,24,29,14,15,,,,7,,,,6,6,0,7,,,,6,8,1,0,2,1,1,0,0,0
"Feb 7, 2021 5:00 PM",21,11,10,16,8,8,24,12,12,17,8,9,,,,9,,,,3,2,1,3,,,,8,17,0,0,4,4,0,0,0,0
"Feb 7, 2021 6:00 PM",14,5,9,16,6,10,13,8,5,10,4,6,,,,3,,,,5,3,2,5,,,,6,8,0,0,0,0,0,0,0,0
"Feb 7, 2021 7:00 PM",16,7,9,12,4,8,12,5,7,14,8,6,,,,4,,,,7,7,0,5,,,,11,6,3,0,3,2,1,0,0,0
"Feb 7, 2021 8:00 PM",17,12,5,6,3,3,11,7,4,6,3,3,,,,4,,,,3,3,0,2,,,,7,7,0,0,2,2,0,0,0,0
"Feb 7, 2021 9:00 PM",13,7,6,7,4,3,8,3,5,8,4,4,,,,4,,,,3,2,1,3,,,,4,10,0,0,3,0,3,0,0,0
"Feb 7, 2021 10:00 PM",4,3,1,1,1,0,3,1,2,2,1,1,,,,1,,,,1,1,0,1,,,,4,4,0,0,1,1,0,0,0,0
"Feb 7, 2021 11:00 PM",2,1,1,0,0,0,2,1,1,2,2,0,,,,2,,,,0,0,0,4,,,,1,2,0,1,1,1,0,0,0,0
"Feb 8, 2021 12:00 AM",1,1,0,0,0,0,0,0,0,0,0,0,,,,0,,,,1,1,0,0,,,,0,1,0,0,0,0,0,0,0,0
"Feb 8, 2021 1:00 AM",0,0,0,0,0,0,1,0,1,0,0,0,,,,0,,,,1,1,0,0,,,,0,0,0,0,0,0,0,0,0,0
"Feb 8, 2021 2:00 AM",1,1,0,0,0,0,0,0,0,0,0,0,,,,0,,,,1,1,0,0,,,,0,0,0,0,0,0,0,0,0,0
"Feb 8, 2021 3:00 AM",1,1,0,0,0,0,0,0,0,0,0,0,,,,0,,,,1,1,0,0,,,,0,0,0,0,0,0,0,0,0,0
"Feb 8, 2021 4:00 AM",1,0,1,0,0,0,1,1,0,0,0,0,,,,0,,,,0,0,0,0,,,,0,0,0,0,0,0,0,0,0,0
"Feb 8, 2021 5:00 AM",3,3,0,0,0,0,0,0,0,1,1,0,,,,1,,,,2,2,0,1,,,,1,5,0,0,1,1,0,0,0,0
"Feb 8, 2021 6:00 AM",14,10,4,4,2,2,9,4,5,6,3,3,,,,1,,,,2,2,0,5,,,,11,23,0,0,1,1,0,0,0,0
"Feb 8, 2021 7:00 AM",39,22,17,14,5,9,20,8,12,18,10,8,,,,8,,,,3,3,0,23,,,,18,41,3,1,1,0,1,0,0,0
"Feb 8, 2021 8:00 AM",66,47,19,34,16,18,33,16,17,32,17,15,,,,6,,,,14,9,5,32,,,,15,38,1,1,1,0,1,0,0,0
"Feb 8, 2021 9:00 AM",34,26,8,40,18,22,43,20,23,31,15,16,,,,3,,,,8,5,3,19,,,,13,20,1,0,2,1,1,0,0,0
"Feb 8, 2021 10:00 AM",27,15,12,29,17,12,35,24,11,23,14,9,,,,10,,,,10,7,3,19,,,,7,16,3,0,3,2,1,0,0,0
"Feb 8, 2021 11:00 AM",26,13,13,35,13,22,33,10,23,20,6,14,,,,12,,,,6,4,2,4,,,,2,13,2,1,3,2,1,0,0,0
"Feb 8, 2021 12:00 PM",29,16,13,20,8,12,39,18,21,25,14,11,,,,12,,,,4,3,1,3,,,,6,8,3,2,1,1,0,0,0,0
"Feb 8, 2021 1:00 PM",33,19,14,38,18,20,27,8,19,26,11,15,,,,12,,,,6,5,1,6,,,,11,19,3,4,4,1,3,0,0,0
"Feb 8, 2021 2:00 PM",33,19,14,37,19,18,37,19,18,32,17,15,,,,19,,,,8,7,1,7,,,,11,11,1,1,3,3,0,0,0,0
"Feb 8, 2021 3:00 PM",39,18,21,26,16,10,39,28,11,31,22,9,,,,13,,,,14,7,7,8,,,,18,26,2,1,2,1,1,0,0,0
"Feb 8, 2021 4:00 PM",64,25,39,36,21,15,46,27,19,34,16,18,,,,10,,,,19,17,2,10,,,,27,30,0,1,3,3,0,0,0,0
"Feb 8, 2021 5:00 PM",69,15,54,44,27,17,63,36,27,51,25,26,,,,11,,,,39,36,3,10,,,,24,20,5,2,7,3,4,0,0,0
"Feb 8, 2021 6:00 PM",48,9,39,27,16,11,35,24,11,27,16,11,,,,8,,,,27,26,1,4,,,,25,19,0,2,1,0,1,0,0,0
"Feb 8, 2021 7:00 PM",24,10,14,8,3,5,7,5,2,4,3,1,,,,3,,,,19,18,1,5,,,,18,11,0,0,2,2,0,0,0,0
"Feb 8, 2021 8:00 PM",15,4,11,6,4,2,10,7,3,8,4,4,,,,2,,,,5,5,0,1,,,,5,7,0,1,4,2,2,0,0,0
"Feb 8, 2021 9:00 PM",11,3,8,2,0,2,2,2,0,1,0,1,,,,0,,,,1,1,0,1,,,,1,7,1,0,0,0,0,0,0,0
"Feb 8, 2021 10:00 PM",4,0,4,1,1,0,2,1,1,8,3,5,,,,3,,,,4,4,0,3,,,,2,0,0,0,0,0,0,0,0,0
"Feb 8, 2021 11:00 PM",0,0,0,0,0,0,0,0,0,0,0,0,,,,0,,,,1,1,0,0,,,,1,1,1,0,1,1,0,0,0,0
"Feb 9, 2021 12:00 AM",1,0,1,0,0,0,0,0,0,0,0,0,,,,0,,,,0,0,0,0,,,,0,0,0,0,0,0,0,0,0,0
"Feb 9, 2021 1:00 AM",2,0,2,0,0,0,0,0,0,0,0,0,,,,0,,,,0,0,0,0,,,,0,0,0,0,0,0,0,0,0,0
"Feb 9, 2021 2:00 AM",3,2,1,0,0,0,0,0,0,0,0,0,,,,1,,,,0,0,0,1,,,,0,0,0,0,0,0,0,0,0,0
"Feb 9, 2021 3:00 AM",0,0,0,0,0,0,0,0,0,0,0,0,,,,0,,,,0,0,0,0,,,,0,1,0,0,0,0,0,0,0,0
"Feb 9, 2021 4:00 AM",1,1,0,0,0,0,1,1,0,0,0,0,,,,0,,,,0,0,0,0,,,,0,0,0,0,0,0,0,0,0,0
"Feb 9, 2021 5:00 AM",2,2,0,0,0,0,1,0,1,2,1,1,,,,1,,,,0,0,0,1,,,,1,3,0,0,0,0,0,0,0,0
"Feb 9, 2021 6:00 AM",8,6,2,7,3,4,13,7,6,7,3,4,,,,1,,,,5,4,1,3,,,,4,19,1,0,1,1,0,0,0,0
"Feb 9, 2021 7:00 AM",26,14,12,19,7,12,26,9,17,23,12,11,,,,5,,,,4,3,1,20,,,,20,31,2,1,0,0,0,0,0,0
"Feb 9, 2021 8:00 AM",50,33,17,28,9,19,32,13,19,31,15,16,,,,6,,,,5,3,2,26,,,,16,44,2,1,2,2,0,0,0,0
"Feb 9, 2021 9:00 AM",40,28,12,37,20,17,34,15,19,29,15,14,,,,5,,,,8,5,3,13,,,,10,15,1,3,2,0,2,0,0,0
"Feb 9, 2021 10:00 AM",28,19,9,24,10,14,21,8,13,18,11,7,,,,6,,,,4,3,1,5,,,,6,11,4,1,3,2,1,0,0,0
"Feb 9, 2021 11:00 AM",20,13,7,38,16,22,36,18,18,29,13,16,,,,7,,,,6,4,2,4,,,,4,15,1,1,2,0,2,0,0,0
"Feb 9, 2021 12:00 PM",41,19,22,36,22,14,47,26,21,31,16,15,,,,19,,,,8,7,1,4,,,,11,18,3,2,1,1,0,0,0,0
"Feb 9, 2021 1:00 PM",44,23,21,34,16,18,38,18,20,35,18,17,,,,8,,,,10,8,2,10,,,,10,15,3,1,5,3,2,0,0,0
"Feb 9, 2021 2:00 PM",44,25,19,33,17,16,30,13,17,31,20,11,,,,7,,,,9,8,1,9,,,,7,10,0,1,5,4,1,0,0,0
"Feb 9, 2021 3:00 PM",35,13,22,30,13,17,25,13,12,23,12,11,,,,22,,,,17,15,2,5,,,,14,12,1,0,2,0,2,0,0,0
"Feb 9, 2021 4:00 PM",52,22,30,24,13,11,42,24,18,30,16,14,,,,23,,,,14,13,1,4,,,,18,21,2,0,8,5,3,0,0,0
"Feb 9, 2021 5:00 PM",69,19,50,23,12,11,48,22,26,50,25,25,,,,6,,,,24,24,0,9,,,,18,15,4,3,1,0,1,0,0,0
"Feb 9, 2021 6:00 PM",51,22,29,34,24,10,48,33,15,42,25,17,,,,4,,,,28,27,1,6,,,,23,23,3,2,3,1,2,0,0,0
"Feb 9, 2021 7:00 PM",31,11,20,23,14,9,16,15,1,14,12,2,,,,2,,,,13,12,1,0,,,,10,15,2,2,1,1,0,0,0,0
"Feb 9, 2021 8:00 PM",14,5,9,11,7,4,14,5,9,13,7,6,,,,2,,,,8,8,0,1,,,,4,10,1,1,1,1,0,0,0,0
"Feb 9, 2021 9:00 PM",13,3,10,6,0,6,7,3,4,5,0,5,,,,0,,,,2,2,0,4,,,,7,5,1,1,1,0,1,0,0,0
"Feb 9, 2021 10:00 PM",6,2,4,6,4,2,1,1,0,3,1,2,,,,0,,,,3,3,0,1,,,,1,1,0,0,0,0,0,0,0,0
"Feb 9, 2021 11:00 PM",2,1,1,0,0,0,0,0,0,0,0,0,,,,1,,,,2,2,0,0,,,,0,1,0,0,2,1,1,0,0,0
"Feb 10, 2021 12:00 AM",3,2,1,0,0,0,0,0,0,0,0,0,,,,0,,,,0,0,0,0,,,,1,3,1,0,1,1,0,0,0,0
"Feb 10, 2021 1:00 AM",0,0,0,0,0,0,0,0,0,0,0,0,,,,0,,,,0,0,0,0,,,,0,1,0,0,0,0,0,0,0,0
"Feb 10, 2021 2:00 AM",1,0,1,0,0,0,0,0,0,0,0,0,,,,0,,,,0,0,0,0,,,,0,0,0,0,0,0,0,0,0,0
"Feb 10, 2021 3:00 AM",1,0,1,0,0,0,0,0,0,0,0,0,,,,0,,,,0,0,0,0,,,,0,1,0,0,0,0,0,0,0,0
"Feb 10, 2021 4:00 AM",0,0,0,0,0,0,1,1,0,0,0,0,,,,0,,,,1,1,0,0,,,,0,0,0,0,0,0,0,0,0,0
"Feb 10, 2021 5:00 AM",3,3,0,0,0,0,1,0,1,1,0,1,,,,1,,,,0,0,0,3,,,,2,3,0,0,0,0,0,0,0,0
"Feb 10, 2021 6:00 AM",8,4,4,8,2,6,11,3,8,6,2,4,,,,0,,,,4,4,0,8,,,,7,20,0,0,2,2,0,0,0,0
"Feb 10, 2021 7:00 AM",18,9,9,16,5,11,20,10,10,17,7,10,,,,3,,,,2,2,0,17,,,,15,34,4,1,1,0,1,0,0,0
"Feb 10, 2021 8:00 AM",46,30,16,38,13,25,28,7,21,34,15,19,,,,2,,,,7,3,4,17,,,,19,28,1,1,3,2,1,0,0,0
"Feb 10, 2021 9:00 AM",36,29,7,26,12,14,37,16,21,33,15,18,,,,3,,,,6,5,1,18,,,,9,13,0,1,0,0,0,0,0,0
"Feb 10, 2021 10:00 AM",20,13,7,34,17,17,36,21,15,24,15,9,,,,3,,,,4,2,2,9,,,,7,8,1,1,1,1,0,0,0,0
"Feb 10, 2021 11:00 AM",25,15,10,30,18,12,53,32,21,34,19,15,,,,3,,,,5,3,2,9,,,,9,16,4,0,2,1,1,0,0,0
"Feb 10, 2021 12:00 PM",28,10,18,59,24,35,63,31,32,46,26,20,,,,7,,,,7,7,0,8,,,,16,22,1,5,1,1,0,0,0,0
"Feb 10, 2021 1:00 PM",32,15,17,81,33,48,80,39,41,72,33,39,,,,2,,,,15,15,0,7,,,,26,17,3,2,4,2,2,0,0,0
"Feb 10, 2021 2:00 PM",51,30,21,100,57,43,96,54,42,95,54,41,,,,28,,,,17,13,4,13,,,,21,23,4,8,16,12,4,0,0,0
"Feb 10, 2021 3:00 PM",66,31,35,109,58,51,102,61,41,95,61,34,,,,22,,,,22,17,5,8,,,,28,36,11,4,7,5,2,0,0,0
"Feb 10, 2021 4:00 PM",51,24,27,89,42,47,86,32,54,90,41,49,,,,21,,,,17,17,0,10,,,,34,24,3,0,6,6,0,0,0,0
"Feb 10, 2021 5:00 PM",72,22,50,72,39,33,82,41,41,69,36,33,,,,12,,,,26,25,1,13,,,,21,30,2,5,3,3,0,0,0,0
"Feb 10, 2021 6:00 PM",59,18,41,47,33,14,54,32,22,43,24,19,,,,10,,,,22,22,0,7,,,,22,20,1,2,4,4,0,0,0,0
"Feb 10, 2021 7:00 PM",40,13,27,14,8,6,23,14,9,17,8,9,,,,9,,,,12,12,0,2,,,,11,22,2,0,2,1,1,0,0,0
"Feb 10, 2021 8:00 PM",29,13,16,12,6,6,13,7,6,8,5,3,,,,1,,,,7,2,5,2,,,,4,12,1,0,1,0,1,0,0,0
"Feb 10, 2021 9:00 PM",16,6,10,7,3,4,11,7,4,11,7,4,,,,0,,,,6,6,0,3,,,,4,3,0,1,1,1,0,0,0,0
"Feb 10, 2021 10:00 PM",7,2,5,2,1,1,4,1,3,5,1,4,,,,1,,,,2,2,0,0,,,,3,2,0,0,2,1,1,0,0,0
"Feb 10, 2021 11:00 PM",4,1,3,0,0,0,0,0,0,0,0,0,,,,2,,,,1,1,0,0,,,,1,1,0,0,1,1,0,0,0,0
"Feb 11, 2021 12:00 AM",2,1,1,0,0,0,1,1,0,0,0,0,,,,0,,,,0,0,0,0,,,,1,0,1,0,1,1,0,0,0,0
"Feb 11, 2021 1:00 AM",0,0,0,0,0,0,0,0,0,0,0,0,,,,0,,,,0,0,0,0,,,,0,0,0,0,0,0,0,0,0,0
"Feb 11, 2021 2:00 AM",4,2,2,0,0,0,0,0,0,0,0,0,,,,0,,,,2,2,0,1,,,,0,0,0,0,0,0,0,0,0,0
"Feb 11, 2021 3:00 AM",1,1,0,0,0,0,0,0,0,0,0,0,,,,0,,,,0,0,0,0,,,,0,0,0,0,0,0,0,0,0,0
"Feb 11, 2021 4:00 AM",0,0,0,0,0,0,0,0,0,0,0,0,,,,0,,,,0,0,0,0,,,,0,0,0,0,0,0,0,0,0,0
"Feb 11, 2021 5:00 AM",2,1,1,2,1,1,2,1,1,3,1,2,,,,0,,,,0,0,0,4,,,,3,5,0,0,0,0,0,0,0,0
"Feb 11, 2021 6:00 AM",12,8,4,6,3,3,12,5,7,10,5,5,,,,0,,,,3,2,1,5,,,,4,12,0,0,2,2,0,0,0,0
"Feb 11, 2021 7:00 AM",36,21,15,13,5,8,20,8,12,17,7,10,,,,6,,,,2,2,0,14,,,,14,25,3,1,2,1,1,0,0,0
"Feb 11, 2021 8:00 AM",43,29,14,36,13,23,24,8,16,28,13,15,,,,6,,,,8,5,3,17,,,,17,36,1,1,2,2,0,0,0,0
"Feb 11, 2021 9:00 AM",34,24,10,19,9,10,20,10,10,21,11,10,,,,8,,,,6,4,2,14,,,,10,9,0,0,1,0,1,0,0,0
"Feb 11, 2021 10:00 AM",27,17,10,17,6,11,19,11,8,14,7,7,,,,5,,,,7,4,3,7,,,,4,8,0,4,0,0,0,0,0,0
"Feb 11, 2021 11:00 AM",21,16,5,23,14,9,29,16,13,18,9,9,,,,1,,,,6,4,2,8,,,,5,10,4,0,2,2,0,0,0,0
"Feb 11, 2021 12:00 PM",23,15,8,32,11,21,29,11,18,26,9,17,,,,9,,,,2,2,0,5,,,,7,11,0,1,5,3,2,0,0,0
"Feb 11, 2021 1:00 PM",33,19,14,29,13,16,25,13,12,20,12,8,,,,8,,,,8,6,2,7,,,,13,11,3,1,3,2,1,0,0,0
"Feb 11, 2021 2:00 PM",31,13,18,31,13,18,32,16,16,25,15,10,,,,13,,,,10,9,1,4,,,,10,16,0,3,3,1,2,0,0,0
"Feb 11, 2021 3:00 PM",31,15,16,18,9,9,21,11,10,24,12,12,,,,18,,,,9,7,2,10,,,,13,17,1,0,1,1,0,0,0,0
"Feb 11, 2021 4:00 PM",59,22,37,15,5,10,36,19,17,27,12,15,,,,12,,,,18,16,2,7,,,,21,13,3,2,3,3,0,0,0,0
"Feb 11, 2021 5:00 PM",76,20,56,28,15,13,37,22,15,35,19,16,,,,14,,,,22,18,4,9,,,,18,19,1,1,2,2,0,0,0,0
"Feb 11, 2021 6:00 PM",35,12,23,23,14,9,27,12,15,21,9,12,,,,7,,,,25,21,4,4,,,,20,17,4,2,3,3,0,0,0,0
"Feb 11, 2021 7:00 PM",38,19,19,11,8,3,14,8,6,10,4,6,,,,7,,,,5,5,0,1,,,,11,12,1,0,3,1,2,0,0,0
"Feb 11, 2021 8:00 PM",32,11,21,4,2,2,10,7,3,6,4,2,,,,3,,,,8,8,0,2,,,,9,9,1,0,2,1,1,0,0,0
"Feb 11, 2021 9:00 PM",11,2,9,1,0,1,5,2,3,3,1,2,,,,4,,,,8,4,4,4,,,,3,4,1,0,2,1,1,0,0,0
"Feb 11, 2021 10:00 PM",4,1,3,0,0,0,1,1,0,0,0,0,,,,1,,,,2,2,0,3,,,,6,3,0,0,1,1,0,0,0,0
"Feb 11, 2021 11:00 PM",4,2,2,0,0,0,0,0,0,0,0,0,,,,0,,,,3,3,0,1,,,,1,1,2,0,4,3,1,0,0,0
"Feb 12, 2021 12:00 AM",2,1,1,0,0,0,0,0,0,0,0,0,,,,0,,,,0,0,0,0,,,,1,1,0,0,1,1,0,0,0,0
"Feb 12, 2021 1:00 AM",2,2,0,0,0,0,0,0,0,0,0,0,,,,0,,,,0,0,0,0,,,,0,0,0,0,0,0,0,0,0,0
"Feb 12, 2021 2:00 AM",1,0,1,0,0,0,1,0,1,0,0,0,,,,0,,,,1,1,0,0,,,,0,0,0,0,0,0,0,0,0,0
"Feb 12, 2021 3:00 AM",1,0,1,0,0,0,0,0,0,0,0,0,,,,0,,,,0,0,0,0,,,,0,0,0,0,0,0,0,0,0,0
"Feb 12, 2021 4:00 AM",0,0,0,0,0,0,0,0,0,0,0,0,,,,0,,,,0,0,0,0,,,,0,0,0,0,0,0,0,0,0,0
"Feb 12, 2021 5:00 AM",2,2,0,0,0,0,1,1,0,1,1,0,,,,0,,,,2,2,0,3,,,,2,4,0,1,0,0,0,0,0,0
"Feb 12, 2021 6:00 AM",11,5,6,7,3,4,11,2,9,9,3,6,,,,0,,,,2,2,0,7,,,,6,13,0,0,2,2,0,0,0,0
"Feb 12, 2021 7:00 AM",29,16,13,15,8,7,20,8,12,17,8,9,,,,4,,,,6,3,3,16,,,,14,27,2,1,2,0,2,0,0,0
"Feb 12, 2021 8:00 AM",35,29,6,38,15,23,40,17,23,36,19,17,,,,7,,,,7,5,2,25,,,,17,33,0,2,0,0,0,0,0,0
"Feb 12, 2021 9:00 AM",42,29,13,25,11,14,40,19,21,27,14,13,,,,1,,,,2,1,1,12,,,,11,17,2,3,0,0,0,0,0,0
"Feb 12, 2021 10:00 AM",31,18,13,28,17,11,25,16,9,30,20,10,,,,9,,,,9,6,3,13,,,,8,10,1,1,5,4,1,0,0,0
"Feb 12, 2021 11:00 AM",21,11,10,36,15,21,40,21,19,38,20,18,,,,9,,,,6,6,0,6,,,,10,12,2,2,1,1,0,0,0,0
"Feb 12, 2021 12:00 PM",40,19,21,48,18,30,45,24,21,40,19,21,,,,18,,,,11,7,4,1,,,,11,19,2,1,2,0,2,0,0,0
"Feb 12, 2021 1:00 PM",40,16,24,45,21,24,52,26,26,43,21,22,,,,14,,,,7,7,0,10,,,,9,12,3,3,2,1,1,1,0,1
"Feb 12, 2021 2:00 PM",43,19,24,45,21,24,44,29,15,42,24,18,,,,12,,,,11,8,3,14,,,,14,13,4,1,1,1,0,2,2,0
"Feb 12, 2021 3:00 PM",49,26,23,65,24,41,64,24,40,54,20,34,,,,7,,,,10,7,3,6,,,,14,27,4,1,4,2,2,0,0,0
"Feb 12, 2021 4:00 PM",47,23,24,48,25,23,61,29,32,53,30,23,,,,15,,,,8,8,0,8,,,,20,24,0,4,4,3,1,5,3,2
"Feb 12, 2021 5:00 PM",65,21,44,36,19,17,47,25,22,38,23,15,,,,9,,,,18,16,2,2,,,,25,13,3,1,9,6,3,6,4,2
"Feb 12, 2021 6:00 PM",49,20,29,19,8,11,28,14,14,30,14,16,,,,6,,,,28,23,5,6,,,,18,13,3,1,1,1,0,0,0,0
"Feb 12, 2021 7:00 PM",49,20,29,16,7,9,21,12,9,13,5,8,,,,14,,,,15,12,3,6,,,,14,14,2,0,1,0,1,3,3,0
"Feb 12, 2021 8:00 PM",20,9,11,6,5,1,12,8,4,7,4,3,,,,0,,,,5,5,0,6,,,,8,6,0,1,8,5,3,6,4,2
"Feb 12, 2021 9:00 PM",18,9,9,4,2,2,3,2,1,4,2,2,,,,1,,,,6,5,1,4,,,,3,2,1,0,1,0,1,0,0,0
"Feb 12, 2021 10:00 PM",3,1,2,1,1,0,2,0,2,1,1,0,,,,3,,,,1,1,0,0,,,,0,5,1,1,1,0,1,0,0,0
"Feb 12, 2021 11:00 PM",7,1,6,0,0,0,0,0,0,0,0,0,,,,1,,,,2,1,1,2,,,,1,2,1,0,1,1,0,0,0,0
"Feb 13, 2021 12:00 AM",4,1,3,0,0,0,0,0,0,0,0,0,,,,1,,,,0,0,0,1,,,,1,2,1,0,0,0,0,,,
"Feb 13, 2021 1:00 AM",1,1,0,0,0,0,2,2,0,0,0,0,,,,0,,,,0,0,0,3,,,,0,0,0,0,0,0,0,,,
"Feb 13, 2021 2:00 AM",1,1,0,0,0,0,0,0,0,0,0,0,,,,2,,,,0,0,0,0,,,,0,0,0,1,0,0,0,,,
"Feb 13, 2021 3:00 AM",1,1,0,1,1,0,0,0,0,0,0,0,,,,1,,,,0,0,0,0,,,,0,0,0,0,0,0,0,,,
"Feb 13, 2021 4:00 AM",2,1,1,0,0,0,0,0,0,0,0,0,,,,0,,,,0,0,0,0,,,,0,0,0,0,0,0,0,,,
"Feb 13, 2021 5:00 AM",0,0,0,0,0,0,1,1,0,1,1,0,,,,1,,,,1,1,0,0,,,,2,0,0,0,0,0,0,,,
"Feb 13, 2021 6:00 AM",2,1,1,0,0,0,0,0,0,0,0,0,,,,1,,,,0,0,0,0,,,,3,2,0,0,0,0,0,,,
"Feb 13, 2021 7:00 AM",3,1,2,1,1,0,2,2,0,2,2,0,,,,0,,,,1,1,0,1,,,,2,6,0,0,0,0,0,,,
"Feb 13, 2021 8:00 AM",3,2,1,1,0,1,3,1,2,2,1,1,,,,0,,,,1,1,0,2,,,,1,2,0,0,2,1,1,,,
"Feb 13, 2021 9:00 AM",9,5,4,1,1,0,9,4,5,3,1,2,,,,0,,,,1,1,0,2,,,,1,2,0,0,0,0,0,,,
"Feb 13, 2021 10:00 AM",2,1,1,3,3,0,5,4,1,4,4,0,,,,0,,,,2,1,1,0,,,,2,2,2,0,1,0,1,,,
"Feb 13, 2021 11:00 AM",7,2,5,10,5,5,10,7,3,8,2,6,,,,0,,,,2,0,2,0,,,,3,2,0,0,0,0,0,,,
"Feb 13, 2021 12:00 PM",22,13,9,10,4,6,22,14,8,13,10,3,,,,9,,,,4,3,1,1,,,,9,6,1,0,1,1,0,,,
"Feb 13, 2021 1:00 PM",26,15,11,28,19,9,36,19,17,25,16,9,,,,3,,,,4,4,0,0,,,,11,11,2,0,0,0,0,,,
"Feb 13, 2021 2:00 PM",29,18,11,31,15,16,36,21,15,30,17,13,,,,21,,,,4,4,0,3,,,,12,11,0,0,0,0,0,,,
"Feb 13, 2021 3:00 PM",31,15,16,39,17,22,47,20,27,37,15,22,,,,11,,,,2,2,0,2,,,,11,16,0,2,4,1,3,,,
"Feb 13, 2021 4:00 PM",27,13,14,34,15,19,36,15,21,24,14,10,,,,7,,,,2,2,0,0,,,,10,16,0,0,1,1,0,,,
"Feb 13, 2021 5:00 PM",13,6,7,14,7,7,24,14,10,16,7,9,,,,2,,,,5,3,2,0,,,,5,10,0,0,1,1,0,,,
"Feb 13, 2021 6:00 PM",18,8,10,2,1,1,7,3,4,6,2,4,,,,4,,,,5,5,0,0,,,,2,6,0,0,2,1,1,,,
"Feb 13, 2021 7:00 PM",21,9,12,4,2,2,11,5,6,4,2,2,,,,2,,,,2,2,0,0,,,,6,6,1,0,0,0,0,,,
"Feb 13, 2021 8:00 PM",17,8,9,2,0,2,6,2,4,3,2,1,,,,1,,,,3,3,0,1,,,,3,5,0,0,0,0,0,,,
"Feb 13, 2021 9:00 PM",10,4,6,0,0,0,5,3,2,3,2,1,,,,2,,,,3,3,0,0,,,,1,4,0,0,2,1,1,,,
"Feb 13, 2021 10:00 PM",3,1,2,1,0,1,1,0,1,0,0,0,,,,2,,,,1,1,0,0,,,,1,4,0,0,0,0,0,,,
"Feb 13, 2021 11:00 PM",4,3,1,0,0,0,1,1,0,0,0,0,,,,1,,,,1,1,0,0,,,,0,0,0,0,1,1,0,,,
"Feb 14, 2021 12:00 AM",2,1,1,0,0,0,0,0,0,0,0,0,,,,3,,,,0,0,0,1,,,,0,0,0,0,0,0,0,,,
"Feb 14, 2021 1:00 AM",0,0,0,0,0,0,1,0,1,1,0,1,,,,0,,,,0,0,0,0,,,,0,0,0,0,0,0,0,,,
"Feb 14, 2021 2:00 AM",2,2,0,0,0,0,1,0,1,0,0,0,,,,0,,,,0,0,0,0,,,,0,2,0,0,0,0,0,,,
"Feb 14, 2021 3:00 AM",3,3,0,0,0,0,0,0,0,0,0,0,,,,0,,,,0,0,0,0,,,,0,0,0,0,0,0,0,,,
"Feb 14, 2021 4:00 AM",0,0,0,0,0,0,0,0,0,0,0,0,,,,0,,,,0,0,0,0,,,,0,0,0,0,0,0,0,,,
"Feb 14, 2021 5:00 AM",0,0,0,0,0,0,1,0,1,1,0,1,,,,0,,,,0,0,0,0,,,,1,2,0,0,0,0,0,0,0,0
"Feb 14, 2021 6:00 AM",1,1,0,0,0,0,0,0,0,0,0,0,,,,1,,,,0,0,0,0,,,,3,3,0,0,0,0,0,0,0,0
"Feb 14, 2021 7:00 AM",6,1,5,1,1,0,2,2,0,2,2,0,,,,0,,,,4,4,0,0,,,,4,0,1,0,0,0,0,0,0,0
"Feb 14, 2021 8:00 AM",6,2,4,2,0,2,3,1,2,0,0,0,,,,0,,,,1,1,0,0,,,,2,3,0,0,1,0,1,0,0,0
"Feb 14, 2021 9:00 AM",10,3,7,15,6,9,16,6,10,13,6,7,,,,1,,,,2,2,0,0,,,,6,7,1,0,1,1,0,0,0,0
"Feb 14, 2021 10:00 AM",15,8,7,10,7,3,19,11,8,16,10,6,,,,5,,,,5,4,1,2,,,,5,9,0,2,0,0,0,0,0,0
"Feb 14, 2021 11:00 AM",20,12,8,10,7,3,24,9,15,16,10,6,,,,1,,,,3,3,0,1,,,,14,10,0,1,2,0,2,0,0,0
"Feb 14, 2021 12:00 PM",12,5,7,21,11,10,25,16,9,17,10,7,,,,7,,,,3,2,1,1,,,,6,7,0,2,0,0,0,0,0,0
"Feb 14, 2021 1:00 PM",10,7,3,23,11,12,28,16,12,29,15,14,,,,10,,,,4,4,0,0,,,,15,13,0,1,1,0,1,0,0,0
"Feb 14, 2021 2:00 PM",26,18,8,26,18,8,46,28,18,23,15,8,,,,6,,,,9,4,5,4,,,,10,11,1,0,7,7,0,0,0,0
"Feb 14, 2021 3:00 PM",21,11,10,67,35,32,54,26,28,63,40,23,,,,12,,,,18,14,4,3,,,,11,20,2,2,5,2,3,0,0,0
"Feb 14, 2021 4:00 PM",37,19,18,93,48,45,99,54,45,87,58,29,,,,21,,,,9,7,2,6,,,,14,16,6,2,12,8,4,0,0,0
"Feb 14, 2021 5:00 PM",26,10,16,134,65,69,115,51,64,111,50,61,,,,24,,,,19,14,5,8,,,,29,42,1,2,8,3,5,0,0,0
"Feb 14, 2021 6:00 PM",34,13,21,67,29,38,73,27,46,49,17,32,,,,1,,,,15,9,6,5,,,,8,25,0,1,6,4,2,0,0,0
"Feb 14, 2021 7:00 PM",24,11,13,27,16,11,16,8,8,20,11,9,,,,3,,,,9,7,2,4,,,,8,7,2,0,3,3,0,0,0,0
"Feb 14, 2021 8:00 PM",13,5,8,6,4,2,13,5,8,10,3,7,,,,1,,,,1,1,0,2,,,,4,2,1,0,0,0,0,0,0,0
"Feb 14, 2021 9:00 PM",4,1,3,7,4,3,4,2,2,5,3,2,,,,1,,,,5,4,1,0,,,,1,5,1,2,3,2,1,0,0,0
"Feb 14, 2021 10:00 PM",3,1,2,4,2,2,5,2,3,4,1,3,,,,1,,,,2,1,1,3,,,,1,7,0,1,0,0,0,0,0,0
"Feb 14, 2021 11:00 PM",5,3,2,0,0,0,2,1,1,1,1,0,,,,2,,,,1,1,0,0,,,,0,3,0,0,0,0,0,0,0,0
"Feb 15, 2021 12:00 AM",3,2,1,1,0,1,0,0,0,4,2,2,,,,0,,,,1,1,0,0,,,,0,0,0,1,0,0,0,,,
"Feb 15, 2021 1:00 AM",1,0,1,2,0,2,2,0,2,2,0,2,,,,2,,,,4,4,0,0,,,,1,1,0,0,0,0,0,,,
"Feb 15, 2021 2:00 AM",2,2,0,0,0,0,0,0,0,0,0,0,,,,0,,,,0,0,0,0,,,,0,0,0,0,0,0,0,,,
"Feb 15, 2021 3:00 AM",0,0,0,0,0,0,0,0,0,0,0,0,,,,0,,,,0,0,0,0,,,,0,0,0,0,0,0,0,,,
"Feb 15, 2021 4:00 AM",0,0,0,0,0,0,1,1,0,1,1,0,,,,0,,,,0,0,0,0,,,,0,0,0,0,0,0,0,,,
"Feb 15, 2021 5:00 AM",1,1,0,0,0,0,4,2,2,3,1,2,,,,1,,,,2,2,0,0,,,,2,7,0,0,0,0,0,,,
"Feb 15, 2021 6:00 AM",22,15,7,16,7,9,15,7,8,16,8,8,,,,1,,,,2,2,0,5,,,,9,22,0,1,0,0,0,,,
"Feb 15, 2021 7:00 AM",54,29,25,33,16,17,32,12,20,29,17,12,,,,6,,,,8,6,2,12,,,,25,42,2,1,1,1,0,,,
"Feb 15, 2021 8:00 AM",54,41,13,41,11,30,47,18,29,37,12,25,,,,5,,,,12,9,3,23,,,,17,45,5,0,5,3,2,,,
"Feb 15, 2021 9:00 AM",54,41,13,42,20,22,59,32,27,46,30,16,,,,5,,,,14,9,5,11,,,,15,26,1,2,1,1,0,,,
"Feb 15, 2021 10:00 AM",48,36,12,97,51,46,96,53,43,89,51,38,,,,10,,,,15,9,6,23,,,,30,23,2,3,9,8,1,,,
"Feb 15, 2021 11:00 AM",36,20,16,181,89,92,152,86,66,121,79,42,,,,10,,,,8,4,4,12,,,,26,27,6,6,23,14,9,,,
"Feb 15, 2021 12:00 PM",66,28,38,181,95,86,245,137,108,150,91,59,,,,22,,,,19,18,1,16,,,,39,30,4,8,8,4,4,,,
"Feb 15, 2021 1:00 PM",67,41,26,214,122,92,255,130,125,202,105,97,,,,31,,,,23,19,4,24,,,,59,47,9,5,18,17,1,,,
"Feb 15, 2021 2:00 PM",98,52,46,209,106,103,245,116,129,191,105,86,,,,36,,,,23,16,7,18,,,,40,52,8,8,15,9,6,,,
"Feb 15, 2021 3:00 PM",87,39,48,237,114,123,232,120,112,194,102,92,,,,45,,,,26,20,6,20,99,53,46,35,48,4,2,7,3,4,,,
"Feb 15, 2021 4:00 PM",92,40,52,166,78,88,203,86,117,175,83,92,,,,36,,,,27,26,1,20,109,67,42,53,50,7,10,20,15,5,,,
"Feb 15, 2021 5:00 PM",108,39,69,129,70,59,175,84,91,128,53,75,,,,28,,,,59,59,0,22,87,34,53,47,53,11,2,9,5,4,,,
"Feb 15, 2021 6:00 PM",73,24,49,83,42,41,98,50,48,90,50,40,,,,14,,,,42,36,6,9,58,31,27,39,51,4,4,4,3,1,,,
"Feb 15, 2021 7:00 PM",51,15,36,40,22,18,47,27,20,37,22,15,,,,7,,,,22,22,0,8,35,20,15,28,24,1,3,6,5,1,,,
"Feb 15, 2021 8:00 PM",27,8,19,20,12,8,33,13,20,27,12,15,,,,1,,,,7,7,0,3,13,11,2,16,18,1,0,2,1,1,,,
"Feb 15, 2021 9:00 PM",13,3,10,5,1,4,3,2,1,4,2,2,,,,8,,,,7,6,1,2,10,7,3,2,11,2,0,1,0,1,,,
"Feb 15, 2021 10:00 PM",8,1,7,2,1,1,4,3,1,3,1,2,,,,4,,,,7,7,0,0,9,5,4,5,3,0,0,1,0,1,,,
"Feb 15, 2021 11:00 PM",3,1,2,2,1,1,1,0,1,2,1,1,,,,2,,,,2,2,0,1,3,2,1,3,1,0,0,1,0,1,,,
"Feb 16, 2021 12:00 AM",1,0,1,1,1,0,1,1,0,1,1,0,,,,0,,,,0,0,0,0,0,0,0,3,2,1,0,1,1,0,,,
"Feb 16, 2021 1:00 AM",0,0,0,0,0,0,2,2,0,2,2,0,,,,0,,,,0,0,0,0,0,0,0,1,0,0,0,0,0,0,,,
"Feb 16, 2021 2:00 AM",1,1,0,0,0,0,1,0,1,0,0,0,,,,0,,,,0,0,0,1,2,2,0,0,0,0,0,0,0,0,,,
"Feb 16, 2021 3:00 AM",1,0,1,0,0,0,0,0,0,0,0,0,,,,0,,,,0,0,0,0,0,0,0,0,0,0,0,0,0,0,,,
"Feb 16, 2021 4:00 AM",0,0,0,0,0,0,4,4,0,0,0,0,,,,0,,,,0,0,0,0,0,0,0,2,0,0,0,0,0,0,,,
"Feb 16, 2021 5:00 AM",0,0,0,2,2,0,2,2,0,4,4,0,,,,2,,,,1,1,0,3,1,1,0,2,7,1,0,0,0,0,,,
"Feb 16, 2021 6:00 AM",24,17,7,13,6,7,18,5,13,10,3,7,,,,2,,,,7,7,0,9,0,0,0,10,21,1,1,0,0,0,,,
"Feb 16, 2021 7:00 AM",47,22,25,46,21,25,56,35,21,49,30,19,,,,6,,,,11,7,4,33,5,2,3,38,51,1,2,2,1,1,,,
"Feb 16, 2021 8:00 AM",75,50,25,97,41,56,90,36,54,81,34,47,,,,14,,,,13,7,6,35,22,13,9,24,61,0,5,4,3,1,,,
"Feb 16, 2021 9:00 AM",75,47,28,74,39,35,69,38,31,64,34,30,,,,9,,,,18,12,6,33,32,16,16,26,33,4,7,5,3,2,,,
"Feb 16, 2021 10:00 AM",45,31,14,130,61,69,100,61,39,92,54,38,,,,13,,,,6,4,2,17,26,17,9,28,34,7,3,5,3,2,,,
"Feb 16, 2021 11:00 AM",46,27,19,181,97,84,179,102,77,148,86,62,,,,24,,,,7,6,1,19,53,42,11,22,33,11,7,5,3,2,,,
"Feb 16, 2021 12:00 PM",61,26,35,156,82,74,205,107,98,138,78,60,,,,15,,,,26,20,6,10,52,38,14,47,38,4,8,5,2,3,,,
"Feb 16, 2021 1:00 PM",67,37,30,161,80,81,219,110,109,166,74,92,,,,33,,,,16,13,3,32,65,36,29,30,42,12,7,10,7,3,,,
"Feb 16, 2021 2:00 PM",72,35,37,191,95,96,237,136,101,155,100,55,,,,27,,,,25,20,5,20,58,33,25,42,45,6,6,10,9,1,,,
"Feb 16, 2021 3:00 PM",76,44,32,167,90,77,187,103,84,155,92,63,,,,28,,,,25,22,3,15,77,54,23,43,42,4,6,10,7,3,,,
"Feb 16, 2021 4:00 PM",115,49,66,216,119,97,215,108,107,179,102,77,,,,28,,,,35,31,4,18,85,65,20,69,61,7,3,10,6,4,,,
"Feb 16, 2021 5:00 PM",116,36,80,182,86,96,200,96,104,144,78,66,,,,33,,,,47,41,6,24,87,35,52,62,55,7,6,7,3,4,,,
"Feb 16, 2021 6:00 PM",98,30,68,90,53,37,136,67,69,100,46,54,,,,20,,,,47,47,0,14,81,48,33,54,46,6,2,10,7,3,,,
"Feb 16, 2021 7:00 PM",52,19,33,40,25,15,52,29,23,48,28,20,,,,5,,,,28,28,0,5,49,28,21,26,32,3,2,3,2,1,,,
"Feb 16, 2021 8:00 PM",27,7,20,33,16,17,35,21,14,38,21,17,,,,6,,,,15,14,1,2,16,9,7,20,12,0,0,1,1,0,,,
"Feb 16, 2021 9:00 PM",20,5,15,14,7,7,17,8,9,16,8,8,,,,3,,,,7,7,0,6,13,11,2,3,13,1,0,1,1,0,,,
"Feb 16, 2021 10:00 PM",17,6,11,11,4,7,9,3,6,7,2,5,,,,0,,,,5,3,2,1,14,8,6,3,10,0,0,0,0,0,,,
"Feb 16, 2021 11:00 PM",4,2,2,3,1,2,3,1,2,4,2,2,,,,1,,,,4,4,0,1,2,1,1,4,2,0,0,3,2,1,,,
"Feb 17, 2021 12:00 AM",2,0,2,0,0,0,0,0,0,0,0,0,,,,1,,,,0,0,0,1,0,0,0,1,0,1,0,2,1,1,,,
"Feb 17, 2021 1:00 AM",0,0,0,0,0,0,0,0,0,0,0,0,,,,0,,,,4,3,1,0,0,0,0,0,0,0,0,0,0,0,,,
"Feb 17, 2021 2:00 AM",4,2,2,0,0,0,1,1,0,0,0,0,,,,0,,,,1,1,0,0,1,1,0,1,0,0,0,0,0,0,,,
"Feb 17, 2021 3:00 AM",0,0,0,2,1,1,2,1,1,2,1,1,,,,0,,,,0,0,0,1,1,1,0,0,0,0,0,0,0,0,,,
"Feb 17, 2021 4:00 AM",0,0,0,0,0,0,1,1,0,0,0,0,,,,0,,,,0,0,0,0,1,0,1,1,1,0,0,0,0,0,,,
"Feb 17, 2021 5:00 AM",4,4,0,0,0,0,3,2,1,2,2,0,,,,0,,,,1,1,0,4,0,0,0,1,8,0,0,0,0,0,,,
"Feb 17, 2021 6:00 AM",16,10,6,23,16,7,23,17,6,16,13,3,,,,2,,,,3,3,0,3,1,1,0,11,25,0,0,1,1,0,,,
"Feb 17, 2021 7:00 AM",45,23,22,59,33,26,74,39,35,69,40,29,,,,5,,,,11,8,3,33,4,3,1,31,59,4,3,1,1,0,,,
"Feb 17, 2021 8:00 AM",88,61,27,116,38,78,113,42,71,106,47,59,,,,18,,,,15,10,5,51,19,13,6,41,86,1,6,3,2,1,,,
"Feb 17, 2021 9:00 AM",66,49,17,100,52,48,95,52,43,83,47,36,,,,14,,,,15,9,6,25,36,22,14,23,31,4,4,5,5,0,,,
"Feb 17, 2021 10:00 AM",51,28,23,163,98,65,123,74,49,115,68,47,,,,21,,,,14,10,4,23,34,24,10,37,22,7,5,4,3,1,,,
"Feb 17, 2021 11:00 AM",60,33,27,159,81,78,187,111,76,128,78,50,,,,15,,,,18,17,1,15,32,21,11,29,35,5,7,10,6,4,,,
"Feb 17, 2021 12:00 PM",54,27,27,213,112,101,247,147,100,191,103,88,,,,40,,,,12,8,4,23,61,40,21,39,44,1,1,7,5,2,,,
"Feb 17, 2021 1:00 PM",73,35,38,207,103,104,260,127,133,189,93,96,,,,22,,,,23,20,3,20,84,65,19,36,53,9,4,9,8,1,,,
"Feb 17, 2021 2:00 PM",69,33,36,172,79,93,279,138,141,159,78,81,,,,24,,,,24,21,3,22,74,55,19,41,47,7,5,7,2,5,,,
"Feb 17, 2021 3:00 PM",57,28,29,198,111,87,240,131,109,168,86,82,,,,51,,,,23,18,5,10,97,73,24,44,45,0,5,6,2,4,,,
"Feb 17, 2021 4:00 PM",94,44,50,156,88,68,225,121,104,162,83,79,,,,36,,,,46,42,4,16,94,63,31,55,53,5,2,10,5,5,,,
"Feb 17, 2021 5:00 PM",107,21,86,118,66,52,169,65,104,112,51,61,,,,14,,,,54,51,3,22,98,56,42,65,59,8,2,0,0,0,,,
"Feb 17, 2021 6:00 PM",76,24,52,68,36,32,113,69,44,80,49,31,,,,14,,,,42,38,4,13,67,41,26,62,32,3,2,1,1,0,,,
"Feb 17, 2021 7:00 PM",52,19,33,26,13,13,35,19,16,29,11,18,,,,7,,,,22,21,1,5,37,29,8,31,26,0,1,2,0,2,,,
"Feb 17, 2021 8:00 PM",33,9,24,18,6,12,24,13,11,21,11,10,,,,14,,,,17,14,3,4,21,13,8,16,13,3,1,2,0,2,,,
"Feb 17, 2021 9:00 PM",18,10,8,10,7,3,18,8,10,15,9,6,,,,2,,,,6,5,1,2,15,8,7,10,4,1,0,3,1,2,,,
"Feb 17, 2021 10:00 PM",10,2,8,3,2,1,2,1,1,2,0,2,,,,0,,,,3,3,0,3,11,5,6,5,3,0,0,3,2,1,,,
"Feb 17, 2021 11:00 PM",3,0,3,1,0,1,2,0,2,1,0,1,,,,3,,,,2,2,0,1,3,1,2,1,2,0,0,0,0,0,,,
"Feb 18, 2021 12:00 AM",2,1,1,0,0,0,0,0,0,0,0,0,,,,0,,,,1,0,1,0,2,2,0,2,0,1,0,0,0,0,,,
"Feb 18, 2021 1:00 AM",2,1,1,0,0,0,0,0,0,0,0,0,,,,0,,,,1,0,1,0,0,0,0,1,1,0,0,0,0,0,,,
"Feb 18, 2021 2:00 AM",2,1,1,0,0,0,0,0,0,0,0,0,,,,0,,,,1,1,0,0,0,0,0,0,0,0,0,0,0,0,,,
"Feb 18, 2021 3:00 AM",0,0,0,0,0,0,0,0,0,0,0,0,,,,0,,,,0,0,0,0,0,0,0,0,2,0,0,0,0,0,,,
"Feb 18, 2021 4:00 AM",0,0,0,0,0,0,1,1,0,0,0,0,,,,0,,,,0,0,0,0,0,0,0,0,0,0,0,0,0,0,,,
"Feb 18, 2021 5:00 AM",2,2,0,1,1,0,2,1,1,4,3,1,,,,1,,,,1,1,0,3,0,0,0,4,3,1,0,0,0,0,,,
"Feb 18, 2021 6:00 AM",18,13,5,5,1,4,8,4,4,6,1,5,,,,3,,,,7,6,1,6,0,0,0,8,20,0,0,0,0,0,,,
"Feb 18, 2021 7:00 AM",51,30,21,37,22,15,51,29,22,41,25,16,,,,4,,,,7,5,2,24,4,2,2,29,42,2,2,3,2,1,,,
"Feb 18, 2021 8:00 AM",87,59,28,91,37,54,96,40,56,90,43,47,,,,11,,,,17,11,6,52,16,9,7,25,56,5,2,6,6,0,,,
"Feb 18, 2021 9:00 AM",56,41,15,56,24,32,60,34,26,59,36,23,,,,6,,,,16,10,6,15,34,15,19,29,36,1,2,1,0,1,,,
"Feb 18, 2021 10:00 AM",40,27,13,76,30,46,84,49,35,76,40,36,,,,18,,,,15,11,4,8,31,19,12,17,32,5,6,7,5,2,,,
"Feb 18, 2021 11:00 AM",45,20,25,111,57,54,126,77,49,94,50,44,,,,10,,,,9,6,3,7,45,33,12,12,19,11,2,13,11,2,,,
"Feb 18, 2021 12:00 PM",53,24,29,106,59,47,160,89,71,122,75,47,,,,16,,,,14,6,8,12,56,40,16,34,27,5,9,8,6,2,,,
"Feb 18, 2021 1:00 PM",58,31,27,162,88,74,154,88,66,102,55,47,,,,23,,,,29,25,4,11,61,34,27,33,36,8,11,4,1,3,,,
"Feb 18, 2021 2:00 PM",60,35,25,144,78,66,199,90,109,170,89,81,,,,10,,,,19,16,3,13,48,31,17,31,39,2,2,4,3,1,,,
"Feb 18, 2021 3:00 PM",52,28,24,158,88,70,220,122,98,163,98,65,,,,31,,,,27,25,2,15,50,35,15,41,34,7,2,14,9,5,,,
"Feb 18, 2021 4:00 PM",107,40,67,168,93,75,220,121,99,170,87,83,,,,23,,,,37,36,1,11,87,62,25,45,36,8,8,9,4,5,,,
"Feb 18, 2021 5:00 PM",128,39,89,147,82,65,186,96,90,133,74,59,,,,20,,,,43,39,4,19,93,44,49,60,57,4,10,12,7,5,,,
"Feb 18, 2021 6:00 PM",89,20,69,71,38,33,93,45,48,67,37,30,,,,7,,,,40,36,4,4,54,25,29,35,53,5,2,7,5,2,,,
"Feb 18, 2021 7:00 PM",53,21,32,38,22,16,54,22,32,51,24,27,,,,17,,,,33,32,1,2,33,20,13,21,30,5,1,7,3,4,,,
"Feb 18, 2021 8:00 PM",30,10,20,15,9,6,24,9,15,25,10,15,,,,6,,,,18,17,1,4,30,20,10,11,16,0,1,1,1,0,,,
"Feb 18, 2021 9:00 PM",15,6,9,14,8,6,18,12,6,16,10,6,,,,4,,,,7,7,0,4,14,5,9,9,12,1,0,3,2,1,,,
"Feb 18, 2021 10:00 PM",9,4,5,5,2,3,9,6,3,12,3,9,,,,0,,,,11,4,7,1,9,6,3,4,5,1,1,1,1,0,,,
"Feb 18, 2021 11:00 PM",5,3,2,2,0,2,5,4,1,4,3,1,,,,1,,,,2,2,0,0,7,4,3,2,4,1,0,3,2,1,,,
"Feb 19, 2021 12:00 AM",3,1,2,0,0,0,0,0,0,2,0,2,,,,0,,,,3,3,0,5,4,4,0,3,0,0,0,0,0,0,,,
"Feb 19, 2021 1:00 AM",4,1,3,1,1,0,0,0,0,0,0,0,,,,0,,,,1,1,0,0,0,0,0,1,0,0,0,0,0,0,,,
"Feb 19, 2021 2:00 AM",5,3,2,0,0,0,0,0,0,0,0,0,,,,0,,,,0,0,0,0,0,0,0,0,0,0,0,1,0,1,,,
"Feb 19, 2021 3:00 AM",0,0,0,0,0,0,0,0,0,0,0,0,,,,1,,,,0,0,0,0,0,0,0,0,2,0,0,0,0,0,,,
"Feb 19, 2021 4:00 AM",0,0,0,0,0,0,0,0,0,0,0,0,,,,0,,,,0,0,0,0,0,0,0,1,0,0,0,0,0,0,,,
"Feb 19, 2021 5:00 AM",1,1,0,0,0,0,2,2,0,2,2,0,,,,0,,,,1,1,0,2,0,0,0,2,4,1,0,0,0,0,,,
"Feb 19, 2021 6:00 AM",15,10,5,6,1,5,7,3,4,3,0,3,,,,0,,,,2,2,0,1,0,0,0,4,9,0,0,3,1,2,,,
"Feb 19, 2021 7:00 AM",26,14,12,12,6,6,16,5,11,18,8,10,,,,3,,,,6,3,3,11,0,0,0,21,32,0,1,1,0,1,,,
"Feb 19, 2021 8:00 AM",61,41,20,34,13,21,42,23,19,30,17,13,,,,7,,,,12,6,6,25,8,4,4,25,35,0,2,0,0,0,,,
"Feb 19, 2021 9:00 AM",44,31,13,29,13,16,34,15,19,35,15,20,,,,1,,,,11,6,5,13,21,11,10,11,19,1,0,3,1,2,,,
"Feb 19, 2021 10:00 AM",31,18,13,30,7,23,36,13,23,23,10,13,,,,7,,,,8,7,1,10,20,12,8,9,17,1,1,2,0,2,,,
"Feb 19, 2021 11:00 AM",35,16,19,37,22,15,50,41,9,50,41,9,,,,9,,,,7,5,2,5,19,14,5,12,11,5,0,4,3,1,,,
"Feb 19, 2021 12:00 PM",36,17,19,57,29,28,63,21,42,41,14,27,,,,8,,,,12,9,3,5,37,24,13,11,14,6,0,2,2,0,,,
"Feb 19, 2021 1:00 PM",29,14,15,32,16,16,36,15,21,23,9,14,,,,3,,,,13,9,4,6,38,18,20,9,23,0,0,1,0,1,,,
"Feb 19, 2021 2:00 PM",27,12,15,17,10,7,30,15,15,17,12,5,,,,9,,,,6,6,0,7,22,11,11,15,4,0,1,2,2,0,,,
"Feb 19, 2021 3:00 PM",33,11,22,21,8,13,36,17,19,25,10,15,,,,13,,,,6,5,1,3,11,6,5,14,15,2,2,4,3,1,,,
"Feb 19, 2021 4:00 PM",37,12,25,39,21,18,52,31,21,43,25,18,,,,8,,,,17,17,0,10,7,5,2,22,26,3,0,3,2,1,,,
"Feb 19, 2021 5:00 PM",69,18,51,58,32,26,93,58,35,74,40,34,,,,14,,,,26,20,6,8,23,17,6,40,19,0,2,3,2,1,,,
"Feb 19, 2021 6:00 PM",52,16,36,41,24,17,68,32,36,44,28,16,,,,14,,,,27,23,4,7,31,22,9,28,36,0,1,6,3,3,,,
"Feb 19, 2021 7:00 PM",40,13,27,22,14,8,27,10,17,25,11,14,,,,15,,,,16,15,1,4,25,21,4,26,16,0,1,4,2,2,,,
"Feb 19, 2021 8:00 PM",24,12,12,19,12,7,21,13,8,21,14,7,,,,1,,,,6,5,1,8,12,4,8,10,15,3,0,0,0,0,,,
"Feb 19, 2021 9:00 PM",22,6,16,10,8,2,6,4,2,8,5,3,,,,2,,,,9,8,1,2,10,6,4,6,8,0,0,3,2,1,,,
"Feb 19, 2021 10:00 PM",6,5,1,8,1,7,10,4,6,5,2,3,,,,7,,,,3,2,1,2,5,4,1,5,5,0,1,0,0,0,,,
"Feb 19, 2021 11:00 PM",9,3,6,1,0,1,1,0,1,5,0,5,,,,1,,,,5,5,0,2,3,0,3,1,5,1,1,2,2,0,,,
"Feb 20, 2021 12:00 AM",5,4,1,1,0,1,0,0,0,0,0,0,,,,4,,,,0,0,0,0,0,0,0,0,1,0,0,0,0,0,,,
"Feb 20, 2021 1:00 AM",2,0,2,2,1,1,2,2,0,0,0,0,,,,2,,,,3,3,0,1,5,3,2,0,1,0,0,1,1,0,,,
"Feb 20, 2021 2:00 AM",3,0,3,2,2,0,1,1,0,0,0,0,,,,0,,,,0,0,0,1,0,0,0,1,0,0,1,0,0,0,,,
"Feb 20, 2021 3:00 AM",1,0,1,0,0,0,0,0,0,0,0,0,,,,1,,,,1,1,0,1,0,0,0,1,1,0,1,0,0,0,,,
"Feb 20, 2021 4:00 AM",2,1,1,2,2,0,3,2,1,0,0,0,,,,0,,,,1,1,0,0,0,0,0,1,0,0,0,0,0,0,,,
"Feb 20, 2021 5:00 AM",0,0,0,0,0,0,0,0,0,0,0,0,,,,1,,,,2,2,0,1,1,1,0,1,2,1,0,1,1,0,,,
"Feb 20, 2021 6:00 AM",4,2,2,5,4,1,3,2,1,4,3,1,,,,2,,,,1,1,0,1,0,0,0,7,4,0,0,0,0,0,,,
"Feb 20, 2021 7:00 AM",15,5,10,20,15,5,30,21,9,25,19,6,,,,3,,,,3,3,0,6,0,0,0,13,10,0,1,1,0,1,,,
"Feb 20, 2021 8:00 AM",14,6,8,47,22,25,46,23,23,34,19,15,,,,3,,,,3,3,0,5,3,2,1,14,18,2,2,3,2,1,,,
"Feb 20, 2021 9:00 AM",36,18,18,42,14,28,56,18,38,37,12,25,,,,1,,,,4,3,1,4,9,8,1,9,14,2,0,2,1,1,,,
"Feb 20, 2021 10:00 AM",16,8,8,16,7,9,19,9,10,8,6,2,,,,3,,,,4,2,2,0,17,11,6,10,10,0,1,1,0,1,,,
"Feb 20, 2021 11:00 AM",30,13,17,30,12,18,33,17,16,25,15,10,,,,5,,,,16,11,5,5,17,12,5,10,11,1,2,4,3,1,,,
"Feb 20, 2021 12:00 PM",29,10,19,29,15,14,42,17,25,29,18,11,,,,5,,,,8,6,2,3,17,9,8,13,10,1,0,4,3,1,,,
"Feb 20, 2021 1:00 PM",26,15,11,13,6,7,17,8,9,17,8,9,,,,0,,,,5,3,2,2,29,10,19,6,9,0,0,2,2,0,,,
"Feb 20, 2021 2:00 PM",18,11,7,14,6,8,26,13,13,11,6,5,,,,4,,,,8,7,1,7,13,7,6,5,12,0,0,1,0,1,,,
"Feb 20, 2021 3:00 PM",17,11,6,32,19,13,36,20,16,27,16,11,,,,3,,,,5,5,0,2,16,12,4,11,12,0,0,0,0,0,,,
"Feb 20, 2021 4:00 PM",27,9,18,62,35,27,61,36,25,47,29,18,,,,10,,,,11,11,0,5,20,14,6,18,12,1,0,2,2,0,,,
"Feb 20, 2021 5:00 PM",25,15,10,86,34,52,91,32,59,66,24,42,,,,20,,,,7,7,0,3,25,12,13,10,15,5,1,5,4,1,,,
"Feb 20, 2021 6:00 PM",27,9,18,30,14,16,39,16,23,28,16,12,,,,11,,,,10,9,1,4,28,11,17,15,22,2,2,1,1,0,,,
"Feb 20, 2021 7:00 PM",33,22,11,14,9,5,24,13,11,21,10,11,,,,8,,,,4,3,1,2,12,8,4,12,16,2,0,2,1,1,,,
"Feb 20, 2021 8:00 PM",17,9,8,12,5,7,14,6,8,11,6,5,,,,6,,,,5,5,0,7,8,5,3,6,8,1,1,0,0,0,,,
"Feb 20, 2021 9:00 PM",13,6,7,8,5,3,10,4,6,7,6,1,,,,0,,,,3,2,1,2,6,3,3,6,5,1,0,0,0,0,,,
"Feb 20, 2021 10:00 PM",9,6,3,8,1,7,6,4,2,11,4,7,,,,1,,,,2,2,0,0,4,3,1,3,7,0,0,1,0,1,,,
"Feb 20, 2021 11:00 PM",4,2,2,3,2,1,2,2,0,3,3,0,,,,1,,,,4,4,0,2,2,0,2,0,0,0,0,5,2,3,,,
"Feb 21, 2021 12:00 AM",1,1,0,0,0,0,0,0,0,1,0,1,,,,0,,,,1,1,0,0,2,2,0,0,1,0,0,0,0,0,,,
"Feb 21, 2021 1:00 AM",2,0,2,2,0,2,2,0,2,2,0,2,,,,0,,,,1,1,0,0,0,0,0,1,0,0,0,0,0,0,,,
"Feb 21, 2021 2:00 AM",3,2,1,0,0,0,3,1,2,1,1,0,,,,0,,,,2,2,0,0,0,0,0,0,2,0,0,1,0,1,,,
"Feb 21, 2021 3:00 AM",1,1,0,0,0,0,0,0,0,0,0,0,,,,0,,,,0,0,0,0,0,0,0,0,0,0,0,1,1,0,,,
"Feb 21, 2021 4:00 AM",0,0,0,0,0,0,0,0,0,0,0,0,,,,0,,,,1,1,0,0,0,0,0,0,0,1,0,0,0,0,,,
"Feb 21, 2021 5:00 AM",2,1,1,0,0,0,1,1,0,2,0,2,,,,0,,,,1,1,0,1,0,0,0,0,2,0,0,1,1,0,,,
"Feb 21, 2021 6:00 AM",3,1,2,3,2,1,7,5,2,8,5,3,,,,4,,,,3,1,2,3,0,0,0,5,8,0,0,0,0,0,,,
"Feb 21, 2021 7:00 AM",12,7,5,22,19,3,37,31,6,27,24,3,,,,1,,,,2,1,1,2,4,4,0,25,14,0,1,0,0,0,,,
"Feb 21, 2021 8:00 AM",24,13,11,88,42,46,84,50,34,83,56,27,,,,5,,,,6,5,1,5,14,13,1,18,25,4,2,0,0,0,,,
"Feb 21, 2021 9:00 AM",51,18,33,218,132,86,238,151,87,207,128,79,,,,12,,,,25,19,6,10,32,21,11,52,45,10,14,4,2,2,,,
"Feb 21, 2021 10:00 AM",79,41,38,477,275,202,424,274,150,430,281,149,,,,28,,,,28,24,4,16,73,51,22,96,102,15,11,5,2,3,,,
"Feb 21, 2021 11:00 AM",142,82,60,608,322,286,600,324,276,585,327,258,,,,40,,,,23,19,4,40,149,123,26,124,129,12,42,10,5,5,,,
"Feb 21, 2021 12:00 PM",138,60,78,567,301,266,609,301,308,579,316,263,,,,49,,,,41,38,3,23,204,146,58,148,168,22,10,13,8,5,,,
"Feb 21, 2021 1:00 PM",114,67,47,593,330,263,616,332,284,566,322,244,,,,44,,,,45,35,10,27,212,134,78,117,133,21,14,18,17,1,,,
"Feb 21, 2021 2:00 PM",159,90,69,519,226,293,604,288,316,553,260,293,,,,46,,,,51,47,4,47,211,136,75,115,147,17,13,31,17,14,,,
"Feb 21, 2021 3:00 PM",149,62,87,459,240,219,556,265,291,539,263,276,,,,53,,,,23,21,2,42,216,132,84,114,161,16,9,19,14,5,,,
"Feb 21, 2021 4:00 PM",144,68,76,388,179,209,467,178,289,379,169,210,,,,57,,,,29,26,3,25,189,98,91,57,125,17,10,19,17,2,,,
"Feb 21, 2021 5:00 PM",74,30,44,181,83,98,298,118,180,188,89,99,,,,20,,,,26,21,5,18,158,86,72,55,90,2,5,7,3,4,,,
"Feb 21, 2021 6:00 PM",41,11,30,84,40,44,134,46,88,89,36,53,,,,15,,,,13,10,3,8,113,45,68,28,41,4,2,8,5,3,,,
"Feb 21, 2021 7:00 PM",37,18,19,18,15,3,25,21,4,16,12,4,,,,9,,,,3,3,0,3,45,12,33,7,11,0,2,3,3,0,,,
"Feb 21, 2021 8:00 PM",16,7,9,12,6,6,16,5,11,16,6,10,,,,5,,,,6,6,0,2,21,17,4,10,13,1,3,2,2,0,,,
"Feb 21, 2021 9:00 PM",12,4,8,5,3,2,9,2,7,6,4,2,,,,6,,,,1,1,0,4,8,3,5,1,9,2,1,2,1,1,,,
"Feb 21, 2021 10:00 PM",6,2,4,5,3,2,4,2,2,2,1,1,,,,0,,,,4,4,0,2,7,3,4,6,3,1,0,5,3,2,,,
"Feb 21, 2021 11:00 PM",6,4,2,4,3,1,1,0,1,1,0,1,,,,1,,,,2,2,0,0,1,1,0,1,2,0,1,2,1,1,,,
"Feb 22, 2021 12:00 AM",1,0,1,0,0,0,0,0,0,0,0,0,,,,3,,,,2,2,0,0,1,0,1,1,1,0,0,0,0,0,,,
"Feb 22, 2021 1:00 AM",0,0,0,1,1,0,0,0,0,0,0,0,,,,1,,,,1,1,0,0,0,0,0,0,0,0,0,0,0,0,,,
"Feb 22, 2021 2:00 AM",1,1,0,0,0,0,1,1,0,1,1,0,,,,0,,,,0,0,0,0,3,0,3,0,0,0,0,0,0,0,,,
"Feb 22, 2021 3:00 AM",0,0,0,0,0,0,1,1,0,1,1,0,,,,0,,,,1,1,0,0,0,0,0,0,0,0,0,0,0,0,,,
"Feb 22, 2021 4:00 AM",0,0,0,0,0,0,0,0,0,0,0,0,,,,0,,,,0,0,0,0,1,1,0,0,0,0,0,0,0,0,,,
"Feb 22, 2021 5:00 AM",2,2,0,0,0,0,3,2,1,5,3,2,,,,0,,,,5,4,1,2,0,0,0,2,8,0,0,0,0,0,,,
"Feb 22, 2021 6:00 AM",26,16,10,17,9,8,19,8,11,14,9,5,,,,1,,,,1,1,0,7,1,0,1,14,25,0,0,3,0,3,,,
"Feb 22, 2021 7:00 AM",54,32,22,79,32,47,114,58,56,81,39,42,,,,7,,,,13,9,4,38,3,2,1,46,58,2,3,5,3,2,,,
"Feb 22, 2021 8:00 AM",91,70,21,110,45,65,145,66,79,105,57,48,,,,10,,,,14,8,6,41,36,23,13,41,76,3,5,2,2,0,,,
"Feb 22, 2021 9:00 AM",73,60,13,91,40,51,135,65,70,79,37,42,,,,23,,,,23,15,8,26,61,40,21,31,42,7,4,7,6,1,,,
"Feb 22, 2021 10:00 AM",47,34,13,136,77,59,178,108,70,140,84,56,,,,13,,,,17,13,4,16,54,42,12,39,28,7,3,5,2,3,,,
"Feb 22, 2021 11:00 AM",42,23,19,225,133,92,196,105,91,186,108,78,,,,15,,,,22,22,0,17,71,55,16,42,42,5,10,3,3,0,,,
"Feb 22, 2021 12:00 PM",67,25,42,209,98,111,252,132,120,206,111,95,,,,16,,,,17,17,0,11,74,57,17,51,53,6,7,8,5,3,,,
"Feb 22, 2021 1:00 PM",74,30,44,257,139,118,271,144,127,251,145,106,,,,23,,,,24,22,2,21,94,53,41,64,58,15,3,17,12,5,,,
"Feb 22, 2021 2:00 PM",80,41,39,225,116,109,194,97,97,194,103,91,,,,41,,,,29,25,4,13,104,65,39,62,42,7,8,15,9,6,,,
"Feb 22, 2021 3:00 PM",80,44,36,226,116,110,225,121,104,212,118,94,,,,27,,,,19,17,2,16,90,65,25,49,50,8,5,11,9,2,,,
"Feb 22, 2021 4:00 PM",100,40,60,234,117,117,266,121,145,196,86,110,,,,36,,,,45,37,8,16,102,67,35,70,95,10,4,20,13,7,,,
"Feb 22, 2021 5:00 PM",130,30,100,178,94,84,214,111,103,165,87,78,,,,38,,,,66,61,5,17,102,55,47,74,85,8,7,8,5,3,,,
"Feb 22, 2021 6:00 PM",87,27,60,95,53,42,138,72,66,90,51,39,,,,14,,,,50,45,5,13,108,64,44,51,53,1,7,4,3,1,,,
"Feb 22, 2021 7:00 PM",63,20,43,32,20,12,44,25,19,33,18,15,,,,7,,,,27,25,2,4,60,39,21,26,25,4,1,5,3,2,,,
"Feb 22, 2021 8:00 PM",34,9,25,23,10,13,29,15,14,26,9,17,,,,11,,,,10,10,0,2,20,11,9,9,23,3,1,5,4,1,,,
"Feb 22, 2021 9:00 PM",15,4,11,9,6,3,11,4,7,9,4,5,,,,1,,,,12,12,0,3,7,6,1,2,3,1,0,3,2,1,,,
"Feb 22, 2021 10:00 PM",3,2,1,1,1,0,0,0,0,2,0,2,,,,1,,,,5,4,1,2,4,4,0,0,2,0,0,3,1,2,,,
"Feb 22, 2021 11:00 PM",8,1,7,0,0,0,2,1,1,1,0,1,,,,1,,,,1,1,0,0,0,0,0,0,1,0,0,0,0,0,,,
"Feb 23, 2021 12:00 AM",3,1,2,0,0,0,0,0,0,0,0,0,,,,0,,,,1,1,0,1,1,1,0,0,1,1,0,1,1,0,,,
"Feb 23, 2021 1:00 AM",0,0,0,0,0,0,0,0,0,0,0,0,,,,0,,,,0,0,0,0,1,1,0,0,2,0,0,1,0,1,,,
"Feb 23, 2021 2:00 AM",1,0,1,0,0,0,0,0,0,0,0,0,,,,0,,,,0,0,0,0,0,0,0,0,0,0,0,0,0,0,,,
"Feb 23, 2021 3:00 AM",0,0,0,0,0,0,0,0,0,0,0,0,,,,0,,,,0,0,0,0,0,0,0,0,1,0,0,0,0,0,,,
"Feb 23, 2021 4:00 AM",0,0,0,0,0,0,0,0,0,0,0,0,,,,0,,,,0,0,0,0,0,0,0,0,0,0,0,0,0,0,,,
"Feb 23, 2021 5:00 AM",2,2,0,1,1,0,3,2,1,3,2,1,,,,2,,,,0,0,0,3,0,0,0,1,7,0,0,0,0,0,,,
"Feb 23, 2021 6:00 AM",11,8,3,3,1,2,5,1,4,3,1,2,,,,1,,,,2,2,0,2,1,0,1,5,13,0,0,0,0,0,,,
"Feb 23, 2021 7:00 AM",26,13,13,15,4,11,21,10,11,11,5,6,,,,1,,,,2,2,0,18,0,0,0,10,30,0,0,0,0,0,,,
"Feb 23, 2021 8:00 AM",39,30,9,11,4,7,19,10,9,11,6,5,,,,5,,,,5,1,4,24,2,1,1,18,32,2,1,5,3,2,,,
"Feb 23, 2021 9:00 AM",30,21,9,11,4,7,15,6,9,11,4,7,,,,4,,,,6,4,2,10,10,5,5,10,15,0,0,3,1,2,,,
"Feb 23, 2021 10:00 AM",14,12,2,7,3,4,6,3,3,4,2,2,,,,2,,,,2,1,1,3,6,2,4,3,4,1,0,0,0,0,,,
"Feb 23, 2021 11:00 AM",11,7,4,8,4,4,10,5,5,5,2,3,,,,5,,,,4,3,1,7,4,2,2,5,12,0,2,2,0,2,,,
"Feb 23, 2021 12:00 PM",23,8,15,15,5,10,13,6,7,11,6,5,,,,6,,,,7,5,2,4,4,2,2,10,8,0,0,0,0,0,,,
"Feb 23, 2021 1:00 PM",21,8,13,11,6,5,11,6,5,12,6,6,,,,3,,,,4,3,1,6,6,4,2,9,7,2,1,2,2,0,,,
"Feb 23, 2021 2:00 PM",23,7,16,7,2,5,5,4,1,5,4,1,,,,3,,,,9,8,1,2,3,2,1,4,4,0,0,1,1,0,,,
"Feb 23, 2021 3:00 PM",20,10,10,15,9,6,23,12,11,17,10,7,,,,4,,,,4,3,1,5,5,2,3,14,8,3,0,1,0,1,,,
"Feb 23, 2021 4:00 PM",27,9,18,16,10,6,28,18,10,21,12,9,,,,4,,,,13,10,3,6,14,6,8,23,13,0,1,2,0,2,,,
"Feb 23, 2021 5:00 PM",57,14,43,19,12,7,27,14,13,16,8,8,,,,2,,,,18,17,1,5,12,10,2,20,15,1,2,3,1,2,,,
"Feb 23, 2021 6:00 PM",39,13,26,12,8,4,19,13,6,21,12,9,,,,3,,,,18,17,1,12,13,8,5,24,13,0,0,4,1,3,,,
"Feb 23, 2021 7:00 PM",15,2,13,7,7,0,8,6,2,8,7,1,,,,4,,,,4,4,0,2,4,4,0,13,4,0,0,2,1,1,,,
"Feb 23, 2021 8:00 PM",10,1,9,1,0,1,2,2,0,1,1,0,,,,0,,,,10,10,0,1,2,1,1,7,5,2,0,2,2,0,,,
"Feb 23, 2021 9:00 PM",4,1,3,1,0,1,3,1,2,3,0,3,,,,1,,,,4,4,0,1,3,2,1,5,6,1,0,3,1,2,,,
"Feb 23, 2021 10:00 PM",4,0,4,3,3,0,4,4,0,4,3,1,,,,1,,,,1,1,0,2,2,2,0,3,3,0,0,0,0,0,,,
"Feb 23, 2021 11:00 PM",2,1,1,0,0,0,0,0,0,0,0,0,,,,0,,,,1,1,0,0,1,0,1,2,1,1,0,1,1,0,,,
"Feb 24, 2021 12:00 AM",2,1,1,0,0,0,0,0,0,0,0,0,,,,0,,,,2,2,0,0,0,0,0,0,0,0,0,0,0,0,,,
"Feb 24, 2021 1:00 AM",2,1,1,0,0,0,0,0,0,0,0,0,,,,0,,,,0,0,0,0,0,0,0,0,0,0,0,0,0,0,,,
"Feb 24, 2021 2:00 AM",1,0,1,1,0,1,1,1,0,2,2,0,,,,0,,,,0,0,0,0,0,0,0,1,0,0,0,0,0,0,,,
"Feb 24, 2021 3:00 AM",0,0,0,0,0,0,0,0,0,0,0,0,,,,0,,,,0,0,0,0,0,0,0,0,0,0,0,0,0,0,,,
"Feb 24, 2021 4:00 AM",1,1,0,0,0,0,0,0,0,0,0,0,,,,0,,,,0,0,0,0,0,0,0,0,1,0,0,0,0,0,,,
"Feb 24, 2021 5:00 AM",3,3,0,1,1,0,3,2,1,3,2,1,,,,1,,,,0,0,0,3,0,0,0,2,6,0,0,0,0,0,0,0,0
"Feb 24, 2021 6:00 AM",8,4,4,7,0,7,10,4,6,6,3,3,,,,0,,,,6,6,0,4,0,0,0,6,19,0,1,0,0,0,0,0,0
"Feb 24, 2021 7:00 AM",43,26,17,36,17,19,32,14,18,31,16,15,,,,5,,,,8,6,2,32,2,1,1,24,46,0,1,1,1,0,0,0,0
"Feb 24, 2021 8:00 AM",64,47,17,62,27,35,64,25,39,56,26,30,,,,10,,,,12,7,5,36,19,12,7,28,47,1,4,1,1,0,0,0,0
"Feb 24, 2021 9:00 AM",49,44,5,52,21,31,48,20,28,36,18,18,,,,6,,,,11,7,4,21,33,12,21,18,29,1,3,2,1,1,0,0,0
"Feb 24, 2021 10:00 AM",30,21,9,65,39,26,79,51,28,50,31,19,,,,9,,,,9,5,4,13,25,12,13,14,17,3,2,4,2,2,0,0,0
"Feb 24, 2021 11:00 AM",33,17,16,76,40,36,94,50,44,61,36,25,,,,17,,,,10,9,1,13,30,18,12,23,18,4,3,5,3,2,0,0,0
"Feb 24, 2021 12:00 PM",43,19,24,105,46,59,94,48,46,70,39,31,,,,16,,,,17,14,3,9,23,11,12,15,35,5,4,6,4,2,0,0,0
"Feb 24, 2021 1:00 PM",56,26,30,90,48,42,90,36,54,70,33,37,,,,7,,,,14,13,1,13,42,27,15,21,37,9,2,7,5,2,0,0,0
"Feb 24, 2021 2:00 PM",45,25,20,56,34,22,82,47,35,70,40,30,,,,20,,,,18,15,3,16,34,18,16,19,28,3,2,12,7,5,0,0,0
"Feb 24, 2021 3:00 PM",46,23,23,114,59,55,97,45,52,101,51,50,,,,25,,,,12,9,3,7,26,16,10,28,19,7,3,19,10,9,0,0,0
"Feb 24, 2021 4:00 PM",86,29,57,123,74,49,116,74,42,111,70,41,,,,28,,,,37,32,5,12,50,33,17,45,40,9,1,13,6,7,0,0,0
"Feb 24, 2021 5:00 PM",100,28,72,106,46,60,110,46,64,87,29,58,,,,16,,,,40,38,2,20,68,44,24,49,43,8,2,11,4,7,0,0,0
"Feb 24, 2021 6:00 PM",71,22,49,69,41,28,75,46,29,75,43,32,,,,11,,,,37,32,5,10,51,32,19,41,31,0,2,25,11,14,0,0,0
"Feb 24, 2021 7:00 PM",53,16,37,53,33,20,61,33,28,50,29,21,,,,2,,,,23,20,3,10,44,23,21,29,35,3,5,7,3,4,0,0,0
"Feb 24, 2021 8:00 PM",34,14,20,32,18,14,28,12,16,29,16,13,,,,16,,,,8,7,1,1,10,7,3,12,25,2,0,1,1,0,0,0,0
"Feb 24, 2021 9:00 PM",20,7,13,23,16,7,23,12,11,23,13,10,,,,6,,,,13,12,1,5,15,11,4,10,17,0,3,2,1,1,0,0,0
"Feb 24, 2021 10:00 PM",10,5,5,4,2,2,6,4,2,7,3,4,,,,3,,,,8,8,0,1,9,5,4,8,2,1,1,0,0,0,0,0,0
"Feb 24, 2021 11:00 PM",4,1,3,7,2,5,6,2,4,6,0,6,,,,3,,,,2,2,0,0,9,5,4,3,1,1,0,1,0,1,0,0,0
"Feb 25, 2021 12:00 AM",2,1,1,0,0,0,0,0,0,0,0,0,,,,0,,,,1,1,0,0,0,0,0,2,2,0,0,0,0,0,0,0,0
"Feb 25, 2021 1:00 AM",0,0,0,3,3,0,0,0,0,0,0,0,,,,0,,,,0,0,0,0,0,0,0,1,2,0,0,0,0,0,0,0,0
"Feb 25, 2021 2:00 AM",4,3,1,1,1,0,1,1,0,1,1,0,,,,0,,,,0,0,0,0,0,0,0,0,0,0,0,0,0,0,0,0,0
"Feb 25, 2021 3:00 AM",0,0,0,0,0,0,0,0,0,0,0,0,,,,1,,,,0,0,0,0,0,0,0,0,2,0,1,0,0,0,0,0,0
"Feb 25, 2021 4:00 AM",1,1,0,0,0,0,1,1,0,0,0,0,,,,1,,,,0,0,0,0,0,0,0,0,0,0,0,1,1,0,0,0,0
"Feb 25, 2021 5:00 AM",1,1,0,3,2,1,1,1,0,3,3,0,,,,1,,,,3,3,0,2,0,0,0,4,4,0,0,0,0,0,0,0,0
"Feb 25, 2021 6:00 AM",25,20,5,12,8,4,16,9,7,9,5,4,,,,2,,,,4,4,0,5,1,0,1,15,23,0,1,0,0,0,0,0,0
"Feb 25, 2021 7:00 AM",56,32,24,107,56,51,144,88,56,95,54,41,,,,6,,,,9,8,1,27,3,3,0,56,51,4,3,2,2,0,0,0,0
"Feb 25, 2021 8:00 AM",90,61,29,143,57,86,156,70,86,101,46,55,,,,17,,,,15,11,4,53,44,27,17,42,88,3,3,8,6,2,0,0,0
"Feb 25, 2021 9:00 AM",92,68,24,86,40,46,107,47,60,93,40,53,,,,5,,,,18,13,5,30,47,28,19,21,52,1,4,2,1,1,0,0,0
"Feb 25, 2021 10:00 AM",49,33,16,125,63,62,144,81,63,116,63,53,,,,25,,,,14,11,3,22,54,39,15,29,28,2,3,2,2,0,0,0,0
"Feb 25, 2021 11:00 AM",48,26,22,160,83,77,176,101,75,133,73,60,,,,18,,,,19,15,4,17,43,38,5,44,37,7,3,9,8,1,0,0,0
"Feb 25, 2021 12:00 PM",58,22,36,209,125,84,251,147,104,174,101,73,,,,30,,,,24,21,3,25,78,66,12,63,47,10,10,10,3,7,0,0,0
"Feb 25, 2021 1:00 PM",81,44,37,168,95,73,197,84,113,150,75,75,,,,13,,,,18,14,4,23,81,63,18,38,49,10,9,10,8,2,0,0,0
"Feb 25, 2021 2:00 PM",77,36,41,126,61,65,119,59,60,114,63,51,,,,23,,,,25,20,5,20,80,55,25,56,32,4,4,9,6,3,0,0,0
"Feb 25, 2021 3:00 PM",69,25,44,136,70,66,159,95,64,133,78,55,,,,30,,,,24,19,5,18,69,42,27,48,48,6,3,12,7,5,0,0,0
"Feb 25, 2021 4:00 PM",113,41,72,181,96,85,202,110,92,182,99,83,,,,49,,,,36,29,7,22,75,48,27,49,52,7,6,11,5,6,0,0,0
"Feb 25, 2021 5:00 PM",123,31,92,207,111,96,234,123,111,231,126,105,,,,26,,,,56,53,3,35,77,55,22,68,72,9,6,10,6,4,0,0,0
"Feb 25, 2021 6:00 PM",110,41,69,141,68,73,160,76,84,135,60,75,,,,12,,,,54,52,2,22,86,59,27,55,67,9,4,6,3,3,0,0,0
"Feb 25, 2021 7:00 PM",67,30,37,48,25,23,73,31,42,68,33,35,,,,10,,,,27,26,1,8,62,35,27,36,32,1,3,5,4,1,0,0,0
"Feb 25, 2021 8:00 PM",22,7,15,19,11,8,33,11,22,23,10,13,,,,4,,,,16,15,1,5,26,12,14,18,17,0,1,5,1,4,0,0,0
"Feb 25, 2021 9:00 PM",24,6,18,19,10,9,16,6,10,12,6,6,,,,0,,,,6,6,0,8,17,10,7,6,15,1,1,3,1,2,0,0,0
"Feb 25, 2021 10:00 PM",8,3,5,13,9,4,13,8,5,10,4,6,,,,1,,,,5,5,0,4,11,4,7,6,6,0,0,3,2,1,0,0,0
"Feb 25, 2021 11:00 PM",3,1,2,7,5,2,5,2,3,3,2,1,,,,4,,,,9,8,1,1,6,5,1,6,6,0,0,0,0,0,0,0,0
"Feb 26, 2021 12:00 AM",2,1,1,0,0,0,0,0,0,2,0,2,,,,0,,,,1,1,0,2,3,0,3,4,0,1,0,1,1,0,0,0,0
"Feb 26, 2021 1:00 AM",4,1,3,1,1,0,2,1,1,2,1,1,,,,1,,,,1,1,0,0,1,0,1,0,1,0,0,0,0,0,0,0,0
"Feb 26, 2021 2:00 AM",4,3,1,0,0,0,1,0,1,0,0,0,,,,0,,,,0,0,0,0,1,1,0,1,0,0,0,0,0,0,0,0,0
"Feb 26, 2021 3:00 AM",1,0,1,0,0,0,0,0,0,0,0,0,,,,0,,,,0,0,0,1,0,0,0,0,0,0,0,0,0,0,0,0,0
"Feb 26, 2021 4:00 AM",1,1,0,0,0,0,1,1,0,0,0,0,,,,0,,,,0,0,0,0,1,0,1,1,0,0,0,0,0,0,0,0,0
"Feb 26, 2021 5:00 AM",0,0,0,0,0,0,1,1,0,2,1,1,,,,1,,,,2,2,0,2,0,0,0,5,8,0,0,0,0,0,0,0,0
"Feb 26, 2021 6:00 AM",23,14,9,16,8,8,20,12,8,17,11,6,,,,0,,,,4,3,1,5,0,0,0,5,31,0,1,1,0,1,0,0,0
"Feb 26, 2021 7:00 AM",47,31,16,114,60,54,123,77,46,98,53,45,,,,6,,,,14,12,2,38,5,4,1,50,56,6,3,4,3,1,0,0,0
"Feb 26, 2021 8:00 AM",89,62,27,133,57,76,146,70,76,109,63,46,,,,8,,,,21,15,6,52,25,18,7,38,85,3,6,13,11,2,0,0,0
"Feb 26, 2021 9:00 AM",78,56,22,108,41,67,128,64,64,94,46,48,,,,8,,,,19,13,6,26,46,31,15,32,39,3,12,3,2,1,0,0,0
"Feb 26, 2021 10:00 AM",47,28,19,152,79,73,174,100,74,135,81,54,,,,14,,,,12,5,7,20,61,49,12,33,41,2,6,7,5,2,0,0,0
"Feb 26, 2021 11:00 AM",58,33,25,196,111,85,229,123,106,165,110,55,,,,23,,,,25,22,3,21,65,54,11,44,44,11,5,14,10,4,0,0,0
"Feb 26, 2021 12:00 PM",80,38,42,220,115,105,245,136,109,193,109,84,,,,40,,,,30,21,9,23,80,60,20,60,53,12,7,20,10,10,0,0,0
"Feb 26, 2021 1:00 PM",81,46,35,238,128,110,274,131,143,205,118,87,,,,35,,,,28,21,7,27,108,65,43,51,52,5,4,14,9,5,0,0,0
"Feb 26, 2021 2:00 PM",116,53,63,228,121,107,244,126,118,220,121,99,,,,23,,,,34,29,5,30,106,69,37,66,56,9,4,13,5,8,0,0,0
"Feb 26, 2021 3:00 PM",94,38,56,237,116,121,271,136,135,227,111,116,,,,28,,,,43,32,11,24,79,47,32,62,78,8,5,22,14,8,0,0,0
"Feb 26, 2021 4:00 PM",113,52,61,285,141,144,284,127,157,246,127,119,,,,40,,,,44,40,4,28,122,73,49,84,77,10,6,22,8,14,0,0,0
"Feb 26, 2021 5:00 PM",115,33,82,217,114,103,259,132,127,197,103,94,,,,39,,,,53,52,1,22,108,57,51,71,86,6,6,18,9,9,0,0,0
"Feb 26, 2021 6:00 PM",84,31,53,122,57,65,163,83,80,137,63,74,,,,25,,,,52,47,5,20,90,60,30,65,52,2,1,5,0,5,0,0,0
"Feb 26, 2021 7:00 PM",78,33,45,48,21,27,77,27,50,57,22,35,,,,9,,,,17,13,4,10,71,42,29,37,37,1,0,3,2,1,0,0,0
"Feb 26, 2021 8:00 PM",38,12,26,35,14,21,25,12,13,22,8,14,,,,6,,,,11,10,1,8,24,12,12,18,21,1,2,1,1,0,0,0,0
"Feb 26, 2021 9:00 PM",26,9,17,11,7,4,23,11,12,14,7,7,,,,8,,,,8,8,0,3,10,1,9,14,14,1,0,0,0,0,0,0,0
"Feb 26, 2021 10:00 PM",12,4,8,9,6,3,9,3,6,7,4,3,,,,5,,,,8,6,2,2,12,5,7,6,6,1,0,2,1,1,0,0,0
"Feb 26, 2021 11:00 PM",8,3,5,2,2,0,8,3,5,6,2,4,,,,2,,,,4,4,0,3,9,7,2,6,9,0,2,1,1,0,0,0,0
"Feb 27, 2021 12:00 AM",9,3,6,0,0,0,5,3,2,5,4,1,,,,1,,,,2,2,0,2,1,0,1,5,0,0,0,3,1,2,0,0,0
"Feb 27, 2021 1:00 AM",4,0,4,0,0,0,1,0,1,0,0,0,,,,0,,,,0,0,0,3,1,1,0,3,3,0,0,0,0,0,0,0,0
"Feb 27, 2021 2:00 AM",6,3,3,0,0,0,2,2,0,1,1,0,,,,0,,,,2,1,1,2,2,2,0,1,2,1,0,1,1,0,0,0,0
"Feb 27, 2021 3:00 AM",1,1,0,0,0,0,0,0,0,0,0,0,,,,0,,,,2,2,0,0,1,1,0,1,1,0,0,2,1,1,0,0,0
"Feb 27, 2021 4:00 AM",1,0,1,0,0,0,0,0,0,0,0,0,,,,1,,,,0,0,0,0,0,0,0,0,0,0,0,0,0,0,0,0,0
"Feb 27, 2021 5:00 AM",0,0,0,0,0,0,2,1,1,3,1,2,,,,1,,,,1,1,0,1,0,0,0,2,4,0,0,0,0,0,0,0,0
"Feb 27, 2021 6:00 AM",11,9,2,6,4,2,6,5,1,4,3,1,,,,0,,,,1,1,0,4,0,0,0,2,14,0,0,0,0,0,0,0,0
"Feb 27, 2021 7:00 AM",14,7,7,59,40,19,63,51,12,67,46,21,,,,1,,,,2,2,0,3,9,9,0,29,18,0,3,1,0,1,0,0,0
"Feb 27, 2021 8:00 AM",14,3,11,133,78,55,121,72,49,105,67,38,,,,4,,,,9,9,0,13,18,16,2,29,44,2,3,4,3,1,0,0,0
"Feb 27, 2021 9:00 AM",69,39,30,249,130,119,292,173,119,217,129,88,,,,15,,,,21,16,5,19,44,28,16,71,46,12,15,5,5,0,0,0,0
"Feb 27, 2021 10:00 AM",63,36,27,372,215,157,500,305,195,422,272,150,,,,26,,,,24,18,6,37,94,83,11,96,94,16,9,6,3,3,0,0,0
"Feb 27, 2021 11:00 AM",135,63,72,511,294,217,556,332,224,449,265,184,,,,34,,,,34,30,4,50,180,154,26,157,122,19,9,11,7,4,0,0,0
"Feb 27, 2021 12:00 PM",95,48,47,453,212,241,574,290,284,424,201,223,,,,58,,,,24,23,1,60,215,154,61,122,114,6,17,22,15,7,0,0,0
"Feb 27, 2021 1:00 PM",104,62,42,421,217,204,496,237,259,422,205,217,,,,33,,,,33,28,5,44,207,132,75,122,142,16,12,5,4,1,0,0,0
"Feb 27, 2021 2:00 PM",93,51,42,304,154,150,356,170,186,262,142,120,,,,22,,,,19,15,4,28,203,106,97,80,81,23,10,16,11,5,0,0,0
"Feb 27, 2021 3:00 PM",77,42,35,278,158,120,331,157,174,289,155,134,,,,40,,,,22,19,3,34,137,96,41,68,91,6,0,9,8,1,0,0,0
"Feb 27, 2021 4:00 PM",97,41,56,323,166,157,349,142,207,332,143,189,,,,53,,,,30,27,3,27,157,99,58,62,84,8,2,11,8,3,0,0,0
"Feb 27, 2021 5:00 PM",58,21,37,184,72,112,236,91,145,204,90,114,,,,47,,,,27,21,6,23,122,53,69,50,84,5,8,3,2,1,0,0,0
"Feb 27, 2021 6:00 PM",50,21,29,65,31,34,101,41,60,76,31,45,,,,18,,,,15,14,1,20,118,48,70,25,51,1,1,3,1,2,0,0,0
"Feb 27, 2021 7:00 PM",53,23,30,44,15,29,41,8,33,34,10,24,,,,9,,,,12,10,2,14,50,18,32,15,27,3,1,1,1,0,0,0,0
"Feb 27, 2021 8:00 PM",34,13,21,12,6,6,31,16,15,14,9,5,,,,7,,,,9,7,2,11,25,15,10,14,17,2,0,1,1,0,0,0,0
"Feb 27, 2021 9:00 PM",19,5,14,21,12,9,18,9,9,22,10,12,,,,5,,,,4,4,0,4,10,4,6,2,13,3,0,1,1,0,0,0,0
"Feb 27, 2021 10:00 PM",14,9,5,13,2,11,11,0,11,16,1,15,,,,2,,,,3,3,0,1,14,11,3,5,12,0,1,0,0,0,0,0,0
"Feb 27, 2021 11:00 PM",7,2,5,13,6,7,6,2,4,2,1,1,,,,4,,,,6,6,0,7,4,2,2,2,7,0,1,0,0,0,0,0,0
"Feb 28, 2021 12:00 AM",4,1,3,0,0,0,0,0,0,3,2,1,,,,2,,,,5,5,0,1,0,0,0,1,4,0,0,0,0,0,0,0,0
"Feb 28, 2021 1:00 AM",2,1,1,3,0,3,4,2,2,4,1,3,,,,0,,,,4,4,0,1,3,3,0,3,1,0,0,0,0,0,0,0,0
"Feb 28, 2021 2:00 AM",4,1,3,0,0,0,1,0,1,0,0,0,,,,0,,,,2,2,0,0,0,0,0,0,1,0,0,0,0,0,0,0,0
"Feb 28, 2021 3:00 AM",3,0,3,0,0,0,0,0,0,0,0,0,,,,0,,,,1,1,0,0,0,0,0,1,0,0,0,0,0,0,0,0,0
"Feb 28, 2021 4:00 AM",1,0,1,0,0,0,1,1,0,0,0,0,,,,0,,,,1,1,0,0,0,0,0,0,1,0,0,0,0,0,0,0,0
"Feb 28, 2021 5:00 AM",0,0,0,0,0,0,0,0,0,0,0,0,,,,1,,,,0,0,0,0,0,0,0,1,3,0,0,0,0,0,0,0,0
"Feb 28, 2021 6:00 AM",5,4,1,2,2,0,12,8,4,7,5,2,,,,4,,,,2,1,1,5,0,0,0,7,8,0,1,1,1,0,0,0,0
"Feb 28, 2021 7:00 AM",16,7,9,61,38,23,64,43,21,57,40,17,,,,2,,,,6,5,1,3,5,5,0,23,18,0,1,4,2,2,0,0,0
"Feb 28, 2021 8:00 AM",27,15,12,152,86,66,136,79,57,139,82,57,,,,6,,,,8,6,2,9,18,15,3,36,46,3,4,4,0,4,0,0,0
"Feb 28, 2021 9:00 AM",51,25,26,317,204,113,289,191,98,297,193,104,,,,14,,,,27,27,0,30,53,35,18,76,67,9,14,3,0,3,0,0,0
"Feb 28, 2021 10:00 AM",84,53,31,394,220,174,515,322,193,430,258,172,,,,20,,,,25,21,4,46,109,95,14,122,114,18,16,11,6,5,0,0,0
"Feb 28, 2021 11:00 AM",133,71,62,599,327,272,674,392,282,550,337,213,,,,54,,,,52,40,12,53,192,157,35,203,116,19,12,17,13,4,0,0,0
"Feb 28, 2021 12:00 PM",132,94,38,638,332,306,805,468,337,626,357,269,,,,56,,,,49,43,6,52,211,154,57,194,179,28,12,23,14,9,0,0,0
"Feb 28, 2021 1:00 PM",133,79,54,504,262,242,753,335,418,566,270,296,,,,53,,,,32,30,2,49,286,175,111,169,216,9,17,28,19,9,0,0,0
"Feb 28, 2021 2:00 PM",163,80,83,508,241,267,663,315,348,538,256,282,,,,63,,,,67,54,13,37,260,156,104,170,175,28,12,30,22,8,0,0,0
"Feb 28, 2021 3:00 PM",149,83,66,405,230,175,556,244,312,435,233,202,,,,85,,,,33,31,2,44,268,169,99,132,176,12,8,13,8,5,0,0,0
"Feb 28, 2021 4:00 PM",130,64,66,402,197,205,381,165,216,375,166,209,,,,61,,,,43,37,6,41,261,139,122,66,145,14,8,17,11,6,0,0,0
"Feb 28, 2021 5:00 PM",105,33,72,166,63,103,230,78,152,192,70,122,,,,14,,,,30,26,4,28,167,67,100,37,100,4,2,11,8,3,0,0,0
"Feb 28, 2021 6:00 PM",54,24,30,62,18,44,104,26,78,75,11,64,,,,12,,,,10,9,1,12,103,40,63,24,46,6,1,7,6,1,0,0,0
"Feb 28, 2021 7:00 PM",39,20,19,11,7,4,21,4,17,18,5,13,,,,5,,,,10,8,2,7,52,16,36,4,25,2,2,5,4,1,0,0,0
"Feb 28, 2021 8:00 PM",29,16,13,4,3,1,7,5,2,12,8,4,,,,10,,,,5,5,0,3,6,1,5,9,20,1,1,5,1,4,0,0,0
"Feb 28, 2021 9:00 PM",13,9,4,21,11,10,18,11,7,17,7,10,,,,6,,,,4,4,0,4,8,1,7,4,9,0,0,2,2,0,0,0,0
"Feb 28, 2021 10:00 PM",9,5,4,2,1,1,3,1,2,1,0,1,,,,2,,,,5,5,0,4,6,5,1,4,4,1,0,0,0,0,0,0,0
"Feb 28, 2021 11:00 PM",4,1,3,7,4,3,4,1,3,4,1,3,,,,2,,,,4,3,1,1,5,2,3,3,5,0,1,0,0,0,0,0,0
"Mar 1, 2021 12:00 AM",1,0,1,1,1,0,1,0,1,1,0,1,,,,0,,,,0,0,0,0,1,1,0,1,0,1,0,1,1,0,0,0,0
"Mar 1, 2021 1:00 AM",1,0,1,0,0,0,1,0,1,0,0,0,,,,0,,,,0,0,0,2,1,1,0,0,0,0,0,0,0,0,0,0,0
"Mar 1, 2021 2:00 AM",1,1,0,0,0,0,0,0,0,0,0,0,,,,0,,,,0,0,0,0,0,0,0,0,0,0,0,0,0,0,0,0,0
"Mar 1, 2021 3:00 AM",0,0,0,0,0,0,0,0,0,0,0,0,,,,0,,,,0,0,0,0,0,0,0,0,0,0,0,0,0,0,0,0,0
"Mar 1, 2021 4:00 AM",1,1,0,0,0,0,1,1,0,1,1,0,,,,0,,,,0,0,0,2,0,0,0,0,0,0,0,0,0,0,0,0,0
"Mar 1, 2021 5:00 AM",3,3,0,0,0,0,1,1,0,3,2,1,,,,1,,,,2,2,0,5,0,0,0,2,8,0,0,0,0,0,0,0,0
"Mar 1, 2021 6:00 AM",18,12,6,19,10,9,21,13,8,17,11,6,,,,0,,,,3,3,0,14,0,0,0,15,27,0,0,1,1,0,0,0,0
"Mar 1, 2021 7:00 AM",61,38,23,105,56,49,94,49,45,88,51,37,,,,11,,,,10,7,3,40,6,5,1,42,70,1,3,3,2,1,0,0,0
"Mar 1, 2021 8:00 AM",113,80,33,120,45,75,133,50,83,109,53,56,,,,21,,,,21,14,7,80,43,25,18,39,74,9,4,9,9,0,0,0,0
"Mar 1, 2021 9:00 AM",72,59,13,103,51,52,100,52,48,95,50,45,,,,12,,,,16,11,5,36,53,13,40,25,51,1,2,1,0,1,0,0,0
"Mar 1, 2021 10:00 AM",54,36,18,73,34,39,84,49,35,72,39,33,,,,11,,,,14,10,4,16,52,29,23,31,24,5,1,5,3,2,0,0,0
"Mar 1, 2021 11:00 AM",40,25,15,82,51,31,118,58,60,73,38,35,,,,13,,,,13,10,3,25,45,24,21,33,29,5,7,6,1,5,0,0,0
"Mar 1, 2021 12:00 PM",60,27,33,108,55,53,109,51,58,98,51,47,,,,26,,,,20,15,5,19,39,24,15,30,41,6,7,13,9,4,0,0,0
"Mar 1, 2021 1:00 PM",55,30,25,145,75,70,181,105,76,123,67,56,,,,21,,,,20,18,2,17,48,27,21,51,34,11,8,9,6,3,0,0,0
"Mar 1, 2021 2:00 PM",70,35,35,132,72,60,181,92,89,111,66,45,,,,26,,,,21,17,4,18,69,38,31,46,52,11,5,7,2,5,0,0,0
"Mar 1, 2021 3:00 PM",74,36,38,128,59,69,136,66,70,101,52,49,,,,27,,,,19,15,4,24,90,56,34,35,38,5,1,9,4,5,0,0,0
"Mar 1, 2021 4:00 PM",103,37,66,169,97,72,165,93,72,143,77,66,,,,33,,,,46,40,6,16,72,44,28,57,42,10,6,15,11,4,0,0,0
"Mar 1, 2021 5:00 PM",149,39,110,158,88,70,168,85,83,175,90,85,,,,30,,,,66,60,6,33,81,51,30,74,67,4,8,5,3,2,0,0,0
"Mar 1, 2021 6:00 PM",79,20,59,108,53,55,112,62,50,97,54,43,,,,13,,,,62,56,6,15,71,49,22,49,50,5,3,6,4,2,0,0,0
"Mar 1, 2021 7:00 PM",54,15,39,44,25,19,61,33,28,44,21,23,,,,13,,,,26,24,2,5,68,50,18,47,21,2,2,1,0,1,0,0,0
"Mar 1, 2021 8:00 PM",36,13,23,30,19,11,26,14,12,29,17,12,,,,3,,,,15,15,0,4,19,12,7,14,15,0,0,1,1,0,0,0,0
"Mar 1, 2021 9:00 PM",14,2,12,16,9,7,11,7,4,10,6,4,,,,3,,,,7,7,0,5,13,8,5,8,13,1,0,2,2,0,0,0,0
"Mar 1, 2021 10:00 PM",5,2,3,3,2,1,10,6,4,8,4,4,,,,5,,,,7,7,0,2,4,4,0,7,5,0,0,1,1,0,0,0,0
"Mar 1, 2021 11:00 PM",6,1,5,1,1,0,1,0,1,2,1,1,,,,3,,,,2,2,0,0,3,1,2,2,1,1,0,0,0,0,0,0,0
"Mar 2, 2021 12:00 AM",2,1,1,3,0,3,0,0,0,1,1,0,,,,0,,,,0,0,0,1,1,1,0,0,2,0,0,1,0,1,0,0,0
"Mar 2, 2021 1:00 AM",1,1,0,0,0,0,1,1,0,2,2,0,,,,0,,,,3,3,0,1,1,1,0,0,0,0,0,0,0,0,0,0,0
"Mar 2, 2021 2:00 AM",3,2,1,0,0,0,0,0,0,0,0,0,,,,1,,,,0,0,0,0,0,0,0,0,1,0,0,0,0,0,0,0,0
"Mar 2, 2021 3:00 AM",0,0,0,0,0,0,0,0,0,0,0,0,,,,0,,,,0,0,0,0,0,0,0,0,1,0,0,0,0,0,0,0,0
"Mar 2, 2021 4:00 AM",1,1,0,0,0,0,1,1,0,1,1,0,,,,0,,,,1,1,0,1,0,0,0,1,1,0,0,0,0,0,0,0,0
"Mar 2, 2021 5:00 AM",1,1,0,1,1,0,4,2,2,4,2,2,,,,1,,,,2,2,0,5,0,0,0,3,7,0,0,0,0,0,0,0,0
"Mar 2, 2021 6:00 AM",21,13,8,17,7,10,25,12,13,22,11,11,,,,1,,,,5,4,1,17,0,0,0,15,25,1,0,0,0,0,0,0,0
"Mar 2, 2021 7:00 AM",81,47,34,102,53,49,100,55,45,86,49,37,,,,9,,,,17,12,5,43,19,12,7,48,69,3,2,8,3,5,0,0,0
"Mar 2, 2021 8:00 AM",118,89,29,118,47,71,121,44,77,109,45,64,,,,20,,,,23,18,5,73,52,25,27,33,87,7,6,10,9,1,0,0,0
"Mar 2, 2021 9:00 AM",67,48,19,81,45,36,77,47,30,69,41,28,,,,7,,,,31,17,14,39,69,19,50,21,35,0,8,3,2,1,0,0,0
"Mar 2, 2021 10:00 AM",33,22,11,47,25,22,69,38,31,49,32,17,,,,14,,,,17,5,12,21,27,16,11,12,28,4,1,5,2,3,0,0,0
"Mar 2, 2021 11:00 AM",47,29,18,87,42,45,96,51,45,65,35,30,,,,7,,,,26,13,13,19,24,13,11,21,21,7,5,6,4,2,0,0,0
"Mar 2, 2021 12:00 PM",62,31,31,122,71,51,132,74,58,101,54,47,,,,18,,,,27,18,9,17,49,32,17,55,43,5,4,5,3,2,0,0,0
"Mar 2, 2021 1:00 PM",73,41,32,115,55,60,132,74,58,113,66,47,,,,18,,,,25,10,15,27,53,32,21,46,39,9,6,5,1,4,0,0,0
"Mar 2, 2021 2:00 PM",57,33,24,111,61,50,161,94,67,109,62,47,,,,27,,,,13,10,3,14,44,27,17,39,43,5,10,9,7,2,0,0,0
"Mar 2, 2021 3:00 PM",59,24,35,114,62,52,118,58,60,91,50,41,,,,23,,,,29,20,9,17,60,39,21,33,53,10,4,9,5,4,0,0,0
"Mar 2, 2021 4:00 PM",92,30,62,100,51,49,125,61,64,97,44,53,,,,30,,,,57,45,12,23,45,27,18,57,68,4,3,2,1,1,0,0,0
"Mar 2, 2021 5:00 PM",123,31,92,115,66,49,122,69,53,130,68,62,,,,21,,,,69,54,15,21,67,35,32,67,43,3,8,1,0,1,0,0,0
"Mar 2, 2021 6:00 PM",101,32,69,93,50,43,125,67,58,100,52,48,,,,18,,,,37,37,0,22,65,35,30,59,46,4,3,2,0,2,0,0,0
"Mar 2, 2021 7:00 PM",53,20,33,41,23,18,40,21,19,33,15,18,,,,10,,,,29,29,0,16,38,22,16,41,32,3,3,7,5,2,0,0,0
"Mar 2, 2021 8:00 PM",30,6,24,20,13,7,35,20,15,28,12,16,,,,2,,,,10,10,0,7,21,12,9,20,23,1,1,3,1,2,0,0,0
"Mar 2, 2021 9:00 PM",13,5,8,9,5,4,8,7,1,10,5,5,,,,3,,,,9,9,0,6,13,8,5,4,10,1,0,0,0,0,0,0,0
"Mar 2, 2021 10:00 PM",9,2,7,2,1,1,4,2,2,5,2,3,,,,2,,,,7,7,0,2,11,6,5,6,4,0,0,2,0,2,0,0,0
"Mar 2, 2021 11:00 PM",3,0,3,1,1,0,1,1,0,0,0,0,,,,0,,,,4,4,0,1,2,0,2,2,3,1,0,2,2,0,0,0,0
"Mar 3, 2021 12:00 AM",0,0,0,0,0,0,2,0,2,2,2,0,,,,0,,,,0,0,0,0,1,1,0,1,0,0,0,0,0,0,0,0,0
"Mar 3, 2021 1:00 AM",0,0,0,0,0,0,0,0,0,1,1,0,,,,0,,,,1,1,0,0,0,0,0,1,0,0,0,0,0,0,0,0,0
"Mar 3, 2021 2:00 AM",3,3,0,0,0,0,0,0,0,0,0,0,,,,0,,,,0,0,0,0,0,0,0,1,1,1,0,0,0,0,0,0,0
"Mar 3, 2021 3:00 AM",0,0,0,0,0,0,0,0,0,0,0,0,,,,0,,,,0,0,0,0,0,0,0,0,0,0,0,0,0,0,0,0,0
"Mar 3, 2021 4:00 AM",1,0,1,0,0,0,2,2,0,0,0,0,,,,0,,,,0,0,0,1,0,0,0,1,1,0,0,0,0,0,0,0,0
"Mar 3, 2021 5:00 AM",3,3,0,1,1,0,1,1,0,3,3,0,,,,0,,,,1,1,0,3,0,0,0,2,6,0,0,0,0,0,0,0,0
"Mar 3, 2021 6:00 AM",24,16,8,23,13,10,24,14,10,17,12,5,,,,2,,,,8,8,0,12,1,0,1,9,28,0,0,1,1,0,0,0,0
"Mar 3, 2021 7:00 AM",68,44,24,96,47,49,90,43,47,90,40,50,,,,13,,,,12,11,1,47,7,7,0,36,63,3,4,1,1,0,0,0,0
"Mar 3, 2021 8:00 AM",126,91,35,102,38,64,112,40,72,92,42,50,,,,14,,,,36,19,17,68,28,22,6,35,76,10,7,6,6,0,0,0,0
"Mar 3, 2021 9:00 AM",71,59,12,80,36,44,87,40,47,86,42,44,,,,6,,,,21,20,1,26,63,30,33,32,49,6,4,5,4,1,0,0,0
"Mar 3, 2021 10:00 AM",50,31,19,76,41,35,80,52,28,75,51,24,,,,20,,,,16,8,8,23,41,21,20,21,31,8,2,4,2,2,0,0,0
"Mar 3, 2021 11:00 AM",53,31,22,92,45,47,105,54,51,85,39,46,,,,15,,,,19,14,5,26,21,12,9,30,26,6,4,6,5,1,0,0,0
"Mar 3, 2021 12:00 PM",58,31,27,87,48,39,118,66,52,99,58,41,,,,17,,,,28,23,5,29,25,16,9,34,47,7,3,5,3,2,0,0,0
"Mar 3, 2021 1:00 PM",66,33,33,88,54,34,127,69,58,88,46,42,,,,10,,,,33,26,7,15,36,19,17,36,37,12,6,9,6,3,0,0,0
"Mar 3, 2021 2:00 PM",45,24,21,104,60,44,130,64,66,93,52,41,,,,43,,,,20,13,7,18,54,34,20,25,33,5,5,16,5,11,0,0,0
"Mar 3, 2021 3:00 PM",42,13,29,73,31,42,99,44,55,73,31,42,,,,24,,,,26,23,3,21,53,34,19,34,41,5,2,11,7,4,0,0,0
"Mar 3, 2021 4:00 PM",82,28,54,81,41,40,94,48,46,96,49,47,,,,27,,,,43,34,9,16,39,19,20,49,29,1,6,14,10,4,0,0,0
"Mar 3, 2021 5:00 PM",113,27,86,100,52,48,112,55,57,96,46,50,,,,13,,,,85,53,32,21,51,32,19,64,49,4,2,12,2,10,0,0,0
"Mar 3, 2021 6:00 PM",84,24,60,70,41,29,102,58,44,86,51,35,,,,25,,,,75,29,46,24,50,34,16,52,43,2,2,10,7,3,0,0,0
"Mar 3, 2021 7:00 PM",58,15,43,34,19,15,57,31,26,40,25,15,,,,10,,,,18,18,0,10,46,27,19,29,26,2,0,1,1,0,0,0,0
"Mar 3, 2021 8:00 PM",27,8,19,29,17,12,30,20,10,28,21,7,,,,6,,,,16,15,1,6,29,16,13,22,21,4,0,2,1,1,0,0,0
"Mar 3, 2021 9:00 PM",18,8,10,23,11,12,13,5,8,15,5,10,,,,11,,,,9,9,0,7,9,8,1,11,7,0,0,2,1,1,0,0,0
"Mar 3, 2021 10:00 PM",17,7,10,5,3,2,10,7,3,8,6,2,,,,6,,,,4,4,0,5,9,5,4,6,7,0,0,0,0,0,0,0,0
"Mar 3, 2021 11:00 PM",3,1,2,1,1,0,5,0,5,1,0,1,,,,4,,,,3,3,0,1,6,4,2,1,4,1,0,0,0,0,0,0,0
"Mar 4, 2021 12:00 AM",1,1,0,0,0,0,2,1,1,0,0,0,,,,0,,,,4,4,0,1,1,1,0,2,0,2,0,0,0,0,0,0,0
"Mar 4, 2021 1:00 AM",2,1,1,0,0,0,0,0,0,0,0,0,,,,0,,,,0,0,0,0,2,2,0,0,0,0,0,0,0,0,0,0,0
"Mar 4, 2021 2:00 AM",7,2,5,0,0,0,0,0,0,0,0,0,,,,0,,,,0,0,0,0,0,0,0,0,1,0,0,0,0,0,0,0,0
"Mar 4, 2021 3:00 AM",0,0,0,0,0,0,0,0,0,0,0,0,,,,0,,,,1,1,0,0,0,0,0,0,0,0,0,0,0,0,0,0,0
"Mar 4, 2021 4:00 AM",0,0,0,0,0,0,2,2,0,1,1,0,,,,5,,,,3,3,0,1,1,1,0,0,0,0,0,0,0,0,0,0,0
"Mar 4, 2021 5:00 AM",1,1,0,0,0,0,2,1,1,3,2,1,,,,0,,,,2,2,0,4,0,0,0,2,4,0,0,1,1,0,0,0,0
"Mar 4, 2021 6:00 AM",18,12,6,10,7,3,19,14,5,14,10,4,,,,2,,,,4,4,0,8,0,0,0,14,22,1,1,2,1,1,0,0,0
"Mar 4, 2021 7:00 AM",70,44,26,65,27,38,65,32,33,57,24,33,,,,11,,,,10,10,0,45,6,6,0,36,58,1,1,3,3,0,0,0,0
"Mar 4, 2021 8:00 AM",114,83,31,101,42,59,124,50,74,100,50,50,,,,14,,,,29,13,16,65,15,6,9,38,82,5,4,9,7,2,0,0,0
"Mar 4, 2021 9:00 AM",71,52,19,72,33,39,79,39,40,76,36,40,,,,12,,,,25,19,6,33,67,34,33,26,37,3,5,7,5,2,0,0,0
"Mar 4, 2021 10:00 AM",47,29,18,73,39,34,73,45,28,58,39,19,,,,16,,,,65,7,58,20,43,22,21,19,37,2,8,6,2,4,0,0,0
"Mar 4, 2021 11:00 AM",31,13,18,83,39,44,62,32,30,56,30,26,,,,17,,,,53,8,45,18,16,12,4,26,27,7,6,4,2,2,0,0,0
"Mar 4, 2021 12:00 PM",48,27,21,81,39,42,98,45,53,74,37,37,,,,22,,,,34,17,17,22,20,6,14,24,34,6,3,8,5,3,0,0,0
"Mar 4, 2021 1:00 PM",63,36,27,86,43,43,102,51,51,72,37,35,,,,29,,,,18,12,6,18,27,17,10,33,28,3,2,8,5,3,0,0,0
"Mar 4, 2021 2:00 PM",54,27,27,77,43,34,90,47,43,80,44,36,,,,27,,,,40,17,23,12,25,17,8,23,36,4,5,11,3,8,0,0,0
"Mar 4, 2021 3:00 PM",73,37,36,79,35,44,104,49,55,68,33,35,,,,27,,,,25,12,13,20,37,20,17,43,32,4,4,12,5,7,0,0,0
"Mar 4, 2021 4:00 PM",91,25,66,75,47,28,118,62,56,91,55,36,,,,17,,,,39,29,10,12,44,33,11,45,38,5,5,16,6,10,0,0,0
"Mar 4, 2021 5:00 PM",105,37,68,74,34,40,112,63,49,91,42,49,,,,26,,,,88,47,41,23,71,41,30,54,50,5,4,10,4,6,0,0,0
"Mar 4, 2021 6:00 PM",83,21,62,55,39,16,79,45,34,60,36,24,,,,20,,,,53,49,4,23,47,26,21,44,37,4,3,9,4,5,0,0,0
"Mar 4, 2021 7:00 PM",53,16,37,35,20,15,56,23,33,56,29,27,,,,18,,,,27,25,2,8,30,20,10,27,25,3,0,8,3,5,0,0,0
"Mar 4, 2021 8:00 PM",28,6,22,24,14,10,23,16,7,23,13,10,,,,10,,,,13,13,0,2,30,14,16,20,15,0,0,5,5,0,0,0,0
"Mar 4, 2021 9:00 PM",19,6,13,8,4,4,12,7,5,10,3,7,,,,7,,,,7,7,0,5,11,5,6,7,10,0,0,3,1,2,0,0,0
"Mar 4, 2021 10:00 PM",10,5,5,3,0,3,8,3,5,6,2,4,,,,4,,,,8,7,1,5,7,4,3,8,5,0,1,6,2,4,0,0,0
"Mar 4, 2021 11:00 PM",7,4,3,1,1,0,1,0,1,0,0,0,,,,1,,,,11,11,0,1,3,2,1,3,2,0,0,3,2,1,0,0,0
"Mar 5, 2021 12:00 AM",4,1,3,0,0,0,0,0,0,0,0,0,,,,0,,,,2,1,1,0,0,0,0,2,0,1,0,1,1,0,0,0,0
"Mar 5, 2021 1:00 AM",1,0,1,0,0,0,0,0,0,0,0,0,,,,0,,,,2,2,0,0,0,0,0,0,0,0,0,0,0,0,0,0,0
"Mar 5, 2021 2:00 AM",4,3,1,0,0,0,0,0,0,0,0,0,,,,1,,,,0,0,0,4,0,0,0,1,1,0,0,0,0,0,0,0,0
"Mar 5, 2021 3:00 AM",1,0,1,0,0,0,1,0,1,0,0,0,,,,0,,,,1,1,0,0,0,0,0,1,1,0,0,0,0,0,0,0,0
"Mar 5, 2021 4:00 AM",1,1,0,0,0,0,1,1,0,0,0,0,,,,0,,,,3,3,0,0,0,0,0,1,1,0,0,0,0,0,0,0,0
"Mar 5, 2021 5:00 AM",3,3,0,0,0,0,4,2,2,4,2,2,,,,0,,,,2,2,0,6,0,0,0,4,9,0,0,1,1,0,0,0,0
"Mar 5, 2021 6:00 AM",21,15,6,19,11,8,18,11,7,12,8,4,,,,1,,,,3,3,0,11,0,0,0,9,28,0,0,1,0,1,0,0,0
"Mar 5, 2021 7:00 AM",56,39,17,113,68,45,119,70,49,96,56,40,,,,10,,,,5,5,0,34,5,4,1,36,57,1,1,4,3,1,0,0,0
"Mar 5, 2021 8:00 AM",124,80,44,115,54,61,59,19,40,116,66,50,,,,21,,,,34,13,21,61,30,21,9,35,79,8,6,9,8,1,0,0,0
"Mar 5, 2021 9:00 AM",55,40,15,89,36,53,53,26,27,97,52,45,,,,6,,,,30,18,12,27,49,24,25,34,37,1,7,3,1,2,0,0,0
"Mar 5, 2021 10:00 AM",42,22,20,86,51,35,57,30,27,78,52,26,,,,12,,,,7,7,0,18,41,24,17,17,27,8,6,6,6,0,0,0,0
"Mar 5, 2021 11:00 AM",40,26,14,97,44,53,3,3,0,107,58,49,,,,10,,,,37,16,21,16,37,29,8,26,33,9,9,12,7,5,0,0,0
"Mar 5, 2021 12:00 PM",53,24,29,120,61,59,26,18,8,94,48,46,,,,15,,,,52,23,29,14,46,32,14,42,38,10,5,15,8,7,0,0,0
"Mar 5, 2021 1:00 PM",96,53,43,110,56,54,134,60,74,106,59,47,,,,23,,,,28,16,12,36,49,27,22,32,52,10,7,12,5,7,0,0,0
"Mar 5, 2021 2:00 PM",69,34,35,104,55,49,34,29,5,84,49,35,,,,25,,,,25,20,5,21,44,35,9,35,36,9,3,18,7,11,0,0,0
"Mar 5, 2021 3:00 PM",66,33,33,152,84,68,56,47,9,146,83,63,,,,20,,,,64,27,37,32,61,42,19,55,38,7,5,16,8,8,0,0,0
"Mar 5, 2021 4:00 PM",101,41,60,154,71,83,198,88,110,148,57,91,,,,19,,,,36,27,9,35,62,40,22,52,57,7,5,10,6,4,0,0,0
"Mar 5, 2021 5:00 PM",113,31,82,145,69,76,187,100,87,126,73,53,,,,15,,,,64,44,20,27,91,48,43,70,57,6,2,13,7,6,0,0,0
"Mar 5, 2021 6:00 PM",87,30,57,111,56,55,144,58,86,107,48,59,,,,31,,,,45,43,2,22,93,57,36,60,61,1,4,7,5,2,0,0,0
"Mar 5, 2021 7:00 PM",53,25,28,42,19,23,67,36,31,45,26,19,,,,16,,,,20,20,0,10,49,34,15,34,29,1,1,3,1,2,0,0,0
"Mar 5, 2021 8:00 PM",29,8,21,21,12,9,41,25,16,29,18,11,,,,9,,,,10,9,1,7,30,20,10,16,19,0,0,4,2,2,0,0,0
"Mar 5, 2021 9:00 PM",19,6,13,9,2,7,15,2,13,7,3,4,,,,2,,,,13,13,0,5,9,5,4,10,15,1,0,0,0,0,0,0,0
"Mar 5, 2021 10:00 PM",13,7,6,8,2,6,16,9,7,7,2,5,,,,1,,,,7,7,0,9,4,1,3,7,7,0,0,1,0,1,0,0,0
"Mar 5, 2021 11:00 PM",17,6,11,3,1,2,5,2,3,5,4,1,,,,8,,,,4,4,0,3,6,2,4,5,8,2,0,1,1,0,0,0,0
"Mar 6, 2021 12:00 AM",5,2,3,0,0,0,2,0,2,4,0,4,,,,2,,,,1,1,0,2,1,0,1,2,5,0,0,0,0,0,0,0,0
"Mar 6, 2021 1:00 AM",4,1,3,0,0,0,6,4,2,2,1,1,,,,2,,,,2,2,0,3,0,0,0,2,2,1,0,0,0,0,0,0,0
"Mar 6, 2021 2:00 AM",0,0,0,4,3,1,4,3,1,3,2,1,,,,0,,,,2,2,0,1,0,0,0,1,2,0,1,1,0,1,0,0,0
"Mar 6, 2021 3:00 AM",1,1,0,5,3,2,0,0,0,3,3,0,,,,0,,,,0,0,0,0,2,2,0,0,2,0,0,0,0,0,0,0,0
"Mar 6, 2021 4:00 AM",1,1,0,1,1,0,2,0,2,2,0,2,,,,0,,,,0,0,0,0,0,0,0,1,0,0,0,0,0,0,0,0,0
"Mar 6, 2021 5:00 AM",1,1,0,0,0,0,0,0,0,0,0,0,,,,2,,,,1,1,0,1,0,0,0,4,2,0,0,0,0,0,0,0,0
"Mar 6, 2021 6:00 AM",4,2,2,2,1,1,9,6,3,6,3,3,,,,4,,,,1,1,0,4,0,0,0,5,4,0,0,0,0,0,0,0,0
"Mar 6, 2021 7:00 AM",17,6,11,31,18,13,36,21,15,31,17,14,,,,1,,,,5,4,1,4,2,2,0,20,24,0,1,0,0,0,0,0,0
"Mar 6, 2021 8:00 AM",21,13,8,119,69,50,98,61,37,88,55,33,,,,5,,,,14,9,5,12,11,6,5,24,22,6,4,6,3,3,0,0,0
"Mar 6, 2021 9:00 AM",43,23,20,182,111,71,173,99,74,188,113,75,,,,13,,,,32,10,22,31,32,18,14,43,54,4,7,3,1,2,0,0,0
"Mar 6, 2021 10:00 AM",69,36,33,234,132,102,268,164,104,251,152,99,,,,21,,,,37,19,18,31,72,50,22,74,69,17,12,6,2,4,0,0,0
"Mar 6, 2021 11:00 AM",100,50,50,329,173,156,292,158,134,277,150,127,,,,34,,,,44,32,12,43,85,59,26,80,101,15,9,18,10,8,0,0,0
"Mar 6, 2021 12:00 PM",94,58,36,337,134,203,342,163,179,349,165,184,,,,26,,,,40,26,14,35,108,70,38,78,98,15,11,21,14,7,0,0,0
"Mar 6, 2021 1:00 PM",139,85,54,331,185,146,400,232,168,346,192,154,,,,37,,,,40,26,14,38,117,71,46,95,85,14,7,30,17,13,0,0,0
"Mar 6, 2021 2:00 PM",141,57,84,363,208,155,431,254,177,353,210,143,,,,50,,,,45,33,12,41,165,111,54,83,74,12,14,27,16,11,0,0,0
"Mar 6, 2021 3:00 PM",114,58,56,391,205,186,528,263,265,394,196,198,,,,50,,,,38,38,0,44,137,98,39,102,85,9,13,16,5,11,0,0,0
"Mar 6, 2021 4:00 PM",87,46,41,314,158,156,406,189,217,317,145,172,,,,45,,,,26,26,0,29,215,125,90,59,130,6,13,19,8,11,0,0,0
"Mar 6, 2021 5:00 PM",127,37,90,155,72,83,248,81,167,179,61,118,,,,29,,,,25,25,0,32,132,72,60,49,88,14,4,23,12,11,0,0,0
"Mar 6, 2021 6:00 PM",69,27,42,43,18,25,88,31,57,48,20,28,,,,15,,,,25,24,1,20,88,41,47,20,42,3,7,4,1,3,0,0,0
"Mar 6, 2021 7:00 PM",58,24,34,22,8,14,32,15,17,17,6,11,,,,7,,,,10,10,0,10,42,14,28,18,17,2,3,5,3,2,0,0,0
"Mar 6, 2021 8:00 PM",38,19,19,18,6,12,23,8,15,17,10,7,,,,11,,,,13,12,1,10,10,4,6,8,11,0,1,6,3,3,0,0,0
"Mar 6, 2021 9:00 PM",20,9,11,4,2,2,22,11,11,11,6,5,,,,9,,,,2,2,0,5,4,1,3,2,12,0,0,1,0,1,0,0,0
"Mar 6, 2021 10:00 PM",10,5,5,6,3,3,7,2,5,7,3,4,,,,4,,,,8,7,1,5,4,3,1,0,8,1,0,3,3,0,0,0,0
"Mar 6, 2021 11:00 PM",11,1,10,5,3,2,8,7,1,3,2,1,,,,1,,,,1,1,0,4,4,0,4,2,2,0,0,0,0,0,0,0,0
"Mar 7, 2021 12:00 AM",6,4,2,0,0,0,2,2,0,3,2,1,,,,4,,,,4,4,0,1,0,0,0,4,5,1,0,1,1,0,0,0,0
"Mar 7, 2021 1:00 AM",5,3,2,1,1,0,4,0,4,3,2,1,,,,1,,,,3,3,0,1,0,0,0,1,0,0,0,2,0,2,0,0,0
"Mar 7, 2021 2:00 AM",3,2,1,0,0,0,1,0,1,1,0,1,,,,1,,,,1,1,0,0,0,0,0,0,2,0,0,0,0,0,0,0,0
"Mar 7, 2021 3:00 AM",5,2,3,0,0,0,0,0,0,0,0,0,,,,0,,,,0,0,0,0,0,0,0,0,1,0,0,0,0,0,0,0,0
"Mar 7, 2021 4:00 AM",2,1,1,0,0,0,1,1,0,1,1,0,,,,0,,,,0,0,0,0,0,0,0,0,0,0,0,0,0,0,0,0,0
"Mar 7, 2021 5:00 AM",2,0,2,0,0,0,0,0,0,1,0,1,,,,1,,,,0,0,0,3,1,1,0,0,5,0,0,0,0,0,0,0,0
"Mar 7, 2021 6:00 AM",4,3,1,9,8,1,17,16,1,10,9,1,,,,1,,,,1,1,0,3,0,0,0,10,3,0,0,1,1,0,0,0,0
"Mar 7, 2021 7:00 AM",9,7,2,33,20,13,50,33,17,31,22,9,,,,3,,,,3,2,1,7,12,12,0,23,24,1,1,0,0,0,0,0,0
"Mar 7, 2021 8:00 AM",26,13,13,122,69,53,134,80,54,111,64,47,,,,4,,,,7,7,0,7,8,6,2,27,43,7,4,5,1,4,0,0,0
"Mar 7, 2021 9:00 AM",61,29,32,250,157,93,237,141,96,220,149,71,,,,21,,,,17,16,1,21,37,28,9,54,58,3,16,7,0,7,0,0,0
"Mar 7, 2021 10:00 AM",75,46,29,426,244,182,408,247,161,397,256,141,,,,19,,,,23,20,3,35,136,112,24,119,90,12,20,25,17,8,0,0,0
"Mar 7, 2021 11:00 AM",141,83,58,491,281,210,472,267,205,447,265,182,,,,32,,,,31,29,2,50,128,106,22,144,137,29,15,30,20,10,0,0,0
"Mar 7, 2021 12:00 PM",116,57,59,584,285,299,587,329,258,569,323,246,,,,56,,,,45,43,2,46,166,124,42,167,167,27,16,17,8,9,0,0,0
"Mar 7, 2021 1:00 PM",116,62,54,587,300,287,630,347,283,594,339,255,,,,38,,,,38,38,0,45,219,146,73,166,150,25,19,28,20,8,0,0,0
"Mar 7, 2021 2:00 PM",145,78,67,509,249,260,583,251,332,539,247,292,,,,60,,,,36,34,2,41,170,99,71,89,158,12,12,31,18,13,0,0,0
"Mar 7, 2021 3:00 PM",120,62,58,444,207,237,551,277,274,446,226,220,,,,53,,,,32,31,1,32,198,147,51,115,151,15,8,18,14,4,0,0,0
"Mar 7, 2021 4:00 PM",106,32,74,339,148,191,551,234,317,393,159,234,,,,68,,,,28,28,0,52,207,108,99,99,178,4,9,25,18,7,0,0,0
"Mar 7, 2021 5:00 PM",72,29,43,191,95,96,309,127,182,205,98,107,,,,38,,,,16,15,1,37,208,71,137,67,90,7,5,5,2,3,0,0,0
"Mar 7, 2021 6:00 PM",60,25,35,96,41,55,128,35,93,78,23,55,,,,16,,,,8,8,0,15,119,51,68,25,66,0,3,8,4,4,0,0,0
"Mar 7, 2021 7:00 PM",33,15,18,23,8,15,33,10,23,34,8,26,,,,7,,,,9,9,0,4,41,17,24,14,23,1,0,3,1,2,0,0,0
"Mar 7, 2021 8:00 PM",21,12,9,12,4,8,14,3,11,9,2,7,,,,5,,,,7,7,0,3,20,11,9,11,13,0,1,3,1,2,0,0,0
"Mar 7, 2021 9:00 PM",12,4,8,7,6,1,12,6,6,12,9,3,,,,2,,,,6,6,0,10,5,1,4,6,8,0,0,1,1,0,0,0,0
"Mar 7, 2021 10:00 PM",7,5,2,4,4,0,4,3,1,3,3,0,,,,3,,,,2,2,0,3,5,2,3,5,8,0,1,2,1,1,0,0,0
"Mar 7, 2021 11:00 PM",3,2,1,1,0,1,3,2,1,3,2,1,,,,1,,,,4,4,0,2,2,2,0,1,2,0,0,2,1,1,0,0,0
"Mar 8, 2021 12:00 AM",3,1,2,0,0,0,0,0,0,2,1,1,,,,0,,,,2,1,1,0,0,0,0,3,0,0,0,0,0,0,0,0,0
"Mar 8, 2021 1:00 AM",0,0,0,2,2,0,1,1,0,0,0,0,,,,0,,,,1,1,0,1,0,0,0,0,0,0,0,1,1,0,0,0,0
"Mar 8, 2021 2:00 AM",2,1,1,3,0,3,1,0,1,3,0,3,,,,0,,,,0,0,0,0,1,1,0,0,0,0,0,0,0,0,0,0,0
"Mar 8, 2021 3:00 AM",2,1,1,0,0,0,0,0,0,0,0,0,,,,0,,,,0,0,0,0,1,0,1,1,0,0,0,0,0,0,0,0,0
"Mar 8, 2021 4:00 AM",0,0,0,3,2,1,0,0,0,0,0,0,,,,0,,,,1,1,0,1,0,0,0,0,1,0,0,0,0,0,0,0,0
"Mar 8, 2021 5:00 AM",5,5,0,1,1,0,3,1,2,4,3,1,,,,0,,,,1,1,0,4,0,0,0,3,9,0,0,1,1,0,0,0,0
"Mar 8, 2021 6:00 AM",28,19,9,15,7,8,21,13,8,14,7,7,,,,3,,,,2,2,0,13,1,1,0,11,35,0,0,0,0,0,0,0,0
"Mar 8, 2021 7:00 AM",71,45,26,86,38,48,86,41,45,73,39,34,,,,16,,,,4,4,0,48,6,5,1,39,61,4,1,5,4,1,0,0,0
"Mar 8, 2021 8:00 AM",117,83,34,97,34,63,126,45,81,93,42,51,,,,24,,,,45,13,32,65,45,25,20,36,80,6,2,10,7,3,0,0,0
"Mar 8, 2021 9:00 AM",77,58,19,81,35,46,88,44,44,73,35,38,,,,11,,,,38,19,19,20,60,24,36,26,40,2,3,3,1,2,0,0,0
"Mar 8, 2021 10:00 AM",46,28,18,78,47,31,91,54,37,66,46,20,,,,6,,,,19,7,12,9,47,21,26,26,27,5,4,3,2,1,0,0,0
"Mar 8, 2021 11:00 AM",43,25,18,129,69,60,133,74,59,120,66,54,,,,16,,,,24,11,13,8,39,29,10,31,34,7,3,6,3,3,0,0,0
"Mar 8, 2021 12:00 PM",65,23,42,156,87,69,164,88,76,161,89,72,,,,16,,,,45,11,34,10,40,23,17,36,48,7,4,8,2,6,0,0,0
"Mar 8, 2021 1:00 PM",69,34,35,138,67,71,147,70,77,134,67,67,,,,14,,,,38,25,13,12,44,29,15,31,51,12,3,17,14,3,0,0,0
"Mar 8, 2021 2:00 PM",45,31,14,136,60,76,128,68,60,112,49,63,,,,18,,,,23,19,4,5,61,40,21,39,45,6,4,18,7,11,0,0,0
"Mar 8, 2021 3:00 PM",73,35,38,99,58,41,106,62,44,96,55,41,,,,27,,,,24,22,2,17,51,28,23,30,47,6,5,12,4,8,0,0,0
"Mar 8, 2021 4:00 PM",95,32,63,121,65,56,125,68,57,108,57,51,,,,30,,,,51,43,8,18,60,39,21,56,38,2,2,6,4,2,0,0,0
"Mar 8, 2021 5:00 PM",121,34,87,106,66,40,179,99,80,108,63,45,,,,20,,,,45,44,1,20,63,35,28,54,56,8,5,11,3,8,0,0,0
"Mar 8, 2021 6:00 PM",77,19,58,100,53,47,118,68,50,99,58,41,,,,21,,,,43,43,0,25,78,54,24,48,43,4,7,7,5,2,0,0,0
"Mar 8, 2021 7:00 PM",58,16,42,43,22,21,58,29,29,42,23,19,,,,11,,,,22,22,0,10,50,36,14,24,16,2,4,4,1,3,0,0,0
"Mar 8, 2021 8:00 PM",29,9,20,33,16,17,35,17,18,37,17,20,,,,11,,,,13,13,0,5,26,16,10,18,13,1,2,6,2,4,0,0,0
"Mar 8, 2021 9:00 PM",22,2,20,6,3,3,11,5,6,6,2,4,,,,7,,,,10,10,0,4,14,6,8,3,10,3,0,2,2,0,0,0,0
"Mar 8, 2021 10:00 PM",7,3,4,5,3,2,6,4,2,10,5,5,,,,0,,,,7,7,0,4,8,1,7,8,5,0,0,0,0,0,0,0,0
"Mar 8, 2021 11:00 PM",2,0,2,6,0,6,3,1,2,1,0,1,,,,2,,,,2,2,0,1,2,2,0,5,3,2,0,3,1,2,0,0,0
"Mar 9, 2021 12:00 AM",1,0,1,0,0,0,2,0,2,2,1,1,,,,1,,,,0,0,0,1,0,0,0,1,2,0,0,1,1,0,0,0,0
"Mar 9, 2021 1:00 AM",1,0,1,0,0,0,1,1,0,2,2,0,,,,0,,,,1,1,0,0,2,2,0,0,1,0,0,0,0,0,0,0,0
"Mar 9, 2021 2:00 AM",4,2,2,1,1,0,1,1,0,1,1,0,,,,0,,,,0,0,0,0,0,0,0,0,0,0,0,0,0,0,0,0,0
"Mar 9, 2021 3:00 AM",0,0,0,0,0,0,0,0,0,0,0,0,,,,0,,,,0,0,0,0,2,2,0,0,0,0,0,0,0,0,0,0,0
"Mar 9, 2021 4:00 AM",1,1,0,0,0,0,1,1,0,0,0,0,,,,0,,,,0,0,0,2,0,0,0,1,1,0,0,1,1,0,0,0,0
"Mar 9, 2021 5:00 AM",2,2,0,1,1,0,3,3,0,5,3,2,,,,1,,,,2,2,0,6,0,0,0,3,6,0,0,0,0,0,0,0,0
"Mar 9, 2021 6:00 AM",33,21,12,21,11,10,31,15,16,19,10,9,,,,2,,,,5,5,0,9,1,1,0,15,31,0,0,2,0,2,0,0,0
"Mar 9, 2021 7:00 AM",66,44,22,74,37,37,107,61,46,85,50,35,,,,13,,,,14,14,0,42,7,6,1,48,65,5,2,8,7,1,0,0,0
"Mar 9, 2021 8:00 AM",126,89,37,101,39,62,123,65,58,107,47,60,,,,23,,,,36,19,17,65,39,24,15,47,91,9,8,9,8,1,0,0,0
"Mar 9, 2021 9:00 AM",67,47,20,101,63,38,98,73,25,86,62,24,,,,12,,,,26,17,9,35,70,31,39,31,40,1,6,19,10,9,0,0,0
"Mar 9, 2021 10:00 AM",37,25,12,106,46,60,118,60,58,99,55,44,,,,9,,,,15,8,7,17,70,43,27,30,29,1,3,8,5,3,0,0,0
"Mar 9, 2021 11:00 AM",48,28,20,136,70,66,104,56,48,119,59,60,,,,15,,,,32,13,19,10,34,22,12,33,46,5,5,11,4,7,0,0,0
"Mar 9, 2021 12:00 PM",57,24,33,150,77,73,136,80,56,123,74,49,,,,21,,,,27,18,9,20,38,21,17,30,41,3,3,4,3,1,0,0,0
"Mar 9, 2021 1:00 PM",61,35,26,111,54,57,106,40,66,99,42,57,,,,14,,,,22,18,4,20,53,25,28,27,48,13,6,11,4,7,0,0,0
"Mar 9, 2021 2:00 PM",54,30,24,61,35,26,56,35,21,56,36,20,,,,26,,,,27,14,13,12,44,22,22,23,28,1,0,10,4,6,0,0,0
"Mar 9, 2021 3:00 PM",64,28,36,63,31,32,45,25,20,59,32,27,,,,33,,,,66,12,54,14,27,15,12,28,32,4,1,15,8,7,0,0,0
"Mar 9, 2021 4:00 PM",81,25,56,61,39,22,85,48,37,68,38,30,,,,6,,,,46,38,8,16,27,11,16,48,38,5,4,7,0,7,0,0,0
"Mar 9, 2021 5:00 PM",109,30,79,74,40,34,81,47,34,64,39,25,,,,17,,,,42,41,1,18,44,33,11,54,41,2,5,11,3,8,0,0,0
"Mar 9, 2021 6:00 PM",75,17,58,53,33,20,76,47,29,70,41,29,,,,16,,,,34,33,1,17,48,30,18,41,30,3,0,10,4,6,0,0,0
"Mar 9, 2021 7:00 PM",53,14,39,18,13,5,24,16,8,18,14,4,,,,14,,,,23,20,3,7,40,28,12,24,24,0,0,9,6,3,0,0,0
"Mar 9, 2021 8:00 PM",19,9,10,5,4,1,13,9,4,7,6,1,,,,2,,,,10,10,0,4,8,5,3,13,13,1,0,3,2,1,0,0,0
"Mar 9, 2021 9:00 PM",10,4,6,2,1,1,4,2,2,6,3,3,,,,1,,,,5,5,0,3,7,4,3,6,6,1,0,0,0,0,0,0,0
"Mar 9, 2021 10:00 PM",5,2,3,2,2,0,3,3,0,6,5,1,,,,0,,,,3,3,0,1,7,2,5,1,4,0,0,0,0,0,0,0,0
"Mar 9, 2021 11:00 PM",1,0,1,3,1,2,0,0,0,2,0,2,,,,0,,,,3,3,0,1,1,0,1,1,2,0,0,0,0,0,0,0,0
"Mar 10, 2021 12:00 AM",2,1,1,0,0,0,0,0,0,0,0,0,,,,0,,,,0,0,0,0,0,0,0,2,1,1,0,1,1,0,0,0,0
"Mar 10, 2021 1:00 AM",1,0,1,0,0,0,1,0,1,5,5,0,,,,0,,,,0,0,0,1,1,1,0,0,3,0,0,0,0,0,0,0,0
"Mar 10, 2021 2:00 AM",2,1,1,0,0,0,0,0,0,0,0,0,,,,0,,,,0,0,0,1,0,0,0,0,0,0,0,0,0,0,0,0,0
"Mar 10, 2021 3:00 AM",1,0,1,0,0,0,1,0,1,0,0,0,,,,0,,,,0,0,0,0,0,0,0,0,0,0,0,0,0,0,0,0,0
"Mar 10, 2021 4:00 AM",1,1,0,0,0,0,1,1,0,0,0,0,,,,0,,,,0,0,0,0,0,0,0,1,0,0,0,0,0,0,0,0,0
"Mar 10, 2021 5:00 AM",1,1,0,1,1,0,2,2,0,4,3,1,,,,1,,,,1,1,0,7,2,1,1,4,2,0,0,0,0,0,0,0,0
"Mar 10, 2021 6:00 AM",19,13,6,16,10,6,17,11,6,14,9,5,,,,4,,,,6,6,0,8,1,1,0,10,25,0,0,0,0,0,0,0,0
"Mar 10, 2021 7:00 AM",48,33,15,30,14,16,40,23,17,31,14,17,,,,4,,,,7,7,0,35,11,8,3,27,43,1,0,3,2,1,0,0,0
"Mar 10, 2021 8:00 AM",78,60,18,48,16,32,66,22,44,47,19,28,,,,15,,,,15,13,2,50,27,10,17,27,57,6,5,7,4,3,0,0,0
"Mar 10, 2021 9:00 AM",54,41,13,46,22,24,51,26,25,45,27,18,,,,5,,,,13,9,4,31,40,22,18,23,17,1,1,3,1,2,0,0,0
"Mar 10, 2021 10:00 AM",24,12,12,46,21,25,46,18,28,35,15,20,,,,2,,,,11,5,6,8,11,3,8,11,21,2,1,2,2,0,0,0,0
"Mar 10, 2021 11:00 AM",16,8,8,9,5,4,11,2,9,6,1,5,,,,3,,,,12,3,9,6,9,2,7,8,12,2,1,1,1,0,0,0,0
"Mar 10, 2021 12:00 PM",32,11,21,19,11,8,24,12,12,19,9,10,,,,5,,,,11,9,2,7,4,3,1,9,11,2,0,1,0,1,0,0,0
"Mar 10, 2021 1:00 PM",32,16,16,21,10,11,22,11,11,20,10,10,,,,2,,,,29,11,18,7,9,4,5,9,11,2,1,1,1,0,0,0,0
"Mar 10, 2021 2:00 PM",28,17,11,21,15,6,25,14,11,21,15,6,,,,12,,,,19,10,9,13,3,3,0,9,19,1,0,3,3,0,0,0,0
"Mar 10, 2021 3:00 PM",32,13,19,36,21,15,32,18,14,33,19,14,,,,9,,,,19,7,12,12,17,9,8,14,12,1,3,5,1,4,0,0,0
"Mar 10, 2021 4:00 PM",50,14,36,51,30,21,40,25,15,42,23,19,,,,11,,,,40,18,22,8,22,17,5,21,17,2,1,2,2,0,0,0,0
"Mar 10, 2021 5:00 PM",68,19,49,40,23,17,42,24,18,38,23,15,,,,8,,,,35,29,6,8,19,8,11,35,29,1,0,9,6,3,0,0,0
"Mar 10, 2021 6:00 PM",56,12,44,37,24,13,42,30,12,42,25,17,,,,15,,,,29,29,0,8,15,10,5,38,32,3,1,9,3,6,0,0,0
"Mar 10, 2021 7:00 PM",35,11,24,32,16,16,33,19,14,25,12,13,,,,5,,,,16,14,2,6,16,8,8,28,16,1,0,0,0,0,0,0,0
"Mar 10, 2021 8:00 PM",18,8,10,10,10,0,19,12,7,14,9,5,,,,8,,,,11,11,0,6,8,6,2,7,13,0,0,2,0,2,0,0,0
"Mar 10, 2021 9:00 PM",12,4,8,3,1,2,9,6,3,6,4,2,,,,1,,,,7,7,0,4,4,3,1,8,7,0,0,0,0,0,0,0,0
"Mar 10, 2021 10:00 PM",3,2,1,1,1,0,2,2,0,2,1,1,,,,0,,,,3,3,0,3,0,0,0,2,1,0,0,0,0,0,0,0,0
"Mar 10, 2021 11:00 PM",3,0,3,0,0,0,1,1,0,0,0,0,,,,1,,,,4,4,0,0,1,1,0,2,1,0,0,2,2,0,0,0,0
"Mar 11, 2021 12:00 AM",2,1,1,0,0,0,0,0,0,0,0,0,,,,0,,,,0,0,0,1,0,0,0,0,0,1,0,1,0,1,0,0,0
"Mar 11, 2021 1:00 AM",1,0,1,0,0,0,0,0,0,0,0,0,,,,0,,,,2,2,0,0,2,2,0,0,0,0,0,1,1,0,0,0,0
"Mar 11, 2021 2:00 AM",3,1,2,0,0,0,0,0,0,0,0,0,,,,0,,,,0,0,0,0,0,0,0,0,0,0,0,0,0,0,0,0,0
"Mar 11, 2021 3:00 AM",0,0,0,0,0,0,0,0,0,0,0,0,,,,0,,,,0,0,0,1,0,0,0,0,0,0,0,0,0,0,0,0,0
"Mar 11, 2021 4:00 AM",0,0,0,0,0,0,0,0,0,0,0,0,,,,0,,,,0,0,0,0,0,0,0,0,0,0,0,0,0,0,0,0,0
"Mar 11, 2021 5:00 AM",2,2,0,0,0,0,2,2,0,2,2,0,,,,1,,,,3,3,0,3,1,1,0,1,4,0,0,0,0,0,0,0,0
"Mar 11, 2021 6:00 AM",15,11,4,10,5,5,9,4,5,7,4,3,,,,1,,,,4,4,0,10,2,2,0,6,18,0,0,0,0,0,0,0,0
"Mar 11, 2021 7:00 AM",47,26,21,50,19,31,69,33,36,55,22,33,,,,5,,,,7,5,2,37,25,13,12,38,50,5,2,2,1,1,0,0,0
"Mar 11, 2021 8:00 AM",107,71,36,75,30,45,98,45,53,65,33,32,,,,10,,,,59,11,48,51,59,27,32,31,61,3,3,6,4,2,0,0,0
"Mar 11, 2021 9:00 AM",58,42,16,64,37,27,71,40,31,62,37,25,,,,12,,,,29,16,13,25,40,23,17,20,32,3,1,4,2,2,0,0,0
"Mar 11, 2021 10:00 AM",45,32,13,64,26,38,79,46,33,54,30,24,,,,12,,,,38,11,27,12,28,15,13,15,20,2,3,4,4,0,0,0,0
"Mar 11, 2021 11:00 AM",32,19,13,69,37,32,64,29,35,50,22,28,,,,9,,,,63,8,55,11,28,19,9,17,19,3,2,4,3,1,0,0,0
"Mar 11, 2021 12:00 PM",53,26,27,83,43,40,76,39,37,64,33,31,,,,26,,,,38,11,27,10,30,18,12,23,27,4,3,2,1,1,0,0,0
"Mar 11, 2021 1:00 PM",47,25,22,40,21,19,71,29,42,35,13,22,,,,13,,,,54,11,43,21,18,10,8,20,26,3,3,3,2,1,0,0,0
"Mar 11, 2021 2:00 PM",41,19,22,37,23,14,51,28,23,44,27,17,,,,7,,,,26,6,20,7,8,6,2,14,24,0,2,7,2,5,0,0,0
"Mar 11, 2021 3:00 PM",34,8,26,31,17,14,36,16,20,24,13,11,,,,12,,,,37,11,26,12,20,10,10,18,27,3,2,6,5,1,0,0,0
"Mar 11, 2021 4:00 PM",61,26,35,38,25,13,55,33,22,43,26,17,,,,15,,,,52,25,27,12,33,21,12,34,27,5,0,3,2,1,0,0,0
"Mar 11, 2021 5:00 PM",91,26,65,91,54,37,91,54,37,87,54,33,,,,21,,,,46,30,16,11,38,27,11,49,51,4,5,6,4,2,0,0,0
"Mar 11, 2021 6:00 PM",74,28,46,54,35,19,76,49,27,52,29,23,,,,8,,,,42,39,3,17,25,22,3,37,27,1,2,1,1,0,0,0,0
"Mar 11, 2021 7:00 PM",40,9,31,27,17,10,23,12,11,23,15,8,,,,12,,,,22,18,4,7,13,6,7,20,23,1,1,2,1,1,0,0,0
"Mar 11, 2021 8:00 PM",19,6,13,13,4,9,15,10,5,10,8,2,,,,8,,,,14,11,3,3,10,8,2,17,9,1,0,1,1,0,0,0,0
"Mar 11, 2021 9:00 PM",10,0,10,16,8,8,17,7,10,17,8,9,,,,2,,,,7,7,0,2,5,2,3,6,8,2,1,1,0,1,0,0,0
"Mar 11, 2021 10:00 PM",7,2,5,2,1,1,6,3,3,7,1,6,,,,2,,,,6,6,0,2,5,3,2,5,10,0,1,0,0,0,0,0,0
"Mar 11, 2021 11:00 PM",2,1,1,0,0,0,4,3,1,1,1,0,,,,1,,,,2,2,0,0,1,1,0,2,1,0,0,1,1,0,0,0,0
"Mar 12, 2021 12:00 AM",4,1,3,0,0,0,0,0,0,1,0,1,,,,0,,,,1,1,0,0,2,1,1,3,0,1,0,2,2,0,0,0,0
"Mar 12, 2021 1:00 AM",1,0,1,2,1,1,1,1,0,2,2,0,,,,0,,,,0,0,0,1,1,1,0,2,0,0,0,0,0,0,0,0,0
"Mar 12, 2021 2:00 AM",2,1,1,1,1,0,1,0,1,0,0,0,,,,1,,,,0,0,0,0,1,0,1,0,0,0,0,0,0,0,0,0,0
"Mar 12, 2021 3:00 AM",0,0,0,0,0,0,0,0,0,0,0,0,,,,0,,,,0,0,0,0,0,0,0,0,0,0,0,0,0,0,0,0,0
"Mar 12, 2021 4:00 AM",1,1,0,0,0,0,0,0,0,0,0,0,,,,0,,,,1,1,0,1,0,0,0,1,0,0,0,0,0,0,0,0,0
"Mar 12, 2021 5:00 AM",0,0,0,2,1,1,4,3,1,4,2,2,,,,0,,,,2,2,0,2,1,1,0,1,4,0,0,0,0,0,0,0,0
"Mar 12, 2021 6:00 AM",16,10,6,12,7,5,12,6,6,8,4,4,,,,1,,,,7,7,0,6,3,1,2,8,21,0,1,0,0,0,0,0,0
"Mar 12, 2021 7:00 AM",49,34,15,45,27,18,72,39,33,57,32,25,,,,7,,,,4,4,0,26,25,16,9,30,47,1,1,1,0,1,,,
"Mar 12, 2021 8:00 AM",93,60,33,67,26,41,82,37,45,70,32,38,,,,12,,,,10,9,1,49,57,38,19,37,65,4,6,9,7,2,0,0,0
"Mar 12, 2021 9:00 AM",56,38,18,70,38,32,89,55,34,61,34,27,,,,9,,,,20,8,12,23,35,25,10,31,39,1,1,3,1,2,0,0,0
"Mar 12, 2021 10:00 AM",48,31,17,65,31,34,90,53,37,61,39,22,,,,10,,,,11,11,0,12,29,21,8,27,32,5,4,0,0,0,0,0,0
"Mar 12, 2021 11:00 AM",37,20,17,84,44,40,85,39,46,62,34,28,,,,13,,,,15,13,2,13,29,23,6,16,35,6,3,9,7,2,0,0,0
"Mar 12, 2021 12:00 PM",46,16,30,80,39,41,96,60,36,61,33,28,,,,19,,,,13,13,0,20,32,25,7,21,15,9,2,8,6,2,0,0,0
"Mar 12, 2021 1:00 PM",49,28,21,88,51,37,142,69,73,88,39,49,,,,16,,,,15,10,5,23,54,41,13,25,42,3,2,7,4,3,0,0,0
"Mar 12, 2021 2:00 PM",51,25,26,84,49,35,96,49,47,67,40,27,,,,18,,,,14,14,0,15,49,29,20,24,20,5,2,9,6,3,0,0,0
"Mar 12, 2021 3:00 PM",51,23,28,109,48,61,86,39,47,80,35,45,,,,25,,,,16,12,4,17,52,33,19,33,34,5,3,6,2,4,0,0,0
"Mar 12, 2021 4:00 PM",74,30,44,85,52,33,113,52,61,87,48,39,,,,16,,,,49,24,25,23,43,28,15,43,31,8,6,11,7,4,0,0,0
"Mar 12, 2021 5:00 PM",105,27,78,75,32,43,96,53,43,73,35,38,,,,23,,,,29,29,0,14,50,36,14,42,41,2,2,2,1,1,0,0,0
"Mar 12, 2021 6:00 PM",62,19,43,33,19,14,47,26,21,44,21,23,,,,22,,,,23,23,0,12,23,18,5,40,22,1,1,6,3,3,0,0,0
"Mar 12, 2021 7:00 PM",45,20,25,19,15,4,30,19,11,25,16,9,,,,10,,,,25,25,0,5,5,4,1,26,26,3,1,4,3,1,0,0,0
"Mar 12, 2021 8:00 PM",21,11,10,11,5,6,15,6,9,14,6,8,,,,6,,,,4,4,0,6,7,4,3,8,13,1,0,3,2,1,0,0,0
"Mar 12, 2021 9:00 PM",15,2,13,1,0,1,5,2,3,4,3,1,,,,3,,,,1,1,0,5,1,1,0,7,6,0,0,1,1,0,0,0,0
"Mar 12, 2021 10:00 PM",8,5,3,4,3,1,4,3,1,5,3,2,,,,2,,,,3,3,0,1,1,0,1,5,3,0,0,0,0,0,0,0,0
"Mar 12, 2021 11:00 PM",8,2,6,1,0,1,1,1,0,0,0,0,,,,1,,,,4,4,0,2,4,3,1,2,3,1,0,1,1,0,0,0,0
"Mar 13, 2021 12:00 AM",5,2,3,0,0,0,1,1,0,5,3,2,,,,3,,,,3,3,0,2,0,0,0,3,1,1,0,2,1,1,,,
"Mar 13, 2021 1:00 AM",2,1,1,0,0,0,0,0,0,0,0,0,,,,0,,,,3,3,0,0,1,1,0,0,0,0,1,2,1,1,0,0,0
"Mar 13, 2021 2:00 AM",5,2,3,1,1,0,2,2,0,1,1,0,,,,0,,,,2,2,0,0,0,0,0,1,0,0,0,0,0,0,0,0,0
"Mar 13, 2021 3:00 AM",1,0,1,1,1,0,1,1,0,1,1,0,,,,0,,,,0,0,0,0,0,0,0,0,1,0,1,0,0,0,0,0,0
"Mar 13, 2021 4:00 AM",1,1,0,0,0,0,0,0,0,0,0,0,,,,0,,,,0,0,0,0,2,2,0,0,0,0,0,0,0,0,0,0,0
"Mar 13, 2021 5:00 AM",2,2,0,0,0,0,0,0,0,0,0,0,,,,0,,,,2,2,0,0,0,0,0,1,2,1,0,0,0,0,0,0,0
"Mar 13, 2021 6:00 AM",5,3,2,6,2,4,3,2,1,5,3,2,,,,3,,,,2,2,0,1,1,1,0,3,4,0,2,1,1,0,0,0,0
"Mar 13, 2021 7:00 AM",18,5,13,25,17,8,36,27,9,24,21,3,,,,1,,,,5,5,0,6,9,8,1,15,13,0,1,0,0,0,0,0,0
"Mar 13, 2021 8:00 AM",31,12,19,86,55,31,83,50,33,71,40,31,,,,7,,,,6,6,0,12,31,25,6,27,35,2,6,2,0,2,0,0,0
"Mar 13, 2021 9:00 AM",41,18,23,137,84,53,152,92,60,122,72,50,,,,8,,,,15,14,1,20,49,37,12,36,22,5,4,8,6,2,0,0,0
"Mar 13, 2021 10:00 AM",54,33,21,158,98,60,181,105,76,172,116,56,,,,8,,,,14,14,0,21,53,32,21,52,56,2,5,2,2,0,0,0,0
"Mar 13, 2021 11:00 AM",77,40,37,220,121,99,238,135,103,184,103,81,,,,12,,,,15,15,0,20,70,50,20,69,65,1,5,6,4,2,0,0,0
"Mar 13, 2021 12:00 PM",80,53,27,233,125,108,251,129,122,209,118,91,,,,33,,,,23,23,0,33,87,54,33,57,69,5,4,4,3,1,0,0,0
"Mar 13, 2021 1:00 PM",85,40,45,179,91,88,223,123,100,201,109,92,,,,32,,,,18,18,0,20,104,80,24,45,60,6,9,6,6,0,0,0,0
"Mar 13, 2021 2:00 PM",62,35,27,186,90,96,204,85,119,156,76,80,,,,27,,,,11,10,1,34,91,49,42,35,54,7,5,2,1,1,0,0,0
"Mar 13, 2021 3:00 PM",77,36,41,159,75,84,189,86,103,164,86,78,,,,19,,,,15,15,0,21,93,58,35,40,48,13,4,11,10,1,0,0,0
"Mar 13, 2021 4:00 PM",70,29,41,115,46,69,136,47,89,106,37,69,,,,20,,,,22,22,0,17,37,16,21,29,55,3,2,11,7,4,0,0,0
"Mar 13, 2021 5:00 PM",41,21,20,41,16,25,62,22,40,42,11,31,,,,16,,,,8,8,0,12,30,8,22,16,28,4,1,1,0,1,0,0,0
"Mar 13, 2021 6:00 PM",25,11,14,23,9,14,30,17,13,18,12,6,,,,3,,,,7,7,0,8,13,4,9,20,11,2,2,0,0,0,0,0,0
"Mar 13, 2021 7:00 PM",35,14,21,11,5,6,16,9,7,10,6,4,,,,6,,,,5,5,0,3,2,1,1,7,18,0,0,3,1,2,0,0,0
"Mar 13, 2021 8:00 PM",18,10,8,5,3,2,6,4,2,8,5,3,,,,3,,,,1,1,0,4,4,3,1,3,8,0,0,1,0,1,0,0,0
"Mar 13, 2021 9:00 PM",12,3,9,7,4,3,16,5,11,7,4,3,,,,2,,,,3,3,0,1,0,0,0,2,9,0,0,2,2,0,0,0,0
"Mar 13, 2021 10:00 PM",6,2,4,2,2,0,5,3,2,3,3,0,,,,0,,,,2,2,0,2,1,1,0,2,7,2,0,2,2,0,0,0,0
"Mar 13, 2021 11:00 PM",5,3,2,0,0,0,2,1,1,1,0,1,,,,1,,,,1,1,0,4,0,0,0,3,0,0,1,0,0,0,0,0,0
"Mar 14, 2021 12:00 AM",6,3,3,1,1,0,1,1,0,3,2,1,,,,0,,,,0,0,0,1,1,0,1,1,5,0,0,0,0,0,0,0,0
"Mar 14, 2021 1:00 AM",1,0,1,1,0,1,0,0,0,0,0,0,,,,0,,,,3,3,0,1,0,0,0,0,1,0,0,0,0,0,0,0,0
"Mar 14, 2021 2:00 AM",0,0,0,0,0,0,0,0,0,1,0,1,,,,1,,,,0,0,0,0,0,0,0,1,0,0,0,0,0,0,0,0,0
"Mar 14, 2021 3:00 AM",1,0,1,0,0,0,1,0,1,0,0,0,,,,0,,,,4,4,0,0,0,0,0,0,0,0,0,0,0,0,0,0,0
"Mar 14, 2021 4:00 AM",2,0,2,0,0,0,0,0,0,0,0,0,,,,0,,,,3,3,0,4,0,0,0,0,1,0,0,0,0,0,0,0,0
"Mar 14, 2021 5:00 AM",1,1,0,1,1,0,2,1,1,2,1,1,,,,0,,,,1,1,0,1,0,0,0,1,1,0,0,0,0,0,0,0,0
"Mar 14, 2021 6:00 AM",5,5,0,4,3,1,9,7,2,8,6,2,,,,3,,,,0,0,0,3,5,5,0,6,1,0,0,0,0,0,0,0,0
"Mar 14, 2021 7:00 AM",16,8,8,24,14,10,27,20,7,29,21,8,,,,1,,,,2,1,1,5,5,5,0,20,18,0,0,1,1,0,0,0,0
"Mar 14, 2021 8:00 AM",25,10,15,78,38,40,73,43,30,73,40,33,,,,5,,,,9,9,0,11,35,23,12,16,32,2,3,0,0,0,0,0,0
"Mar 14, 2021 9:00 AM",29,12,17,165,112,53,183,110,73,151,92,59,,,,4,,,,20,18,2,15,61,40,21,42,31,4,7,1,1,0,0,0,0
"Mar 14, 2021 10:00 AM",51,20,31,188,87,101,210,115,95,159,81,78,,,,17,,,,11,11,0,27,56,31,25,59,70,10,9,4,3,1,0,0,0
"Mar 14, 2021 11:00 AM",37,17,20,150,66,84,150,70,80,130,65,65,,,,9,,,,13,9,4,17,17,7,10,32,57,5,12,2,2,0,0,0,0
"Mar 14, 2021 12:00 PM",32,15,17,97,42,55,114,47,67,84,35,49,,,,18,,,,18,17,1,20,22,7,15,37,39,9,3,5,5,0,0,0,0
"Mar 14, 2021 1:00 PM",39,17,22,76,37,39,103,56,47,66,33,33,,,,13,,,,6,6,0,17,35,24,11,26,28,2,3,6,5,1,0,0,0
"Mar 14, 2021 2:00 PM",42,22,20,88,39,49,99,45,54,86,48,38,,,,18,,,,9,9,0,12,29,13,16,24,21,2,2,6,2,4,0,0,0
"Mar 14, 2021 3:00 PM",22,10,12,41,27,14,66,38,28,42,26,16,,,,9,,,,7,7,0,8,49,22,27,19,20,3,5,3,1,2,0,0,0
"Mar 14, 2021 4:00 PM",25,12,13,41,18,23,59,30,29,50,25,25,,,,22,,,,7,7,0,8,29,11,18,9,21,0,1,4,3,1,0,0,0
"Mar 14, 2021 5:00 PM",35,18,17,62,35,27,56,34,22,39,26,13,,,,11,,,,5,5,0,18,20,11,9,18,20,2,0,4,1,3,0,0,0
"Mar 14, 2021 6:00 PM",30,19,11,33,17,16,47,17,30,35,18,17,,,,10,,,,6,6,0,13,16,10,6,15,17,0,2,4,2,2,0,0,0
"Mar 14, 2021 7:00 PM",25,11,14,9,4,5,21,9,12,14,7,7,,,,4,,,,5,5,0,12,6,2,4,11,17,3,0,1,0,1,0,0,0
"Mar 14, 2021 8:00 PM",16,7,9,6,3,3,6,3,3,6,4,2,,,,1,,,,3,3,0,2,4,2,2,4,19,0,0,0,0,0,0,0,0
"Mar 14, 2021 9:00 PM",8,1,7,6,3,3,6,3,3,7,3,4,,,,3,,,,5,5,0,2,3,1,2,2,7,0,2,2,1,1,0,0,0
"Mar 14, 2021 10:00 PM",5,3,2,2,1,1,2,1,1,2,1,1,,,,1,,,,6,6,0,2,0,0,0,5,7,0,0,2,2,0,0,0,0
"Mar 14, 2021 11:00 PM",2,1,1,0,0,0,1,0,1,0,0,0,,,,2,,,,3,3,0,0,0,0,0,1,2,0,1,0,0,0,0,0,0
"Mar 15, 2021 12:00 AM",1,1,0,0,0,0,0,0,0,0,0,0,,,,0,,,,0,0,0,0,0,0,0,0,0,0,0,1,1,0,0,0,0
"Mar 15, 2021 1:00 AM",0,0,0,1,1,0,1,1,0,1,1,0,,,,0,,,,0,0,0,0,0,0,0,0,0,0,0,0,0,0,,,
"Mar 15, 2021 2:00 AM",0,0,0,0,0,0,0,0,0,0,0,0,,,,0,,,,0,0,0,0,0,0,0,1,0,0,0,0,0,0,0,0,0
"Mar 15, 2021 3:00 AM",0,0,0,0,0,0,0,0,0,0,0,0,,,,0,,,,1,1,0,0,0,0,0,0,1,0,0,0,0,0,0,0,0
"Mar 15, 2021 4:00 AM",0,0,0,0,0,0,0,0,0,0,0,0,,,,0,,,,0,0,0,0,0,0,0,0,0,0,0,0,0,0,0,0,0
"Mar 15, 2021 5:00 AM",2,2,0,0,0,0,2,1,1,2,1,1,,,,1,,,,1,1,0,6,0,0,0,2,8,0,0,2,2,0,0,0,0
"Mar 15, 2021 6:00 AM",21,14,7,22,12,10,27,17,10,22,14,8,,,,3,,,,4,4,0,11,5,4,1,8,33,1,0,2,1,1,0,0,0
"Mar 15, 2021 7:00 AM",74,45,29,64,32,32,69,30,39,53,28,25,,,,16,,,,7,7,0,45,20,10,10,38,65,1,0,0,0,0,0,0,0
"Mar 15, 2021 8:00 AM",131,89,42,108,43,65,120,50,70,126,58,68,,,,30,,,,22,20,2,84,54,22,32,43,93,6,1,14,12,2,0,0,0
"Mar 15, 2021 9:00 AM",81,61,20,91,37,54,91,40,51,74,32,42,,,,11,,,,20,11,9,36,49,26,23,20,40,2,1,1,0,1,0,0,0
"Mar 15, 2021 10:00 AM",49,37,12,83,50,33,104,63,41,78,53,25,,,,23,,,,19,16,3,17,39,27,12,31,30,3,6,5,2,3,0,0,0
"Mar 15, 2021 11:00 AM",47,27,20,104,58,46,99,51,48,87,43,44,,,,8,,,,29,17,12,24,32,23,9,23,30,8,1,3,3,0,0,0,0
"Mar 15, 2021 12:00 PM",60,26,34,124,72,52,131,70,61,106,61,45,,,,8,,,,15,14,1,16,39,19,20,38,27,9,4,4,4,0,0,0,0
"Mar 15, 2021 1:00 PM",61,29,32,110,56,54,143,66,77,89,45,44,,,,21,,,,28,14,14,21,52,28,24,36,48,11,6,2,0,2,0,0,0
"Mar 15, 2021 2:00 PM",54,30,24,89,50,39,134,75,59,97,55,42,,,,25,,,,37,18,19,14,41,23,18,37,35,7,10,3,1,2,0,0,0
"Mar 15, 2021 3:00 PM",64,24,40,74,43,31,89,44,45,71,40,31,,,,20,,,,26,19,7,29,40,23,17,44,46,10,2,5,4,1,0,0,0
"Mar 15, 2021 4:00 PM",87,40,47,117,63,54,110,63,47,92,55,37,,,,28,,,,87,34,53,16,36,30,6,50,46,4,4,1,1,0,0,0,0
"Mar 15, 2021 5:00 PM",111,31,80,130,65,65,142,72,70,130,70,60,,,,30,,,,57,55,2,20,66,40,26,64,56,6,4,6,3,3,0,0,0
"Mar 15, 2021 6:00 PM",83,20,63,102,59,43,118,69,49,99,58,41,,,,36,,,,43,43,0,30,50,29,21,67,45,4,2,5,4,1,0,0,0
"Mar 15, 2021 7:00 PM",64,19,45,58,31,27,58,29,29,63,36,27,,,,14,,,,20,19,1,13,25,16,9,32,34,11,2,7,3,4,0,0,0
"Mar 15, 2021 8:00 PM",26,10,16,37,22,15,34,20,14,35,21,14,,,,2,,,,13,13,0,4,10,6,4,10,18,1,2,3,1,2,0,0,0
"Mar 15, 2021 9:00 PM",15,5,10,16,10,6,21,13,8,19,11,8,,,,2,,,,13,13,0,4,7,6,1,5,10,2,1,0,0,0,0,0,0
"Mar 15, 2021 10:00 PM",11,4,7,9,5,4,5,2,3,7,4,3,,,,2,,,,5,5,0,5,0,0,0,3,5,0,0,2,1,1,0,0,0
"Mar 15, 2021 11:00 PM",1,0,1,3,1,2,6,4,2,4,2,2,,,,2,,,,2,2,0,0,0,0,0,4,4,1,0,2,1,1,0,0,0
"Mar 16, 2021 12:00 AM",3,2,1,0,0,0,0,0,0,1,0,1,,,,0,,,,2,2,0,1,0,0,0,0,0,0,0,0,0,0,0,0,0
"Mar 16, 2021 1:00 AM",1,0,1,3,0,3,2,0,2,1,1,0,,,,1,,,,1,1,0,1,0,0,0,0,1,0,0,1,0,1,0,0,0
"Mar 16, 2021 2:00 AM",5,2,3,0,0,0,0,0,0,0,0,0,,,,0,,,,1,1,0,0,1,1,0,0,0,0,0,0,0,0,0,0,0
"Mar 16, 2021 3:00 AM",0,0,0,0,0,0,0,0,0,0,0,0,,,,0,,,,1,1,0,0,0,0,0,0,1,0,0,0,0,0,0,0,0
"Mar 16, 2021 4:00 AM",1,1,0,0,0,0,0,0,0,0,0,0,,,,0,,,,2,2,0,3,0,0,0,0,1,0,0,0,0,0,0,0,0
"Mar 16, 2021 5:00 AM",3,2,1,1,1,0,2,1,1,3,2,1,,,,1,,,,3,3,0,4,0,0,0,3,8,0,0,0,0,0,0,0,0
"Mar 16, 2021 6:00 AM",30,21,9,25,13,12,28,17,11,26,15,11,,,,6,,,,8,8,0,12,7,5,2,14,28,0,1,1,1,0,0,0,0
"Mar 16, 2021 7:00 AM",82,53,29,72,39,33,85,40,45,64,38,26,,,,24,,,,9,9,0,44,45,22,23,43,72,1,2,2,2,0,0,0,0
"Mar 16, 2021 8:00 AM",143,107,36,150,61,89,155,60,95,137,60,77,,,,22,,,,37,28,9,72,73,39,34,55,81,8,4,8,6,2,0,0,0
"Mar 16, 2021 9:00 AM",65,43,22,107,56,51,112,59,53,104,58,46,,,,10,,,,25,10,15,37,40,22,18,29,46,2,5,7,3,4,0,0,0
"Mar 16, 2021 10:00 AM",61,45,16,86,43,43,88,47,41,72,36,36,,,,10,,,,24,13,11,26,36,24,12,23,53,2,2,10,5,5,0,0,0
"Mar 16, 2021 11:00 AM",49,28,21,121,61,60,153,95,58,142,84,58,,,,15,,,,24,18,6,21,60,46,14,33,41,9,6,10,4,6,0,0,0
"Mar 16, 2021 12:00 PM",70,30,40,196,109,87,205,122,83,174,95,79,,,,16,,,,29,13,16,22,82,53,29,64,52,10,6,10,5,5,0,0,0
"Mar 16, 2021 1:00 PM",77,40,37,197,100,97,267,133,134,185,99,86,,,,22,,,,37,23,14,24,80,54,26,57,55,8,3,17,13,4,0,0,0
"Mar 16, 2021 2:00 PM",79,44,35,191,110,81,254,136,118,176,105,71,,,,18,,,,59,19,40,32,101,78,23,59,59,6,16,20,12,8,0,0,0
"Mar 16, 2021 3:00 PM",100,45,55,204,117,87,276,147,129,213,123,90,,,,33,,,,36,24,12,25,115,78,37,76,66,16,5,20,7,13,0,0,0
"Mar 16, 2021 4:00 PM",109,46,63,210,100,110,268,122,146,243,125,118,,,,35,,,,60,45,15,27,109,63,46,69,63,16,7,25,17,8,0,0,0
"Mar 16, 2021 5:00 PM",183,63,120,225,125,100,256,128,128,216,118,98,,,,35,,,,57,56,1,36,105,54,51,80,76,6,8,11,3,8,0,0,0
"Mar 16, 2021 6:00 PM",134,43,91,182,83,99,183,79,104,141,54,87,,,,25,,,,52,52,0,23,95,59,36,61,80,6,5,12,4,8,0,0,0
"Mar 16, 2021 7:00 PM",65,22,43,74,36,38,75,34,41,77,37,40,,,,26,,,,20,20,0,17,38,26,12,26,53,6,2,6,3,3,0,0,0
"Mar 16, 2021 8:00 PM",37,14,23,26,11,15,53,30,23,28,15,13,,,,4,,,,17,17,0,12,10,8,2,17,23,4,1,6,2,4,0,0,0
"Mar 16, 2021 9:00 PM",31,10,21,10,6,4,23,13,10,18,10,8,,,,11,,,,17,17,0,2,8,7,1,11,7,1,2,2,1,1,0,0,0
"Mar 16, 2021 10:00 PM",19,9,10,5,4,1,11,5,6,10,7,3,,,,0,,,,12,11,1,3,8,4,4,9,17,0,0,3,2,1,0,0,0
"Mar 16, 2021 11:00 PM",12,1,11,11,7,4,8,3,5,5,0,5,,,,1,,,,4,4,0,4,1,1,0,3,5,0,1,5,4,1,0,0,0
"Mar 17, 2021 12:00 AM",9,2,7,0,0,0,1,0,1,0,0,0,,,,1,,,,2,2,0,1,0,0,0,1,4,1,0,0,0,0,0,0,0
"Mar 17, 2021 1:00 AM",0,0,0,0,0,0,1,0,1,2,2,0,,,,0,,,,1,1,0,3,0,0,0,0,1,0,0,5,3,2,0,0,0
"Mar 17, 2021 2:00 AM",5,3,2,1,1,0,2,2,0,2,2,0,,,,0,,,,1,1,0,1,0,0,0,5,0,0,0,0,0,0,0,0,0
"Mar 17, 2021 3:00 AM",2,0,2,2,2,0,0,0,0,0,0,0,,,,1,,,,0,0,0,1,1,1,0,0,2,0,0,0,0,0,0,0,0
"Mar 17, 2021 4:00 AM",2,2,0,0,0,0,1,1,0,1,1,0,,,,0,,,,2,2,0,1,2,2,0,0,0,0,0,0,0,0,0,0,0
"Mar 17, 2021 5:00 AM",1,1,0,0,0,0,1,1,0,1,1,0,,,,0,,,,0,0,0,2,0,0,0,1,5,0,0,0,0,0,0,0,0
"Mar 17, 2021 6:00 AM",12,7,5,20,17,3,27,20,7,21,16,5,,,,0,,,,1,1,0,7,6,6,0,8,16,0,1,0,0,0,0,0,0
"Mar 17, 2021 7:00 AM",26,18,8,79,41,38,56,28,28,61,33,28,,,,1,,,,6,4,2,10,15,12,3,19,22,1,5,2,0,2,0,0,0
"Mar 17, 2021 8:00 AM",43,14,29,136,88,48,115,75,40,109,74,35,,,,6,,,,14,14,0,21,48,33,15,33,40,12,12,9,5,4,0,0,0
"Mar 17, 2021 9:00 AM",65,34,31,316,202,114,296,214,82,303,206,97,,,,11,,,,27,25,2,29,100,76,24,58,55,10,15,17,9,8,0,0,0
"Mar 17, 2021 10:00 AM",90,50,40,417,226,191,436,250,186,399,251,148,,,,44,,,,30,30,0,38,169,115,54,97,81,10,10,17,6,11,0,0,0
"Mar 17, 2021 11:00 AM",101,60,41,492,282,210,523,315,208,428,264,164,,,,40,,,,26,23,3,42,206,126,80,129,123,10,22,33,17,16,0,0,0
"Mar 17, 2021 12:00 PM",129,80,49,509,246,263,620,337,283,499,263,236,,,,57,,,,28,26,2,67,235,150,85,152,123,18,16,21,11,10,0,0,0
"Mar 17, 2021 1:00 PM",160,83,77,554,330,224,682,399,283,553,328,225,,,,52,,,,22,22,0,55,287,221,66,201,145,31,5,31,18,13,0,0,0
"Mar 17, 2021 2:00 PM",159,97,62,511,267,244,699,382,317,544,304,240,,,,49,,,,21,21,0,59,287,224,63,146,131,24,7,29,14,15,0,0,0
"Mar 17, 2021 3:00 PM",118,69,49,477,227,250,658,270,388,549,251,298,,,,62,,,,34,33,1,64,284,168,116,133,157,16,9,33,21,12,0,0,0
"Mar 17, 2021 4:00 PM",142,60,82,462,202,260,584,232,352,472,201,271,,,,50,,,,28,28,0,49,275,123,152,123,136,15,12,23,12,11,0,0,0
"Mar 17, 2021 5:00 PM",119,55,64,277,109,168,382,114,268,287,92,195,,,,36,,,,30,30,0,38,160,57,103,64,140,12,6,10,3,7,0,0,0
"Mar 17, 2021 6:00 PM",88,30,58,116,49,67,186,50,136,144,45,99,,,,33,,,,18,18,0,24,82,16,66,24,90,7,6,19,12,7,0,0,0
"Mar 17, 2021 7:00 PM",38,18,20,46,12,34,62,25,37,49,25,24,,,,18,,,,13,13,0,12,32,15,17,22,28,2,0,6,3,3,0,0,0
"Mar 17, 2021 8:00 PM",38,16,22,20,12,8,38,12,26,20,11,9,,,,9,,,,10,10,0,4,14,4,10,15,22,0,2,2,1,1,0,0,0
"Mar 17, 2021 9:00 PM",25,13,12,9,6,3,22,10,12,9,5,4,,,,6,,,,7,7,0,11,5,3,2,4,13,2,0,4,1,3,0,0,0
"Mar 17, 2021 10:00 PM",5,1,4,8,1,7,11,4,7,3,1,2,,,,5,,,,6,6,0,0,3,1,2,8,6,4,3,3,3,0,0,0,0
"Mar 17, 2021 11:00 PM",10,4,6,5,3,2,4,1,3,5,0,5,,,,4,,,,1,1,0,3,4,4,0,4,6,1,1,1,1,0,0,0,0
"Mar 18, 2021 12:00 AM",3,1,2,0,0,0,4,1,3,4,2,2,,,,0,,,,7,6,1,0,1,1,0,3,1,0,0,1,1,0,0,0,0
"Mar 18, 2021 1:00 AM",4,1,3,2,1,1,2,2,0,3,3,0,,,,0,,,,3,3,0,2,0,0,0,2,4,0,0,1,1,0,0,0,0
"Mar 18, 2021 2:00 AM",4,3,1,0,0,0,1,0,1,1,0,1,,,,1,,,,1,1,0,0,0,0,0,0,0,0,0,0,0,0,0,0,0
"Mar 18, 2021 3:00 AM",4,0,4,0,0,0,2,2,0,2,2,0,,,,0,,,,1,1,0,0,0,0,0,0,1,0,0,0,0,0,0,0,0
"Mar 18, 2021 4:00 AM",1,1,0,0,0,0,0,0,0,0,0,0,,,,0,,,,1,1,0,1,0,0,0,0,0,0,0,0,0,0,0,0,0
"Mar 18, 2021 5:00 AM",3,3,0,0,0,0,2,2,0,3,3,0,,,,0,,,,1,1,0,4,0,0,0,4,8,0,0,0,0,0,0,0,0
"Mar 18, 2021 6:00 AM",26,22,4,26,15,11,23,16,7,22,17,5,,,,2,,,,5,5,0,8,5,5,0,9,25,0,0,0,0,0,0,0,0
"Mar 18, 2021 7:00 AM",72,46,26,56,25,31,68,27,41,60,28,32,,,,16,,,,11,10,1,55,38,19,19,42,58,3,3,4,4,0,0,0,0
"Mar 18, 2021 8:00 AM",119,77,42,117,35,82,145,48,97,125,53,72,,,,25,,,,30,25,5,46,71,23,48,44,80,12,5,19,15,4,0,0,0
"Mar 18, 2021 9:00 AM",64,51,13,82,35,47,79,45,34,77,38,39,,,,12,,,,25,15,10,32,49,29,20,27,47,3,2,11,10,1,0,0,0
"Mar 18, 2021 10:00 AM",51,33,18,96,53,43,94,57,37,98,64,34,,,,8,,,,12,8,4,16,27,14,13,30,28,4,4,3,3,0,0,0,0
"Mar 18, 2021 11:00 AM",47,26,21,110,62,48,98,52,46,77,50,27,,,,11,,,,22,10,12,17,36,17,19,37,32,4,2,5,3,2,,,
"Mar 18, 2021 12:00 PM",56,26,30,104,61,43,135,66,69,108,51,57,,,,17,,,,19,17,2,19,63,41,22,28,34,7,6,5,1,4,0,0,0
"Mar 18, 2021 1:00 PM",66,34,32,116,70,46,174,100,74,135,71,64,,,,22,,,,25,23,2,25,68,55,13,41,53,8,4,9,6,3,0,0,0
"Mar 18, 2021 2:00 PM",66,35,31,178,98,80,196,105,91,141,86,55,,,,15,,,,16,13,3,16,82,57,25,56,35,5,8,10,2,8,0,0,0
"Mar 18, 2021 3:00 PM",78,34,44,148,85,63,211,119,92,157,87,70,,,,22,,,,35,32,3,26,80,36,44,68,56,13,5,12,5,7,0,0,0
"Mar 18, 2021 4:00 PM",103,42,61,140,63,77,191,84,107,156,81,75,,,,30,,,,45,38,7,24,69,44,25,71,65,8,5,13,6,7,0,0,0
"Mar 18, 2021 5:00 PM",113,35,78,155,91,64,180,98,82,131,71,60,,,,42,,,,54,53,1,26,70,41,29,71,73,11,7,18,7,11,0,0,0
"Mar 18, 2021 6:00 PM",91,30,61,136,78,58,133,66,67,106,52,54,,,,29,,,,40,40,0,26,46,34,12,64,61,2,3,16,8,8,0,0,0
"Mar 18, 2021 7:00 PM",58,25,33,62,25,37,82,38,44,63,27,36,,,,10,,,,17,17,0,11,26,10,16,31,45,6,5,11,6,5,0,0,0
"Mar 18, 2021 8:00 PM",21,10,11,28,17,11,25,16,9,37,20,17,,,,3,,,,13,13,0,9,15,6,9,18,16,1,4,8,2,6,0,0,0
"Mar 18, 2021 9:00 PM",28,8,20,12,7,5,21,14,7,20,15,5,,,,5,,,,7,7,0,3,5,2,3,11,6,1,0,0,0,0,0,0,0
"Mar 18, 2021 10:00 PM",11,4,7,3,1,2,8,2,6,11,1,10,,,,4,,,,4,4,0,2,5,4,1,8,9,0,0,2,1,1,0,0,0
"Mar 18, 2021 11:00 PM",7,3,4,1,1,0,4,2,2,3,3,0,,,,2,,,,2,2,0,1,6,1,5,1,7,0,1,1,1,0,0,0,0
"Mar 19, 2021 12:00 AM",4,2,2,0,0,0,0,0,0,0,0,0,,,,0,,,,2,2,0,0,3,1,2,3,2,1,0,0,0,0,0,0,0
"Mar 19, 2021 1:00 AM",0,0,0,0,0,0,0,0,0,0,0,0,,,,0,,,,0,0,0,0,0,0,0,0,0,0,0,0,0,0,0,0,0
"Mar 19, 2021 2:00 AM",4,4,0,0,0,0,0,0,0,0,0,0,,,,1,,,,0,0,0,0,0,0,0,0,3,0,0,0,0,0,0,0,0
"Mar 19, 2021 3:00 AM",2,0,2,0,0,0,0,0,0,0,0,0,,,,0,,,,0,0,0,0,0,0,0,0,1,0,0,0,0,0,0,0,0
"Mar 19, 2021 4:00 AM",1,1,0,0,0,0,2,2,0,1,1,0,,,,0,,,,1,1,0,0,0,0,0,2,0,0,0,0,0,0,0,0,0
"Mar 19, 2021 5:00 AM",2,2,0,1,1,0,4,3,1,4,3,1,,,,1,,,,3,3,0,5,1,1,0,3,7,0,0,1,1,0,0,0,0
"Mar 19, 2021 6:00 AM",26,20,6,33,23,10,43,32,11,39,26,13,,,,2,,,,5,5,0,9,8,7,1,15,26,1,0,2,1,1,0,0,0
"Mar 19, 2021 7:00 AM",72,45,27,113,50,63,101,49,52,100,53,47,,,,8,,,,12,11,1,44,27,16,11,40,70,3,2,4,2,2,0,0,0
"Mar 19, 2021 8:00 AM",132,91,41,136,46,90,180,58,122,150,61,89,,,,28,,,,31,24,7,68,86,34,52,48,107,8,6,15,13,2,0,0,0
"Mar 19, 2021 9:00 AM",75,52,23,120,61,59,125,65,60,112,59,53,,,,14,,,,18,17,1,37,50,31,19,23,49,2,6,7,4,3,0,0,0
"Mar 19, 2021 10:00 AM",86,56,30,176,101,75,182,116,66,168,108,60,,,,20,,,,17,9,8,24,43,34,9,54,39,11,11,10,6,4,0,0,0
"Mar 19, 2021 11:00 AM",76,47,29,186,100,86,190,108,82,180,93,87,,,,23,,,,27,25,2,21,69,41,28,55,61,3,6,14,8,6,0,0,0
"Mar 19, 2021 12:00 PM",72,23,49,174,94,80,206,100,106,173,84,89,,,,15,,,,23,17,6,26,77,49,28,46,48,5,10,12,7,5,0,0,0
"Mar 19, 2021 1:00 PM",96,48,48,156,79,77,211,109,102,136,67,69,,,,15,,,,26,23,3,26,89,54,35,52,53,13,9,15,10,5,0,0,0
"Mar 19, 2021 2:00 PM",87,39,48,178,99,79,229,137,92,185,116,69,,,,35,,,,20,19,1,24,108,72,36,55,40,6,10,16,4,12,0,0,0
"Mar 19, 2021 3:00 PM",91,43,48,188,93,95,262,155,107,184,106,78,,,,32,,,,28,22,6,36,98,49,49,64,61,14,11,20,14,6,0,0,0
"Mar 19, 2021 4:00 PM",110,44,66,210,120,90,273,140,133,205,109,96,,,,35,,,,44,43,1,38,104,49,55,76,87,21,9,27,21,6,0,0,0
"Mar 19, 2021 5:00 PM",131,47,84,223,111,112,317,168,149,233,135,98,,,,40,,,,74,73,1,48,109,49,60,97,84,16,8,17,10,7,0,0,0
"Mar 19, 2021 6:00 PM",117,35,82,177,96,81,204,106,98,171,83,88,,,,20,,,,42,42,0,28,72,41,31,60,71,4,3,13,9,4,0,0,0
"Mar 19, 2021 7:00 PM",75,24,51,86,44,42,122,49,73,76,35,41,,,,16,,,,29,28,1,16,41,18,23,37,48,2,4,4,4,0,0,0,0
"Mar 19, 2021 8:00 PM",47,17,30,33,16,17,50,26,24,37,22,15,,,,7,,,,13,13,0,15,16,9,7,18,22,2,1,5,3,2,0,0,0
"Mar 19, 2021 9:00 PM",24,9,15,15,8,7,10,5,5,5,3,2,,,,6,,,,9,9,0,1,1,0,1,6,16,1,0,5,2,3,0,0,0
"Mar 19, 2021 10:00 PM",18,8,10,13,4,9,27,11,16,23,10,13,,,,1,,,,7,7,0,5,10,6,4,6,8,1,0,1,0,1,0,0,0
"Mar 19, 2021 11:00 PM",13,8,5,8,6,2,8,5,3,10,4,6,,,,3,,,,2,2,0,6,2,1,1,6,6,0,0,1,1,0,0,0,0
"Mar 20, 2021 12:00 AM",6,2,4,0,0,0,0,0,0,4,4,0,,,,0,,,,3,3,0,2,1,0,1,2,4,0,0,0,0,0,0,0,0
"Mar 20, 2021 1:00 AM",3,1,2,1,1,0,3,3,0,2,1,1,,,,0,,,,1,1,0,1,2,1,1,1,0,0,0,0,0,0,0,0,0
"Mar 20, 2021 2:00 AM",4,1,3,0,0,0,1,1,0,3,1,2,,,,0,,,,0,0,0,0,0,0,0,1,1,0,0,0,0,0,0,0,0
"Mar 20, 2021 3:00 AM",1,0,1,1,1,0,2,1,1,1,1,0,,,,0,,,,4,3,1,1,0,0,0,1,0,0,0,0,0,0,0,0,0
"Mar 20, 2021 4:00 AM",0,0,0,0,0,0,0,0,0,0,0,0,,,,0,,,,2,2,0,0,0,0,0,0,0,0,0,0,0,0,0,0,0
"Mar 20, 2021 5:00 AM",3,3,0,3,2,1,4,4,0,3,3,0,,,,1,,,,1,1,0,2,2,2,0,3,2,0,0,1,1,0,0,0,0
"Mar 20, 2021 6:00 AM",6,5,1,12,7,5,10,5,5,13,6,7,,,,2,,,,4,4,0,2,3,1,2,7,8,1,0,0,0,0,0,0,0
"Mar 20, 2021 7:00 AM",20,11,9,67,56,11,45,31,14,58,43,15,,,,1,,,,6,5,1,13,11,9,2,31,24,2,2,4,3,1,0,0,0
"Mar 20, 2021 8:00 AM",43,17,26,192,124,68,127,86,41,145,102,43,,,,6,,,,15,14,1,19,49,31,18,32,39,7,2,5,2,3,0,0,0
"Mar 20, 2021 9:00 AM",69,36,33,230,112,118,201,94,107,216,111,105,,,,5,,,,28,25,3,22,75,44,31,51,71,12,9,5,2,3,0,0,0
"Mar 20, 2021 10:00 AM",80,46,34,286,148,138,291,186,105,304,197,107,,,,19,,,,27,24,3,52,108,66,42,64,75,10,16,15,9,6,0,0,0
"Mar 20, 2021 11:00 AM",93,55,38,383,191,192,346,193,153,329,184,145,,,,30,,,,34,34,0,35,120,65,55,91,97,15,13,15,3,12,0,0,0
"Mar 20, 2021 12:00 PM",107,56,51,379,180,199,423,222,201,394,200,194,,,,34,,,,33,32,1,40,125,76,49,117,125,11,9,17,0,17,0,0,0
"Mar 20, 2021 1:00 PM",119,68,51,356,187,169,423,219,204,326,180,146,,,,29,,,,45,45,0,44,166,105,61,118,91,19,11,33,24,9,0,0,0
"Mar 20, 2021 2:00 PM",104,58,46,344,178,166,390,198,192,333,172,161,,,,45,,,,31,29,2,33,159,119,40,82,120,13,17,12,6,6,0,0,0
"Mar 20, 2021 3:00 PM",95,51,44,292,136,156,412,209,203,303,145,158,,,,41,,,,26,26,0,47,144,83,61,82,101,20,6,21,15,6,0,0,0
"Mar 20, 2021 4:00 PM",100,46,54,216,112,104,356,128,228,252,114,138,,,,34,,,,26,26,0,35,148,47,101,72,104,16,2,22,15,7,0,0,0
"Mar 20, 2021 5:00 PM",63,28,35,141,56,85,165,51,114,131,44,87,,,,18,,,,14,14,0,14,62,20,42,25,50,10,3,24,10,14,0,0,0
"Mar 20, 2021 6:00 PM",51,20,31,53,21,32,94,30,64,67,29,38,,,,21,,,,19,19,0,18,51,18,33,23,41,3,5,3,1,2,0,0,0
"Mar 20, 2021 7:00 PM",44,23,21,25,13,12,51,25,26,36,20,16,,,,8,,,,10,10,0,8,6,3,3,21,29,1,1,6,2,4,0,0,0
"Mar 20, 2021 8:00 PM",34,17,17,14,10,4,26,13,13,28,17,11,,,,5,,,,6,5,1,7,13,8,5,16,22,4,0,6,2,4,0,0,0
"Mar 20, 2021 9:00 PM",24,11,13,6,2,4,15,4,11,9,5,4,,,,1,,,,6,5,1,8,3,1,2,7,8,2,1,3,3,0,0,0,0
"Mar 20, 2021 10:00 PM",15,8,7,20,6,14,22,10,12,16,5,11,,,,5,,,,9,8,1,5,14,6,8,5,12,1,0,1,0,1,0,0,0
"Mar 20, 2021 11:00 PM",11,5,6,6,3,3,10,8,2,11,2,9,,,,3,,,,2,2,0,1,2,0,2,3,6,0,0,0,0,0,0,0,0
"Mar 21, 2021 12:00 AM",9,3,6,0,0,0,1,0,1,7,3,4,,,,0,,,,3,3,0,2,3,3,0,4,2,0,0,1,1,0,0,0,0
"Mar 21, 2021 1:00 AM",4,0,4,1,1,0,8,4,4,5,3,2,,,,1,,,,3,3,0,1,9,7,2,0,1,0,0,0,0,0,0,0,0
"Mar 21, 2021 2:00 AM",1,1,0,0,0,0,1,0,1,3,2,1,,,,0,,,,1,1,0,0,4,1,3,0,2,0,0,0,0,0,0,0,0
"Mar 21, 2021 3:00 AM",5,0,5,0,0,0,0,0,0,0,0,0,,,,0,,,,1,1,0,1,0,0,0,1,0,0,0,1,1,0,0,0,0
"Mar 21, 2021 4:00 AM",0,0,0,0,0,0,1,1,0,0,0,0,,,,0,,,,2,2,0,0,0,0,0,1,1,0,0,0,0,0,0,0,0
"Mar 21, 2021 5:00 AM",2,0,2,0,0,0,0,0,0,0,0,0,,,,0,,,,0,0,0,1,1,1,0,0,2,0,0,0,0,0,0,0,0
"Mar 21, 2021 6:00 AM",4,2,2,7,4,3,18,13,5,13,8,5,,,,2,,,,2,2,0,5,4,4,0,7,4,0,2,1,1,0,0,0,0
"Mar 21, 2021 7:00 AM",14,7,7,47,30,17,47,31,16,48,34,14,,,,3,,,,1,0,1,5,16,13,3,26,29,3,0,0,0,0,0,0,0
"Mar 21, 2021 8:00 AM",35,18,17,136,76,60,128,75,53,146,88,58,,,,8,,,,6,6,0,15,54,35,19,40,65,2,5,6,1,5,0,0,0
"Mar 21, 2021 9:00 AM",67,36,31,291,177,114,261,166,95,253,171,82,,,,11,,,,17,16,1,28,91,48,43,66,62,7,24,8,2,6,0,0,0
"Mar 21, 2021 10:00 AM",77,46,31,424,237,187,391,232,159,395,226,169,,,,30,,,,22,21,1,38,131,91,40,107,91,21,17,11,10,1,0,0,0
"Mar 21, 2021 11:00 AM",101,48,53,445,225,220,470,242,228,426,232,194,,,,37,,,,35,32,3,41,143,94,49,126,136,12,10,29,14,15,0,0,0
"Mar 21, 2021 12:00 PM",132,69,63,464,234,230,552,266,286,493,246,247,,,,35,,,,41,39,2,55,200,122,78,136,122,15,11,7,5,2,0,0,0
"Mar 21, 2021 1:00 PM",98,47,51,418,243,175,489,278,211,455,266,189,,,,39,,,,26,24,2,62,175,131,44,117,124,19,13,29,23,6,0,0,0
"Mar 21, 2021 2:00 PM",135,78,57,468,254,214,570,329,241,450,271,179,,,,56,,,,45,44,1,48,212,168,44,130,121,12,14,32,16,16,0,0,0
"Mar 21, 2021 3:00 PM",128,70,58,485,245,240,606,299,307,461,218,243,,,,51,,,,42,42,0,37,196,90,106,135,141,15,14,37,24,13,0,0,0
"Mar 21, 2021 4:00 PM",116,47,69,367,155,212,559,222,337,425,165,260,,,,28,,,,23,23,0,54,193,100,93,78,156,9,15,24,18,6,0,0,0
"Mar 21, 2021 5:00 PM",110,51,59,257,108,149,352,114,238,256,83,173,,,,47,,,,20,19,1,26,179,72,107,69,124,9,6,7,6,1,0,0,0
"Mar 21, 2021 6:00 PM",80,36,44,127,61,66,166,57,109,109,32,77,,,,29,,,,24,24,0,18,83,19,64,32,81,1,4,10,6,4,0,0,0
"Mar 21, 2021 7:00 PM",26,8,18,31,18,13,45,20,25,29,13,16,,,,4,,,,8,5,3,10,14,5,9,15,36,5,1,2,1,1,0,0,0
"Mar 21, 2021 8:00 PM",33,16,17,12,5,7,22,11,11,19,9,10,,,,7,,,,3,3,0,4,11,3,8,16,12,1,0,1,1,0,0,0,0
"Mar 21, 2021 9:00 PM",22,7,15,7,5,2,15,6,9,10,5,5,,,,11,,,,13,12,1,6,5,3,2,6,9,1,2,0,0,0,0,0,0
"Mar 21, 2021 10:00 PM",9,7,2,4,2,2,6,5,1,7,5,2,,,,3,,,,2,2,0,5,2,2,0,3,4,0,0,1,0,1,0,0,0
"Mar 21, 2021 11:00 PM",5,1,4,1,0,1,2,0,2,2,0,2,,,,3,,,,3,3,0,2,0,0,0,3,1,0,0,0,0,0,0,0,0
"Mar 22, 2021 12:00 AM",2,2,0,0,0,0,0,0,0,1,1,0,,,,0,,,,1,1,0,0,0,0,0,1,0,0,0,0,0,0,0,0,0
"Mar 22, 2021 1:00 AM",1,1,0,0,0,0,1,0,1,0,0,0,,,,0,,,,1,1,0,0,0,0,0,0,0,0,0,0,0,0,0,0,0
"Mar 22, 2021 2:00 AM",1,0,1,0,0,0,1,0,1,0,0,0,,,,0,,,,0,0,0,0,0,0,0,0,0,0,0,0,0,0,0,0,0
"Mar 22, 2021 3:00 AM",1,0,1,0,0,0,0,0,0,0,0,0,,,,0,,,,0,0,0,0,0,0,0,0,0,0,0,0,0,0,0,0,0
"Mar 22, 2021 4:00 AM",0,0,0,0,0,0,2,2,0,0,0,0,,,,0,,,,1,1,0,2,0,0,0,2,0,0,0,0,0,0,0,0,0
"Mar 22, 2021 5:00 AM",2,2,0,0,0,0,2,1,1,4,3,1,,,,1,,,,3,3,0,5,0,0,0,5,6,0,0,0,0,0,0,0,0
"Mar 22, 2021 6:00 AM",33,26,7,30,18,12,33,20,13,26,14,12,,,,2,,,,3,3,0,13,8,6,2,14,30,0,2,2,2,0,0,0,0
"Mar 22, 2021 7:00 AM",85,49,36,74,27,47,91,36,55,60,33,27,,,,14,,,,8,7,1,54,29,15,14,41,89,1,3,5,3,2,0,0,0
"Mar 22, 2021 8:00 AM",135,101,34,136,56,80,195,86,109,132,61,71,,,,34,,,,26,26,0,86,77,27,50,56,80,12,5,13,8,5,0,0,0
"Mar 22, 2021 9:00 AM",70,57,13,99,48,51,110,49,61,91,44,47,,,,16,,,,15,15,0,48,53,23,30,25,51,1,3,2,1,1,0,0,0
"Mar 22, 2021 10:00 AM",49,36,13,90,49,41,103,60,43,94,53,41,,,,12,,,,17,16,1,19,54,30,24,22,27,1,1,5,3,2,0,0,0
"Mar 22, 2021 11:00 AM",43,24,19,97,49,48,91,50,41,84,48,36,,,,8,,,,17,16,1,19,32,14,18,31,38,4,1,6,3,3,0,0,0
"Mar 22, 2021 12:00 PM",58,24,34,114,60,54,99,46,53,85,47,38,,,,20,,,,10,10,0,10,25,13,12,26,35,8,4,8,5,3,0,0,0
"Mar 22, 2021 1:00 PM",70,37,33,76,30,46,85,39,46,72,28,44,,,,22,,,,15,15,0,26,30,14,16,26,29,8,3,7,3,4,0,0,0
"Mar 22, 2021 2:00 PM",61,33,28,101,59,42,109,64,45,77,46,31,,,,17,,,,19,18,1,20,45,27,18,37,27,3,8,16,8,8,0,0,0
"Mar 22, 2021 3:00 PM",57,28,29,83,52,31,116,72,44,64,44,20,,,,18,,,,16,15,1,20,57,41,16,42,26,7,6,17,7,10,0,0,0
"Mar 22, 2021 4:00 PM",97,41,56,75,31,44,107,57,50,75,33,42,,,,24,,,,38,34,4,23,57,39,18,51,46,9,6,14,5,9,0,0,0
"Mar 22, 2021 5:00 PM",138,41,97,85,44,41,136,75,61,96,44,52,,,,25,,,,59,59,0,23,64,40,24,61,58,6,5,18,5,13,0,0,0
"Mar 22, 2021 6:00 PM",89,27,62,84,55,29,113,69,44,69,42,27,,,,29,,,,56,56,0,19,48,27,21,68,52,3,4,11,7,4,0,0,0
"Mar 22, 2021 7:00 PM",60,24,36,42,24,18,58,28,30,43,21,22,,,,11,,,,36,36,0,8,18,9,9,33,33,3,0,9,7,2,0,0,0
"Mar 22, 2021 8:00 PM",34,8,26,36,22,14,44,24,20,41,23,18,,,,10,,,,16,16,0,5,21,11,10,14,17,0,1,7,4,3,0,0,0
"Mar 22, 2021 9:00 PM",17,4,13,19,11,8,24,11,13,17,9,8,,,,8,,,,12,12,0,7,4,3,1,9,12,5,1,2,2,0,0,0,0
"Mar 22, 2021 10:00 PM",9,3,6,9,4,5,17,8,9,12,5,7,,,,1,,,,4,4,0,3,4,1,3,6,6,0,0,1,0,1,0,0,0
"Mar 22, 2021 11:00 PM",4,0,4,8,4,4,3,1,2,4,2,2,,,,2,,,,1,1,0,1,0,0,0,2,5,1,0,2,1,1,0,0,0
"Mar 23, 2021 12:00 AM",2,1,1,0,0,0,0,0,0,1,1,0,,,,0,,,,2,2,0,1,2,0,2,1,0,0,0,3,1,2,0,0,0
"Mar 23, 2021 1:00 AM",1,1,0,0,0,0,0,0,0,0,0,0,,,,0,,,,0,0,0,0,0,0,0,1,1,0,0,0,0,0,0,0,0
"Mar 23, 2021 2:00 AM",0,0,0,0,0,0,0,0,0,0,0,0,,,,0,,,,0,0,0,1,0,0,0,0,0,0,0,0,0,0,0,0,0
"Mar 23, 2021 3:00 AM",1,0,1,0,0,0,0,0,0,0,0,0,,,,0,,,,1,1,0,0,0,0,0,0,1,0,0,0,0,0,0,0,0
"Mar 23, 2021 4:00 AM",1,1,0,0,0,0,1,1,0,0,0,0,,,,0,,,,2,2,0,2,0,0,0,1,1,0,0,0,0,0,0,0,0
"Mar 23, 2021 5:00 AM",4,4,0,1,1,0,4,4,0,5,5,0,,,,1,,,,2,2,0,6,2,1,1,3,6,0,0,1,1,0,0,0,0
"Mar 23, 2021 6:00 AM",32,22,10,29,16,13,40,26,14,18,9,9,,,,3,,,,9,8,1,8,9,7,2,16,30,1,2,2,1,1,0,0,0
"Mar 23, 2021 7:00 AM",83,52,31,87,42,45,128,61,67,94,52,42,,,,9,,,,13,13,0,51,48,26,22,52,78,7,7,7,6,1,0,0,0
"Mar 23, 2021 8:00 AM",154,114,40,152,59,93,198,83,115,150,61,89,,,,31,,,,29,29,0,80,106,48,58,54,107,10,6,16,13,3,0,0,0
"Mar 23, 2021 9:00 AM",80,52,28,102,50,52,108,52,56,100,52,48,,,,7,,,,14,13,1,44,59,27,32,25,54,4,2,10,5,5,0,0,0
"Mar 23, 2021 10:00 AM",43,30,13,58,33,25,91,48,43,67,42,25,,,,13,,,,12,9,3,13,29,16,13,24,26,1,5,5,3,2,0,0,0
"Mar 23, 2021 11:00 AM",49,36,13,102,46,56,93,43,50,82,39,43,,,,15,,,,6,5,1,17,40,21,19,26,27,4,5,3,3,0,0,0,0
"Mar 23, 2021 12:00 PM",70,35,35,114,66,48,100,63,37,90,55,35,,,,29,,,,27,13,14,28,42,27,15,30,24,5,6,8,4,4,0,0,0
"Mar 23, 2021 1:00 PM",64,28,36,106,62,44,105,53,52,92,52,40,,,,24,,,,11,11,0,21,30,20,10,33,33,6,6,1,1,0,0,0,0
"Mar 23, 2021 2:00 PM",60,36,24,77,32,45,106,57,49,86,45,41,,,,21,,,,10,9,1,19,47,24,23,30,28,1,2,15,4,11,0,0,0
"Mar 23, 2021 3:00 PM",76,28,48,74,38,36,96,42,54,69,28,41,,,,18,,,,26,25,1,22,42,23,19,41,41,7,3,26,11,15,0,0,0
"Mar 23, 2021 4:00 PM",93,37,56,79,46,33,112,66,46,67,44,23,,,,19,,,,43,42,1,21,50,36,14,52,47,10,5,24,10,14,0,0,0
"Mar 23, 2021 5:00 PM",136,32,104,101,65,36,123,73,50,107,60,47,,,,23,,,,69,69,0,29,70,52,18,55,51,11,5,14,3,11,0,0,0
"Mar 23, 2021 6:00 PM",103,26,77,130,76,54,145,86,59,126,71,55,,,,34,,,,54,52,2,29,62,29,33,74,43,4,1,15,9,6,0,0,0
"Mar 23, 2021 7:00 PM",62,17,45,67,33,34,75,36,39,60,30,30,,,,9,,,,30,30,0,12,24,16,8,40,32,6,3,4,2,2,0,0,0
"Mar 23, 2021 8:00 PM",16,4,12,20,11,9,26,9,17,28,12,16,,,,14,,,,14,14,0,11,4,3,1,20,17,1,1,0,0,0,0,0,0
"Mar 23, 2021 9:00 PM",17,7,10,10,3,7,16,5,11,14,5,9,,,,9,,,,6,6,0,5,9,5,4,3,9,1,0,2,0,2,0,0,0
"Mar 23, 2021 10:00 PM",12,5,7,4,2,2,3,1,2,3,1,2,,,,0,,,,2,2,0,7,5,3,2,2,5,0,0,1,1,0,0,0,0
"Mar 23, 2021 11:00 PM",5,2,3,2,2,0,5,3,2,5,3,2,,,,0,,,,2,2,0,0,0,0,0,3,5,1,0,0,0,0,0,0,0
"Mar 24, 2021 12:00 AM",2,1,1,0,0,0,0,0,0,0,0,0,,,,0,,,,4,4,0,0,0,0,0,0,0,1,0,2,2,0,0,0,0
"Mar 24, 2021 1:00 AM",1,0,1,0,0,0,0,0,0,0,0,0,,,,1,,,,2,2,0,1,0,0,0,0,2,0,0,0,0,0,0,0,0
"Mar 24, 2021 2:00 AM",3,1,2,0,0,0,1,1,0,0,0,0,,,,0,,,,0,0,0,0,0,0,0,1,0,0,0,0,0,0,0,0,0
"Mar 24, 2021 3:00 AM",0,0,0,0,0,0,0,0,0,0,0,0,,,,0,,,,0,0,0,0,0,0,0,0,0,0,0,0,0,0,0,0,0
"Mar 24, 2021 4:00 AM",0,0,0,0,0,0,1,1,0,0,0,0,,,,0,,,,3,3,0,1,0,0,0,0,1,0,0,0,0,0,0,0,0
"Mar 24, 2021 5:00 AM",4,4,0,1,1,0,5,4,1,5,4,1,,,,2,,,,2,2,0,5,3,2,1,4,4,0,0,0,0,0,0,0,0
"Mar 24, 2021 6:00 AM",31,21,10,23,13,10,50,31,19,22,12,10,,,,3,,,,7,7,0,8,8,6,2,17,41,0,2,1,1,0,0,0,0
"Mar 24, 2021 7:00 AM",83,46,37,102,50,52,124,64,60,102,50,52,,,,12,,,,17,14,3,52,59,40,19,46,81,5,3,8,6,2,0,0,0
"Mar 24, 2021 8:00 AM",143,105,38,160,65,95,216,85,131,151,66,85,,,,38,,,,31,22,9,89,89,38,51,57,114,7,6,11,10,1,0,0,0
"Mar 24, 2021 9:00 AM",87,60,27,143,75,68,168,89,79,118,72,46,,,,16,,,,20,15,5,45,66,46,20,32,42,2,3,16,8,8,0,0,0
"Mar 24, 2021 10:00 AM",59,39,20,150,92,58,185,122,63,145,102,43,,,,12,,,,28,22,6,29,63,49,14,46,39,3,2,10,5,5,0,0,0
"Mar 24, 2021 11:00 AM",64,36,28,150,62,88,162,76,86,130,64,66,,,,13,,,,30,17,13,23,70,44,26,30,51,9,4,9,4,5,0,0,0
"Mar 24, 2021 12:00 PM",59,31,28,180,94,86,201,92,109,152,75,77,,,,25,,,,27,19,8,33,48,23,25,39,51,3,4,8,4,4,0,0,0
"Mar 24, 2021 1:00 PM",84,50,34,147,72,75,171,85,86,167,84,83,,,,19,,,,26,18,8,15,84,47,37,38,44,12,5,9,6,3,0,0,0
"Mar 24, 2021 2:00 PM",79,37,42,129,66,63,140,83,57,142,83,59,,,,29,,,,28,24,4,33,65,45,20,48,55,3,7,15,8,7,0,0,0
"Mar 24, 2021 3:00 PM",93,51,42,101,55,46,119,59,60,96,50,46,,,,27,,,,21,18,3,23,46,31,15,43,49,5,3,17,10,7,0,0,0
"Mar 24, 2021 4:00 PM",86,30,56,93,52,41,95,51,44,92,51,41,,,,17,,,,47,38,9,18,59,33,26,48,46,3,3,10,6,4,0,0,0
"Mar 24, 2021 5:00 PM",122,35,87,128,67,61,150,81,69,128,65,63,,,,23,,,,51,51,0,27,51,35,16,66,62,4,4,17,7,10,0,0,0
"Mar 24, 2021 6:00 PM",95,32,63,125,74,51,156,80,76,119,68,51,,,,13,,,,55,55,0,24,54,30,24,82,55,8,4,20,10,10,0,0,0
"Mar 24, 2021 7:00 PM",72,19,53,58,30,28,69,35,34,66,28,38,,,,4,,,,28,28,0,14,27,20,7,41,36,4,3,11,6,5,0,0,0
"Mar 24, 2021 8:00 PM",30,9,21,29,13,16,51,19,32,32,15,17,,,,6,,,,11,10,1,6,16,8,8,24,16,2,0,9,3,6,0,0,0
"Mar 24, 2021 9:00 PM",24,7,17,6,5,1,13,8,5,14,10,4,,,,3,,,,8,8,0,6,12,9,3,4,10,2,1,1,0,1,0,0,0
"Mar 24, 2021 10:00 PM",16,6,10,8,1,7,9,2,7,15,1,14,,,,1,,,,9,8,1,2,6,2,4,7,7,0,0,0,0,0,0,0,0
"Mar 24, 2021 11:00 PM",7,2,5,2,2,0,9,7,2,7,5,2,,,,0,,,,4,4,0,2,2,1,1,2,4,1,0,1,1,0,0,0,0
"Mar 25, 2021 12:00 AM",2,1,1,0,0,0,0,0,0,1,1,0,,,,0,,,,2,2,0,0,1,0,1,2,1,0,0,1,1,0,0,0,0
"Mar 25, 2021 1:00 AM",1,0,1,0,0,0,0,0,0,1,1,0,,,,0,,,,0,0,0,0,0,0,0,0,2,1,1,1,0,1,0,0,0
"Mar 25, 2021 2:00 AM",5,3,2,0,0,0,1,1,0,2,0,2,,,,1,,,,4,4,0,2,0,0,0,0,0,0,0,0,0,0,0,0,0
"Mar 25, 2021 3:00 AM",1,1,0,0,0,0,0,0,0,0,0,0,,,,0,,,,0,0,0,0,0,0,0,0,0,0,0,0,0,0,0,0,0
"Mar 25, 2021 4:00 AM",1,1,0,0,0,0,1,0,1,0,0,0,,,,0,,,,2,2,0,0,0,0,0,0,1,0,0,0,0,0,0,0,0
"Mar 25, 2021 5:00 AM",3,3,0,1,1,0,5,4,1,5,4,1,,,,1,,,,2,2,0,7,2,1,1,3,7,0,0,1,1,0,0,0,0
"Mar 25, 2021 6:00 AM",18,16,2,41,27,14,54,31,23,39,24,15,,,,3,,,,9,9,0,10,8,5,3,22,31,1,0,1,0,1,0,0,0
"Mar 25, 2021 7:00 AM",79,57,22,77,36,41,119,56,63,81,35,46,,,,6,,,,25,11,14,47,46,21,25,38,75,2,5,5,4,1,0,0,0
"Mar 25, 2021 8:00 AM",147,103,44,128,49,79,178,68,110,129,53,76,,,,23,,,,38,18,20,74,92,42,50,55,86,12,3,17,15,2,0,0,0
"Mar 25, 2021 9:00 AM",77,55,22,66,35,31,109,60,49,64,39,25,,,,20,,,,29,11,18,35,38,20,18,29,49,2,1,2,0,2,0,0,0
"Mar 25, 2021 10:00 AM",37,28,9,76,28,48,95,51,44,73,43,30,,,,13,,,,14,7,7,21,28,15,13,21,23,4,4,7,5,2,0,0,0
"Mar 25, 2021 11:00 AM",36,23,13,63,33,30,88,39,49,64,30,34,,,,7,,,,17,12,5,20,39,20,19,14,42,1,6,3,2,1,0,0,0
"Mar 25, 2021 12:00 PM",46,24,22,98,47,51,95,43,52,73,32,41,,,,16,,,,20,13,7,13,33,20,13,17,28,2,2,3,3,0,0,0,0
"Mar 25, 2021 1:00 PM",58,30,28,87,43,44,94,41,53,81,39,42,,,,11,,,,20,13,7,18,26,16,10,32,26,7,4,13,2,11,0,0,0
"Mar 25, 2021 2:00 PM",62,40,22,74,37,37,72,37,35,69,39,30,,,,4,,,,20,12,8,18,34,24,10,22,26,1,5,11,4,7,0,0,0
"Mar 25, 2021 3:00 PM",62,26,36,67,47,20,89,61,28,73,50,23,,,,25,,,,33,23,10,20,37,25,12,44,46,8,3,9,3,6,0,0,0
"Mar 25, 2021 4:00 PM",99,36,63,80,48,32,114,65,49,90,56,34,,,,14,,,,39,30,9,19,45,30,15,40,35,5,2,18,8,10,0,0,0
"Mar 25, 2021 5:00 PM",142,52,90,138,80,58,150,80,70,136,76,60,,,,40,,,,44,42,2,24,44,27,17,63,63,3,8,12,4,8,0,0,0
"Mar 25, 2021 6:00 PM",104,31,73,132,74,58,156,88,68,129,69,60,,,,38,,,,37,37,0,25,80,49,31,64,54,4,4,10,6,4,0,0,0
"Mar 25, 2021 7:00 PM",80,31,49,58,38,20,78,44,34,51,29,22,,,,33,,,,38,38,0,14,22,15,7,30,35,0,7,9,4,5,0,0,0
"Mar 25, 2021 8:00 PM",31,7,24,24,14,10,40,26,14,33,19,14,,,,13,,,,17,17,0,5,17,8,9,29,9,0,5,6,3,3,0,0,0
"Mar 25, 2021 9:00 PM",23,4,19,22,13,9,33,11,22,20,10,10,,,,8,,,,12,11,1,8,6,4,2,9,17,2,1,4,2,2,0,0,0
"Mar 25, 2021 10:00 PM",16,7,9,7,3,4,11,8,3,7,3,4,,,,5,,,,7,7,0,2,1,1,0,8,7,0,0,2,1,1,0,0,0
"Mar 25, 2021 11:00 PM",7,1,6,3,1,2,4,1,3,6,3,3,,,,1,,,,2,2,0,4,2,2,0,1,3,1,0,1,1,0,0,0,0
"Mar 26, 2021 12:00 AM",2,2,0,0,0,0,0,0,0,0,0,0,,,,2,,,,2,2,0,1,0,0,0,1,2,1,0,0,0,0,0,0,0
"Mar 26, 2021 1:00 AM",3,1,2,0,0,0,2,2,0,2,2,0,,,,0,,,,0,0,0,1,0,0,0,0,1,0,0,1,1,0,0,0,0
"Mar 26, 2021 2:00 AM",5,2,3,0,0,0,1,1,0,1,1,0,,,,2,,,,1,1,0,0,1,1,0,0,1,0,0,0,0,0,0,0,0
"Mar 26, 2021 3:00 AM",0,0,0,0,0,0,0,0,0,0,0,0,,,,0,,,,0,0,0,1,0,0,0,0,0,0,0,0,0,0,0,0,0
"Mar 26, 2021 4:00 AM",2,1,1,0,0,0,1,1,0,0,0,0,,,,0,,,,1,1,0,0,0,0,0,1,0,0,0,0,0,0,0,0,0
"Mar 26, 2021 5:00 AM",3,3,0,1,1,0,2,2,0,3,3,0,,,,0,,,,2,2,0,3,1,0,1,2,2,0,0,0,0,0,0,0,0
"Mar 26, 2021 6:00 AM",23,14,9,23,16,7,30,21,9,22,12,10,,,,2,,,,5,5,0,9,11,9,2,11,21,0,0,0,0,0,0,0,0
"Mar 26, 2021 7:00 AM",56,31,25,85,39,46,113,61,52,77,41,36,,,,15,,,,12,7,5,46,46,26,20,48,55,1,3,3,3,0,0,0,0
"Mar 26, 2021 8:00 AM",113,73,40,131,48,83,196,75,121,137,59,78,,,,23,,,,37,29,8,54,75,41,34,48,95,6,5,10,7,3,0,0,0
"Mar 26, 2021 9:00 AM",71,52,19,130,72,58,126,68,58,92,50,42,,,,7,,,,20,11,9,43,54,38,16,21,51,4,4,9,3,6,0,0,0
"Mar 26, 2021 10:00 AM",43,23,20,117,68,49,157,92,65,101,68,33,,,,13,,,,22,15,7,17,37,30,7,37,34,5,8,15,5,10,0,0,0
"Mar 26, 2021 11:00 AM",36,22,14,84,30,54,110,47,63,75,33,42,,,,16,,,,16,10,6,11,37,25,12,27,28,6,6,17,10,7,0,0,0
"Mar 26, 2021 12:00 PM",53,21,32,81,48,33,101,64,37,71,46,25,,,,17,,,,11,10,1,21,56,36,20,28,43,4,0,13,6,7,0,0,0
"Mar 26, 2021 1:00 PM",69,38,31,71,41,30,90,48,42,68,35,33,,,,11,,,,21,11,10,14,32,23,9,34,37,7,1,7,6,1,0,0,0
"Mar 26, 2021 2:00 PM",59,28,31,53,24,29,65,28,37,47,23,24,,,,20,,,,25,14,11,26,43,23,20,22,37,2,1,4,3,1,0,0,0
"Mar 26, 2021 3:00 PM",52,22,30,56,34,22,80,49,31,56,30,26,,,,12,,,,42,27,15,17,53,30,23,29,30,2,3,11,9,2,0,0,0
"Mar 26, 2021 4:00 PM",76,22,54,75,48,27,87,47,40,93,55,38,,,,12,,,,23,22,1,13,38,30,8,36,31,2,4,8,3,5,0,0,0
"Mar 26, 2021 5:00 PM",97,35,62,48,26,22,64,32,32,48,24,24,,,,9,,,,36,36,0,10,37,18,19,37,35,3,5,6,2,4,0,0,0
"Mar 26, 2021 6:00 PM",84,32,52,55,33,22,67,39,28,52,31,21,,,,17,,,,29,29,0,16,28,20,8,48,29,0,4,3,0,3,0,0,0
"Mar 26, 2021 7:00 PM",57,21,36,21,12,9,30,17,13,18,11,7,,,,15,,,,22,21,1,20,10,5,5,18,17,1,5,3,2,1,0,0,0
"Mar 26, 2021 8:00 PM",21,8,13,14,7,7,14,5,9,12,7,5,,,,4,,,,9,9,0,4,2,2,0,14,16,0,0,0,0,0,0,0,0
"Mar 26, 2021 9:00 PM",24,11,13,3,2,1,4,1,3,4,1,3,,,,7,,,,4,4,0,4,1,1,0,6,13,2,0,3,1,2,0,0,0
"Mar 26, 2021 10:00 PM",8,2,6,8,1,7,2,2,0,1,1,0,,,,3,,,,6,6,0,3,0,0,0,6,9,0,0,1,0,1,0,0,0
"Mar 26, 2021 11:00 PM",9,5,4,1,1,0,4,3,1,1,1,0,,,,2,,,,5,5,0,4,0,0,0,6,4,1,0,2,2,0,0,0,0
"Mar 27, 2021 12:00 AM",6,2,4,0,0,0,0,0,0,2,1,1,,,,0,,,,1,1,0,0,0,0,0,1,1,0,0,0,0,0,0,0,0
"Mar 27, 2021 1:00 AM",3,0,3,3,3,0,3,3,0,1,1,0,,,,0,,,,4,4,0,2,1,1,0,0,0,0,0,1,0,1,0,0,0
"Mar 27, 2021 2:00 AM",1,1,0,0,0,0,1,1,0,0,0,0,,,,0,,,,2,2,0,0,0,0,0,2,1,0,0,0,0,0,0,0,0
"Mar 27, 2021 3:00 AM",1,1,0,1,1,0,0,0,0,0,0,0,,,,1,,,,0,0,0,0,0,0,0,0,2,0,0,2,1,1,0,0,0
"Mar 27, 2021 4:00 AM",2,1,1,0,0,0,0,0,0,0,0,0,,,,0,,,,3,3,0,0,1,1,0,0,0,0,0,1,0,1,0,0,0
"Mar 27, 2021 5:00 AM",1,0,1,1,1,0,3,3,0,3,3,0,,,,1,,,,2,2,0,2,0,0,0,1,1,0,0,0,0,0,0,0,0
"Mar 27, 2021 6:00 AM",9,6,3,8,8,0,11,9,2,4,4,0,,,,0,,,,0,0,0,3,1,1,0,8,3,0,1,0,0,0,0,0,0
"Mar 27, 2021 7:00 AM",17,9,8,50,33,17,56,37,19,43,30,13,,,,3,,,,4,3,1,8,25,14,11,26,15,1,3,1,0,1,0,0,0
"Mar 27, 2021 8:00 AM",28,11,17,117,75,42,121,78,43,100,71,29,,,,5,,,,12,11,1,15,43,29,14,30,32,4,9,5,2,3,0,0,0
"Mar 27, 2021 9:00 AM",65,35,30,201,118,83,213,139,74,163,107,56,,,,15,,,,20,18,2,22,69,46,23,66,45,6,16,6,3,3,0,0,0
"Mar 27, 2021 10:00 AM",72,42,30,300,159,141,389,223,166,284,169,115,,,,8,,,,20,19,1,25,122,81,41,82,75,9,10,12,5,7,0,0,0
"Mar 27, 2021 11:00 AM",95,50,45,391,213,178,513,294,219,372,205,167,,,,13,,,,18,16,2,44,154,97,57,122,121,24,12,22,7,15,0,0,0
"Mar 27, 2021 12:00 PM",85,45,40,403,190,213,419,179,240,373,197,176,,,,47,,,,26,26,0,45,149,77,72,92,121,9,14,20,7,13,0,0,0
"Mar 27, 2021 1:00 PM",101,46,55,287,139,148,326,155,171,277,138,139,,,,19,,,,30,30,0,37,83,53,30,79,83,9,8,17,11,6,0,0,0
"Mar 27, 2021 2:00 PM",103,56,47,261,131,130,271,129,142,279,122,157,,,,35,,,,24,24,0,49,132,80,52,64,78,5,2,7,3,4,0,0,0
"Mar 27, 2021 3:00 PM",70,34,36,169,90,79,224,107,117,178,92,86,,,,27,,,,23,23,0,27,91,51,40,61,66,8,1,17,9,8,0,0,0
"Mar 27, 2021 4:00 PM",77,34,43,162,73,89,193,90,103,175,74,101,,,,24,,,,16,16,0,36,88,40,48,38,61,8,6,15,7,8,0,0,0
"Mar 27, 2021 5:00 PM",53,29,24,113,49,64,113,39,74,98,40,58,,,,25,,,,29,29,0,20,53,26,27,20,43,2,2,11,5,6,0,0,0
"Mar 27, 2021 6:00 PM",31,14,17,28,11,17,51,19,32,33,14,19,,,,9,,,,8,8,0,8,35,13,22,16,20,1,6,2,2,0,0,0,0
"Mar 27, 2021 7:00 PM",40,17,23,22,6,16,33,12,21,30,10,20,,,,12,,,,10,10,0,10,10,7,3,10,19,2,4,7,3,4,0,0,0
"Mar 27, 2021 8:00 PM",25,14,11,19,7,12,12,7,5,13,6,7,,,,6,,,,9,9,0,5,8,5,3,9,17,0,0,3,2,1,0,0,0
"Mar 27, 2021 9:00 PM",11,4,7,6,4,2,10,4,6,12,6,6,,,,1,,,,2,2,0,5,4,2,2,8,7,1,0,3,1,2,0,0,0
"Mar 27, 2021 10:00 PM",8,1,7,1,0,1,5,1,4,7,3,4,,,,3,,,,3,3,0,3,13,2,11,1,7,0,0,3,1,2,0,0,0
"Mar 27, 2021 11:00 PM",10,4,6,4,2,2,3,1,2,4,2,2,,,,2,,,,4,4,0,2,2,0,2,2,2,0,0,2,0,2,0,0,0
"Mar 28, 2021 12:00 AM",3,1,2,0,0,0,2,2,0,4,3,1,,,,2,,,,1,1,0,1,1,1,0,1,0,0,0,2,1,1,0,0,0
"Mar 28, 2021 2:00 AM",,,,,,,,,,,,,,,,,,,,,,,,,,,,,,,,,,,,
"Mar 28, 2021 2:00 AM",2,1,1,0,0,0,2,0,2,0,0,0,,,,0,,,,1,1,0,3,3,2,1,0,1,0,0,1,1,0,0,0,0
"Mar 28, 2021 3:00 AM",5,0,5,1,1,0,1,0,1,2,2,0,,,,0,,,,3,3,0,2,1,1,0,1,2,0,0,0,0,0,0,0,0
"Mar 28, 2021 4:00 AM",0,0,0,0,0,0,1,1,0,0,0,0,,,,0,,,,2,2,0,0,0,0,0,1,1,0,0,2,1,1,0,0,0
"Mar 28, 2021 5:00 AM",1,1,0,0,0,0,2,1,1,1,1,0,,,,0,,,,1,1,0,3,0,0,0,0,4,0,0,0,0,0,0,0,0
"Mar 28, 2021 6:00 AM",5,4,1,3,3,0,5,4,1,3,3,0,,,,1,,,,2,2,0,4,2,2,0,6,2,0,1,1,0,1,0,0,0
"Mar 28, 2021 7:00 AM",4,3,1,13,10,3,12,9,3,10,8,2,,,,1,,,,2,2,0,4,6,4,2,6,6,0,1,0,0,0,0,0,0
"Mar 28, 2021 8:00 AM",18,9,9,30,20,10,27,13,14,31,22,9,,,,1,,,,2,2,0,8,22,15,7,9,23,2,2,3,2,1,0,0,0
"Mar 28, 2021 9:00 AM",23,9,14,67,42,25,69,51,18,66,49,17,,,,1,,,,11,10,1,7,34,22,12,18,20,1,8,5,1,4,0,0,0
"Mar 28, 2021 10:00 AM",25,12,13,160,95,65,207,120,87,142,86,56,,,,9,,,,9,8,1,19,58,30,28,38,31,6,9,7,6,1,0,0,0
"Mar 28, 2021 11:00 AM",53,31,22,239,108,131,202,106,96,177,87,90,,,,16,,,,8,8,0,30,53,33,20,51,60,7,8,13,8,5,0,0,0
"Mar 28, 2021 12:00 PM",76,53,23,224,96,128,265,128,137,229,122,107,,,,56,,,,26,26,0,32,87,50,37,59,54,6,9,10,3,7,0,0,0
"Mar 28, 2021 1:00 PM",76,42,34,235,123,112,277,155,122,225,129,96,,,,40,,,,21,21,0,27,115,66,49,72,75,8,5,14,6,8,0,0,0
"Mar 28, 2021 2:00 PM",104,47,57,251,122,129,304,158,146,263,151,112,,,,53,,,,22,22,0,28,121,68,53,60,70,8,2,25,16,9,0,0,0
"Mar 28, 2021 3:00 PM",98,46,52,229,95,134,267,109,158,194,85,109,,,,33,,,,24,24,0,35,95,54,41,39,73,4,8,12,6,6,0,0,0
"Mar 28, 2021 4:00 PM",62,36,26,204,122,82,203,105,98,174,97,77,,,,25,,,,21,21,0,21,78,39,39,29,57,5,3,18,11,7,0,0,0
"Mar 28, 2021 5:00 PM",38,19,19,90,39,51,156,70,86,108,45,63,,,,15,,,,18,14,4,8,68,25,43,19,39,1,3,19,8,11,0,0,0
"Mar 28, 2021 6:00 PM",42,18,24,59,22,37,63,26,37,55,21,34,,,,11,,,,11,11,0,18,21,13,8,18,34,2,0,7,3,4,0,0,0
"Mar 28, 2021 7:00 PM",35,15,20,41,22,19,51,27,24,48,27,21,,,,19,,,,11,11,0,10,18,6,12,14,11,4,1,3,1,2,0,0,0
"Mar 28, 2021 8:00 PM",13,5,8,23,12,11,34,12,22,22,8,14,,,,6,,,,7,7,0,9,10,3,7,12,14,0,1,1,1,0,0,0,0
"Mar 28, 2021 9:00 PM",12,5,7,19,4,15,11,1,10,13,3,10,,,,8,,,,0,0,0,9,5,1,4,7,7,0,0,3,1,2,0,0,0
"Mar 28, 2021 10:00 PM",9,1,8,5,0,5,8,4,4,13,8,5,,,,1,,,,4,4,0,4,0,0,0,3,5,0,0,3,2,1,0,0,0
"Mar 28, 2021 11:00 PM",2,0,2,5,4,1,1,1,0,3,2,1,,,,1,,,,1,1,0,4,0,0,0,2,0,0,0,2,1,1,0,0,0
"Mar 29, 2021 12:00 AM",4,2,2,4,3,1,2,1,1,2,0,2,,,,0,,,,3,3,0,1,3,2,1,0,0,0,0,0,0,0,0,0,0
"Mar 29, 2021 1:00 AM",0,0,0,0,0,0,1,1,0,1,1,0,,,,1,,,,1,1,0,0,1,1,0,0,2,0,0,1,1,0,0,0,0
"Mar 29, 2021 2:00 AM",0,0,0,3,1,2,1,1,0,0,0,0,,,,0,,,,2,2,0,0,0,0,0,1,0,0,0,1,1,0,0,0,0
"Mar 29, 2021 3:00 AM",1,0,1,2,0,2,0,0,0,0,0,0,,,,1,,,,1,1,0,0,0,0,0,0,0,0,0,0,0,0,0,0,0
"Mar 29, 2021 4:00 AM",0,0,0,0,0,0,0,0,0,0,0,0,,,,0,,,,1,1,0,1,0,0,0,0,0,0,0,0,0,0,0,0,0
"Mar 29, 2021 5:00 AM",1,1,0,0,0,0,2,2,0,3,2,1,,,,2,,,,1,1,0,5,1,0,1,3,9,0,0,0,0,0,0,0,0
"Mar 29, 2021 6:00 AM",24,18,6,22,16,6,27,24,3,19,15,4,,,,3,,,,3,3,0,14,11,10,1,13,30,0,0,1,1,0,0,0,0
"Mar 29, 2021 7:00 AM",57,40,17,73,33,40,73,33,40,67,35,32,,,,4,,,,15,9,6,43,19,11,8,36,53,2,2,2,1,1,0,0,0
"Mar 29, 2021 8:00 AM",100,70,30,85,31,54,87,34,53,74,30,44,,,,10,,,,20,12,8,55,48,20,28,27,83,4,3,7,5,2,0,0,0
"Mar 29, 2021 9:00 AM",94,70,24,89,44,45,112,57,55,89,47,42,,,,6,,,,16,9,7,52,56,30,26,23,40,1,4,10,6,4,0,0,0
"Mar 29, 2021 10:00 AM",46,36,10,112,71,41,118,81,37,109,73,36,,,,15,,,,15,13,2,23,40,22,18,22,39,3,3,9,3,6,0,0,0
"Mar 29, 2021 11:00 AM",50,31,19,128,66,62,173,83,90,119,59,60,,,,12,,,,12,4,8,14,52,33,19,34,27,9,5,20,17,3,0,0,0
"Mar 29, 2021 12:00 PM",62,30,32,144,83,61,254,149,105,142,84,58,,,,18,,,,26,16,10,26,98,70,28,58,42,6,4,20,9,11,0,0,0
"Mar 29, 2021 1:00 PM",88,54,34,165,94,71,262,137,125,159,92,67,,,,44,,,,19,14,5,36,99,68,31,72,53,5,4,17,10,7,0,0,0
"Mar 29, 2021 2:00 PM",92,48,44,204,116,88,304,178,126,190,113,77,,,,38,,,,40,30,10,30,112,85,27,67,68,4,7,13,8,5,0,0,0
"Mar 29, 2021 3:00 PM",80,41,39,293,165,128,303,174,129,231,146,85,,,,35,,,,42,35,7,25,104,61,43,89,69,14,4,17,12,5,0,0,0
"Mar 29, 2021 4:00 PM",118,44,74,257,134,123,324,157,167,249,126,123,,,,26,,,,63,53,10,28,135,75,60,70,91,9,8,29,22,7,0,0,0
"Mar 29, 2021 5:00 PM",160,52,108,286,145,141,314,151,163,286,134,152,,,,40,,,,54,54,0,26,123,70,53,88,85,9,10,14,11,3,0,0,0
"Mar 29, 2021 6:00 PM",153,55,98,377,199,178,397,201,196,325,191,134,,,,39,,,,53,50,3,31,112,64,48,109,116,7,6,21,12,9,0,0,0
"Mar 29, 2021 7:00 PM",91,33,58,248,112,136,299,137,162,252,119,133,,,,30,,,,40,40,0,26,129,66,63,58,94,8,5,16,8,8,0,0,0
"Mar 29, 2021 8:00 PM",64,12,52,130,57,73,116,28,88,143,42,101,,,,12,,,,21,18,3,12,53,21,32,19,48,0,4,9,5,4,0,0,0
"Mar 29, 2021 9:00 PM",31,12,19,38,20,18,51,23,28,32,14,18,,,,3,,,,11,11,0,11,15,2,13,9,15,3,1,2,2,0,0,0,0
"Mar 29, 2021 10:00 PM",7,2,5,10,5,5,11,4,7,9,4,5,,,,1,,,,8,7,1,5,5,3,2,4,14,0,0,1,1,0,0,0,0
"Mar 29, 2021 11:00 PM",13,5,8,9,3,6,8,2,6,4,2,2,,,,2,,,,2,2,0,0,0,0,0,5,2,1,0,1,0,1,0,0,0
"Mar 30, 2021 12:00 AM",4,2,2,0,0,0,2,2,0,1,0,1,,,,2,,,,2,2,0,1,2,2,0,2,2,0,0,1,1,0,0,0,0
"Mar 30, 2021 1:00 AM",6,1,5,1,1,0,5,2,3,1,1,0,,,,0,,,,3,3,0,2,1,1,0,0,0,1,0,1,0,1,0,0,0
"Mar 30, 2021 2:00 AM",1,0,1,2,2,0,2,2,0,2,2,0,,,,1,,,,1,1,0,1,2,1,1,1,0,1,1,1,1,0,0,0,0
"Mar 30, 2021 3:00 AM",0,0,0,0,0,0,1,1,0,1,1,0,,,,0,,,,2,2,0,0,0,0,0,0,2,0,0,1,0,1,0,0,0
"Mar 30, 2021 4:00 AM",3,1,2,0,0,0,0,0,0,0,0,0,,,,0,,,,1,1,0,1,0,0,0,0,0,0,0,1,1,0,0,0,0
"Mar 30, 2021 5:00 AM",4,4,0,0,0,0,4,3,1,5,4,1,,,,1,,,,1,1,0,6,1,0,1,3,9,0,0,0,0,0,0,0,0
"Mar 30, 2021 6:00 AM",34,27,7,36,29,7,62,51,11,35,29,6,,,,1,,,,6,6,0,13,14,13,1,33,38,0,1,2,1,1,0,0,0
"Mar 30, 2021 7:00 AM",87,56,31,152,92,60,125,72,53,136,91,45,,,,20,,,,25,17,8,50,29,18,11,47,78,1,6,3,2,1,0,0,0
"Mar 30, 2021 8:00 AM",121,80,41,169,64,105,140,49,91,143,61,82,,,,19,,,,25,14,11,70,71,37,34,39,98,6,6,12,9,3,0,0,0
"Mar 30, 2021 9:00 AM",96,75,21,149,71,78,169,95,74,155,83,72,,,,4,,,,22,17,5,47,72,46,26,41,49,4,5,16,7,9,0,0,0
"Mar 30, 2021 10:00 AM",67,49,18,175,89,86,207,129,78,173,112,61,,,,19,,,,18,14,4,39,93,73,20,34,56,13,3,14,10,4,0,0,0
"Mar 30, 2021 11:00 AM",90,51,39,224,140,84,287,191,96,227,150,77,,,,39,,,,19,15,4,33,151,110,41,69,38,6,8,18,12,6,0,0,0
"Mar 30, 2021 12:00 PM",88,40,48,258,136,122,385,217,168,275,152,123,,,,24,,,,29,26,3,41,129,90,39,100,84,10,7,27,17,10,0,0,0
"Mar 30, 2021 1:00 PM",113,50,63,305,176,129,525,280,245,277,161,116,,,,42,,,,35,31,4,43,232,142,90,127,79,11,8,28,17,11,0,0,0
"Mar 30, 2021 2:00 PM",127,73,54,341,190,151,480,301,179,325,197,128,,,,36,,,,31,23,8,29,185,114,71,104,87,15,7,25,14,11,0,0,0
"Mar 30, 2021 3:00 PM",110,40,70,268,141,127,467,222,245,285,142,143,,,,39,,,,38,33,5,40,175,92,83,106,98,10,13,26,11,15,0,0,0
"Mar 30, 2021 4:00 PM",140,58,82,316,161,155,466,192,274,299,138,161,,,,26,,,,65,57,8,45,193,93,100,91,130,17,3,27,22,5,0,0,0
"Mar 30, 2021 5:00 PM",182,62,120,317,157,160,399,181,218,333,159,174,,,,38,,,,69,61,8,45,152,66,86,124,150,14,9,28,22,6,0,0,0
"Mar 30, 2021 6:00 PM",162,56,106,377,207,170,424,227,197,353,200,153,,,,35,,,,65,64,1,50,141,79,62,110,107,8,13,18,11,7,0,0,0
"Mar 30, 2021 7:00 PM",111,48,63,248,113,135,293,119,174,274,123,151,,,,30,,,,47,47,0,41,132,62,70,65,101,7,9,20,11,9,0,0,0
"Mar 30, 2021 8:00 PM",55,13,42,78,24,54,132,36,96,99,28,71,,,,11,,,,27,27,0,15,51,22,29,29,61,5,2,8,5,3,0,0,0
"Mar 30, 2021 9:00 PM",28,6,22,40,23,17,51,14,37,46,18,28,,,,14,,,,12,12,0,11,25,11,14,9,22,5,0,1,0,1,0,0,0
"Mar 30, 2021 10:00 PM",13,7,6,8,2,6,11,1,10,11,3,8,,,,2,,,,12,12,0,4,5,2,3,6,11,0,1,2,2,0,0,0,0
"Mar 30, 2021 11:00 PM",9,3,6,6,6,0,9,3,6,6,6,0,,,,1,,,,4,4,0,4,2,1,1,0,6,0,0,1,0,1,0,0,0
"Mar 31, 2021 12:00 AM",3,1,2,2,2,0,4,2,2,4,2,2,,,,1,,,,3,3,0,0,1,1,0,3,1,0,0,0,0,0,0,0,0
"Mar 31, 2021 1:00 AM",2,1,1,2,2,0,1,1,0,1,1,0,,,,1,,,,4,4,0,0,1,1,0,1,0,0,1,0,0,0,0,0,0
"Mar 31, 2021 2:00 AM",3,2,1,2,1,1,1,1,0,1,0,1,,,,0,,,,5,4,1,1,0,0,0,0,0,0,1,0,0,0,0,0,0
"Mar 31, 2021 3:00 AM",3,0,3,0,0,0,0,0,0,0,0,0,,,,0,,,,0,0,0,0,0,0,0,0,1,0,0,0,0,0,0,0,0
"Mar 31, 2021 4:00 AM",1,1,0,0,0,0,4,4,0,0,0,0,,,,0,,,,2,2,0,0,0,0,0,3,2,0,0,0,0,0,0,0,0
"Mar 31, 2021 5:00 AM",8,6,2,4,4,0,5,4,1,6,5,1,,,,0,,,,2,2,0,5,2,2,0,2,6,0,0,2,0,2,0,0,0
"Mar 31, 2021 6:00 AM",25,17,8,26,18,8,29,18,11,25,18,7,,,,2,,,,7,7,0,12,7,5,2,14,33,1,2,1,0,1,0,0,0
"Mar 31, 2021 7:00 AM",66,45,21,96,43,53,93,42,51,80,39,41,,,,9,,,,20,16,4,54,27,15,12,29,65,5,2,6,3,3,0,0,0
"Mar 31, 2021 8:00 AM",126,94,32,108,39,69,101,42,59,87,37,50,,,,15,,,,16,15,1,74,51,21,30,48,85,3,3,13,9,4,0,0,0
"Mar 31, 2021 9:00 AM",84,63,21,104,53,51,101,53,48,103,51,52,,,,15,,,,15,15,0,33,38,24,14,29,39,3,4,9,6,3,0,0,0
"Mar 31, 2021 10:00 AM",65,42,23,119,66,53,149,92,57,114,72,42,,,,20,,,,13,10,3,28,45,36,9,29,35,2,5,6,2,4,0,0,0
"Mar 31, 2021 11:00 AM",56,36,20,190,95,95,183,103,80,146,77,69,,,,32,,,,16,15,1,20,78,49,29,49,49,4,3,15,8,7,0,0,0
"Mar 31, 2021 12:00 PM",79,50,29,215,133,82,254,134,120,215,125,90,,,,20,,,,17,17,0,38,93,50,43,60,48,7,4,11,5,6,0,0,0
"Mar 31, 2021 1:00 PM",74,40,34,183,102,81,272,130,142,189,103,86,,,,28,,,,25,25,0,36,104,68,36,48,70,5,10,26,17,9,0,0,0
"Mar 31, 2021 2:00 PM",77,48,29,198,105,93,233,125,108,175,102,73,,,,27,,,,20,18,2,25,113,67,46,59,59,5,3,18,7,11,0,0,0
"Mar 31, 2021 3:00 PM",73,36,37,151,78,73,223,106,117,168,95,73,,,,49,,,,20,18,2,21,86,54,32,31,63,9,11,17,9,8,0,0,0
"Mar 31, 2021 4:00 PM",111,46,65,186,80,106,214,107,107,169,79,90,,,,32,,,,41,38,3,25,100,47,53,66,50,7,6,5,3,2,0,0,0
"Mar 31, 2021 5:00 PM",155,50,105,191,96,95,235,118,117,188,81,107,,,,54,,,,64,63,1,34,94,47,47,100,76,7,9,9,5,4,0,0,0
"Mar 31, 2021 6:00 PM",148,51,97,228,116,112,229,126,103,201,118,83,,,,15,,,,59,58,1,42,93,56,37,75,64,7,4,8,3,5,0,0,0
"Mar 31, 2021 7:00 PM",71,26,45,159,85,74,147,65,82,155,81,74,,,,24,,,,34,34,0,20,64,42,22,51,54,9,4,8,6,2,0,0,0
"Mar 31, 2021 8:00 PM",44,16,28,77,40,37,71,34,37,69,32,37,,,,28,,,,19,19,0,13,28,18,10,29,32,4,1,4,2,2,0,0,0
"Mar 31, 2021 9:00 PM",26,11,15,44,22,22,35,13,22,36,15,21,,,,7,,,,5,5,0,6,10,5,5,11,23,0,1,2,0,2,0,0,0
"Mar 31, 2021 10:00 PM",16,7,9,25,13,12,13,8,5,13,9,4,,,,3,,,,4,4,0,6,3,2,1,7,3,0,3,1,1,0,0,0,0
"Mar 31, 2021 11:00 PM",8,4,4,2,0,2,6,1,5,4,1,3,,,,1,,,,7,7,0,0,0,0,0,3,8,1,1,1,1,0,0,0,0
"Apr 1, 2021 12:00 AM",3,0,3,0,0,0,1,1,0,2,0,2,,,,0,,,,2,2,0,1,0,0,0,2,2,0,0,0,0,0,0,0,0
"Apr 1, 2021 1:00 AM",0,0,0,0,0,0,2,1,1,0,0,0,,,,0,,,,0,0,0,1,2,1,1,0,0,0,0,1,1,0,0,0,0
"Apr 1, 2021 2:00 AM",3,2,1,0,0,0,0,0,0,0,0,0,,,,0,,,,2,1,1,0,0,0,0,0,0,0,0,0,0,0,0,0,0
"Apr 1, 2021 3:00 AM",2,0,2,0,0,0,0,0,0,0,0,0,,,,0,,,,0,0,0,1,0,0,0,0,5,0,0,0,0,0,0,0,0
"Apr 1, 2021 4:00 AM",0,0,0,0,0,0,3,2,1,0,0,0,,,,0,,,,3,2,1,0,2,2,0,1,0,0,0,1,1,0,0,0,0
"Apr 1, 2021 5:00 AM",4,2,2,2,2,0,5,4,1,5,4,1,,,,0,,,,2,2,0,3,1,1,0,1,8,0,0,0,0,0,0,0,0
"Apr 1, 2021 6:00 AM",23,18,5,36,29,7,43,35,8,37,31,6,,,,1,,,,5,5,0,10,10,9,1,15,32,0,0,1,1,0,0,0,0
"Apr 1, 2021 7:00 AM",76,48,28,84,36,48,84,35,49,69,38,31,,,,9,,,,15,13,2,46,32,19,13,36,56,1,2,5,3,2,0,0,0
"Apr 1, 2021 8:00 AM",103,72,31,85,44,41,94,43,51,74,39,35,,,,12,,,,18,15,3,62,42,19,23,45,80,5,2,5,5,0,0,0,0
"Apr 1, 2021 9:00 AM",70,48,22,82,42,40,96,61,35,82,50,32,,,,13,,,,14,11,3,36,40,24,16,35,36,4,3,4,3,1,0,0,0
"Apr 1, 2021 10:00 AM",62,45,17,114,64,50,113,67,46,104,61,43,,,,17,,,,10,9,1,34,39,26,13,23,34,11,6,3,3,0,0,0,0
"Apr 1, 2021 11:00 AM",49,37,12,102,43,59,113,52,61,105,45,60,,,,17,,,,13,12,1,21,56,29,27,29,45,16,4,9,4,5,0,0,0
"Apr 1, 2021 12:00 PM",71,37,34,117,59,58,150,77,73,131,67,64,,,,21,,,,17,17,0,23,71,37,34,41,42,8,5,7,6,1,0,0,0
"Apr 1, 2021 1:00 PM",68,39,29,107,59,48,116,64,52,84,49,35,,,,24,,,,22,20,2,19,64,42,22,34,40,6,3,16,13,3,0,0,0
"Apr 1, 2021 2:00 PM",66,42,24,82,47,35,153,83,70,97,54,43,,,,19,,,,30,28,2,13,58,33,25,47,50,11,12,7,7,0,0,0,0
"Apr 1, 2021 3:00 PM",85,36,49,119,59,60,142,78,64,126,75,51,,,,36,,,,27,19,8,26,74,40,34,37,39,8,5,2,1,1,0,0,0
"Apr 1, 2021 4:00 PM",98,29,69,118,59,59,142,60,82,107,48,59,,,,24,,,,27,27,0,21,52,23,29,48,31,3,3,5,1,4,0,0,0
"Apr 1, 2021 5:00 PM",150,42,108,110,62,48,131,70,61,123,60,63,,,,27,,,,54,54,0,28,63,36,27,58,55,9,9,9,7,2,0,0,0
"Apr 1, 2021 6:00 PM",104,37,67,139,73,66,134,80,54,109,58,51,,,,27,,,,45,44,1,28,51,32,19,68,46,5,5,13,5,8,0,0,0
"Apr 1, 2021 7:00 PM",70,28,42,92,45,47,105,55,50,92,54,38,,,,18,,,,25,25,0,17,42,21,21,41,33,9,4,10,8,2,0,0,0
"Apr 1, 2021 8:00 PM",41,13,28,56,29,27,46,23,23,52,26,26,,,,11,,,,22,22,0,14,29,15,14,27,24,1,1,7,3,4,0,0,0
"Apr 1, 2021 9:00 PM",39,17,22,12,9,3,21,9,12,16,10,6,,,,9,,,,12,11,1,13,13,6,7,5,9,1,0,0,0,0,0,0,0
"Apr 1, 2021 10:00 PM",14,5,9,9,5,4,14,5,9,16,8,8,,,,2,,,,13,12,1,3,5,5,0,11,5,0,0,0,0,0,0,0,0
"Apr 1, 2021 11:00 PM",13,5,8,4,2,2,4,1,3,5,1,4,,,,2,,,,7,7,0,3,5,2,3,6,7,0,0,0,0,0,0,0,0
"Apr 2, 2021 12:00 AM",5,3,2,2,2,0,8,4,4,7,4,3,,,,3,,,,4,4,0,0,1,0,1,2,2,1,0,0,0,0,0,0,0
"Apr 2, 2021 1:00 AM",1,0,1,0,0,0,1,0,1,0,0,0,,,,0,,,,1,1,0,2,1,0,1,2,0,1,0,0,0,0,0,0,0
"Apr 2, 2021 2:00 AM",3,1,2,0,0,0,0,0,0,0,0,0,,,,0,,,,1,1,0,1,0,0,0,0,2,0,0,0,0,0,0,0,0
"Apr 2, 2021 3:00 AM",1,1,0,0,0,0,0,0,0,0,0,0,,,,1,,,,3,3,0,0,1,1,0,0,1,0,0,0,0,0,0,0,0
"Apr 2, 2021 4:00 AM",0,0,0,0,0,0,2,2,0,1,0,1,,,,0,,,,2,2,0,1,0,0,0,2,2,0,0,0,0,0,0,0,0
"Apr 2, 2021 5:00 AM",0,0,0,1,0,1,4,2,2,4,2,2,,,,1,,,,1,1,0,4,0,0,0,2,3,0,0,0,0,0,0,0,0
"Apr 2, 2021 6:00 AM",21,16,5,47,30,17,34,27,7,27,24,3,,,,1,,,,1,1,0,6,7,7,0,11,22,1,0,0,0,0,0,0,0
"Apr 2, 2021 7:00 AM",46,23,23,61,33,28,45,24,21,58,34,24,,,,6,,,,8,8,0,22,21,16,5,21,43,0,6,1,1,0,0,0,0
"Apr 2, 2021 8:00 AM",62,35,27,130,61,69,103,51,52,98,59,39,,,,6,,,,15,14,1,22,52,23,29,34,44,8,7,2,2,0,0,0,0
"Apr 2, 2021 9:00 AM",52,33,19,207,135,72,202,139,63,198,130,68,,,,11,,,,19,19,0,33,77,54,23,56,59,2,16,2,1,1,0,0,0
"Apr 2, 2021 10:00 AM",75,42,33,281,164,117,251,150,101,242,152,90,,,,21,,,,23,21,2,21,87,62,25,80,62,7,15,7,1,6,0,0,0
"Apr 2, 2021 11:00 AM",106,53,53,318,172,146,280,154,126,274,152,122,,,,33,,,,18,16,2,40,108,59,49,96,90,16,14,9,8,1,0,0,0
"Apr 2, 2021 12:00 PM",97,48,49,301,150,151,324,175,149,276,145,131,,,,47,,,,28,26,2,46,144,75,69,95,105,19,13,10,6,4,0,0,0
"Apr 2, 2021 1:00 PM",98,58,40,268,135,133,376,222,154,326,183,143,,,,36,,,,27,25,2,35,166,128,38,83,89,10,12,18,12,6,0,0,0
"Apr 2, 2021 2:00 PM",111,71,40,266,138,128,376,229,147,274,170,104,,,,49,,,,38,37,1,38,131,78,53,115,72,15,4,7,6,1,0,0,0
"Apr 2, 2021 3:00 PM",111,55,56,317,179,138,414,233,181,307,186,121,,,,45,,,,41,38,3,41,212,137,75,121,118,16,13,10,5,5,0,0,0
"Apr 2, 2021 4:00 PM",147,66,81,329,171,158,418,180,238,333,143,190,,,,55,,,,35,34,1,49,169,87,82,92,112,9,3,10,4,6,0,0,0
"Apr 2, 2021 5:00 PM",101,46,55,279,115,164,389,165,224,304,131,173,,,,29,,,,31,31,0,37,154,91,63,76,114,10,10,7,5,2,0,0,0
"Apr 2, 2021 6:00 PM",97,49,48,170,79,91,231,85,146,178,75,103,,,,24,,,,32,32,0,26,95,46,49,45,74,7,3,14,8,6,0,0,0
"Apr 2, 2021 7:00 PM",73,29,44,96,52,44,166,65,101,114,54,60,,,,18,,,,31,30,1,21,66,24,42,26,73,10,3,14,5,9,0,0,0
"Apr 2, 2021 8:00 PM",61,21,40,52,29,23,83,27,56,66,30,36,,,,10,,,,8,8,0,12,39,13,26,19,36,4,4,3,2,1,0,0,0
"Apr 2, 2021 9:00 PM",35,17,18,10,7,3,26,11,15,12,5,7,,,,9,,,,14,14,0,10,10,5,5,15,16,1,0,1,0,1,0,0,0
"Apr 2, 2021 10:00 PM",25,11,14,22,11,11,12,4,8,15,5,10,,,,2,,,,9,9,0,10,7,4,3,9,12,1,1,0,0,0,0,0,0
"Apr 2, 2021 11:00 PM",8,5,3,8,1,7,6,4,2,7,4,3,,,,2,,,,5,5,0,8,1,1,0,5,18,0,0,3,1,2,0,0,0
"Apr 3, 2021 12:00 AM",9,0,9,1,1,0,3,2,1,8,3,5,,,,4,,,,1,1,0,2,0,0,0,3,1,0,0,0,0,0,0,0,0
"Apr 3, 2021 1:00 AM",10,6,4,3,2,1,5,4,1,4,3,1,,,,0,,,,5,5,0,3,0,0,0,6,4,0,0,0,0,0,0,0,0
"Apr 3, 2021 2:00 AM",3,1,2,1,1,0,6,5,1,2,2,0,,,,2,,,,4,4,0,2,0,0,0,4,2,0,2,0,0,0,0,0,0
"Apr 3, 2021 3:00 AM",0,0,0,1,0,1,6,2,4,5,2,3,,,,0,,,,2,2,0,0,1,0,1,0,1,0,1,0,0,0,0,0,0
"Apr 3, 2021 4:00 AM",2,1,1,1,1,0,3,3,0,1,1,0,,,,0,,,,5,4,1,1,0,0,0,1,0,0,0,0,0,0,0,0,0
"Apr 3, 2021 5:00 AM",3,0,3,1,0,1,2,2,0,3,2,1,,,,2,,,,2,2,0,4,1,1,0,1,2,0,0,0,0,0,0,0,0
"Apr 3, 2021 6:00 AM",3,1,2,14,8,6,22,17,5,10,9,1,,,,1,,,,0,0,0,2,4,2,2,9,13,0,0,0,0,0,0,0,0
"Apr 3, 2021 7:00 AM",16,8,8,57,34,23,59,39,20,54,35,19,,,,1,,,,4,3,1,7,21,17,4,18,22,1,3,0,0,0,0,0,0
"Apr 3, 2021 8:00 AM",26,7,19,121,64,57,77,42,35,87,47,40,,,,17,,,,14,14,0,14,27,20,7,20,32,4,3,3,2,1,0,0,0
"Apr 3, 2021 9:00 AM",59,31,28,269,145,124,263,155,108,257,154,103,,,,11,,,,17,15,2,13,92,70,22,58,59,8,12,8,6,2,0,0,0
"Apr 3, 2021 10:00 AM",71,38,33,375,205,170,318,181,137,303,181,122,,,,20,,,,17,15,2,32,109,79,30,84,78,17,11,10,5,5,0,0,0
"Apr 3, 2021 11:00 AM",92,45,47,374,203,171,391,230,161,354,212,142,,,,36,,,,23,22,1,47,188,137,51,121,81,13,11,10,6,4,0,0,0
"Apr 3, 2021 12:00 PM",101,62,39,462,242,220,472,263,209,469,263,206,,,,30,,,,36,31,5,48,211,144,67,125,123,11,15,13,6,7,0,0,0
"Apr 3, 2021 1:00 PM",121,64,57,405,219,186,475,258,217,388,217,171,,,,24,,,,30,29,1,50,153,90,63,132,133,13,15,22,15,7,0,0,0
"Apr 3, 2021 2:00 PM",143,89,54,429,241,188,526,281,245,434,258,176,,,,48,,,,35,35,0,64,193,118,75,130,148,12,10,9,6,3,0,0,0
"Apr 3, 2021 3:00 PM",122,69,53,405,216,189,559,334,225,432,251,181,,,,66,,,,27,27,0,29,250,144,106,112,101,13,12,21,14,7,0,0,0
"Apr 3, 2021 4:00 PM",109,55,54,445,224,221,550,290,260,412,199,213,,,,26,,,,35,35,0,26,215,112,103,92,94,14,8,22,11,11,0,0,0
"Apr 3, 2021 5:00 PM",130,51,79,289,138,151,466,178,288,310,128,182,,,,41,,,,22,22,0,29,172,95,77,73,130,9,10,15,12,3,0,0,0
"Apr 3, 2021 6:00 PM",89,34,55,212,94,118,308,88,220,207,76,131,,,,35,,,,26,26,0,25,119,59,60,41,111,10,5,11,7,4,0,0,0
"Apr 3, 2021 7:00 PM",66,33,33,143,60,83,178,44,134,116,38,78,,,,16,,,,18,18,0,25,72,28,44,24,70,6,3,10,3,7,0,0,0
"Apr 3, 2021 8:00 PM",34,12,22,53,22,31,104,40,64,63,26,37,,,,11,,,,9,9,0,17,32,13,19,27,42,2,2,3,1,2,0,0,0
"Apr 3, 2021 9:00 PM",35,6,29,35,14,21,39,11,28,30,10,20,,,,6,,,,6,6,0,10,16,5,11,19,32,1,0,3,2,1,0,0,0
"Apr 3, 2021 10:00 PM",14,8,6,3,2,1,13,5,8,8,4,4,,,,7,,,,7,7,0,8,10,5,5,7,15,1,0,0,0,0,0,0,0
"Apr 3, 2021 11:00 PM",13,6,7,14,6,8,11,9,2,9,6,3,,,,3,,,,4,4,0,9,6,3,3,5,7,1,0,0,0,0,0,0,0
"Apr 4, 2021 12:00 AM",2,1,1,0,0,0,5,0,5,15,3,12,,,,5,,,,7,5,2,2,1,1,0,6,6,0,0,4,2,2,0,0,0
"Apr 4, 2021 1:00 AM",8,4,4,1,1,0,5,2,3,2,2,0,,,,1,,,,3,3,0,1,5,5,0,3,3,0,0,0,0,0,0,0,0
"Apr 4, 2021 2:00 AM",3,2,1,1,1,0,0,0,0,1,1,0,,,,0,,,,0,0,0,2,0,0,0,0,1,0,0,0,0,0,0,0,0
"Apr 4, 2021 3:00 AM",1,1,0,3,3,0,2,2,0,1,1,0,,,,0,,,,1,1,0,1,1,1,0,2,0,0,0,0,0,0,0,0,0
"Apr 4, 2021 4:00 AM",2,1,1,0,0,0,1,1,0,0,0,0,,,,0,,,,2,2,0,1,0,0,0,2,2,0,0,0,0,0,0,0,0
"Apr 4, 2021 5:00 AM",2,2,0,1,1,0,1,1,0,1,1,0,,,,1,,,,2,2,0,1,0,0,0,4,2,0,0,0,0,0,0,0,0
"Apr 4, 2021 6:00 AM",6,4,2,15,11,4,25,23,2,17,14,3,,,,3,,,,2,2,0,6,5,5,0,11,9,0,0,0,0,0,0,0,0
"Apr 4, 2021 7:00 AM",16,9,7,33,17,16,62,36,26,33,18,15,,,,0,,,,4,3,1,9,16,12,4,19,23,0,4,4,2,2,0,0,0
"Apr 4, 2021 8:00 AM",30,13,17,119,76,43,124,83,41,102,78,24,,,,18,,,,10,10,0,15,34,22,12,38,27,3,5,1,1,0,0,0,0
"Apr 4, 2021 9:00 AM",48,21,27,249,163,86,215,149,66,223,155,68,,,,13,,,,25,25,0,22,70,58,12,56,63,12,16,4,2,2,0,0,0
"Apr 4, 2021 10:00 AM",71,34,37,365,220,145,347,213,134,318,198,120,,,,21,,,,19,19,0,38,104,78,26,98,69,18,17,12,8,4,0,0,0
"Apr 4, 2021 11:00 AM",90,45,45,403,210,193,426,225,201,420,224,196,,,,32,,,,25,24,1,63,154,116,38,99,116,19,12,13,7,6,0,0,0
"Apr 4, 2021 12:00 PM",119,65,54,465,248,217,536,300,236,461,278,183,,,,29,,,,48,45,3,65,194,149,45,121,111,22,20,13,8,5,0,0,0
"Apr 4, 2021 1:00 PM",100,64,36,502,292,210,481,261,220,454,261,193,,,,40,,,,40,40,0,44,142,87,55,118,103,28,5,22,17,5,0,0,0
"Apr 4, 2021 2:00 PM",101,58,43,382,177,205,363,181,182,331,169,162,,,,30,,,,27,26,1,47,152,121,31,99,73,13,9,12,9,3,0,0,0
"Apr 4, 2021 3:00 PM",93,40,53,312,163,149,409,215,194,331,170,161,,,,22,,,,35,35,0,28,157,93,64,82,74,11,5,3,1,2,0,0,0
"Apr 4, 2021 4:00 PM",93,36,57,342,169,173,431,189,242,354,167,187,,,,40,,,,35,35,0,35,139,80,59,88,117,8,8,8,4,4,0,0,0
"Apr 4, 2021 5:00 PM",60,35,25,202,85,117,350,116,234,235,90,145,,,,47,,,,25,25,0,33,177,58,119,54,120,2,6,8,5,3,0,0,0
"Apr 4, 2021 6:00 PM",57,26,31,144,40,104,166,46,120,127,44,83,,,,15,,,,13,13,0,27,71,25,46,21,77,4,3,10,5,5,0,0,0
"Apr 4, 2021 7:00 PM",43,20,23,71,31,40,91,31,60,78,29,49,,,,19,,,,11,11,0,18,46,20,26,12,35,0,1,7,6,1,0,0,0
"Apr 4, 2021 8:00 PM",34,17,17,31,17,14,43,16,27,36,23,13,,,,5,,,,8,8,0,20,18,12,6,18,28,1,0,2,1,1,0,0,0
"Apr 4, 2021 9:00 PM",18,9,9,4,3,1,17,7,10,12,5,7,,,,4,,,,6,6,0,16,5,3,2,8,12,2,0,1,1,0,0,0,0
"Apr 4, 2021 10:00 PM",12,4,8,10,2,8,8,2,6,6,3,3,,,,1,,,,4,4,0,12,4,2,2,5,9,0,0,0,0,0,0,0,0
"Apr 4, 2021 11:00 PM",6,3,3,6,1,5,3,0,3,6,1,5,,,,2,,,,2,2,0,3,1,0,1,5,2,0,0,0,0,0,0,0,0
"Apr 5, 2021 12:00 AM",2,2,0,0,0,0,1,1,0,1,1,0,,,,0,,,,6,6,0,2,3,1,2,3,0,0,0,0,0,0,0,0,0
"Apr 5, 2021 1:00 AM",0,0,0,1,1,0,4,1,3,0,0,0,,,,0,,,,2,1,1,0,0,0,0,2,0,0,1,0,0,0,0,0,0
"Apr 5, 2021 2:00 AM",2,0,2,0,0,0,0,0,0,0,0,0,,,,0,,,,2,2,0,0,0,0,0,0,1,0,0,0,0,0,0,0,0
"Apr 5, 2021 3:00 AM",0,0,0,0,0,0,0,0,0,0,0,0,,,,0,,,,1,1,0,0,0,0,0,0,1,0,0,0,0,0,0,0,0
"Apr 5, 2021 4:00 AM",0,0,0,0,0,0,0,0,0,0,0,0,,,,0,,,,1,1,0,1,0,0,0,0,1,0,0,0,0,0,0,0,0
"Apr 5, 2021 5:00 AM",0,0,0,1,1,0,4,3,1,3,2,1,,,,0,,,,2,2,0,1,2,1,1,2,2,0,0,0,0,0,0,0,0
"Apr 5, 2021 6:00 AM",5,3,2,2,2,0,13,12,1,7,6,1,,,,1,,,,1,1,0,2,8,7,1,3,10,0,1,0,0,0,0,0,0
"Apr 5, 2021 7:00 AM",13,5,8,29,19,10,33,22,11,22,15,7,,,,3,,,,3,3,0,6,12,9,3,16,12,1,1,1,1,0,0,0,0
"Apr 5, 2021 8:00 AM",18,5,13,28,15,13,53,32,21,31,20,11,,,,4,,,,3,3,0,12,20,13,7,16,20,4,1,6,4,2,0,0,0
"Apr 5, 2021 9:00 AM",32,16,16,105,74,31,111,65,46,100,73,27,,,,5,,,,11,11,0,14,35,31,4,27,29,3,5,1,1,0,0,0,0
"Apr 5, 2021 10:00 AM",35,21,14,172,96,76,175,107,68,142,96,46,,,,20,,,,7,6,1,12,42,26,16,39,41,6,4,2,1,1,0,0,0
"Apr 5, 2021 11:00 AM",42,22,20,181,113,68,173,87,86,160,96,64,,,,23,,,,9,8,1,24,57,39,18,48,60,3,7,4,2,2,0,0,0
"Apr 5, 2021 12:00 PM",59,34,25,189,82,107,217,90,127,199,86,113,,,,29,,,,23,23,0,27,80,45,35,49,62,7,2,3,0,3,0,0,0
"Apr 5, 2021 1:00 PM",74,47,27,152,80,72,182,103,79,144,87,57,,,,24,,,,16,16,0,40,82,57,25,56,44,7,2,8,6,2,0,0,0
"Apr 5, 2021 2:00 PM",63,28,35,224,131,93,216,125,91,223,137,86,,,,37,,,,21,21,0,32,75,53,22,53,46,2,2,5,3,2,0,0,0
"Apr 5, 2021 3:00 PM",65,35,30,170,80,90,244,123,121,180,91,89,,,,37,,,,21,21,0,37,114,76,38,45,55,9,3,16,9,7,0,0,0
"Apr 5, 2021 4:00 PM",68,36,32,142,69,73,213,94,119,147,65,82,,,,37,,,,27,27,0,13,91,50,41,36,38,14,3,6,4,2,0,0,0
"Apr 5, 2021 5:00 PM",44,20,24,86,44,42,149,64,85,96,50,46,,,,23,,,,15,15,0,12,74,38,36,32,48,3,6,11,7,4,0,0,0
"Apr 5, 2021 6:00 PM",51,24,27,58,33,25,74,26,48,56,28,28,,,,27,,,,3,3,0,17,47,15,32,14,32,1,6,0,0,0,0,0,0
"Apr 5, 2021 7:00 PM",29,15,14,28,10,18,43,21,22,26,12,14,,,,12,,,,7,7,0,16,18,8,10,18,15,0,0,1,0,1,0,0,0
"Apr 5, 2021 8:00 PM",21,6,15,30,20,10,29,15,14,37,25,12,,,,3,,,,10,10,0,9,9,3,6,10,14,2,0,4,2,2,0,0,0
"Apr 5, 2021 9:00 PM",9,3,6,6,2,4,18,6,12,14,5,9,,,,3,,,,3,3,0,7,4,2,2,7,9,2,0,0,0,0,0,0,0
"Apr 5, 2021 10:00 PM",8,6,2,8,7,1,5,3,2,4,1,3,,,,4,,,,5,5,0,3,1,0,1,3,5,0,0,1,1,0,0,0,0
"Apr 5, 2021 11:00 PM",5,1,4,0,0,0,1,1,0,1,0,1,,,,0,,,,1,1,0,2,1,1,0,2,1,2,0,0,0,0,0,0,0
"Apr 6, 2021 12:00 AM",3,1,2,0,0,0,0,0,0,0,0,0,,,,1,,,,2,2,0,3,0,0,0,1,1,0,0,0,0,0,0,0,0
"Apr 6, 2021 1:00 AM",3,1,2,0,0,0,0,0,0,0,0,0,,,,0,,,,0,0,0,0,0,0,0,0,0,0,0,0,0,0,0,0,0
"Apr 6, 2021 2:00 AM",3,2,1,0,0,0,2,1,1,0,0,0,,,,0,,,,2,2,0,1,0,0,0,1,0,0,0,0,0,0,0,0,0
"Apr 6, 2021 3:00 AM",1,0,1,0,0,0,0,0,0,2,0,2,,,,0,,,,1,1,0,0,0,0,0,0,0,0,0,0,0,0,0,0,0
"Apr 6, 2021 4:00 AM",2,1,1,0,0,0,1,1,0,0,0,0,,,,0,,,,1,1,0,0,1,1,0,1,1,0,0,0,0,0,0,0,0
"Apr 6, 2021 5:00 AM",0,0,0,1,1,0,5,4,1,5,4,1,,,,1,,,,3,3,0,5,0,0,0,3,7,0,0,0,0,0,0,0,0
"Apr 6, 2021 6:00 AM",23,19,4,11,7,4,14,8,6,8,5,3,,,,0,,,,1,1,0,6,5,3,2,12,24,0,0,0,0,0,0,0,0
"Apr 6, 2021 7:00 AM",55,40,15,36,20,16,71,36,35,39,21,18,,,,5,,,,11,9,2,29,21,8,13,28,49,3,4,1,0,1,0,0,0
"Apr 6, 2021 8:00 AM",101,75,26,70,29,41,74,32,42,58,26,32,,,,12,,,,14,12,2,47,24,12,12,34,55,3,6,6,5,1,0,0,0
"Apr 6, 2021 9:00 AM",62,42,20,65,35,30,98,54,44,59,34,25,,,,8,,,,8,7,1,42,43,33,10,23,35,2,10,4,2,2,0,0,0
"Apr 6, 2021 10:00 AM",46,33,13,85,39,46,95,53,42,72,35,37,,,,24,,,,8,6,2,24,42,29,13,18,29,2,2,3,3,0,0,0,0
"Apr 6, 2021 11:00 AM",60,32,28,115,58,57,130,78,52,112,66,46,,,,27,,,,6,6,0,21,41,28,13,31,29,4,1,6,4,2,0,0,0
"Apr 6, 2021 12:00 PM",57,32,25,129,60,69,140,55,85,107,51,56,,,,20,,,,18,14,4,15,45,30,15,35,30,4,7,5,3,2,0,0,0
"Apr 6, 2021 1:00 PM",63,32,31,69,32,37,81,37,44,70,29,41,,,,12,,,,16,14,2,27,26,18,8,24,36,5,4,1,0,1,0,0,0
"Apr 6, 2021 2:00 PM",77,38,39,73,43,30,83,47,36,71,43,28,,,,12,,,,14,14,0,21,49,32,17,21,23,7,4,2,2,0,0,0,0
"Apr 6, 2021 3:00 PM",66,29,37,53,29,24,56,28,28,45,26,19,,,,19,,,,8,7,1,12,33,24,9,26,29,9,2,8,4,4,0,0,0
"Apr 6, 2021 4:00 PM",70,21,49,57,32,25,80,38,42,66,29,37,,,,17,,,,32,31,1,17,36,20,16,40,23,6,1,3,2,1,0,0,0
"Apr 6, 2021 5:00 PM",110,27,83,47,30,17,80,44,36,49,31,18,,,,16,,,,57,57,0,23,33,21,12,57,39,9,7,10,9,1,0,0,0
"Apr 6, 2021 6:00 PM",95,26,69,64,37,27,78,42,36,66,37,29,,,,18,,,,29,29,0,19,23,13,10,46,47,3,2,9,6,3,0,0,0
"Apr 6, 2021 7:00 PM",59,19,40,56,34,22,66,37,29,46,26,20,,,,15,,,,21,21,0,13,21,17,4,30,28,1,0,3,1,2,0,0,0
"Apr 6, 2021 8:00 PM",22,5,17,20,9,11,43,15,28,27,13,14,,,,21,,,,8,8,0,6,22,10,12,19,28,1,2,5,5,0,0,0,0
"Apr 6, 2021 9:00 PM",20,4,16,7,5,2,12,8,4,9,7,2,,,,4,,,,3,3,0,4,5,3,2,5,8,3,2,2,1,1,0,0,0
"Apr 6, 2021 10:00 PM",15,3,12,6,5,1,9,6,3,5,2,3,,,,3,,,,5,5,0,3,4,2,2,7,5,5,2,2,0,2,0,0,0
"Apr 6, 2021 11:00 PM",4,1,3,0,0,0,1,1,0,0,0,0,,,,3,,,,3,3,0,2,0,0,0,0,1,0,0,0,0,0,0,0,0
"Apr 7, 2021 12:00 AM",5,1,4,0,0,0,0,0,0,0,0,0,,,,1,,,,2,2,0,0,0,0,0,1,0,1,0,1,1,0,0,0,0
"Apr 7, 2021 1:00 AM",2,1,1,0,0,0,2,0,2,1,1,0,,,,1,,,,2,2,0,0,0,0,0,1,0,0,0,0,0,0,0,0,0
"Apr 7, 2021 2:00 AM",1,1,0,0,0,0,1,1,0,0,0,0,,,,0,,,,1,1,0,1,0,0,0,1,0,0,0,0,0,0,0,0,0
"Apr 7, 2021 3:00 AM",0,0,0,0,0,0,0,0,0,0,0,0,,,,0,,,,0,0,0,0,0,0,0,0,1,0,0,0,0,0,0,0,0
"Apr 7, 2021 4:00 AM",0,0,0,0,0,0,2,1,1,3,2,1,,,,0,,,,2,2,0,0,0,0,0,1,1,0,0,0,0,0,0,0,0
"Apr 7, 2021 5:00 AM",2,2,0,1,1,0,2,2,0,4,3,1,,,,0,,,,4,4,0,7,3,2,1,4,6,1,0,1,1,0,0,0,0
"Apr 7, 2021 6:00 AM",19,13,6,26,15,11,35,22,13,28,19,9,,,,1,,,,3,3,0,5,13,11,2,19,30,1,0,1,1,0,0,0,0
"Apr 7, 2021 7:00 AM",59,42,17,66,33,33,75,36,39,61,36,25,,,,4,,,,13,10,3,45,23,13,10,39,65,2,1,2,2,0,0,0,0
"Apr 7, 2021 8:00 AM",114,83,31,72,26,46,76,28,48,58,21,37,,,,9,,,,17,14,3,64,30,13,17,29,61,6,3,8,7,1,0,0,0
"Apr 7, 2021 9:00 AM",74,55,19,58,34,24,87,52,35,64,41,23,,,,5,,,,18,17,1,41,51,29,22,25,43,1,1,0,0,0,0,0,0
"Apr 7, 2021 10:00 AM",42,29,13,87,50,37,100,60,40,86,56,30,,,,13,,,,13,11,2,22,55,39,16,27,22,3,2,2,1,1,0,0,0
"Apr 7, 2021 11:00 AM",69,43,26,109,65,44,145,83,62,123,74,49,,,,22,,,,16,13,3,24,59,34,25,29,30,7,4,7,2,5,0,0,0
"Apr 7, 2021 12:00 PM",85,38,47,140,63,77,153,69,84,117,62,55,,,,22,,,,13,13,0,20,64,31,33,26,34,4,3,9,6,3,0,0,0
"Apr 7, 2021 1:00 PM",58,37,21,105,43,62,125,55,70,100,34,66,,,,13,,,,20,18,2,16,53,20,33,28,47,7,6,5,3,2,0,0,0
"Apr 7, 2021 2:00 PM",77,49,28,105,60,45,104,46,58,100,53,47,,,,28,,,,20,19,1,17,34,17,17,31,41,5,3,10,4,6,0,0,0
"Apr 7, 2021 3:00 PM",77,34,43,98,57,41,109,61,48,99,53,46,,,,26,,,,13,13,0,22,27,13,14,46,36,12,7,11,8,3,0,0,0
"Apr 7, 2021 4:00 PM",89,26,63,109,57,52,109,56,53,83,45,38,,,,23,,,,29,27,2,21,36,19,17,38,54,10,4,7,2,5,0,0,0
"Apr 7, 2021 5:00 PM",119,35,84,89,55,34,106,62,44,87,48,39,,,,33,,,,46,46,0,24,46,34,12,51,49,5,7,11,4,7,0,0,0
"Apr 7, 2021 6:00 PM",125,41,84,122,57,65,131,64,67,121,52,69,,,,20,,,,40,39,1,34,45,25,20,58,55,5,7,5,2,3,0,0,0
"Apr 7, 2021 7:00 PM",54,27,27,91,52,39,112,66,46,94,58,36,,,,15,,,,36,35,1,14,43,30,13,47,54,1,3,4,3,1,0,0,0
"Apr 7, 2021 8:00 PM",46,18,28,44,25,19,57,25,32,43,21,22,,,,3,,,,11,11,0,5,14,5,9,24,17,3,0,6,6,0,0,0,0
"Apr 7, 2021 9:00 PM",22,6,16,13,4,9,19,7,12,17,10,7,,,,2,,,,3,3,0,10,7,5,2,4,11,4,2,3,3,0,0,0,0
"Apr 7, 2021 10:00 PM",12,6,6,5,2,3,4,1,3,9,2,7,,,,2,,,,5,5,0,4,4,1,3,7,6,0,0,0,0,0,0,0,0
"Apr 7, 2021 11:00 PM",8,2,6,0,0,0,0,0,0,2,1,1,,,,3,,,,3,3,0,1,0,0,0,2,0,1,0,2,2,0,0,0,0
"Apr 8, 2021 12:00 AM",5,1,4,0,0,0,0,0,0,0,0,0,,,,1,,,,1,1,0,2,1,1,0,1,0,0,0,0,0,0,0,0,0
"Apr 8, 2021 1:00 AM",1,0,1,0,0,0,0,0,0,1,1,0,,,,1,,,,2,2,0,0,0,0,0,1,2,0,0,0,0,0,0,0,0
"Apr 8, 2021 2:00 AM",1,1,0,0,0,0,0,0,0,0,0,0,,,,0,,,,1,1,0,1,0,0,0,0,0,0,0,0,0,0,0,0,0
"Apr 8, 2021 3:00 AM",1,1,0,0,0,0,0,0,0,0,0,0,,,,0,,,,0,0,0,0,0,0,0,1,0,1,0,0,0,0,0,0,0
"Apr 8, 2021 4:00 AM",1,1,0,0,0,0,0,0,0,0,0,0,,,,0,,,,2,2,0,0,0,0,0,1,1,0,0,0,0,0,0,0,0
"Apr 8, 2021 5:00 AM",1,1,0,1,1,0,6,5,1,7,6,1,,,,0,,,,2,2,0,1,0,0,0,2,7,0,0,1,1,0,0,0,0
"Apr 8, 2021 6:00 AM",26,18,8,28,17,11,34,26,8,22,15,7,,,,2,,,,4,4,0,10,5,5,0,13,27,0,2,1,1,0,0,0,0
"Apr 8, 2021 7:00 AM",58,39,19,75,39,36,81,38,43,66,31,35,,,,12,,,,10,8,2,52,21,12,9,30,75,1,3,4,3,1,0,0,0
"Apr 8, 2021 8:00 AM",100,66,34,102,44,58,105,47,58,81,39,42,,,,15,,,,16,15,1,63,50,22,28,38,70,4,7,3,3,0,0,0,0
"Apr 8, 2021 9:00 AM",65,48,17,87,41,46,101,50,51,95,45,50,,,,8,,,,14,14,0,33,46,23,23,26,41,0,4,1,1,0,0,0,0
"Apr 8, 2021 10:00 AM",57,39,18,96,52,44,103,63,40,76,48,28,,,,16,,,,10,9,1,27,31,22,9,28,28,4,11,5,5,0,0,0,0
"Apr 8, 2021 11:00 AM",42,25,17,111,58,53,121,64,57,97,53,44,,,,26,,,,5,3,2,27,55,35,20,20,41,0,5,4,2,2,0,0,0
"Apr 8, 2021 12:00 PM",56,27,29,124,52,72,119,62,57,80,38,42,,,,16,,,,16,9,7,10,49,27,22,24,29,4,3,9,4,5,0,0,0
"Apr 8, 2021 1:00 PM",56,28,28,106,55,51,142,71,71,108,53,55,,,,21,,,,13,11,2,24,30,16,14,32,30,5,5,5,4,1,0,0,0
"Apr 8, 2021 2:00 PM",68,37,31,67,40,27,96,51,45,88,51,37,,,,20,,,,23,22,1,11,38,28,10,28,33,5,4,2,1,1,0,0,0
"Apr 8, 2021 3:00 PM",58,22,36,89,50,39,71,35,36,80,42,38,,,,12,,,,19,19,0,23,36,19,17,35,33,8,4,3,3,0,0,0,0
"Apr 8, 2021 4:00 PM",96,34,62,77,45,32,100,58,42,83,43,40,,,,19,,,,29,24,5,25,41,26,15,41,39,2,3,9,2,7,0,0,0
"Apr 8, 2021 5:00 PM",108,31,77,87,52,35,116,57,59,97,47,50,,,,28,,,,43,43,0,27,37,22,15,63,50,6,4,10,7,3,0,0,0
"Apr 8, 2021 6:00 PM",111,28,83,119,66,53,117,69,48,121,70,51,,,,24,,,,54,54,0,32,56,38,18,60,42,6,2,5,5,0,0,0,0
"Apr 8, 2021 7:00 PM",68,24,44,116,61,55,100,54,46,90,46,44,,,,14,,,,42,41,1,15,41,26,15,42,34,5,5,3,1,2,0,0,0
"Apr 8, 2021 8:00 PM",44,17,27,42,22,20,47,22,25,51,22,29,,,,8,,,,15,14,1,7,24,9,15,18,20,0,4,2,1,1,0,0,0
"Apr 8, 2021 9:00 PM",29,11,18,26,10,16,28,14,14,26,12,14,,,,4,,,,6,6,0,9,7,3,4,10,13,0,0,0,0,0,0,0,0
"Apr 8, 2021 10:00 PM",10,5,5,13,10,3,17,9,8,13,8,5,,,,1,,,,2,2,0,8,2,2,0,16,10,0,0,0,0,0,0,0,0
"Apr 8, 2021 11:00 PM",8,2,6,1,0,1,8,3,5,8,4,4,,,,0,,,,4,4,0,3,2,1,1,2,2,0,0,1,1,0,0,0,0
"Apr 9, 2021 12:00 AM",2,0,2,0,0,0,2,2,0,0,0,0,,,,1,,,,4,4,0,1,2,0,2,0,0,1,0,1,1,0,0,0,0
"Apr 9, 2021 1:00 AM",0,0,0,0,0,0,1,1,0,1,1,0,,,,0,,,,1,1,0,1,0,0,0,2,1,0,0,0,0,0,0,0,0
"Apr 9, 2021 2:00 AM",0,0,0,0,0,0,0,0,0,0,0,0,,,,2,,,,0,0,0,0,0,0,0,1,1,0,0,0,0,0,0,0,0
"Apr 9, 2021 3:00 AM",0,0,0,0,0,0,0,0,0,0,0,0,,,,0,,,,1,1,0,0,0,0,0,0,2,0,0,0,0,0,0,0,0
"Apr 9, 2021 4:00 AM",1,1,0,0,0,0,2,2,0,0,0,0,,,,0,,,,1,1,0,0,0,0,0,2,0,0,0,0,0,0,0,0,0
"Apr 9, 2021 5:00 AM",1,1,0,1,1,0,1,1,0,2,2,0,,,,0,,,,3,3,0,3,0,0,0,3,2,0,0,0,0,0,0,0,0
"Apr 9, 2021 6:00 AM",23,14,9,24,13,11,30,22,8,25,16,9,,,,2,,,,2,2,0,8,7,7,0,13,26,0,1,0,0,0,0,0,0
"Apr 9, 2021 7:00 AM",58,36,22,100,51,49,85,47,38,85,48,37,,,,4,,,,12,12,0,41,28,21,7,31,64,3,6,2,1,1,0,0,0
"Apr 9, 2021 8:00 AM",80,45,35,102,43,59,117,48,69,93,46,47,,,,18,,,,15,15,0,70,64,36,28,28,65,5,5,7,5,2,0,0,0
"Apr 9, 2021 9:00 AM",49,36,13,89,39,50,115,70,45,87,49,38,,,,4,,,,15,15,0,27,53,44,9,39,53,5,7,4,1,3,0,0,0
"Apr 9, 2021 10:00 AM",44,22,22,143,89,54,160,90,70,119,63,56,,,,16,,,,12,12,0,27,63,47,16,33,40,2,4,5,4,1,0,0,0
"Apr 9, 2021 11:00 AM",57,24,33,151,77,74,183,99,84,132,83,49,,,,16,,,,8,7,1,16,73,44,29,29,33,7,3,5,2,3,0,0,0
"Apr 9, 2021 12:00 PM",34,12,22,114,44,70,162,68,94,99,32,67,,,,17,,,,16,16,0,21,36,16,20,33,30,3,17,5,4,1,0,0,0
"Apr 9, 2021 1:00 PM",46,26,20,73,34,39,81,38,43,68,39,29,,,,1,,,,13,13,0,16,27,14,13,33,28,7,2,12,6,6,0,0,0
"Apr 9, 2021 2:00 PM",51,29,22,87,50,37,79,45,34,77,45,32,,,,7,,,,17,17,0,13,31,23,8,24,24,7,5,1,0,1,0,0,0
"Apr 9, 2021 3:00 PM",42,14,28,111,65,46,110,60,50,94,50,44,,,,11,,,,19,19,0,20,44,34,10,29,39,5,0,7,6,1,0,0,0
"Apr 9, 2021 4:00 PM",94,35,59,121,53,68,119,59,60,108,53,55,,,,24,,,,30,30,0,10,36,19,17,39,44,3,7,11,2,9,0,0,0
"Apr 9, 2021 5:00 PM",100,26,74,112,60,52,99,49,50,87,48,39,,,,19,,,,36,36,0,20,43,28,15,46,43,6,4,14,9,5,0,0,0
"Apr 9, 2021 6:00 PM",94,29,65,112,68,44,90,64,26,78,55,23,,,,13,,,,38,38,0,14,31,22,9,45,33,7,3,10,4,6,0,0,0
"Apr 9, 2021 7:00 PM",58,19,39,70,39,31,77,37,40,62,31,31,,,,18,,,,21,20,1,16,29,18,11,25,27,1,1,4,3,1,0,0,0
"Apr 9, 2021 8:00 PM",52,24,28,38,18,20,43,19,24,35,21,14,,,,27,,,,15,15,0,14,27,13,14,25,20,2,0,1,0,1,0,0,0
"Apr 9, 2021 9:00 PM",28,9,19,11,5,6,34,17,17,20,8,12,,,,5,,,,6,6,0,8,11,7,4,14,10,4,1,1,1,0,0,0,0
"Apr 9, 2021 10:00 PM",9,2,7,7,4,3,10,6,4,12,4,8,,,,2,,,,6,6,0,3,2,1,1,10,17,1,1,0,0,0,0,0,0
"Apr 9, 2021 11:00 PM",8,2,6,4,2,2,11,4,7,4,2,2,,,,1,,,,3,3,0,6,1,1,0,3,3,1,0,1,1,0,0,0,0
"Apr 10, 2021 12:00 AM",7,3,4,0,0,0,1,1,0,0,0,0,,,,2,,,,0,0,0,1,2,0,2,2,2,0,0,0,0,0,0,0,0
"Apr 10, 2021 1:00 AM",2,1,1,1,0,1,3,0,3,3,0,3,,,,1,,,,6,6,0,1,0,0,0,3,1,0,0,0,0,0,0,0,0
"Apr 10, 2021 2:00 AM",8,3,5,1,1,0,2,2,0,0,0,0,,,,2,,,,0,0,0,0,1,1,0,3,2,0,0,0,0,0,0,0,0
"Apr 10, 2021 3:00 AM",1,1,0,1,0,1,1,0,1,1,0,1,,,,0,,,,1,1,0,0,0,0,0,0,0,0,0,0,0,0,0,0,0
"Apr 10, 2021 4:00 AM",4,1,3,0,0,0,1,0,1,3,2,1,,,,1,,,,0,0,0,0,0,0,0,0,0,0,0,0,0,0,0,0,0
"Apr 10, 2021 5:00 AM",1,1,0,0,0,0,0,0,0,1,1,0,,,,0,,,,2,2,0,0,0,0,0,1,0,0,0,0,0,0,0,0,0
"Apr 10, 2021 6:00 AM",9,5,4,13,6,7,12,10,2,12,11,1,,,,2,,,,1,1,0,2,1,1,0,9,9,0,0,1,1,0,0,0,0
"Apr 10, 2021 7:00 AM",20,7,13,39,23,16,32,20,12,35,24,11,,,,1,,,,4,4,0,5,12,11,1,13,20,1,6,1,0,1,0,0,0
"Apr 10, 2021 8:00 AM",27,5,22,117,80,37,107,78,29,105,76,29,,,,5,,,,10,10,0,17,39,33,6,30,47,3,2,0,0,0,0,0,0
"Apr 10, 2021 9:00 AM",59,27,32,207,109,98,222,136,86,191,108,83,,,,7,,,,18,18,0,22,69,48,21,46,47,7,12,4,4,0,0,0,0
"Apr 10, 2021 10:00 AM",59,30,29,303,181,122,304,186,118,258,176,82,,,,16,,,,13,13,0,37,104,87,17,109,76,10,8,9,5,4,0,0,0
"Apr 10, 2021 11:00 AM",96,59,37,385,211,174,428,244,184,364,219,145,,,,31,,,,32,30,2,39,170,126,44,123,95,16,16,7,6,1,0,0,0
"Apr 10, 2021 12:00 PM",123,57,66,460,248,212,483,270,213,447,237,210,,,,17,,,,24,22,2,28,115,88,27,125,111,12,19,12,4,8,0,0,0
"Apr 10, 2021 1:00 PM",103,55,48,354,162,192,386,180,206,293,144,149,,,,40,,,,20,20,0,39,123,78,45,91,107,12,7,9,6,3,0,0,0
"Apr 10, 2021 2:00 PM",95,56,39,260,116,144,328,142,186,237,115,122,,,,45,,,,24,23,1,41,129,88,41,58,93,9,11,16,13,3,0,0,0
"Apr 10, 2021 3:00 PM",68,33,35,280,160,120,265,125,140,255,142,113,,,,34,,,,35,35,0,43,96,53,43,62,81,14,5,13,9,4,0,0,0
"Apr 10, 2021 4:00 PM",81,55,26,264,134,130,302,150,152,261,126,135,,,,30,,,,27,26,1,19,121,54,67,72,80,15,7,21,10,11,0,0,0
"Apr 10, 2021 5:00 PM",70,36,34,227,93,134,220,77,143,217,90,127,,,,22,,,,22,21,1,18,68,27,41,34,73,7,11,11,4,7,0,0,0
"Apr 10, 2021 6:00 PM",55,32,23,85,41,44,94,39,55,83,30,53,,,,9,,,,25,24,1,18,57,26,31,23,50,7,2,7,6,1,0,0,0
"Apr 10, 2021 7:00 PM",68,36,32,57,33,24,67,23,44,56,28,28,,,,12,,,,14,14,0,13,32,17,15,25,38,5,1,2,1,1,0,0,0
"Apr 10, 2021 8:00 PM",29,11,18,41,17,24,39,13,26,35,11,24,,,,8,,,,11,11,0,12,32,8,24,9,19,2,0,3,3,0,0,0,0
"Apr 10, 2021 9:00 PM",18,4,14,13,6,7,23,10,13,18,8,10,,,,5,,,,3,3,0,13,9,4,5,11,10,1,2,4,1,3,0,0,0
"Apr 10, 2021 10:00 PM",17,6,11,6,1,5,9,3,6,8,3,5,,,,3,,,,2,2,0,3,7,5,2,6,13,1,1,4,1,3,0,0,0
"Apr 10, 2021 11:00 PM",14,2,12,9,5,4,4,2,2,6,4,2,,,,3,,,,6,6,0,6,3,1,2,2,4,0,0,0,0,0,0,0,0
"Apr 11, 2021 12:00 AM",8,0,8,0,0,0,3,0,3,4,3,1,,,,0,,,,4,4,0,4,2,2,0,3,4,0,0,1,0,1,0,0,0
"Apr 11, 2021 1:00 AM",2,1,1,1,1,0,1,0,1,4,2,2,,,,0,,,,2,2,0,3,0,0,0,2,5,1,0,1,1,0,0,0,0
"Apr 11, 2021 2:00 AM",2,2,0,1,1,0,1,0,1,1,1,0,,,,0,,,,1,1,0,2,0,0,0,1,2,0,0,0,0,0,0,0,0
"Apr 11, 2021 3:00 AM",4,1,3,0,0,0,0,0,0,0,0,0,,,,0,,,,1,1,0,2,0,0,0,1,0,0,0,0,0,0,0,0,0
"Apr 11, 2021 4:00 AM",3,2,1,0,0,0,0,0,0,0,0,0,,,,0,,,,1,1,0,0,1,1,0,0,1,0,0,0,0,0,0,0,0
"Apr 11, 2021 5:00 AM",0,0,0,0,0,0,1,1,0,0,0,0,,,,0,,,,2,2,0,1,0,0,0,0,2,0,0,0,0,0,0,0,0
"Apr 11, 2021 6:00 AM",5,4,1,7,4,3,18,12,6,7,5,2,,,,0,,,,0,0,0,4,7,7,0,5,2,0,0,0,0,0,0,0,0
"Apr 11, 2021 7:00 AM",10,4,6,20,17,3,26,22,4,27,19,8,,,,2,,,,6,5,1,9,5,5,0,11,11,0,3,0,0,0,0,0,0
"Apr 11, 2021 8:00 AM",23,8,15,78,51,27,84,45,39,79,48,31,,,,7,,,,9,9,0,10,42,31,11,22,28,4,9,1,0,1,0,0,0
"Apr 11, 2021 9:00 AM",43,18,25,202,126,76,232,153,79,193,127,66,,,,7,,,,13,13,0,30,85,66,19,56,47,3,8,3,1,2,0,0,0
"Apr 11, 2021 10:00 AM",78,38,40,361,210,151,407,239,168,322,197,125,,,,35,,,,19,18,1,35,105,85,20,121,91,18,28,8,3,5,0,0,0
"Apr 11, 2021 11:00 AM",86,39,47,469,259,210,498,280,218,442,278,164,,,,47,,,,26,25,1,46,152,110,42,118,123,21,14,11,10,1,0,0,0
"Apr 11, 2021 12:00 PM",109,62,47,418,221,197,501,249,252,438,226,212,,,,30,,,,28,26,2,35,194,125,69,119,102,23,23,9,8,1,0,0,0
"Apr 11, 2021 1:00 PM",96,48,48,312,158,154,358,185,173,277,151,126,,,,32,,,,39,38,1,37,132,87,45,103,127,18,15,18,12,6,0,0,0
"Apr 11, 2021 2:00 PM",94,51,43,280,122,158,343,136,207,304,119,185,,,,40,,,,25,25,0,48,145,79,66,52,101,18,5,10,9,1,0,0,0
"Apr 11, 2021 3:00 PM",81,29,52,160,75,85,222,94,128,194,96,98,,,,19,,,,16,15,1,26,82,52,30,63,78,5,5,8,6,2,0,0,0
"Apr 11, 2021 4:00 PM",37,23,14,181,91,90,206,81,125,167,78,89,,,,29,,,,25,25,0,21,97,39,58,47,72,6,2,4,3,1,0,0,0
"Apr 11, 2021 5:00 PM",35,12,23,130,54,76,137,42,95,122,38,84,,,,28,,,,16,16,0,21,51,14,37,24,46,8,2,9,2,7,0,0,0
"Apr 11, 2021 6:00 PM",50,18,32,41,21,20,50,23,27,36,16,20,,,,4,,,,13,13,0,16,20,9,11,14,30,3,2,6,4,2,0,0,0
"Apr 11, 2021 7:00 PM",25,13,12,22,11,11,32,17,15,21,8,13,,,,9,,,,5,5,0,14,20,8,12,9,10,1,2,2,0,2,0,0,0
"Apr 11, 2021 8:00 PM",15,5,10,7,3,4,9,4,5,12,5,7,,,,2,,,,11,11,0,8,5,3,2,7,11,0,1,1,1,0,0,0,0
"Apr 11, 2021 9:00 PM",11,2,9,6,2,4,10,3,7,4,0,4,,,,5,,,,4,4,0,3,2,1,1,3,7,1,1,0,0,0,0,0,0
"Apr 11, 2021 10:00 PM",5,1,4,1,0,1,2,1,1,1,0,1,,,,0,,,,1,1,0,5,0,0,0,5,7,0,1,0,0,0,0,0,0
"Apr 11, 2021 11:00 PM",3,1,2,1,1,0,0,0,0,0,0,0,,,,0,,,,4,4,0,0,0,0,0,2,2,0,0,0,0,0,0,0,0
"Apr 12, 2021 12:00 AM",1,0,1,0,0,0,0,0,0,0,0,0,,,,1,,,,1,1,0,1,0,0,0,1,2,0,0,1,1,0,,,
"Apr 12, 2021 1:00 AM",1,0,1,0,0,0,0,0,0,0,0,0,,,,0,,,,1,1,0,0,0,0,0,0,1,0,0,0,0,0,,,
"Apr 12, 2021 2:00 AM",1,1,0,0,0,0,0,0,0,0,0,0,,,,0,,,,1,1,0,0,0,0,0,0,0,0,0,0,0,0,,,
"Apr 12, 2021 3:00 AM",0,0,0,0,0,0,0,0,0,0,0,0,,,,2,,,,0,0,0,0,0,0,0,0,0,0,0,0,0,0,,,
"Apr 12, 2021 4:00 AM",0,0,0,0,0,0,1,1,0,2,2,0,,,,0,,,,1,1,0,0,0,0,0,0,0,0,0,0,0,0,,,
"Apr 12, 2021 5:00 AM",2,2,0,0,0,0,2,1,1,3,2,1,,,,0,,,,1,1,0,4,1,0,1,1,7,0,0,0,0,0,,,
"Apr 12, 2021 6:00 AM",31,21,10,18,7,11,24,12,12,17,7,10,,,,3,,,,3,3,0,11,3,3,0,15,27,1,0,3,3,0,,,
"Apr 12, 2021 7:00 AM",81,47,34,80,26,54,76,27,49,59,29,30,,,,8,,,,19,18,1,55,35,14,21,37,71,3,2,3,3,0,,,
"Apr 12, 2021 8:00 AM",143,91,52,104,45,59,143,54,89,117,45,72,,,,19,,,,30,30,0,81,90,29,61,47,92,9,1,14,12,2,,,
"Apr 12, 2021 9:00 AM",84,61,23,75,33,42,76,38,38,65,33,32,,,,9,,,,7,7,0,41,35,17,18,31,36,2,5,1,1,0,,,
"Apr 12, 2021 10:00 AM",44,31,13,72,37,35,79,42,37,66,34,32,,,,6,,,,10,10,0,15,31,22,9,28,27,1,3,3,2,1,,,
"Apr 12, 2021 11:00 AM",49,29,20,67,36,31,76,38,38,59,32,27,,,,11,,,,7,7,0,9,36,23,13,22,27,2,0,3,1,2,,,
"Apr 12, 2021 12:00 PM",44,28,16,86,39,47,95,46,49,60,32,28,,,,15,,,,14,14,0,24,36,23,13,31,34,6,7,3,2,1,,,
"Apr 12, 2021 1:00 PM",44,18,26,68,30,38,93,30,63,59,21,38,,,,16,,,,12,11,1,17,24,11,13,16,38,7,8,5,4,1,,,
"Apr 12, 2021 2:00 PM",51,35,16,50,29,21,87,51,36,53,32,21,,,,15,,,,16,16,0,13,34,21,13,28,24,2,4,11,6,5,,,
"Apr 12, 2021 3:00 PM",71,25,46,26,14,12,63,38,25,41,27,14,,,,19,,,,21,19,2,23,38,26,12,38,37,5,0,4,3,1,,,
"Apr 12, 2021 4:00 PM",83,29,54,72,54,18,94,69,25,60,47,13,,,,16,,,,29,28,1,26,41,35,6,51,45,4,3,7,3,4,,,
"Apr 12, 2021 5:00 PM",116,29,87,57,41,16,87,55,32,65,38,27,,,,7,,,,42,42,0,17,34,24,10,61,36,4,3,7,2,5,,,
"Apr 12, 2021 6:00 PM",99,28,71,97,63,34,92,58,34,79,50,29,,,,17,,,,48,48,0,21,46,38,8,63,37,4,7,4,4,0,,,
"Apr 12, 2021 7:00 PM",62,19,43,86,51,35,84,49,35,68,42,26,,,,19,,,,30,30,0,19,43,23,20,41,36,3,3,11,8,3,,,
"Apr 12, 2021 8:00 PM",27,9,18,31,15,16,60,29,31,39,15,24,,,,4,,,,15,15,0,9,25,15,10,17,22,2,0,11,7,4,,,
"Apr 12, 2021 9:00 PM",10,4,6,17,11,6,20,6,14,19,8,11,,,,1,,,,9,9,0,6,7,2,5,17,17,2,2,4,2,2,,,
"Apr 12, 2021 10:00 PM",13,2,11,6,0,6,3,2,1,3,1,2,,,,1,,,,7,7,0,5,1,1,0,3,7,0,1,2,0,2,,,
"Apr 12, 2021 11:00 PM",6,1,5,9,5,4,1,1,0,1,1,0,,,,2,,,,1,1,0,0,0,0,0,6,2,0,0,0,0,0,,,
"Apr 13, 2021 12:00 AM",1,1,0,0,0,0,0,0,0,0,0,0,,,,0,,,,1,1,0,0,0,0,0,3,2,1,0,1,1,0,,,
"Apr 13, 2021 1:00 AM",1,0,1,0,0,0,0,0,0,0,0,0,,,,0,,,,3,3,0,2,0,0,0,0,0,0,0,0,0,0,,,
"Apr 13, 2021 2:00 AM",2,1,1,0,0,0,0,0,0,0,0,0,,,,0,,,,1,1,0,1,0,0,0,0,0,0,0,0,0,0,,,
"Apr 13, 2021 3:00 AM",0,0,0,0,0,0,0,0,0,0,0,0,,,,0,,,,0,0,0,0,0,0,0,0,2,0,0,0,0,0,,,
"Apr 13, 2021 4:00 AM",4,4,0,0,0,0,2,2,0,1,1,0,,,,0,,,,2,2,0,0,1,1,0,0,1,0,0,0,0,0,,,
"Apr 13, 2021 5:00 AM",3,2,1,1,0,1,3,1,2,3,2,1,,,,1,,,,3,3,0,2,0,0,0,1,9,0,0,0,0,0,,,
"Apr 13, 2021 6:00 AM",35,22,13,33,17,16,41,20,21,29,16,13,,,,11,,,,6,6,0,3,11,6,5,13,38,3,2,2,2,0,,,
"Apr 13, 2021 7:00 AM",92,50,42,109,44,65,109,46,63,97,46,51,,,,27,,,,24,24,0,60,41,20,21,47,83,3,3,2,2,0,,,
"Apr 13, 2021 8:00 AM",163,111,52,150,47,103,183,51,132,140,40,100,,,,35,,,,43,43,0,100,100,35,65,51,125,13,7,11,10,1,,,
"Apr 13, 2021 9:00 AM",96,63,33,105,54,51,100,60,40,98,59,39,,,,10,,,,25,22,3,35,47,33,14,42,42,4,5,3,2,1,,,
"Apr 13, 2021 10:00 AM",46,35,11,139,75,64,133,70,63,111,62,49,,,,11,,,,13,8,5,23,50,36,14,28,43,3,6,3,1,2,,,
"Apr 13, 2021 11:00 AM",62,32,30,125,61,64,128,66,62,105,61,44,,,,11,,,,11,9,2,25,52,38,14,28,40,6,8,5,3,2,,,
"Apr 13, 2021 12:00 PM",61,26,35,160,91,69,205,114,91,139,75,64,,,,8,,,,26,20,6,14,67,41,26,49,54,13,6,4,3,1,,,
"Apr 13, 2021 1:00 PM",67,30,37,108,60,48,177,87,90,104,54,50,,,,14,,,,18,12,6,20,56,33,23,42,58,5,4,4,2,2,,,
"Apr 13, 2021 2:00 PM",58,26,32,90,44,46,139,70,69,99,57,42,,,,20,,,,29,15,14,11,61,35,26,39,33,2,2,8,4,4,,,
"Apr 13, 2021 3:00 PM",69,31,38,78,44,34,123,72,51,78,47,31,,,,17,,,,42,27,15,29,77,54,23,50,45,3,0,6,2,4,,,
"Apr 13, 2021 4:00 PM",106,48,58,113,65,48,134,83,51,116,73,43,,,,21,,,,35,32,3,28,54,35,19,75,64,3,3,6,2,4,,,
"Apr 13, 2021 5:00 PM",143,46,97,112,64,48,159,91,68,110,64,46,,,,28,,,,57,57,0,26,63,36,27,88,51,4,11,3,2,1,,,
"Apr 13, 2021 6:00 PM",133,54,79,192,107,85,191,115,76,185,118,67,,,,18,,,,58,57,1,33,61,34,27,109,74,11,5,13,5,8,,,
"Apr 13, 2021 7:00 PM",86,34,52,166,77,89,170,86,84,149,71,78,,,,35,,,,34,34,0,31,50,29,21,55,59,7,0,5,3,2,,,
"Apr 13, 2021 8:00 PM",55,14,41,95,53,42,109,42,67,96,41,55,,,,12,,,,9,9,0,16,39,26,13,41,36,2,7,3,3,0,,,
"Apr 13, 2021 9:00 PM",37,14,23,18,8,10,22,15,7,20,13,7,,,,8,,,,18,17,1,10,10,3,7,12,14,5,0,1,0,1,,,
"Apr 13, 2021 10:00 PM",10,3,7,10,8,2,14,9,5,11,7,4,,,,3,,,,4,4,0,5,9,7,2,7,3,0,0,1,1,0,,,
"Apr 13, 2021 11:00 PM",8,3,5,6,2,4,4,1,3,7,3,4,,,,1,,,,1,1,0,3,1,0,1,5,4,1,0,1,1,0,,,
"Apr 14, 2021 12:00 AM",3,2,1,0,0,0,1,0,1,0,0,0,,,,0,,,,2,2,0,0,5,2,3,4,1,0,0,0,0,0,,,
"Apr 14, 2021 1:00 AM",3,0,3,2,2,0,3,3,0,1,1,0,,,,0,,,,0,0,0,1,1,1,0,3,1,0,0,0,0,0,,,
"Apr 14, 2021 2:00 AM",0,0,0,0,0,0,3,2,1,0,0,0,,,,0,,,,0,0,0,1,0,0,0,1,2,0,0,0,0,0,,,
"Apr 14, 2021 3:00 AM",0,0,0,0,0,0,0,0,0,0,0,0,,,,0,,,,0,0,0,0,1,1,0,0,0,0,0,0,0,0,,,
"Apr 14, 2021 4:00 AM",3,3,0,0,0,0,1,1,0,1,1,0,,,,0,,,,2,2,0,1,1,0,1,0,0,0,0,0,0,0,,,
"Apr 14, 2021 5:00 AM",6,6,0,2,1,1,5,3,2,7,4,3,,,,2,,,,1,1,0,4,0,0,0,3,9,0,0,0,0,0,,,
"Apr 14, 2021 6:00 AM",33,18,15,53,35,18,57,36,21,43,28,15,,,,5,,,,6,5,1,5,17,13,4,22,27,1,1,2,2,0,,,
"Apr 14, 2021 7:00 AM",96,57,39,110,44,66,134,47,87,108,47,61,,,,11,,,,24,22,2,67,36,19,17,43,91,6,5,1,0,1,,,
"Apr 14, 2021 8:00 AM",187,124,63,161,62,99,208,74,134,175,64,111,,,,36,,,,53,42,11,99,93,41,52,61,126,8,7,18,17,1,,,
"Apr 14, 2021 9:00 AM",91,65,26,130,69,61,134,79,55,131,82,49,,,,6,,,,27,16,11,47,89,67,22,39,59,1,5,1,0,1,,,
"Apr 14, 2021 10:00 AM",73,49,24,135,79,56,157,100,57,119,81,38,,,,5,,,,22,13,9,28,78,58,20,44,39,5,7,4,2,2,,,
"Apr 14, 2021 11:00 AM",58,28,30,144,67,77,153,72,81,128,58,70,,,,15,,,,20,13,7,22,54,39,15,50,48,3,3,3,1,2,,,
"Apr 14, 2021 12:00 PM",78,47,31,172,97,75,208,123,85,129,75,54,,,,18,,,,20,14,6,20,73,43,30,49,47,7,10,4,4,0,,,
"Apr 14, 2021 1:00 PM",95,40,55,182,102,80,287,162,125,185,108,77,,,,15,,,,59,31,28,29,95,68,27,77,69,10,6,7,3,4,,,
"Apr 14, 2021 2:00 PM",91,50,41,146,83,63,203,106,97,147,79,68,,,,32,,,,43,22,21,16,80,52,28,48,52,3,7,8,5,3,,,
"Apr 14, 2021 3:00 PM",98,35,63,158,84,74,218,127,91,162,98,64,,,,18,,,,37,25,12,29,85,49,36,90,55,7,9,13,8,5,,,
"Apr 14, 2021 4:00 PM",132,50,82,179,93,86,205,107,98,132,61,71,,,,61,,,,47,31,16,37,82,28,54,71,49,11,4,11,7,4,,,
"Apr 14, 2021 5:00 PM",166,47,119,195,120,75,285,159,126,191,117,74,,,,34,,,,78,77,1,43,92,35,57,105,99,12,8,12,8,4,,,
"Apr 14, 2021 6:00 PM",134,53,81,258,159,99,302,191,111,242,149,93,,,,22,,,,51,51,0,30,119,42,77,125,105,15,10,3,3,0,,,
"Apr 14, 2021 7:00 PM",104,36,68,255,115,140,264,114,150,210,104,106,,,,29,,,,37,36,1,29,129,61,68,68,82,10,5,3,1,2,,,
"Apr 14, 2021 8:00 PM",54,20,34,119,50,69,138,52,86,120,45,75,,,,16,,,,23,20,3,25,63,29,34,31,57,2,3,4,3,1,,,
"Apr 14, 2021 9:00 PM",35,12,23,32,13,19,49,12,37,25,6,19,,,,2,,,,14,14,0,9,17,7,10,14,28,2,0,2,1,1,,,
"Apr 14, 2021 10:00 PM",12,4,8,11,9,2,14,5,9,18,8,10,,,,0,,,,5,5,0,3,8,5,3,12,11,1,0,1,1,0,,,
"Apr 14, 2021 11:00 PM",8,0,8,16,3,13,10,6,4,9,5,4,,,,3,,,,5,5,0,1,1,0,1,5,2,1,0,2,1,1,,,
"Apr 15, 2021 12:00 AM",3,1,2,0,0,0,0,0,0,2,1,1,,,,0,,,,2,2,0,0,2,0,2,3,0,0,0,1,1,0,,,
"Apr 15, 2021 1:00 AM",2,0,2,0,0,0,1,1,0,1,1,0,,,,1,,,,2,2,0,0,1,1,0,0,0,0,1,0,0,0,,,
"Apr 15, 2021 2:00 AM",4,2,2,0,0,0,0,0,0,0,0,0,,,,0,,,,1,1,0,2,0,0,0,0,1,0,0,0,0,0,,,
"Apr 15, 2021 3:00 AM",2,1,1,0,0,0,0,0,0,0,0,0,,,,0,,,,0,0,0,1,0,0,0,0,0,0,0,0,0,0,,,
"Apr 15, 2021 4:00 AM",1,1,0,0,0,0,1,1,0,0,0,0,,,,0,,,,2,2,0,1,0,0,0,0,2,0,0,0,0,0,,,
"Apr 15, 2021 5:00 AM",2,2,0,1,1,0,2,2,0,4,3,1,,,,1,,,,1,1,0,4,2,1,1,2,10,0,0,0,0,0,,,
"Apr 15, 2021 6:00 AM",30,19,11,45,27,18,44,27,17,39,27,12,,,,5,,,,9,9,0,14,8,5,3,18,27,0,0,0,0,0,,,
"Apr 15, 2021 7:00 AM",104,60,44,101,42,59,123,49,74,92,43,49,,,,29,,,,21,19,2,57,36,23,13,44,85,4,8,4,4,0,,,
"Apr 15, 2021 8:00 AM",192,127,65,154,48,106,209,71,138,175,64,111,,,,27,,,,41,39,2,105,100,48,52,53,118,11,8,10,10,0,,,
"Apr 15, 2021 9:00 AM",85,59,26,140,77,63,139,85,54,129,89,40,,,,11,,,,27,22,5,40,66,50,16,36,57,4,10,5,1,4,,,
"Apr 15, 2021 10:00 AM",60,38,22,99,53,46,129,72,57,105,62,43,,,,8,,,,14,11,3,24,61,42,19,31,32,6,6,5,2,3,,,
"Apr 15, 2021 11:00 AM",69,32,37,116,60,56,162,92,70,129,75,54,,,,6,,,,14,12,2,13,50,33,17,31,41,7,9,4,0,4,,,
"Apr 15, 2021 12:00 PM",75,36,39,161,95,66,167,97,70,123,79,44,,,,24,,,,24,23,1,36,53,33,20,50,43,3,5,5,3,2,,,
"Apr 15, 2021 1:00 PM",75,41,34,127,68,59,205,110,95,114,58,56,,,,17,,,,18,18,0,23,80,52,28,62,58,7,8,5,4,1,,,
"Apr 15, 2021 2:00 PM",67,32,35,98,51,47,176,93,83,124,76,48,,,,13,,,,22,22,0,22,67,52,15,39,52,4,8,5,0,5,,,
"Apr 15, 2021 3:00 PM",81,43,38,131,71,60,173,100,73,123,64,59,,,,23,,,,23,17,6,47,70,45,25,57,64,7,2,5,4,1,,,
"Apr 15, 2021 4:00 PM",113,35,78,109,61,48,185,116,69,109,62,47,,,,33,,,,39,34,5,30,77,39,38,74,47,10,10,10,5,5,,,
"Apr 15, 2021 5:00 PM",138,46,92,135,78,57,189,110,79,156,88,68,,,,27,,,,50,50,0,41,77,46,31,76,63,8,11,2,1,1,,,
"Apr 15, 2021 6:00 PM",132,51,81,163,88,75,196,98,98,152,85,67,,,,22,,,,64,64,0,34,82,51,31,83,78,4,9,16,9,7,,,
"Apr 15, 2021 7:00 PM",90,32,58,122,64,58,154,85,69,122,59,63,,,,30,,,,34,34,0,15,47,30,17,61,57,2,4,4,2,2,,,
"Apr 15, 2021 8:00 PM",69,27,42,100,49,51,105,47,58,90,40,50,,,,19,,,,23,23,0,24,37,21,16,32,33,2,5,1,0,1,,,
"Apr 15, 2021 9:00 PM",39,14,25,8,5,3,33,12,21,21,8,13,,,,5,,,,17,17,0,12,19,9,10,10,24,1,0,1,1,0,,,
"Apr 15, 2021 10:00 PM",12,2,10,2,1,1,4,2,2,3,1,2,,,,1,,,,10,9,1,6,0,0,0,7,11,0,1,0,0,0,,,
"Apr 15, 2021 11:00 PM",11,4,7,4,4,0,8,4,4,5,3,2,,,,1,,,,6,6,0,5,4,4,0,6,3,1,0,1,0,1,,,
"Apr 16, 2021 12:00 AM",3,0,3,0,0,0,1,1,0,2,2,0,,,,1,,,,0,0,0,0,1,1,0,2,1,0,1,0,0,0,,,
"Apr 16, 2021 1:00 AM",3,2,1,0,0,0,2,1,1,0,0,0,,,,0,,,,0,0,0,0,0,0,0,1,0,0,0,0,0,0,,,
"Apr 16, 2021 2:00 AM",1,0,1,1,1,0,1,1,0,2,2,0,,,,1,,,,2,2,0,1,0,0,0,1,1,0,0,0,0,0,,,
"Apr 16, 2021 3:00 AM",0,0,0,0,0,0,0,0,0,0,0,0,,,,0,,,,0,0,0,1,0,0,0,0,0,0,0,0,0,0,,,
"Apr 16, 2021 4:00 AM",0,0,0,0,0,0,2,2,0,0,0,0,,,,0,,,,2,2,0,1,1,0,1,2,1,0,0,0,0,0,,,
"Apr 16, 2021 5:00 AM",4,3,1,2,1,1,3,3,0,4,4,0,,,,0,,,,2,2,0,4,0,0,0,1,2,0,0,1,1,0,,,
"Apr 16, 2021 6:00 AM",31,17,14,46,31,15,46,34,12,44,29,15,,,,3,,,,5,5,0,12,17,14,3,16,35,0,3,0,0,0,,,
"Apr 16, 2021 7:00 AM",78,36,42,138,58,80,127,58,69,108,55,53,,,,14,,,,24,24,0,62,31,19,12,43,77,4,2,2,0,2,,,
"Apr 16, 2021 8:00 AM",126,54,72,178,63,115,218,63,155,183,73,110,,,,36,,,,44,43,1,89,94,33,61,54,99,11,6,17,15,2,,,
"Apr 16, 2021 9:00 AM",63,36,27,126,64,62,142,77,65,124,72,52,,,,10,,,,25,20,5,40,47,35,12,34,53,4,8,7,6,1,,,
"Apr 16, 2021 10:00 AM",49,32,17,113,64,49,143,83,60,121,68,53,,,,12,,,,18,17,1,23,42,28,14,30,49,5,5,2,0,2,,,
"Apr 16, 2021 11:00 AM",53,31,22,129,59,70,155,90,65,136,81,55,,,,25,,,,18,16,2,18,66,41,25,44,37,3,7,6,6,0,,,
"Apr 16, 2021 12:00 PM",55,31,24,138,73,65,171,89,82,133,65,68,,,,16,,,,32,20,12,28,48,27,21,52,54,6,6,9,5,4,,,
"Apr 16, 2021 1:00 PM",87,44,43,136,75,61,193,105,88,127,63,64,,,,13,,,,21,16,5,28,78,48,30,65,49,14,6,3,2,1,,,
"Apr 16, 2021 2:00 PM",72,31,41,126,66,60,170,89,81,123,66,57,,,,25,,,,27,22,5,25,63,34,29,63,43,7,10,8,3,5,,,
"Apr 16, 2021 3:00 PM",79,34,45,91,53,38,151,87,64,107,68,39,,,,31,,,,36,32,4,28,65,40,25,44,56,9,3,7,5,2,,,
"Apr 16, 2021 4:00 PM",103,34,69,125,67,58,168,106,62,140,83,57,,,,16,,,,40,33,7,20,81,60,21,82,57,2,8,5,2,3,,,
"Apr 16, 2021 5:00 PM",124,43,81,127,72,55,199,117,82,135,77,58,,,,40,,,,63,60,3,30,68,41,27,80,63,5,7,12,9,3,,,
"Apr 16, 2021 6:00 PM",122,46,76,110,68,42,179,97,82,117,73,44,,,,14,,,,46,45,1,35,66,40,26,80,48,6,3,3,2,1,,,
"Apr 16, 2021 7:00 PM",85,43,42,136,79,57,126,58,68,111,61,50,,,,15,,,,38,35,3,21,44,26,18,43,51,2,6,4,2,2,,,
"Apr 16, 2021 8:00 PM",60,29,31,60,29,31,79,26,53,53,25,28,,,,12,,,,13,13,0,8,26,8,18,14,33,2,1,2,1,1,,,
"Apr 16, 2021 9:00 PM",30,9,21,28,7,21,34,12,22,22,6,16,,,,10,,,,12,12,0,10,7,2,5,13,16,2,2,2,2,0,,,
"Apr 16, 2021 10:00 PM",22,12,10,16,10,6,20,8,12,9,5,4,,,,4,,,,11,11,0,5,4,2,2,10,16,1,1,4,3,1,,,
"Apr 16, 2021 11:00 PM",9,2,7,2,0,2,7,3,4,4,1,3,,,,1,,,,10,10,0,7,4,3,1,6,1,2,0,1,1,0,,,
"Apr 17, 2021 12:00 AM",12,3,9,0,0,0,0,0,0,6,4,2,,,,0,,,,3,3,0,1,2,2,0,4,9,0,0,0,0,0,,,
"Apr 17, 2021 1:00 AM",4,0,4,9,4,5,9,3,6,11,5,6,,,,1,,,,3,3,0,0,1,1,0,6,0,0,0,0,0,0,,,
"Apr 17, 2021 2:00 AM",6,4,2,5,1,4,2,2,0,3,1,2,,,,0,,,,2,2,0,1,5,3,2,4,0,0,0,0,0,0,,,
"Apr 17, 2021 3:00 AM",2,1,1,2,1,1,3,3,0,1,1,0,,,,0,,,,0,0,0,2,1,1,0,0,0,0,0,0,0,0,,,
"Apr 17, 2021 4:00 AM",0,0,0,0,0,0,1,1,0,1,1,0,,,,1,,,,0,0,0,0,0,0,0,0,0,0,0,0,0,0,,,
"Apr 17, 2021 5:00 AM",0,0,0,7,6,1,8,8,0,5,4,1,,,,0,,,,2,2,0,2,0,0,0,6,2,0,1,0,0,0,,,
"Apr 17, 2021 6:00 AM",5,2,3,21,18,3,40,30,10,25,19,6,,,,3,,,,2,2,0,8,10,10,0,11,11,0,1,1,1,0,,,
"Apr 17, 2021 7:00 AM",29,11,18,78,47,31,91,57,34,75,52,23,,,,4,,,,5,5,0,12,42,31,11,33,40,0,3,3,0,3,,,
"Apr 17, 2021 8:00 AM",41,20,21,183,121,62,176,121,55,176,123,53,,,,4,,,,17,16,1,31,36,29,7,54,45,3,4,3,1,2,,,
"Apr 17, 2021 9:00 AM",52,25,27,253,139,114,268,140,128,260,147,113,,,,18,,,,10,10,0,31,99,81,18,66,83,4,20,3,1,2,,,
"Apr 17, 2021 10:00 AM",94,63,31,374,218,156,365,199,166,366,215,151,,,,21,,,,22,22,0,33,112,75,37,105,101,10,12,8,3,5,,,
"Apr 17, 2021 11:00 AM",112,61,51,336,182,154,398,224,174,362,217,145,,,,26,,,,33,32,1,51,184,131,53,119,126,13,10,11,10,1,,,
"Apr 17, 2021 12:00 PM",126,59,67,414,210,204,485,277,208,417,231,186,,,,35,,,,33,33,0,42,220,152,68,123,123,13,13,15,9,6,,,
"Apr 17, 2021 1:00 PM",113,56,57,412,229,183,559,316,243,458,260,198,,,,28,,,,33,33,0,56,194,138,56,165,114,11,15,11,6,5,,,
"Apr 17, 2021 2:00 PM",112,67,45,394,218,176,492,283,209,382,227,155,,,,23,,,,34,33,1,50,243,182,61,137,111,12,18,20,13,7,,,
"Apr 17, 2021 3:00 PM",111,54,57,404,176,228,559,277,282,402,195,207,,,,27,,,,27,25,2,42,187,99,88,111,135,14,5,16,13,3,,,
"Apr 17, 2021 4:00 PM",103,63,40,317,155,162,424,183,241,325,143,182,,,,38,,,,36,35,1,57,170,75,95,100,132,9,9,18,10,8,,,
"Apr 17, 2021 5:00 PM",96,39,57,233,92,141,410,142,268,262,95,167,,,,35,,,,23,23,0,51,147,57,90,75,133,3,8,6,3,3,,,
"Apr 17, 2021 6:00 PM",93,44,49,128,57,71,215,71,144,138,60,78,,,,13,,,,30,29,1,40,122,46,76,44,78,7,5,6,5,1,,,
"Apr 17, 2021 7:00 PM",58,32,26,84,32,52,117,33,84,76,28,48,,,,11,,,,17,16,1,26,58,17,41,27,59,4,1,5,4,1,,,
"Apr 17, 2021 8:00 PM",49,14,35,38,14,24,66,23,43,46,16,30,,,,20,,,,10,10,0,13,17,9,8,16,34,1,2,2,1,1,,,
"Apr 17, 2021 9:00 PM",40,19,21,31,13,18,29,14,15,27,13,14,,,,1,,,,6,6,0,12,10,2,8,9,27,0,1,0,0,0,,,
"Apr 17, 2021 10:00 PM",11,3,8,17,10,7,14,7,7,17,9,8,,,,3,,,,17,17,0,7,7,0,7,7,13,3,0,3,1,2,,,
"Apr 17, 2021 11:00 PM",12,6,6,4,2,2,10,3,7,7,2,5,,,,3,,,,7,7,0,5,1,0,1,4,7,1,1,0,0,0,,,
"Apr 18, 2021 12:00 AM",8,2,6,1,1,0,7,6,1,13,8,5,,,,0,,,,2,2,0,1,7,4,3,6,13,1,0,0,0,0,,,
"Apr 18, 2021 1:00 AM",9,4,5,1,0,1,3,1,2,0,0,0,,,,1,,,,3,3,0,6,1,0,1,1,2,0,0,0,0,0,,,
"Apr 18, 2021 2:00 AM",6,0,6,2,1,1,0,0,0,6,2,4,,,,2,,,,4,4,0,3,1,1,0,1,3,0,0,0,0,0,,,
"Apr 18, 2021 3:00 AM",0,0,0,0,0,0,1,0,1,0,0,0,,,,0,,,,1,1,0,1,0,0,0,1,1,0,1,0,0,0,,,
"Apr 18, 2021 4:00 AM",1,0,1,0,0,0,1,1,0,0,0,0,,,,0,,,,1,1,0,0,1,1,0,1,0,0,0,0,0,0,,,
"Apr 18, 2021 5:00 AM",2,1,1,0,0,0,4,3,1,1,0,1,,,,0,,,,2,2,0,0,0,0,0,1,2,0,0,0,0,0,,,
"Apr 18, 2021 6:00 AM",5,4,1,5,3,2,5,3,2,6,4,2,,,,1,,,,2,2,0,5,4,3,1,4,6,0,0,0,0,0,,,
"Apr 18, 2021 7:00 AM",12,5,7,18,11,7,30,18,12,22,13,9,,,,5,,,,5,4,1,7,7,4,3,16,18,5,5,3,2,1,,,
"Apr 18, 2021 8:00 AM",23,12,11,78,47,31,95,63,32,81,56,25,,,,5,,,,6,6,0,15,46,27,19,30,36,5,17,4,2,2,,,
"Apr 18, 2021 9:00 AM",42,14,28,193,138,55,164,107,57,153,104,49,,,,11,,,,11,9,2,22,49,35,14,59,61,5,16,3,1,2,,,
"Apr 18, 2021 10:00 AM",48,30,18,225,125,100,230,129,101,230,134,96,,,,16,,,,16,15,1,32,77,45,32,75,54,11,10,6,4,2,,,
"Apr 18, 2021 11:00 AM",54,31,23,324,162,162,290,156,134,276,149,127,,,,30,,,,21,21,0,14,83,52,31,84,88,10,19,2,1,1,,,
"Apr 18, 2021 12:00 PM",84,49,35,276,102,174,282,118,164,292,117,175,,,,35,,,,17,15,2,37,106,53,53,90,102,16,7,18,14,4,,,
"Apr 18, 2021 1:00 PM",72,39,33,231,120,111,244,122,122,229,119,110,,,,22,,,,21,21,0,36,89,57,32,70,74,13,5,11,10,1,,,
"Apr 18, 2021 2:00 PM",68,35,33,194,98,96,296,137,159,232,104,128,,,,19,,,,23,23,0,24,119,67,52,91,76,6,6,6,5,1,,,
"Apr 18, 2021 3:00 PM",59,38,21,213,108,105,222,112,110,201,99,102,,,,9,,,,21,21,0,20,97,56,41,38,71,3,5,7,5,2,,,
"Apr 18, 2021 4:00 PM",48,27,21,169,90,79,243,123,120,190,97,93,,,,30,,,,23,23,0,28,92,41,51,65,61,8,4,9,4,5,,,
"Apr 18, 2021 5:00 PM",58,24,34,155,75,80,170,74,96,132,69,63,,,,20,,,,14,14,0,26,52,22,30,41,72,4,3,6,0,6,,,
"Apr 18, 2021 6:00 PM",57,29,28,84,41,43,116,51,65,87,38,49,,,,27,,,,17,17,0,15,35,18,17,31,46,1,3,6,2,4,,,
"Apr 18, 2021 7:00 PM",45,20,25,47,20,27,71,26,45,56,25,31,,,,6,,,,7,7,0,9,31,9,22,20,25,1,2,6,6,0,,,
"Apr 18, 2021 8:00 PM",30,16,14,25,11,14,27,12,15,23,11,12,,,,2,,,,6,6,0,3,7,2,5,15,19,2,0,3,0,3,,,
"Apr 18, 2021 9:00 PM",24,13,11,10,4,6,16,6,10,10,5,5,,,,4,,,,2,2,0,7,6,4,2,9,12,1,1,0,0,0,,,
"Apr 18, 2021 10:00 PM",5,1,4,5,4,1,8,1,7,7,2,5,,,,2,,,,5,5,0,2,1,0,1,3,6,0,0,0,0,0,,,
"Apr 18, 2021 11:00 PM",3,0,3,4,1,3,0,0,0,3,1,2,,,,1,,,,3,3,0,5,0,0,0,1,2,0,1,0,0,0,,,
"Apr 19, 2021 12:00 AM",1,1,0,0,0,0,1,0,1,0,0,0,,,,0,,,,0,0,0,0,2,2,0,5,1,0,0,2,1,1,,,
"Apr 19, 2021 1:00 AM",2,1,1,0,0,0,3,1,2,1,0,1,,,,0,,,,2,2,0,1,2,1,1,2,0,0,0,0,0,0,,,
"Apr 19, 2021 2:00 AM",0,0,0,0,0,0,0,0,0,0,0,0,,,,0,,,,0,0,0,1,0,0,0,0,0,0,0,0,0,0,,,
"Apr 19, 2021 3:00 AM",0,0,0,0,0,0,0,0,0,0,0,0,,,,0,,,,0,0,0,0,0,0,0,0,0,0,0,0,0,0,,,
"Apr 19, 2021 4:00 AM",1,0,1,0,0,0,1,1,0,1,1,0,,,,0,,,,1,1,0,0,0,0,0,0,1,0,0,0,0,0,,,
"Apr 19, 2021 5:00 AM",4,4,0,5,2,3,7,2,5,8,3,5,,,,0,,,,2,2,0,3,0,0,0,3,7,0,0,1,1,0,,,
"Apr 19, 2021 6:00 AM",34,25,9,24,12,12,37,19,18,22,14,8,,,,3,,,,7,7,0,13,10,5,5,13,30,0,2,1,1,0,,,
"Apr 19, 2021 7:00 AM",93,51,42,85,32,53,119,42,77,98,38,60,,,,24,,,,17,17,0,64,32,14,18,44,84,5,3,2,2,0,,,
"Apr 19, 2021 8:00 AM",187,122,65,122,39,83,190,65,125,145,57,88,,,,21,,,,44,41,3,97,81,21,60,46,105,8,4,15,15,0,,,
"Apr 19, 2021 9:00 AM",83,62,21,99,56,43,93,52,41,79,45,34,,,,12,,,,27,15,12,31,46,28,18,33,52,3,1,3,1,2,,,
"Apr 19, 2021 10:00 AM",45,34,11,92,47,45,96,58,38,94,50,44,,,,14,,,,14,10,4,20,37,27,10,18,32,6,6,5,3,2,,,
"Apr 19, 2021 11:00 AM",49,27,22,97,47,50,113,57,56,98,52,46,,,,13,,,,9,9,0,23,52,35,17,34,26,3,3,4,2,2,,,
"Apr 19, 2021 12:00 PM",54,29,25,129,57,72,120,63,57,92,51,41,,,,16,,,,18,18,0,14,40,27,13,24,34,4,7,5,4,1,,,
"Apr 19, 2021 1:00 PM",74,43,31,109,61,48,127,58,69,106,48,58,,,,18,,,,18,15,3,24,43,25,18,31,27,5,4,3,2,1,,,
"Apr 19, 2021 2:00 PM",67,33,34,89,48,41,118,66,52,93,55,38,,,,12,,,,15,12,3,18,52,31,21,33,44,6,10,11,7,4,,,
"Apr 19, 2021 3:00 PM",71,32,39,67,35,32,123,72,51,69,36,33,,,,20,,,,32,29,3,33,52,31,21,46,50,3,6,10,4,6,,,
"Apr 19, 2021 4:00 PM",111,55,56,75,50,25,171,110,61,97,66,31,,,,23,,,,49,40,9,22,71,51,20,68,46,6,3,9,5,4,,,
"Apr 19, 2021 5:00 PM",142,42,100,111,66,45,178,102,76,123,65,58,,,,32,,,,53,52,1,26,58,40,18,88,53,6,7,6,4,2,,,
"Apr 19, 2021 6:00 PM",132,40,92,141,83,58,209,123,86,145,87,58,,,,13,,,,59,59,0,37,75,51,24,91,78,4,5,4,3,1,,,
"Apr 19, 2021 7:00 PM",68,30,38,131,62,69,150,77,73,118,58,60,,,,24,,,,42,41,1,20,74,38,36,44,63,4,3,0,0,0,,,
"Apr 19, 2021 8:00 PM",50,13,37,65,32,33,76,32,44,58,26,32,,,,5,,,,20,20,0,5,33,16,17,32,38,5,1,4,3,1,,,
"Apr 19, 2021 9:00 PM",15,3,12,21,11,10,28,12,16,21,8,13,,,,2,,,,14,13,1,8,6,2,4,8,14,5,0,3,1,2,,,
"Apr 19, 2021 10:00 PM",10,2,8,4,3,1,6,4,2,7,2,5,,,,1,,,,4,4,0,3,6,2,4,7,7,0,0,1,1,0,,,
"Apr 19, 2021 11:00 PM",6,0,6,3,0,3,2,0,2,1,1,0,,,,2,,,,3,3,0,0,1,1,0,1,1,0,0,0,0,0,,,
"Apr 20, 2021 12:00 AM",1,0,1,0,0,0,0,0,0,0,0,0,,,,0,,,,1,1,0,0,0,0,0,3,0,0,0,0,0,0,,,
"Apr 20, 2021 1:00 AM",0,0,0,0,0,0,0,0,0,0,0,0,,,,0,,,,1,1,0,0,0,0,0,1,1,0,0,0,0,0,,,
"Apr 20, 2021 2:00 AM",2,1,1,2,0,2,0,0,0,0,0,0,,,,0,,,,1,1,0,0,0,0,0,0,0,0,0,0,0,0,,,
"Apr 20, 2021 3:00 AM",0,0,0,0,0,0,0,0,0,1,0,1,,,,0,,,,0,0,0,0,0,0,0,0,1,0,0,0,0,0,,,
"Apr 20, 2021 4:00 AM",1,1,0,0,0,0,1,1,0,0,0,0,,,,0,,,,2,2,0,0,0,0,0,1,1,0,0,0,0,0,,,
"Apr 20, 2021 5:00 AM",1,1,0,1,1,0,6,4,2,5,3,2,,,,0,,,,1,1,0,4,0,0,0,3,7,0,0,0,0,0,0,0,0
"Apr 20, 2021 6:00 AM",33,20,13,43,23,20,44,23,21,32,15,17,,,,4,,,,4,4,0,11,6,3,3,14,31,0,1,1,1,0,0,0,0
"Apr 20, 2021 7:00 AM",94,54,40,65,19,46,92,30,62,63,25,38,,,,10,,,,15,14,1,56,37,18,19,37,89,5,4,4,4,0,0,0,0
"Apr 20, 2021 8:00 AM",168,115,53,114,39,75,164,43,121,141,46,95,,,,27,,,,41,40,1,93,80,23,57,57,117,6,6,17,16,1,0,0,0
"Apr 20, 2021 9:00 AM",82,53,29,75,38,37,90,56,34,76,42,34,,,,9,,,,20,20,0,37,25,15,10,31,43,1,5,3,2,1,0,0,0
"Apr 20, 2021 10:00 AM",50,36,14,63,29,34,69,39,30,56,27,29,,,,10,,,,8,8,0,28,30,16,14,24,31,5,2,1,1,0,0,0,0
"Apr 20, 2021 11:00 AM",43,27,16,88,39,49,71,34,37,65,34,31,,,,9,,,,7,7,0,25,41,23,18,18,27,4,5,3,2,1,0,0,0
"Apr 20, 2021 12:00 PM",56,25,31,81,41,40,73,33,40,67,37,30,,,,14,,,,20,18,2,20,54,24,30,19,32,7,7,6,5,1,0,0,0
"Apr 20, 2021 1:00 PM",67,33,34,85,43,42,92,50,42,78,42,36,,,,16,,,,19,15,4,24,22,11,11,33,26,5,7,4,1,3,0,0,0
"Apr 20, 2021 2:00 PM",63,28,35,64,35,29,97,52,45,78,44,34,,,,21,,,,17,16,1,18,31,16,15,38,32,3,2,6,4,2,0,0,0
"Apr 20, 2021 3:00 PM",78,30,48,96,54,42,131,91,40,88,57,31,,,,16,,,,30,30,0,22,37,19,18,52,48,7,5,6,2,4,0,0,0
"Apr 20, 2021 4:00 PM",109,48,61,143,83,60,150,96,54,113,75,38,,,,23,,,,25,24,1,20,38,14,24,96,57,11,7,3,2,1,0,0,0
"Apr 20, 2021 5:00 PM",136,56,80,157,90,67,230,131,99,142,87,55,,,,19,,,,58,56,2,32,49,26,23,101,76,10,16,9,6,3,0,0,0
"Apr 20, 2021 6:00 PM",131,40,91,189,110,79,237,133,104,192,112,80,,,,24,,,,59,59,0,33,67,45,22,103,83,12,8,8,5,3,0,0,0
"Apr 20, 2021 7:00 PM",94,33,61,157,66,91,172,93,79,134,64,70,,,,20,,,,37,36,1,24,61,33,28,43,56,13,2,2,0,2,0,0,0
"Apr 20, 2021 8:00 PM",60,18,42,94,56,38,110,49,61,88,45,43,,,,8,,,,18,15,3,16,44,26,18,51,32,5,4,4,2,2,0,0,0
"Apr 20, 2021 9:00 PM",37,9,28,34,16,18,43,15,28,27,8,19,,,,11,,,,11,11,0,10,22,8,14,19,22,2,1,0,0,0,0,0,0
"Apr 20, 2021 10:00 PM",18,3,15,7,4,3,11,5,6,7,3,4,,,,1,,,,11,11,0,3,12,3,9,7,7,2,1,5,4,1,0,0,0
"Apr 20, 2021 11:00 PM",6,4,2,1,1,0,5,5,0,5,3,2,,,,0,,,,6,5,1,1,2,2,0,1,0,0,1,0,0,0,0,0,0
"Apr 21, 2021 12:00 AM",3,1,2,0,0,0,0,0,0,1,0,1,,,,0,,,,1,1,0,2,2,0,2,1,0,0,0,0,0,0,0,0,0
"Apr 21, 2021 1:00 AM",3,0,3,0,0,0,0,0,0,0,0,0,,,,0,,,,1,1,0,0,0,0,0,2,0,0,0,0,0,0,0,0,0
"Apr 21, 2021 2:00 AM",4,3,1,0,0,0,2,1,1,1,0,1,,,,0,,,,1,1,0,1,0,0,0,1,0,0,0,0,0,0,0,0,0
"Apr 21, 2021 3:00 AM",0,0,0,2,2,0,0,0,0,2,2,0,,,,0,,,,0,0,0,1,0,0,0,0,1,0,0,0,0,0,0,0,0
"Apr 21, 2021 4:00 AM",0,0,0,0,0,0,4,1,3,1,1,0,,,,0,,,,2,2,0,0,3,0,3,0,2,0,0,1,1,0,0,0,0
"Apr 21, 2021 5:00 AM",5,3,2,3,2,1,5,3,2,6,3,3,,,,1,,,,2,2,0,4,0,0,0,3,9,0,0,0,0,0,0,0,0
"Apr 21, 2021 6:00 AM",32,21,11,44,23,21,59,40,19,33,18,15,,,,4,,,,3,3,0,12,10,7,3,34,36,0,1,1,1,0,0,0,0
"Apr 21, 2021 7:00 AM",110,64,46,133,56,77,171,68,103,123,56,67,,,,17,,,,21,19,2,69,49,29,20,54,101,4,5,2,1,1,0,0,0
"Apr 21, 2021 8:00 AM",187,122,65,182,69,113,253,84,169,184,74,110,,,,32,,,,44,44,0,109,109,31,78,55,133,11,4,16,15,1,0,0,0
"Apr 21, 2021 9:00 AM",77,48,29,114,58,56,153,82,71,118,56,62,,,,11,,,,18,18,0,39,43,19,24,43,55,3,5,2,1,1,0,0,0
"Apr 21, 2021 10:00 AM",61,49,12,105,46,59,109,54,55,95,47,48,,,,5,,,,21,18,3,27,39,15,24,24,42,1,3,4,1,3,0,0,0
"Apr 21, 2021 11:00 AM",58,29,29,88,45,43,106,55,51,84,44,40,,,,9,,,,11,10,1,11,41,29,12,33,43,5,4,3,2,1,0,0,0
"Apr 21, 2021 12:00 PM",77,46,31,106,54,52,141,66,75,118,60,58,,,,20,,,,24,24,0,23,37,19,18,39,52,8,3,4,2,2,0,0,0
"Apr 21, 2021 1:00 PM",74,34,40,139,75,64,153,89,64,120,75,45,,,,17,,,,29,28,1,34,52,30,22,65,44,8,4,8,5,3,0,0,0
"Apr 21, 2021 2:00 PM",61,25,36,108,72,36,136,81,55,108,66,42,,,,28,,,,22,21,1,29,50,20,30,36,52,1,9,7,4,3,0,0,0
"Apr 21, 2021 3:00 PM",92,51,41,138,77,61,154,91,63,122,73,49,,,,38,,,,24,24,0,22,60,27,33,52,48,7,4,10,6,4,0,0,0
"Apr 21, 2021 4:00 PM",111,39,72,147,74,73,162,100,62,130,76,54,,,,29,,,,38,37,1,29,54,21,33,65,53,10,3,8,5,3,0,0,0
"Apr 21, 2021 5:00 PM",185,57,128,198,126,72,231,137,94,191,108,83,,,,35,,,,73,73,0,40,78,26,52,111,90,8,5,5,4,1,0,0,0
"Apr 21, 2021 6:00 PM",157,59,98,255,135,120,294,181,113,210,125,85,,,,46,,,,71,68,3,37,82,37,45,144,78,6,10,13,11,2,0,0,0
"Apr 21, 2021 7:00 PM",107,47,60,218,105,113,307,161,146,239,114,125,,,,45,,,,35,35,0,30,80,44,36,89,89,8,3,11,8,3,0,0,0
"Apr 21, 2021 8:00 PM",68,25,43,110,51,59,178,61,117,125,51,74,,,,20,,,,24,24,0,24,54,20,34,38,68,1,0,3,1,2,0,0,0
"Apr 21, 2021 9:00 PM",40,13,27,34,15,19,54,15,39,39,16,23,,,,10,,,,11,11,0,9,25,10,15,15,45,2,2,8,5,3,0,0,0
"Apr 21, 2021 10:00 PM",11,4,7,11,4,7,15,6,9,11,3,8,,,,5,,,,4,4,0,4,14,7,7,10,7,0,1,2,0,2,0,0,0
"Apr 21, 2021 11:00 PM",7,0,7,3,3,0,10,4,6,4,0,4,,,,1,,,,3,2,1,8,5,4,1,3,1,0,0,1,1,0,0,0,0
"Apr 22, 2021 12:00 AM",8,3,5,0,0,0,1,1,0,2,1,1,,,,2,,,,0,0,0,1,1,1,0,2,1,0,0,2,1,1,0,0,0
"Apr 22, 2021 1:00 AM",3,2,1,1,0,1,1,0,1,0,0,0,,,,0,,,,0,0,0,1,0,0,0,2,1,1,1,0,0,0,0,0,0
"Apr 22, 2021 2:00 AM",7,5,2,1,1,0,0,0,0,0,0,0,,,,0,,,,0,0,0,0,0,0,0,3,1,0,0,0,0,0,0,0,0
"Apr 22, 2021 3:00 AM",0,0,0,0,0,0,1,0,1,0,0,0,,,,0,,,,1,1,0,1,0,0,0,0,1,0,0,0,0,0,0,0,0
"Apr 22, 2021 4:00 AM",0,0,0,0,0,0,0,0,0,0,0,0,,,,0,,,,3,3,0,0,1,0,1,0,4,0,0,0,0,0,0,0,0
"Apr 22, 2021 5:00 AM",3,3,0,4,3,1,14,12,2,6,5,1,,,,0,,,,3,3,0,1,9,8,1,10,7,0,0,1,0,1,0,0,0
"Apr 22, 2021 6:00 AM",37,26,11,56,34,22,71,48,23,45,27,18,,,,7,,,,4,4,0,17,11,5,6,28,35,1,2,0,0,0,0,0,0
"Apr 22, 2021 7:00 AM",108,54,54,115,47,68,187,70,117,112,50,62,,,,19,,,,19,18,1,82,63,33,30,61,100,4,11,3,2,1,0,0,0
"Apr 22, 2021 8:00 AM",183,124,59,175,58,117,261,91,170,176,58,118,,,,42,,,,41,41,0,98,127,38,89,69,148,9,8,20,17,3,0,0,0
"Apr 22, 2021 9:00 AM",96,64,32,103,59,44,139,83,56,83,53,30,,,,13,,,,21,21,0,37,60,22,38,40,65,3,6,5,4,1,0,0,0
"Apr 22, 2021 10:00 AM",69,43,26,111,55,56,154,85,69,102,56,46,,,,10,,,,10,9,1,26,56,34,22,38,39,8,3,5,3,2,0,0,0
"Apr 22, 2021 11:00 AM",56,27,29,140,80,60,194,97,97,134,85,49,,,,17,,,,13,12,1,28,51,26,25,49,56,4,6,8,3,5,0,0,0
"Apr 22, 2021 12:00 PM",50,24,26,158,82,76,176,99,77,145,83,62,,,,18,,,,20,18,2,21,69,38,31,43,41,7,2,11,5,6,0,0,0
"Apr 22, 2021 1:00 PM",64,34,30,145,65,80,189,89,100,128,59,69,,,,21,,,,20,20,0,27,68,31,37,65,41,7,5,10,9,1,0,0,0
"Apr 22, 2021 2:00 PM",85,36,49,161,101,60,166,84,82,166,98,68,,,,24,,,,29,29,0,20,49,25,24,56,63,3,8,11,4,7,0,0,0
"Apr 22, 2021 3:00 PM",114,55,59,162,86,76,188,103,85,156,96,60,,,,23,,,,33,33,0,36,59,23,36,63,62,7,3,11,7,4,0,0,0
"Apr 22, 2021 4:00 PM",145,62,83,194,114,80,219,140,79,183,114,69,,,,35,,,,44,40,4,39,71,14,57,103,59,9,9,12,9,3,0,0,0
"Apr 22, 2021 5:00 PM",157,49,108,210,122,88,292,174,118,218,134,84,,,,41,,,,68,68,0,42,90,36,54,121,102,9,18,11,8,3,0,0,0
"Apr 22, 2021 6:00 PM",147,59,88,255,154,101,361,205,156,268,150,118,,,,47,,,,71,70,1,37,112,38,74,163,101,9,10,9,6,3,0,0,0
"Apr 22, 2021 7:00 PM",133,65,68,233,115,118,329,179,150,237,121,116,,,,32,,,,45,42,3,35,94,37,57,97,101,5,2,4,2,2,0,0,0
"Apr 22, 2021 8:00 PM",78,26,52,145,56,89,181,51,130,128,41,87,,,,31,,,,20,20,0,24,44,13,31,41,68,3,6,7,6,1,0,0,0
"Apr 22, 2021 9:00 PM",44,16,28,46,18,28,74,15,59,66,20,46,,,,6,,,,13,13,0,17,37,12,25,13,35,1,2,4,3,1,0,0,0
"Apr 22, 2021 10:00 PM",21,10,11,12,8,4,16,4,12,13,6,7,,,,5,,,,5,5,0,7,6,1,5,13,18,1,3,1,1,0,0,0,0
"Apr 22, 2021 11:00 PM",14,7,7,4,4,0,7,1,6,2,2,0,,,,1,,,,2,2,0,6,0,0,0,5,2,0,1,5,4,1,0,0,0
"Apr 23, 2021 12:00 AM",3,2,1,0,0,0,0,0,0,0,0,0,,,,2,,,,7,7,0,0,1,0,1,4,1,0,0,0,0,0,,,
"Apr 23, 2021 1:00 AM",2,0,2,0,0,0,1,1,0,1,1,0,,,,0,,,,2,2,0,1,0,0,0,1,0,0,0,0,0,0,,,
"Apr 23, 2021 2:00 AM",5,5,0,0,0,0,0,0,0,0,0,0,,,,1,,,,2,2,0,1,0,0,0,1,0,0,0,0,0,0,,,
"Apr 23, 2021 3:00 AM",0,0,0,0,0,0,0,0,0,0,0,0,,,,0,,,,0,0,0,0,0,0,0,0,1,0,0,0,0,0,,,
"Apr 23, 2021 4:00 AM",2,1,1,0,0,0,4,4,0,1,1,0,,,,0,,,,1,1,0,0,0,0,0,1,2,0,0,0,0,0,,,
"Apr 23, 2021 5:00 AM",4,2,2,13,13,0,16,16,0,14,13,1,,,,1,,,,4,4,0,5,4,4,0,15,9,0,0,0,0,0,,,
"Apr 23, 2021 6:00 AM",32,18,14,54,27,27,65,40,25,39,19,20,,,,8,,,,3,3,0,15,16,13,3,25,40,1,3,2,1,1,,,
"Apr 23, 2021 7:00 AM",112,66,46,104,48,56,178,82,96,95,50,45,,,,17,,,,23,23,0,69,55,32,23,46,91,5,7,6,3,3,,,
"Apr 23, 2021 8:00 AM",189,125,64,165,61,104,280,102,178,189,79,110,,,,25,,,,30,30,0,84,101,26,75,53,130,12,2,17,14,3,,,
"Apr 23, 2021 9:00 AM",82,51,31,151,83,68,185,111,74,122,72,50,,,,22,,,,14,14,0,41,61,35,26,49,65,3,5,7,5,2,,,
"Apr 23, 2021 10:00 AM",57,35,22,168,98,70,198,123,75,136,80,56,,,,11,,,,12,12,0,21,45,32,13,48,43,6,8,3,3,0,,,
"Apr 23, 2021 11:00 AM",67,34,33,147,75,72,202,96,106,119,61,58,,,,11,,,,10,10,0,21,70,40,30,46,48,12,3,4,3,1,,,
"Apr 23, 2021 12:00 PM",77,40,37,151,76,75,198,97,101,123,61,62,,,,21,,,,19,19,0,27,49,22,27,51,66,6,3,7,4,3,,,
"Apr 23, 2021 1:00 PM",88,38,50,136,65,71,192,99,93,135,67,68,,,,17,,,,17,17,0,26,56,32,24,47,63,4,9,9,5,4,,,
"Apr 23, 2021 2:00 PM",97,47,50,143,72,71,145,80,65,126,77,49,,,,39,,,,19,17,2,24,40,17,23,49,44,6,8,9,8,1,,,
"Apr 23, 2021 3:00 PM",87,44,43,127,81,46,179,107,72,150,97,53,,,,22,,,,18,18,0,24,62,30,32,71,66,4,4,6,3,3,,,
"Apr 23, 2021 4:00 PM",127,42,85,201,122,79,220,138,82,194,111,83,,,,50,,,,44,43,1,23,71,35,36,114,64,12,5,17,11,6,,,
"Apr 23, 2021 5:00 PM",149,58,91,200,110,90,236,132,104,221,110,111,,,,23,,,,59,56,3,41,94,43,51,110,77,14,13,11,5,6,,,
"Apr 23, 2021 6:00 PM",145,55,90,207,132,75,259,157,102,186,122,64,,,,32,,,,59,58,1,37,95,39,56,136,76,4,10,5,5,0,,,
"Apr 23, 2021 7:00 PM",96,43,53,163,74,89,211,91,120,165,76,89,,,,28,,,,37,34,3,28,75,40,35,62,63,9,4,9,7,2,,,
"Apr 23, 2021 8:00 PM",72,30,42,89,32,57,149,65,84,83,41,42,,,,12,,,,16,15,1,20,57,26,31,29,67,2,1,7,7,0,,,
"Apr 23, 2021 9:00 PM",40,18,22,52,16,36,76,20,56,43,8,35,,,,12,,,,10,10,0,11,23,13,10,21,34,4,1,1,0,1,,,
"Apr 23, 2021 10:00 PM",28,13,15,14,5,9,37,5,32,28,5,23,,,,9,,,,9,9,0,12,10,1,9,11,26,1,1,2,1,1,,,
"Apr 23, 2021 11:00 PM",20,8,12,9,5,4,26,14,12,14,8,6,,,,4,,,,14,14,0,5,6,2,4,4,16,0,0,4,4,0,,,
"Apr 24, 2021 12:00 AM",15,3,12,3,3,0,6,3,3,4,2,2,,,,2,,,,5,5,0,0,7,4,3,3,5,1,0,1,1,0,,,
"Apr 24, 2021 1:00 AM",15,5,10,3,2,1,2,1,1,3,2,1,,,,0,,,,8,8,0,1,1,0,1,2,2,0,0,0,0,0,,,
"Apr 24, 2021 2:00 AM",7,3,4,4,1,3,6,2,4,5,1,4,,,,0,,,,3,3,0,4,0,0,0,2,1,0,0,0,0,0,,,
"Apr 24, 2021 3:00 AM",2,1,1,0,0,0,1,1,0,0,0,0,,,,0,,,,0,0,0,2,0,0,0,2,0,0,0,0,0,0,,,
"Apr 24, 2021 4:00 AM",2,2,0,0,0,0,3,3,0,1,1,0,,,,0,,,,0,0,0,1,0,0,0,2,0,0,1,0,0,0,,,
"Apr 24, 2021 5:00 AM",4,1,3,6,6,0,12,11,1,7,6,1,,,,0,,,,2,1,1,2,2,2,0,8,2,0,0,0,0,0,,,
"Apr 24, 2021 6:00 AM",11,6,5,19,13,6,27,18,9,20,13,7,,,,5,,,,1,1,0,3,11,8,3,10,8,0,1,1,1,0,,,
"Apr 24, 2021 7:00 AM",22,9,13,77,51,26,71,45,26,61,43,18,,,,7,,,,8,6,2,7,19,17,2,25,34,0,4,1,1,0,,,
"Apr 24, 2021 8:00 AM",47,18,29,148,92,56,178,110,68,135,95,40,,,,4,,,,18,14,4,17,61,44,17,53,50,9,10,4,2,2,,,
"Apr 24, 2021 9:00 AM",88,39,49,243,144,99,304,203,101,212,147,65,,,,18,,,,19,18,1,32,88,61,27,96,66,7,15,1,1,0,,,
"Apr 24, 2021 10:00 AM",89,44,45,271,163,108,434,268,166,293,196,97,,,,15,,,,26,26,0,53,141,91,50,132,110,12,12,7,4,3,,,
"Apr 24, 2021 11:00 AM",98,47,51,362,201,161,507,307,200,329,209,120,,,,31,,,,16,14,2,35,164,99,65,233,97,13,12,3,2,1,,,
"Apr 24, 2021 12:00 PM",125,67,58,385,187,198,525,278,247,373,192,181,,,,29,,,,31,31,0,56,190,120,70,156,119,20,8,22,14,8,,,
"Apr 24, 2021 1:00 PM",143,97,46,397,220,177,545,291,254,392,237,155,,,,32,,,,27,27,0,77,192,118,74,162,165,22,7,8,5,3,,,
"Apr 24, 2021 2:00 PM",146,81,65,450,263,187,536,327,209,489,298,191,,,,78,,,,21,20,1,59,192,130,62,195,149,24,16,16,8,8,,,
"Apr 24, 2021 3:00 PM",118,50,68,420,243,177,501,277,224,404,241,163,,,,54,,,,27,26,1,50,158,80,78,137,125,15,7,16,14,2,,,
"Apr 24, 2021 4:00 PM",128,65,63,426,192,234,492,217,275,404,186,218,,,,42,,,,35,34,1,35,178,76,102,105,123,14,9,19,12,7,,,
"Apr 24, 2021 5:00 PM",104,36,68,364,165,199,447,159,288,430,158,272,,,,27,,,,27,26,1,35,166,80,86,96,146,15,9,15,13,2,,,
"Apr 24, 2021 6:00 PM",105,52,53,195,71,124,266,68,198,186,56,130,,,,20,,,,21,21,0,30,133,76,57,42,145,8,8,5,4,1,,,
"Apr 24, 2021 7:00 PM",77,35,42,175,63,112,162,63,99,155,58,97,,,,16,,,,23,23,0,30,81,16,65,39,63,4,5,10,5,5,,,
"Apr 24, 2021 8:00 PM",51,29,22,83,33,50,105,31,74,78,30,48,,,,9,,,,14,14,0,19,49,17,32,26,41,8,3,2,1,1,,,
"Apr 24, 2021 9:00 PM",39,10,29,53,18,35,59,15,44,50,16,34,,,,6,,,,5,5,0,12,17,4,13,21,23,0,1,4,3,1,,,
"Apr 24, 2021 10:00 PM",25,11,14,20,9,11,41,11,30,25,5,20,,,,3,,,,8,8,0,10,12,1,11,12,17,1,0,4,3,1,,,
"Apr 24, 2021 11:00 PM",17,6,11,8,5,3,19,9,10,10,5,5,,,,3,,,,7,7,0,4,4,2,2,4,6,1,1,5,2,3,,,
"Apr 25, 2021 12:00 AM",13,7,6,0,0,0,6,1,5,5,0,5,,,,4,,,,0,0,0,6,3,1,2,3,6,0,0,2,1,1,,,
"Apr 25, 2021 1:00 AM",5,0,5,2,2,0,9,6,3,5,5,0,,,,0,,,,4,4,0,5,0,0,0,2,3,0,0,0,0,0,,,
"Apr 25, 2021 2:00 AM",5,1,4,2,1,1,5,2,3,2,2,0,,,,0,,,,4,4,0,5,0,0,0,1,2,0,1,0,0,0,,,
"Apr 25, 2021 3:00 AM",2,0,2,2,1,1,2,2,0,2,1,1,,,,0,,,,1,1,0,2,0,0,0,1,0,0,0,0,0,0,,,
"Apr 25, 2021 4:00 AM",2,1,1,0,0,0,2,1,1,0,0,0,,,,0,,,,1,1,0,0,0,0,0,1,3,0,0,0,0,0,,,
"Apr 25, 2021 5:00 AM",3,1,2,9,9,0,11,10,1,11,9,2,,,,0,,,,1,1,0,2,1,1,0,5,2,0,0,0,0,0,,,
"Apr 25, 2021 6:00 AM",6,3,3,15,9,6,22,14,8,14,10,4,,,,3,,,,1,1,0,3,12,9,3,11,8,0,0,0,0,0,,,
"Apr 25, 2021 7:00 AM",18,9,9,72,37,35,66,40,26,60,36,24,,,,6,,,,5,4,1,16,13,11,2,36,44,1,6,0,0,0,,,
"Apr 25, 2021 8:00 AM",31,18,13,166,121,45,168,113,55,139,100,39,,,,17,,,,10,10,0,21,48,28,20,64,43,4,9,7,2,5,,,
"Apr 25, 2021 9:00 AM",60,31,29,276,160,116,333,207,126,262,170,92,,,,19,,,,28,28,0,31,100,76,24,97,76,11,23,9,6,3,,,
"Apr 25, 2021 10:00 AM",89,46,43,421,243,178,496,294,202,419,258,161,,,,21,,,,25,24,1,28,135,80,55,157,117,9,21,6,3,3,,,
"Apr 25, 2021 11:00 AM",104,59,45,435,220,215,612,339,273,436,224,212,,,,27,,,,31,30,1,52,174,113,61,146,153,24,11,10,6,4,,,
"Apr 25, 2021 12:00 PM",117,53,64,444,227,217,580,289,291,400,217,183,,,,13,,,,28,28,0,49,183,109,74,155,148,26,15,16,9,7,,,
"Apr 25, 2021 1:00 PM",131,58,73,347,190,157,500,259,241,372,204,168,,,,30,,,,27,27,0,42,187,110,77,135,146,13,11,10,6,4,,,
"Apr 25, 2021 2:00 PM",92,50,42,399,211,188,490,257,233,403,226,177,,,,46,,,,36,35,1,54,181,121,60,130,125,16,10,24,19,5,,,
"Apr 25, 2021 3:00 PM",81,40,41,372,202,170,392,202,190,368,196,172,,,,38,,,,18,18,0,27,168,78,90,99,101,10,11,17,12,5,,,
"Apr 25, 2021 4:00 PM",93,43,50,342,173,169,365,171,194,349,151,198,,,,42,,,,20,20,0,30,155,66,89,89,122,4,10,9,6,3,,,
"Apr 25, 2021 5:00 PM",83,32,51,268,106,162,325,103,222,261,93,168,,,,30,,,,21,21,0,40,116,43,73,56,130,10,7,6,4,2,,,
"Apr 25, 2021 6:00 PM",64,30,34,123,51,72,191,51,140,146,35,111,,,,25,,,,15,14,1,28,72,34,38,36,85,5,5,15,10,5,,,
"Apr 25, 2021 7:00 PM",60,28,32,81,35,46,94,31,63,75,30,45,,,,15,,,,14,14,0,17,41,10,31,30,54,6,0,6,3,3,,,
"Apr 25, 2021 8:00 PM",39,23,16,39,22,17,55,22,33,41,21,20,,,,6,,,,7,7,0,16,27,8,19,26,24,2,2,3,0,3,,,
"Apr 25, 2021 9:00 PM",25,14,11,14,2,12,17,3,14,25,6,19,,,,10,,,,3,3,0,7,16,5,11,8,17,4,0,7,6,1,,,
"Apr 25, 2021 10:00 PM",10,5,5,4,3,1,12,3,9,6,2,4,,,,2,,,,6,6,0,3,2,1,1,5,12,0,2,2,0,2,,,
"Apr 25, 2021 11:00 PM",4,2,2,0,0,0,3,2,1,0,0,0,,,,2,,,,6,6,0,1,0,0,0,2,0,1,1,1,1,0,,,
"Apr 26, 2021 12:00 AM",3,1,2,0,0,0,0,0,0,0,0,0,,,,1,,,,1,1,0,2,0,0,0,0,1,0,0,0,0,0,,,
"Apr 26, 2021 1:00 AM",1,1,0,0,0,0,0,0,0,2,0,2,,,,1,,,,0,0,0,3,0,0,0,1,0,0,0,0,0,0,,,
"Apr 26, 2021 2:00 AM",1,1,0,0,0,0,1,1,0,1,1,0,,,,1,,,,1,1,0,0,0,0,0,0,0,0,0,0,0,0,,,
"Apr 26, 2021 3:00 AM",0,0,0,0,0,0,0,0,0,0,0,0,,,,0,,,,0,0,0,0,0,0,0,0,0,1,0,0,0,0,,,
"Apr 26, 2021 4:00 AM",0,0,0,0,0,0,1,1,0,0,0,0,,,,0,,,,0,0,0,1,1,0,1,0,1,0,0,0,0,0,,,
"Apr 26, 2021 5:00 AM",5,4,1,5,4,1,6,3,3,8,5,3,,,,1,,,,3,3,0,6,0,0,0,0,11,0,1,1,1,0,,,
"Apr 26, 2021 6:00 AM",39,25,14,38,20,18,37,20,17,37,21,16,,,,3,,,,4,4,0,16,17,9,8,24,32,1,2,2,2,0,,,
"Apr 26, 2021 7:00 AM",115,73,42,106,41,65,124,50,74,101,43,58,,,,15,,,,23,19,4,67,37,16,21,51,82,2,8,2,1,1,,,
"Apr 26, 2021 8:00 AM",185,122,63,153,59,94,221,73,148,179,79,100,,,,30,,,,46,46,0,93,113,43,70,43,138,8,6,21,19,2,,,
"Apr 26, 2021 9:00 AM",90,68,22,103,48,55,125,64,61,104,47,57,,,,9,,,,22,21,1,45,60,36,24,31,69,5,4,7,4,3,,,
"Apr 26, 2021 10:00 AM",50,31,19,97,55,42,136,85,51,109,69,40,,,,8,,,,7,5,2,30,61,40,21,33,30,5,2,6,3,3,,,
"Apr 26, 2021 11:00 AM",47,26,21,115,67,48,176,112,64,117,66,51,,,,10,,,,15,15,0,17,65,50,15,36,39,3,2,0,0,0,,,
"Apr 26, 2021 12:00 PM",84,43,41,158,88,70,219,120,99,127,70,57,,,,12,,,,16,16,0,36,81,55,26,63,34,4,5,6,5,1,,,
"Apr 26, 2021 1:00 PM",87,57,30,152,81,71,248,114,134,137,75,62,,,,20,,,,23,23,0,32,100,60,40,55,52,6,3,4,1,3,,,
"Apr 26, 2021 2:00 PM",95,47,48,154,89,65,192,104,88,140,82,58,,,,18,,,,16,16,0,22,81,63,18,57,55,6,4,7,6,1,,,
"Apr 26, 2021 3:00 PM",85,30,55,149,90,59,218,126,92,141,96,45,,,,17,,,,35,35,0,37,81,55,26,84,52,5,8,11,5,6,,,
"Apr 26, 2021 4:00 PM",129,51,78,191,122,69,216,127,89,198,122,76,,,,57,,,,61,60,1,29,110,52,58,99,97,11,2,8,6,2,,,
"Apr 26, 2021 5:00 PM",162,52,110,252,140,112,258,144,114,215,108,107,,,,31,,,,73,72,1,37,97,43,54,113,86,9,11,14,5,9,,,
"Apr 26, 2021 6:00 PM",139,53,86,287,167,120,335,193,142,283,164,119,,,,38,,,,58,58,0,37,138,86,52,128,103,11,4,10,7,3,,,
"Apr 26, 2021 7:00 PM",92,35,57,225,113,112,222,106,116,224,100,124,,,,43,,,,34,33,1,22,95,49,46,72,84,3,3,6,2,4,,,
"Apr 26, 2021 8:00 PM",62,21,41,110,37,73,138,42,96,97,28,69,,,,22,,,,32,32,0,17,51,12,39,31,64,4,5,11,9,2,,,
"Apr 26, 2021 9:00 PM",32,10,22,64,29,35,60,20,40,40,13,27,,,,2,,,,14,13,1,11,24,6,18,13,22,5,2,3,2,1,,,
"Apr 26, 2021 10:00 PM",12,3,9,10,3,7,19,5,14,18,9,9,,,,2,,,,4,4,0,5,8,5,3,5,12,1,0,0,0,0,,,
"Apr 26, 2021 11:00 PM",12,1,11,6,0,6,12,3,9,7,2,5,,,,1,,,,3,3,0,6,2,2,0,2,5,0,0,3,1,2,,,
"Apr 27, 2021 12:00 AM",4,1,3,0,0,0,0,0,0,0,0,0,,,,0,,,,2,2,0,1,2,0,2,2,2,1,0,0,0,0,,,
"Apr 27, 2021 1:00 AM",1,0,1,1,1,0,3,3,0,2,2,0,,,,0,,,,1,1,0,4,0,0,0,2,1,1,0,0,0,0,,,
"Apr 27, 2021 2:00 AM",1,1,0,0,0,0,0,0,0,0,0,0,,,,0,,,,0,0,0,1,0,0,0,0,0,0,0,0,0,0,,,
"Apr 27, 2021 3:00 AM",1,1,0,0,0,0,0,0,0,0,0,0,,,,0,,,,2,2,0,1,0,0,0,0,0,0,0,0,0,0,,,
"Apr 27, 2021 4:00 AM",1,1,0,0,0,0,0,0,0,0,0,0,,,,0,,,,0,0,0,1,0,0,0,0,1,0,0,0,0,0,,,
"Apr 27, 2021 5:00 AM",6,5,1,5,3,2,10,6,4,12,6,6,,,,0,,,,2,2,0,6,0,0,0,6,8,0,0,0,0,0,,,
"Apr 27, 2021 6:00 AM",39,27,12,56,35,21,44,26,18,48,30,18,,,,2,,,,4,4,0,21,13,10,3,15,35,1,1,2,2,0,,,
"Apr 27, 2021 7:00 AM",120,68,52,135,48,87,125,50,75,95,42,53,,,,19,,,,21,20,1,61,48,22,26,50,81,2,3,6,6,0,,,
"Apr 27, 2021 8:00 AM",162,110,52,112,37,75,182,55,127,144,54,90,,,,35,,,,39,38,1,89,89,28,61,52,133,9,7,30,23,7,,,
"Apr 27, 2021 9:00 AM",79,63,16,70,33,37,85,41,44,64,35,29,,,,10,,,,18,17,1,36,40,23,17,29,43,4,3,4,2,2,,,
"Apr 27, 2021 10:00 AM",57,35,22,51,22,29,59,30,29,51,34,17,,,,11,,,,8,6,2,25,25,14,11,31,29,3,4,1,0,1,,,
"Apr 27, 2021 11:00 AM",52,33,19,54,31,23,64,40,24,56,41,15,,,,11,,,,11,10,1,18,25,16,9,20,25,5,2,6,3,3,,,
"Apr 27, 2021 12:00 PM",37,22,15,73,35,38,80,40,40,63,31,32,,,,11,,,,16,16,0,10,29,16,13,25,27,6,2,3,1,2,,,
"Apr 27, 2021 1:00 PM",64,32,32,61,27,34,101,47,54,41,18,23,,,,10,,,,13,12,1,15,24,12,12,23,42,5,2,6,4,2,,,
"Apr 27, 2021 2:00 PM",49,25,24,56,32,24,86,46,40,63,37,26,,,,6,,,,10,10,0,10,23,16,7,26,32,2,5,7,4,3,,,
"Apr 27, 2021 3:00 PM",76,36,40,74,45,29,88,53,35,62,41,21,,,,14,,,,22,22,0,30,33,26,7,36,46,4,3,6,4,2,,,
"Apr 27, 2021 4:00 PM",121,43,78,72,43,29,92,62,30,71,50,21,,,,19,,,,32,32,0,21,57,42,15,53,53,2,1,4,1,3,,,
"Apr 27, 2021 5:00 PM",143,51,92,108,62,46,136,73,63,119,58,61,,,,26,,,,51,51,0,31,56,33,23,78,64,7,10,11,8,3,,,
"Apr 27, 2021 6:00 PM",136,43,93,115,74,41,142,77,65,127,70,57,,,,31,,,,57,56,1,20,58,36,22,79,57,7,5,7,4,3,,,
"Apr 27, 2021 7:00 PM",89,36,53,117,73,44,119,68,51,114,68,46,,,,21,,,,35,34,1,18,43,27,16,46,42,7,5,4,2,2,,,
"Apr 27, 2021 8:00 PM",51,15,36,44,25,19,47,28,19,43,21,22,,,,7,,,,17,17,0,12,19,13,6,27,20,4,1,5,4,1,,,
"Apr 27, 2021 9:00 PM",31,5,26,20,7,13,33,8,25,22,6,16,,,,6,,,,13,13,0,10,14,2,12,12,16,2,1,1,1,0,,,
"Apr 27, 2021 10:00 PM",15,6,9,5,2,3,6,3,3,10,3,7,,,,0,,,,3,3,0,8,4,2,2,5,9,0,0,0,0,0,,,
"Apr 27, 2021 11:00 PM",10,3,7,3,3,0,7,4,3,6,4,2,,,,0,,,,2,2,0,0,1,1,0,5,3,1,0,1,1,0,,,
"Apr 28, 2021 12:00 AM",1,0,1,0,0,0,1,0,1,2,0,2,,,,0,,,,2,1,1,0,0,0,0,0,2,0,0,0,0,0,,,
"Apr 28, 2021 1:00 AM",1,1,0,0,0,0,1,0,1,0,0,0,,,,2,,,,2,2,0,0,0,0,0,0,0,0,0,0,0,0,,,
"Apr 28, 2021 2:00 AM",1,1,0,0,0,0,0,0,0,0,0,0,,,,0,,,,0,0,0,1,0,0,0,1,0,0,0,0,0,0,,,
"Apr 28, 2021 3:00 AM",0,0,0,0,0,0,1,1,0,0,0,0,,,,0,,,,0,0,0,0,0,0,0,1,0,0,0,0,0,0,,,
"Apr 28, 2021 4:00 AM",0,0,0,0,0,0,1,1,0,0,0,0,,,,0,,,,0,0,0,0,0,0,0,0,2,0,0,0,0,0,,,
"Apr 28, 2021 5:00 AM",6,5,1,2,1,1,4,2,2,5,3,2,,,,0,,,,1,1,0,4,1,1,0,7,8,0,0,0,0,0,,,
"Apr 28, 2021 6:00 AM",39,24,15,26,15,11,27,17,10,21,15,6,,,,6,,,,7,7,0,13,11,9,2,10,31,0,4,3,2,1,,,
"Apr 28, 2021 7:00 AM",85,48,37,75,33,42,75,27,48,66,30,36,,,,14,,,,20,20,0,68,27,13,14,30,64,4,2,6,4,2,,,
"Apr 28, 2021 8:00 AM",177,121,56,68,18,50,136,47,89,108,39,69,,,,27,,,,34,33,1,78,55,19,36,54,102,8,5,21,20,1,,,
"Apr 28, 2021 9:00 AM",72,52,20,49,25,24,57,35,22,51,29,22,,,,9,,,,14,12,2,44,23,13,10,27,41,3,1,8,6,2,,,
"Apr 28, 2021 10:00 AM",66,47,19,45,27,18,59,36,23,50,32,18,,,,11,,,,11,10,1,13,18,9,9,24,40,2,1,1,1,0,,,
"Apr 28, 2021 11:00 AM",55,36,19,43,19,24,56,25,31,44,21,23,,,,9,,,,15,15,0,10,17,11,6,12,19,2,3,3,2,1,,,
"Apr 28, 2021 12:00 PM",49,25,24,43,28,15,71,40,31,49,29,20,,,,13,,,,13,13,0,21,24,9,15,28,27,4,3,4,3,1,,,
"Apr 28, 2021 1:00 PM",63,27,36,78,50,28,94,58,36,82,56,26,,,,15,,,,31,30,1,17,27,21,6,47,39,8,4,5,3,2,,,
"Apr 28, 2021 2:00 PM",60,21,39,46,26,20,65,38,27,54,34,20,,,,18,,,,17,14,3,23,23,16,7,16,29,4,3,8,3,5,,,
"Apr 28, 2021 3:00 PM",83,42,41,76,48,28,83,46,37,56,33,23,,,,16,,,,25,25,0,22,27,15,12,36,25,2,3,6,3,3,,,
"Apr 28, 2021 4:00 PM",107,41,66,59,39,20,89,60,29,58,41,17,,,,33,,,,33,31,2,15,33,21,12,39,37,3,8,3,2,1,,,
"Apr 28, 2021 5:00 PM",141,45,96,109,69,40,132,87,45,108,64,44,,,,24,,,,48,48,0,34,44,27,17,76,58,9,9,5,3,2,,,
"Apr 28, 2021 6:00 PM",130,50,80,150,100,50,173,114,59,165,110,55,,,,26,,,,47,47,0,26,62,37,25,90,68,4,12,8,3,5,,,
"Apr 28, 2021 7:00 PM",88,29,59,119,56,63,154,70,84,123,55,68,,,,24,,,,44,43,1,23,67,37,30,54,59,7,2,4,2,2,,,
"Apr 28, 2021 8:00 PM",52,22,30,79,35,44,88,32,56,78,29,49,,,,13,,,,20,20,0,17,36,16,20,38,48,8,1,3,1,2,,,
"Apr 28, 2021 9:00 PM",28,13,15,22,11,11,33,13,20,28,9,19,,,,4,,,,13,13,0,7,10,3,7,17,18,1,2,2,1,1,,,
"Apr 28, 2021 10:00 PM",18,5,13,9,3,6,15,6,9,8,3,5,,,,3,,,,3,3,0,4,4,4,0,7,7,2,0,1,1,0,,,
"Apr 28, 2021 11:00 PM",8,4,4,3,1,2,0,0,0,0,0,0,,,,1,,,,4,4,0,3,2,0,2,3,1,2,0,2,1,1,,,
"Apr 29, 2021 12:00 AM",3,1,2,0,0,0,3,2,1,4,2,2,,,,2,,,,5,5,0,2,1,1,0,0,2,2,0,2,1,1,,,
"Apr 29, 2021 1:00 AM",2,1,1,0,0,0,1,0,1,0,0,0,,,,1,,,,1,1,0,0,0,0,0,2,1,0,1,1,1,0,,,
"Apr 29, 2021 2:00 AM",3,3,0,0,0,0,0,0,0,0,0,0,,,,0,,,,1,1,0,0,0,0,0,1,0,0,0,0,0,0,,,
"Apr 29, 2021 3:00 AM",0,0,0,0,0,0,0,0,0,0,0,0,,,,2,,,,0,0,0,0,0,0,0,1,0,0,0,0,0,0,,,
"Apr 29, 2021 4:00 AM",1,1,0,0,0,0,2,2,0,0,0,0,,,,0,,,,0,0,0,0,0,0,0,1,3,0,0,0,0,0,,,
"Apr 29, 2021 5:00 AM",4,3,1,3,2,1,4,2,2,8,6,2,,,,0,,,,3,3,0,5,0,0,0,3,3,0,0,0,0,0,,,
"Apr 29, 2021 6:00 AM",36,22,14,42,26,16,43,25,18,41,24,17,,,,8,,,,7,7,0,17,9,7,2,19,29,0,2,1,1,0,,,
"Apr 29, 2021 7:00 AM",116,65,51,96,35,61,107,42,65,91,38,53,,,,24,,,,14,12,2,69,39,20,19,41,77,1,6,3,2,1,,,
"Apr 29, 2021 8:00 AM",178,114,64,134,52,82,182,54,128,141,54,87,,,,47,,,,38,38,0,75,85,26,59,53,113,8,5,23,19,4,,,
"Apr 29, 2021 9:00 AM",77,55,22,88,42,46,98,54,44,92,49,43,,,,14,,,,16,16,0,35,35,20,15,29,49,3,6,2,1,1,,,
"Apr 29, 2021 10:00 AM",49,35,14,54,20,34,71,33,38,53,29,24,,,,7,,,,4,4,0,30,27,16,11,23,29,4,3,6,6,0,,,
"Apr 29, 2021 11:00 AM",37,16,21,36,22,14,48,26,22,35,21,14,,,,4,,,,9,9,0,11,20,5,15,14,24,1,4,0,0,0,,,
"Apr 29, 2021 12:00 PM",48,23,25,71,35,36,88,51,37,52,28,24,,,,13,,,,12,11,1,15,28,20,8,31,33,1,1,2,2,0,,,
"Apr 29, 2021 1:00 PM",60,32,28,79,42,37,112,62,50,68,32,36,,,,12,,,,15,15,0,16,41,25,16,35,30,5,3,2,1,1,,,
"Apr 29, 2021 2:00 PM",76,37,39,77,35,42,106,48,58,81,38,43,,,,22,,,,17,17,0,18,68,41,27,32,43,7,3,10,5,5,,,
"Apr 29, 2021 3:00 PM",73,26,47,95,57,38,150,95,55,92,62,30,,,,19,,,,31,31,0,25,65,30,35,39,52,8,5,8,3,5,,,
"Apr 29, 2021 4:00 PM",96,38,58,100,57,43,120,78,42,99,62,37,,,,32,,,,39,37,2,37,67,43,24,58,48,11,5,10,5,5,,,
"Apr 29, 2021 5:00 PM",160,57,103,143,84,59,157,95,62,132,78,54,,,,38,,,,57,57,0,32,58,42,16,73,72,7,11,7,3,4,,,
"Apr 29, 2021 6:00 PM",142,48,94,144,85,59,157,89,68,138,71,67,,,,32,,,,52,52,0,45,79,45,34,82,60,10,4,10,6,4,,,
"Apr 29, 2021 7:00 PM",85,33,52,135,68,67,141,73,68,144,74,70,,,,20,,,,41,41,0,28,56,34,22,44,51,12,3,9,8,1,,,
"Apr 29, 2021 8:00 PM",72,30,42,97,54,43,94,46,48,80,38,42,,,,11,,,,18,18,0,16,32,19,13,38,29,5,3,9,8,1,,,
"Apr 29, 2021 9:00 PM",36,11,25,40,18,22,44,18,26,37,14,23,,,,3,,,,11,11,0,11,17,5,12,19,22,3,4,8,2,6,,,
"Apr 29, 2021 10:00 PM",19,2,17,27,14,13,26,8,18,24,11,13,,,,1,,,,12,12,0,10,9,3,6,9,14,1,1,2,0,2,,,
"Apr 29, 2021 11:00 PM",7,3,4,12,4,8,8,1,7,10,2,8,,,,1,,,,5,5,0,3,1,1,0,2,7,0,0,2,2,0,,,
"Apr 30, 2021 12:00 AM",5,1,4,0,0,0,0,0,0,0,0,0,,,,1,,,,4,4,0,1,1,1,0,5,3,1,0,1,1,0,,,
"Apr 30, 2021 1:00 AM",2,1,1,1,1,0,1,1,0,1,1,0,,,,0,,,,0,0,0,1,0,0,0,3,0,0,0,0,0,0,,,
"Apr 30, 2021 2:00 AM",3,1,2,0,0,0,0,0,0,0,0,0,,,,1,,,,1,1,0,0,0,0,0,0,0,0,0,0,0,0,,,
"Apr 30, 2021 3:00 AM",0,0,0,0,0,0,0,0,0,0,0,0,,,,0,,,,0,0,0,0,0,0,0,0,0,0,0,0,0,0,,,
"Apr 30, 2021 4:00 AM",2,1,1,0,0,0,4,4,0,2,2,0,,,,1,,,,1,1,0,1,1,0,1,2,1,0,1,0,0,0,,,
"Apr 30, 2021 5:00 AM",7,6,1,12,9,3,13,10,3,13,11,2,,,,1,,,,3,3,0,4,3,3,0,10,8,0,0,0,0,0,,,
"Apr 30, 2021 6:00 AM",29,18,11,40,22,18,40,23,17,39,24,15,,,,3,,,,7,6,1,13,10,7,3,16,34,0,4,1,1,0,,,
"Apr 30, 2021 7:00 AM",82,40,42,88,41,47,97,37,60,84,43,41,,,,10,,,,16,16,0,45,25,11,14,50,76,3,3,6,6,0,,,
"Apr 30, 2021 8:00 AM",166,101,65,121,40,81,151,50,101,116,44,72,,,,23,,,,29,28,1,86,46,13,33,51,83,5,2,11,11,0,,,
"Apr 30, 2021 9:00 AM",83,59,24,88,46,42,90,52,38,80,49,31,,,,16,,,,17,17,0,41,41,29,12,29,43,1,1,7,3,4,,,
"Apr 30, 2021 10:00 AM",50,30,20,76,30,46,77,37,40,72,34,38,,,,10,,,,11,9,2,20,29,15,14,17,38,1,6,0,0,0,,,
"Apr 30, 2021 11:00 AM",31,14,17,45,16,29,62,21,41,39,13,26,,,,3,,,,7,6,1,14,16,6,10,16,30,3,1,8,5,3,,,
"Apr 30, 2021 12:00 PM",50,30,20,39,21,18,60,35,25,42,23,19,,,,10,,,,11,11,0,16,28,17,11,23,10,4,2,8,4,4,,,
"Apr 30, 2021 1:00 PM",76,39,37,74,37,37,88,55,33,80,48,32,,,,13,,,,15,15,0,33,33,25,8,32,27,4,4,4,1,3,,,
"Apr 30, 2021 2:00 PM",83,47,36,76,44,32,118,60,58,85,57,28,,,,17,,,,20,18,2,32,45,34,11,40,34,1,3,11,8,3,,,
"Apr 30, 2021 3:00 PM",77,34,43,129,82,47,177,122,55,128,82,46,,,,20,,,,29,28,1,28,67,39,28,63,64,6,2,6,3,3,,,
"Apr 30, 2021 4:00 PM",125,43,82,143,77,66,173,96,77,128,73,55,,,,28,,,,43,42,1,26,62,43,19,75,67,7,6,4,2,2,,,
"Apr 30, 2021 5:00 PM",141,62,79,175,97,78,228,120,108,181,108,73,,,,49,,,,47,46,1,32,71,37,34,88,80,9,7,21,12,9,,,
"Apr 30, 2021 6:00 PM",126,43,83,146,87,59,185,119,66,135,85,50,,,,19,,,,36,35,1,29,81,41,40,92,70,7,4,4,4,0,,,
"Apr 30, 2021 7:00 PM",127,50,77,146,70,76,164,75,89,132,59,73,,,,18,,,,26,26,0,34,72,38,34,47,58,2,3,4,2,2,,,
"Apr 30, 2021 8:00 PM",42,17,25,101,54,47,112,50,62,86,44,42,,,,15,,,,18,18,0,13,48,21,27,40,52,2,1,9,5,4,,,
"Apr 30, 2021 9:00 PM",42,17,25,39,18,21,53,20,33,38,17,21,,,,4,,,,17,16,1,13,18,9,9,18,32,2,1,8,5,3,,,
"Apr 30, 2021 10:00 PM",21,11,10,18,8,10,30,13,17,20,7,13,,,,12,,,,5,5,0,9,16,5,11,8,15,1,0,2,1,1,,,
"Apr 30, 2021 11:00 PM",18,7,11,8,5,3,12,5,7,11,7,4,,,,2,,,,2,2,0,15,2,0,2,9,13,1,1,2,2,0,,,
"May 1, 2021 12:00 AM",9,4,5,0,0,0,1,0,1,4,2,2,,,,2,,,,6,6,0,3,1,0,1,8,4,0,0,0,0,0,,,
"May 1, 2021 1:00 AM",12,1,11,3,3,0,3,2,1,4,4,0,,,,1,,,,3,3,0,1,2,0,2,3,1,0,0,0,0,0,,,
"May 1, 2021 2:00 AM",3,1,2,0,0,0,2,2,0,0,0,0,,,,1,,,,5,5,0,0,1,1,0,2,0,0,0,0,0,0,,,
"May 1, 2021 3:00 AM",3,1,2,0,0,0,1,1,0,0,0,0,,,,0,,,,0,0,0,0,0,0,0,2,0,0,0,0,0,0,,,
"May 1, 2021 4:00 AM",2,2,0,0,0,0,3,3,0,2,2,0,,,,0,,,,1,1,0,1,0,0,0,3,0,0,0,0,0,0,,,
"May 1, 2021 5:00 AM",3,1,2,2,1,1,4,4,0,2,2,0,,,,1,,,,1,1,0,1,1,1,0,7,0,0,0,0,0,0,,,
"May 1, 2021 6:00 AM",7,4,3,6,5,1,11,8,3,10,7,3,,,,3,,,,2,2,0,4,5,5,0,8,11,0,1,0,0,0,,,
"May 1, 2021 7:00 AM",24,7,17,47,27,20,51,34,17,50,32,18,,,,3,,,,4,4,0,24,11,6,5,23,21,3,1,1,1,0,,,
"May 1, 2021 8:00 AM",35,14,21,90,61,29,84,56,28,77,54,23,,,,8,,,,10,9,1,17,26,19,7,32,28,5,6,4,4,0,,,
"May 1, 2021 9:00 AM",65,36,29,190,127,63,169,108,61,180,128,52,,,,10,,,,17,17,0,23,52,33,19,89,36,6,10,1,0,1,,,
"May 1, 2021 10:00 AM",85,36,49,253,134,119,215,123,92,235,124,111,,,,22,,,,11,11,0,25,61,40,21,92,86,4,13,4,4,0,,,
"May 1, 2021 11:00 AM",85,47,38,283,155,128,266,166,100,238,147,91,,,,35,,,,27,26,1,34,121,90,31,97,103,14,10,7,5,2,,,
"May 1, 2021 12:00 PM",101,59,42,310,132,178,292,132,160,285,126,159,,,,25,,,,38,38,0,52,110,60,50,81,89,23,10,17,13,4,,,
"May 1, 2021 1:00 PM",101,58,43,233,134,99,283,156,127,220,130,90,,,,24,,,,35,32,3,43,114,68,46,96,124,13,7,13,9,4,,,
"May 1, 2021 2:00 PM",89,51,38,252,116,136,292,157,135,236,130,106,,,,25,,,,16,16,0,39,87,53,34,91,86,11,5,12,9,3,,,
"May 1, 2021 3:00 PM",75,40,35,253,131,122,262,128,134,213,106,107,,,,44,,,,27,26,1,46,89,51,38,64,79,10,11,8,6,2,,,
"May 1, 2021 4:00 PM",73,32,41,222,123,99,271,130,141,203,96,107,,,,33,,,,33,33,0,20,104,47,57,69,72,16,10,16,14,2,,,
"May 1, 2021 5:00 PM",83,48,35,175,72,103,214,82,132,147,59,88,,,,24,,,,13,13,0,37,71,26,45,51,85,12,6,4,2,2,,,
"May 1, 2021 6:00 PM",85,33,52,157,77,80,180,66,114,148,58,90,,,,16,,,,25,24,1,18,83,30,53,36,69,5,8,6,3,3,,,
"May 1, 2021 7:00 PM",58,27,31,101,49,52,101,31,70,89,31,58,,,,18,,,,13,13,0,17,55,17,38,23,50,3,6,2,2,0,,,
"May 1, 2021 8:00 PM",40,21,19,76,30,46,62,28,34,47,15,32,,,,11,,,,14,14,0,12,32,20,12,19,32,3,2,4,3,1,,,
"May 1, 2021 9:00 PM",20,8,12,44,25,19,41,14,27,32,11,21,,,,7,,,,10,10,0,12,10,6,4,11,18,4,1,2,2,0,,,
"May 1, 2021 10:00 PM",29,11,18,22,14,8,26,11,15,12,6,6,,,,1,,,,6,6,0,9,7,2,5,6,15,2,1,2,1,1,,,
"May 1, 2021 11:00 PM",17,2,15,10,9,1,14,2,12,13,3,10,,,,1,,,,12,12,0,2,3,1,2,3,9,1,3,3,1,2,,,
"May 2, 2021 12:00 AM",13,3,10,0,0,0,0,0,0,7,6,1,,,,6,,,,3,3,0,3,3,1,2,5,6,0,1,4,3,1,,,
"May 2, 2021 1:00 AM",4,1,3,1,1,0,4,2,2,5,4,1,,,,1,,,,1,1,0,3,3,2,1,4,4,1,0,0,0,0,,,
"May 2, 2021 2:00 AM",4,3,1,0,0,0,1,1,0,2,2,0,,,,1,,,,1,1,0,1,0,0,0,3,3,0,0,1,0,1,,,
"May 2, 2021 3:00 AM",3,1,2,0,0,0,0,0,0,0,0,0,,,,3,,,,2,2,0,1,0,0,0,0,1,0,0,0,0,0,,,
"May 2, 2021 4:00 AM",1,0,1,1,1,0,3,3,0,1,1,0,,,,0,,,,0,0,0,0,1,1,0,2,0,0,0,0,0,0,,,
"May 2, 2021 5:00 AM",0,0,0,1,1,0,8,6,2,4,3,1,,,,0,,,,3,3,0,2,2,2,0,2,3,0,0,0,0,0,,,
"May 2, 2021 6:00 AM",1,1,0,12,8,4,22,14,8,19,12,7,,,,4,,,,1,1,0,4,7,6,1,10,7,0,0,0,0,0,,,
"May 2, 2021 7:00 AM",15,6,9,60,36,24,53,33,20,49,34,15,,,,2,,,,4,3,1,12,15,10,5,17,20,0,3,2,0,2,,,
"May 2, 2021 8:00 AM",28,8,20,118,84,34,103,67,36,103,72,31,,,,7,,,,8,8,0,12,24,14,10,45,44,5,11,1,1,0,,,
"May 2, 2021 9:00 AM",53,23,30,239,160,79,236,165,71,221,163,58,,,,12,,,,13,12,1,27,76,53,23,91,49,11,22,8,6,2,,,
"May 2, 2021 10:00 AM",96,58,38,394,223,171,328,212,116,338,211,127,,,,26,,,,14,14,0,37,134,94,40,104,82,13,29,15,8,7,,,
"May 2, 2021 11:00 AM",81,35,46,424,218,206,378,205,173,378,199,179,,,,27,,,,16,13,3,51,138,81,57,128,115,17,18,12,8,4,,,
"May 2, 2021 12:00 PM",98,46,52,350,159,191,403,198,205,353,165,188,,,,37,,,,23,22,1,23,176,88,88,109,115,17,5,12,9,3,,,
"May 2, 2021 1:00 PM",113,51,62,301,167,134,395,186,209,323,177,146,,,,28,,,,25,25,0,45,143,96,47,108,97,15,7,9,6,3,,,
"May 2, 2021 2:00 PM",80,41,39,335,192,143,330,201,129,274,155,119,,,,51,,,,21,21,0,26,157,92,65,112,83,15,4,10,5,5,,,
"May 2, 2021 3:00 PM",78,42,36,259,118,141,314,155,159,266,134,132,,,,28,,,,24,22,2,33,115,67,48,98,75,3,6,3,1,2,,,
"May 2, 2021 4:00 PM",64,34,30,204,100,104,251,97,154,199,85,114,,,,26,,,,27,25,2,44,119,48,71,54,62,2,4,6,4,2,,,
"May 2, 2021 5:00 PM",56,34,22,205,94,111,281,131,150,193,78,115,,,,21,,,,16,16,0,25,108,54,54,56,96,9,4,7,5,2,,,
"May 2, 2021 6:00 PM",62,42,20,133,63,70,170,45,125,114,44,70,,,,14,,,,17,17,0,23,83,32,51,23,60,5,3,3,2,1,,,
"May 2, 2021 7:00 PM",59,28,31,64,30,34,110,40,70,54,26,28,,,,14,,,,8,8,0,24,51,14,37,19,38,1,1,4,3,1,,,
"May 2, 2021 8:00 PM",23,10,13,63,33,30,77,33,44,62,27,35,,,,9,,,,11,11,0,10,29,14,15,22,42,2,0,5,3,2,,,
"May 2, 2021 9:00 PM",31,11,20,23,8,15,22,12,10,21,8,13,,,,4,,,,7,7,0,11,21,10,11,7,17,3,2,2,2,0,,,
"May 2, 2021 10:00 PM",22,9,13,22,7,15,19,7,12,9,5,4,,,,0,,,,9,9,0,12,8,2,6,9,12,5,0,1,0,1,,,
"May 2, 2021 11:00 PM",14,4,10,15,8,7,18,10,8,20,10,10,,,,2,,,,6,6,0,2,3,1,2,4,11,2,1,0,0,0,,,
"May 3, 2021 12:00 AM",6,1,5,1,1,0,1,0,1,3,1,2,,,,2,,,,3,3,0,3,0,0,0,2,1,0,0,0,0,0,,,
"May 3, 2021 1:00 AM",1,0,1,0,0,0,2,0,2,3,0,3,,,,2,,,,2,2,0,0,1,0,1,2,3,0,1,0,0,0,,,
"May 3, 2021 2:00 AM",1,0,1,4,3,1,1,0,1,4,4,0,,,,2,,,,3,3,0,1,0,0,0,1,1,0,2,0,0,0,,,
"May 3, 2021 3:00 AM",1,0,1,0,0,0,3,0,3,4,0,4,,,,0,,,,1,1,0,0,1,1,0,1,3,0,0,0,0,0,,,
"May 3, 2021 4:00 AM",1,0,1,0,0,0,1,1,0,0,0,0,,,,0,,,,0,0,0,0,0,0,0,0,1,0,0,0,0,0,,,
"May 3, 2021 5:00 AM",1,0,1,4,4,0,8,8,0,5,4,1,,,,1,,,,1,1,0,1,0,0,0,4,3,0,0,0,0,0,,,
"May 3, 2021 6:00 AM",10,7,3,6,2,4,12,6,6,8,4,4,,,,0,,,,1,1,0,1,6,3,3,5,10,0,1,1,1,0,,,
"May 3, 2021 7:00 AM",13,5,8,13,5,8,18,8,10,14,7,7,,,,4,,,,4,4,0,3,3,2,1,10,9,0,0,0,0,0,,,
"May 3, 2021 8:00 AM",7,2,5,4,0,4,7,2,5,4,2,2,,,,1,,,,3,3,0,4,2,1,1,5,5,0,1,0,0,0,,,
"May 3, 2021 9:00 AM",13,8,5,8,7,1,11,6,5,9,5,4,,,,5,,,,3,3,0,3,4,4,0,7,4,1,2,0,0,0,,,
"May 3, 2021 10:00 AM",14,8,6,13,8,5,18,8,10,11,5,6,,,,1,,,,4,4,0,5,7,6,1,3,5,0,0,0,0,0,,,
"May 3, 2021 11:00 AM",16,4,12,15,8,7,18,8,10,13,9,4,,,,2,,,,2,2,0,5,3,1,2,6,7,0,0,0,0,0,,,
"May 3, 2021 12:00 PM",6,4,2,18,4,14,16,4,12,11,2,9,,,,0,,,,4,4,0,3,7,4,3,6,4,2,0,0,0,0,,,
"May 3, 2021 1:00 PM",8,2,6,20,13,7,13,6,7,10,5,5,,,,1,,,,5,5,0,3,10,4,6,4,3,2,0,4,2,2,,,
"May 3, 2021 2:00 PM",9,8,1,17,8,9,15,7,8,13,6,7,,,,4,,,,3,3,0,5,11,9,2,6,11,0,0,6,6,0,,,
"May 3, 2021 3:00 PM",33,16,17,42,27,15,47,34,13,34,26,8,,,,6,,,,5,5,0,8,14,9,5,16,17,2,3,2,1,1,,,
"May 3, 2021 4:00 PM",44,19,25,84,46,38,81,43,38,59,30,29,,,,11,,,,15,13,2,13,24,14,10,19,21,2,2,5,3,2,,,
"May 3, 2021 5:00 PM",34,14,20,62,28,34,76,30,46,51,24,27,,,,17,,,,9,9,0,11,17,7,10,12,17,1,0,2,1,1,,,
"May 3, 2021 6:00 PM",24,13,11,27,14,13,35,20,15,31,15,16,,,,8,,,,6,6,0,8,16,9,7,15,12,0,1,8,3,5,,,
"May 3, 2021 7:00 PM",31,14,17,19,7,12,33,14,19,21,11,10,,,,2,,,,3,2,1,4,12,5,7,12,9,1,0,4,3,1,,,
"May 3, 2021 8:00 PM",13,3,10,18,8,10,7,2,5,4,1,3,,,,1,,,,3,3,0,9,3,1,2,4,9,0,0,3,1,2,,,
"May 3, 2021 9:00 PM",9,4,5,2,2,0,4,0,4,1,0,1,,,,2,,,,2,2,0,6,3,2,1,3,2,0,0,0,0,0,,,
"May 3, 2021 10:00 PM",7,4,3,1,1,0,2,1,1,2,2,0,,,,2,,,,1,1,0,2,0,0,0,3,6,3,0,0,0,0,,,
"May 3, 2021 11:00 PM",4,1,3,0,0,0,0,0,0,1,0,1,,,,1,,,,0,0,0,0,0,0,0,1,3,0,0,0,0,0,,,
"May 4, 2021 12:00 AM",2,0,2,0,0,0,0,0,0,0,0,0,,,,0,,,,0,0,0,0,1,1,0,0,0,0,0,0,0,0,,,
"May 4, 2021 1:00 AM",0,0,0,0,0,0,0,0,0,0,0,0,,,,0,,,,3,3,0,1,0,0,0,0,2,0,0,0,0,0,,,
"May 4, 2021 2:00 AM",2,1,1,0,0,0,0,0,0,0,0,0,,,,0,,,,0,0,0,0,1,0,1,0,0,0,0,0,0,0,,,
"May 4, 2021 3:00 AM",0,0,0,0,0,0,1,1,0,0,0,0,,,,0,,,,0,0,0,0,0,0,0,1,0,0,0,0,0,0,,,
"May 4, 2021 4:00 AM",1,1,0,0,0,0,0,0,0,0,0,0,,,,0,,,,0,0,0,0,0,0,0,0,2,0,0,0,0,0,,,
"May 4, 2021 5:00 AM",4,4,0,3,3,0,9,7,2,8,7,1,,,,0,,,,1,1,0,6,3,3,0,2,4,0,0,1,1,0,,,
"May 4, 2021 6:00 AM",29,16,13,25,11,14,20,12,8,18,10,8,,,,0,,,,4,4,0,15,5,5,0,17,30,2,0,2,2,0,,,
"May 4, 2021 7:00 AM",100,56,44,69,32,37,77,32,45,68,33,35,,,,9,,,,14,14,0,59,23,13,10,29,69,1,4,5,5,0,,,
"May 4, 2021 8:00 AM",128,98,30,92,29,63,111,36,75,100,40,60,,,,19,,,,14,14,0,59,52,15,37,41,91,8,5,12,12,0,,,
"May 4, 2021 9:00 AM",70,53,17,55,26,29,82,42,40,60,31,29,,,,7,,,,14,13,1,43,31,16,15,26,52,1,2,4,4,0,,,
"May 4, 2021 10:00 AM",29,20,9,51,23,28,72,35,37,70,39,31,,,,6,,,,12,9,3,15,30,14,16,31,26,1,3,1,1,0,,,
"May 4, 2021 11:00 AM",43,25,18,52,27,25,58,31,27,56,30,26,,,,18,,,,12,11,1,19,18,11,7,20,21,1,7,1,0,1,,,
"May 4, 2021 12:00 PM",31,21,10,57,29,28,56,25,31,62,27,35,,,,17,,,,10,9,1,16,24,14,10,21,22,7,3,4,2,2,,,
"May 4, 2021 1:00 PM",42,18,24,45,33,12,70,42,28,52,35,17,,,,20,,,,16,16,0,16,30,17,13,23,24,7,6,5,3,2,,,
"May 4, 2021 2:00 PM",50,24,26,29,14,15,36,21,15,34,20,14,,,,11,,,,10,9,1,7,19,12,7,28,20,3,2,1,0,1,,,
"May 4, 2021 3:00 PM",54,24,30,31,23,8,56,39,17,42,28,14,,,,12,,,,19,17,2,6,18,15,3,34,24,6,3,4,3,1,,,
"May 4, 2021 4:00 PM",77,20,57,83,48,35,75,44,31,78,44,34,,,,19,,,,22,22,0,19,33,21,12,47,40,5,0,6,1,5,,,
"May 4, 2021 5:00 PM",135,41,94,47,33,14,68,35,33,63,32,31,,,,8,,,,62,61,1,18,22,14,8,52,48,3,3,3,2,1,,,
"May 4, 2021 6:00 PM",102,32,70,53,33,20,68,48,20,57,35,22,,,,13,,,,34,33,1,22,27,23,4,57,42,2,0,4,2,2,,,
"May 4, 2021 7:00 PM",68,24,44,55,31,24,68,37,31,48,29,19,,,,8,,,,21,19,2,11,29,21,8,34,23,1,2,1,1,0,,,
"May 4, 2021 8:00 PM",52,17,35,29,15,14,40,21,19,25,13,12,,,,13,,,,14,13,1,9,19,11,8,18,11,2,1,1,0,1,,,
"May 4, 2021 9:00 PM",17,5,12,16,9,7,19,6,13,15,8,7,,,,8,,,,7,6,1,4,11,5,6,10,8,2,1,3,3,0,,,
"May 4, 2021 10:00 PM",5,1,4,6,5,1,6,4,2,6,4,2,,,,1,,,,4,4,0,3,2,1,1,2,7,0,0,2,0,2,,,
"May 4, 2021 11:00 PM",7,2,5,4,2,2,6,3,3,4,2,2,,,,0,,,,3,3,0,2,0,0,0,0,0,1,0,2,2,0,,,
"May 5, 2021 12:00 AM",5,1,4,0,0,0,0,0,0,0,0,0,,,,0,,,,3,3,0,1,0,0,0,2,1,1,0,0,0,0,,,
"May 5, 2021 1:00 AM",0,0,0,0,0,0,0,0,0,0,0,0,,,,0,,,,0,0,0,0,0,0,0,1,0,0,0,0,0,0,,,
"May 5, 2021 2:00 AM",1,1,0,0,0,0,0,0,0,0,0,0,,,,0,,,,0,0,0,0,0,0,0,0,1,0,0,0,0,0,,,
"May 5, 2021 3:00 AM",0,0,0,0,0,0,1,1,0,0,0,0,,,,0,,,,0,0,0,0,0,0,0,1,0,0,0,0,0,0,,,
"May 5, 2021 4:00 AM",1,1,0,0,0,0,0,0,0,0,0,0,,,,0,,,,0,0,0,0,0,0,0,0,1,0,0,0,0,0,,,
"May 5, 2021 5:00 AM",4,3,1,3,1,2,10,6,4,7,4,3,,,,0,,,,2,2,0,4,1,1,0,2,5,0,1,1,1,0,,,
"May 5, 2021 6:00 AM",38,24,14,39,23,16,46,30,16,34,21,13,,,,6,,,,9,9,0,11,9,3,6,14,36,0,0,3,3,0,,,
"May 5, 2021 7:00 AM",104,67,37,78,33,45,116,47,69,73,37,36,,,,4,,,,20,18,2,51,32,14,18,53,82,2,2,6,4,2,,,
"May 5, 2021 8:00 AM",158,102,56,116,43,73,166,64,102,143,55,88,,,,30,,,,38,36,2,90,70,25,45,56,118,8,5,14,9,5,,,
"May 5, 2021 9:00 AM",82,59,23,123,74,49,151,95,56,112,67,45,,,,17,,,,19,15,4,42,44,26,18,29,50,0,8,1,0,1,,,
"May 5, 2021 10:00 AM",47,26,21,78,41,37,114,66,48,79,51,28,,,,9,,,,18,17,1,24,29,21,8,26,41,5,8,3,0,3,,,
"May 5, 2021 11:00 AM",47,30,17,77,38,39,79,33,46,68,37,31,,,,13,,,,17,16,1,18,26,14,12,23,25,7,2,1,1,0,,,
"May 5, 2021 12:00 PM",55,26,29,94,28,66,101,25,76,92,22,70,,,,11,,,,15,13,2,18,26,7,19,15,36,5,5,6,6,0,,,
"May 5, 2021 1:00 PM",57,30,27,63,41,22,81,51,30,67,44,23,,,,9,,,,17,15,2,13,42,30,12,47,30,4,3,4,2,2,,,
"May 5, 2021 2:00 PM",51,20,31,34,23,11,43,27,16,36,28,8,,,,12,,,,18,15,3,15,23,14,9,19,28,1,2,5,2,3,,,
"May 5, 2021 3:00 PM",70,27,43,33,22,11,55,30,25,38,21,17,,,,25,,,,17,12,5,22,27,15,12,26,32,1,2,4,1,3,,,
"May 5, 2021 4:00 PM",99,38,61,60,32,28,62,39,23,56,29,27,,,,10,,,,19,19,0,11,29,19,10,46,42,7,2,4,3,1,,,
"May 5, 2021 5:00 PM",117,33,84,23,16,7,60,27,33,43,22,21,,,,11,,,,54,52,2,28,25,16,9,48,44,3,3,5,2,3,,,
"May 5, 2021 6:00 PM",94,46,48,46,37,9,72,49,23,45,27,18,,,,6,,,,36,35,1,23,39,33,6,57,48,2,4,4,2,2,,,
"May 5, 2021 7:00 PM",62,26,36,43,25,18,65,36,29,41,22,19,,,,13,,,,24,24,0,10,24,17,7,35,31,4,0,4,3,1,,,
"May 5, 2021 8:00 PM",31,6,25,21,9,12,30,14,16,25,14,11,,,,3,,,,16,15,1,4,18,10,8,12,17,0,1,1,0,1,,,
"May 5, 2021 9:00 PM",19,7,12,12,5,7,24,10,14,18,8,10,,,,0,,,,7,7,0,5,6,3,3,9,12,1,0,7,5,2,,,
"May 5, 2021 10:00 PM",14,8,6,8,4,4,5,3,2,6,3,3,,,,5,,,,7,6,1,0,4,2,2,11,3,0,0,0,0,0,,,
"May 5, 2021 11:00 PM",5,1,4,6,4,2,1,1,0,1,1,0,,,,1,,,,5,5,0,3,3,1,2,0,1,1,0,1,1,0,,,
"May 6, 2021 12:00 AM",3,1,2,0,0,0,0,0,0,1,1,0,,,,0,,,,3,3,0,1,0,0,0,3,0,1,0,0,0,0,,,
"May 6, 2021 1:00 AM",1,0,1,0,0,0,0,0,0,0,0,0,,,,0,,,,0,0,0,0,0,0,0,1,1,0,0,0,0,0,,,
"May 6, 2021 2:00 AM",1,0,1,0,0,0,0,0,0,0,0,0,,,,1,,,,0,0,0,0,0,0,0,2,0,0,0,2,2,0,,,
"May 6, 2021 3:00 AM",1,0,1,0,0,0,0,0,0,0,0,0,,,,0,,,,0,0,0,0,1,0,1,1,0,0,0,0,0,0,,,
"May 6, 2021 4:00 AM",0,0,0,0,0,0,0,0,0,0,0,0,,,,0,,,,0,0,0,0,0,0,0,0,2,0,0,0,0,0,,,
"May 6, 2021 5:00 AM",2,1,1,4,3,1,7,6,1,8,7,1,,,,0,,,,2,2,0,4,0,0,0,2,5,0,0,0,0,0,,,
"May 6, 2021 6:00 AM",34,21,13,33,17,16,38,23,15,31,16,15,,,,5,,,,8,8,0,15,6,4,2,17,33,0,1,1,1,0,,,
"May 6, 2021 7:00 AM",93,48,45,83,32,51,107,48,59,78,33,45,,,,11,,,,20,17,3,53,45,23,22,49,71,5,4,6,5,1,,,
"May 6, 2021 8:00 AM",180,113,67,149,52,97,252,95,157,166,67,99,,,,27,,,,38,33,5,84,97,38,59,53,127,9,4,18,16,2,,,
"May 6, 2021 9:00 AM",87,59,28,126,68,58,144,75,69,123,70,53,,,,11,,,,23,18,5,38,50,28,22,34,51,2,2,2,2,0,,,
"May 6, 2021 10:00 AM",55,36,19,83,36,47,87,45,42,67,37,30,,,,13,,,,6,4,2,24,40,28,12,28,33,1,3,1,0,1,,,
"May 6, 2021 11:00 AM",50,19,31,76,36,40,125,61,64,79,42,37,,,,14,,,,15,13,2,19,34,17,17,21,41,1,1,5,3,2,,,
"May 6, 2021 12:00 PM",61,32,29,139,69,70,145,60,85,117,63,54,,,,15,,,,17,15,2,15,55,31,24,27,50,16,10,2,2,0,,,
"May 6, 2021 1:00 PM",70,40,30,107,56,51,93,43,50,75,40,35,,,,22,,,,21,18,3,17,34,19,15,28,33,5,2,6,5,1,,,
"May 6, 2021 2:00 PM",59,32,27,103,49,54,130,85,45,109,72,37,,,,16,,,,19,17,2,14,44,24,20,40,24,1,4,6,5,1,,,
"May 6, 2021 3:00 PM",70,25,45,84,53,31,118,79,39,94,45,49,,,,25,,,,36,31,5,22,58,44,14,46,51,4,7,11,8,3,,,
"May 6, 2021 4:00 PM",109,42,67,107,61,46,126,72,54,105,58,47,,,,41,,,,39,35,4,26,53,39,14,59,54,4,5,6,2,4,,,
"May 6, 2021 5:00 PM",138,45,93,114,71,43,141,76,65,112,64,48,,,,24,,,,66,64,2,33,58,36,22,93,68,9,4,9,4,5,,,
"May 6, 2021 6:00 PM",136,48,88,159,95,64,165,91,74,152,87,65,,,,27,,,,55,55,0,41,71,51,20,90,68,4,6,7,4,3,,,
"May 6, 2021 7:00 PM",95,41,54,122,70,52,171,89,82,130,77,53,,,,16,,,,39,39,0,25,59,38,21,54,58,9,5,6,3,3,,,
"May 6, 2021 8:00 PM",74,26,48,102,52,50,121,61,60,96,50,46,,,,8,,,,27,25,2,16,48,27,21,43,42,6,3,6,5,1,,,
"May 6, 2021 9:00 PM",40,19,21,52,24,28,58,23,35,50,23,27,,,,4,,,,13,13,0,15,20,5,15,15,32,5,1,2,2,0,,,
"May 6, 2021 10:00 PM",15,4,11,13,7,6,18,7,11,14,7,7,,,,4,,,,5,5,0,8,8,1,7,9,20,0,0,0,0,0,,,
"May 6, 2021 11:00 PM",4,1,3,2,0,2,2,1,1,2,0,2,,,,0,,,,0,0,0,2,0,0,0,5,3,0,0,2,1,1,,,
"May 7, 2021 12:00 AM",6,2,4,0,0,0,0,0,0,0,0,0,,,,1,,,,2,2,0,1,0,0,0,1,0,2,0,2,2,0,,,
"May 7, 2021 1:00 AM",1,0,1,1,0,1,0,0,0,0,0,0,,,,1,,,,2,2,0,1,0,0,0,2,0,0,0,0,0,0,,,
"May 7, 2021 2:00 AM",5,3,2,0,0,0,0,0,0,0,0,0,,,,0,,,,0,0,0,1,0,0,0,1,0,1,1,1,1,0,,,
"May 7, 2021 3:00 AM",1,0,1,1,1,0,0,0,0,0,0,0,,,,0,,,,0,0,0,0,2,1,1,0,0,0,0,0,0,0,,,
"May 7, 2021 4:00 AM",3,1,2,0,0,0,1,1,0,0,0,0,,,,0,,,,0,0,0,1,0,0,0,1,2,0,0,0,0,0,,,
"May 7, 2021 5:00 AM",6,5,1,7,5,2,13,12,1,11,10,1,,,,0,,,,1,1,0,8,3,3,0,5,4,0,1,0,0,0,,,
"May 7, 2021 6:00 AM",31,19,12,50,22,28,56,32,24,41,23,18,,,,3,,,,6,6,0,18,11,7,4,15,43,3,2,3,2,1,,,
"May 7, 2021 7:00 AM",91,48,43,94,38,56,144,61,83,94,40,54,,,,8,,,,17,16,1,54,50,26,24,57,75,2,4,6,5,1,,,
"May 7, 2021 8:00 AM",172,118,54,158,64,94,246,93,153,182,77,105,,,,15,,,,43,35,8,73,84,33,51,54,134,9,4,18,15,3,,,
"May 7, 2021 9:00 AM",93,54,39,105,53,52,130,68,62,101,55,46,,,,9,,,,22,19,3,33,63,36,27,36,59,4,6,8,5,3,,,
"May 7, 2021 10:00 AM",64,38,26,130,72,58,168,102,66,128,84,44,,,,20,,,,11,9,2,21,58,40,18,45,55,3,6,8,5,3,,,
"May 7, 2021 11:00 AM",70,38,32,147,78,69,175,95,80,123,70,53,,,,12,,,,17,15,2,19,62,32,30,44,56,8,2,4,2,2,,,
"May 7, 2021 12:00 PM",78,42,36,132,68,64,186,89,97,117,64,53,,,,21,,,,23,22,1,19,47,22,25,48,38,7,4,9,6,3,,,
"May 7, 2021 1:00 PM",95,49,46,153,68,85,203,89,114,159,72,87,,,,16,,,,25,19,6,27,78,47,31,53,53,6,9,5,3,2,,,
"May 7, 2021 2:00 PM",85,48,37,111,60,51,132,67,65,96,60,36,,,,22,,,,22,17,5,18,39,24,15,54,56,8,4,7,4,3,,,
"May 7, 2021 3:00 PM",97,37,60,98,56,42,140,88,52,101,60,41,,,,17,,,,27,24,3,31,59,43,16,55,44,7,6,7,6,1,,,
"May 7, 2021 4:00 PM",119,44,75,198,114,84,195,132,63,177,108,69,,,,22,,,,35,31,4,24,61,36,25,75,67,8,6,12,9,3,,,
"May 7, 2021 5:00 PM",160,66,94,145,83,62,161,87,74,130,76,54,,,,17,,,,58,56,2,46,55,34,21,83,73,7,13,9,5,4,,,
"May 7, 2021 6:00 PM",119,56,63,132,69,63,190,117,73,133,70,63,,,,23,,,,47,45,2,33,62,38,24,100,52,10,8,2,2,0,,,
"May 7, 2021 7:00 PM",103,53,50,124,66,58,136,61,75,106,51,55,,,,14,,,,31,25,6,27,55,37,18,51,50,5,3,10,5,5,,,
"May 7, 2021 8:00 PM",72,41,31,66,29,37,99,38,61,60,22,38,,,,8,,,,15,13,2,14,33,18,15,30,43,2,1,3,1,2,,,
"May 7, 2021 9:00 PM",42,16,26,25,13,12,51,15,36,35,9,26,,,,4,,,,8,7,1,16,15,2,13,13,30,2,2,2,2,0,,,
"May 7, 2021 10:00 PM",29,7,22,16,7,9,21,8,13,16,8,8,,,,10,,,,8,8,0,6,12,4,8,10,21,0,1,2,2,0,,,
"May 7, 2021 11:00 PM",21,4,17,4,2,2,7,1,6,3,1,2,,,,3,,,,4,4,0,3,3,1,2,6,7,1,0,2,1,1,,,
"May 8, 2021 12:00 AM",8,1,7,0,0,0,1,1,0,5,0,5,,,,4,,,,4,4,0,2,3,1,2,4,6,2,1,0,0,0,,,
"May 8, 2021 1:00 AM",7,3,4,0,0,0,2,1,1,2,2,0,,,,1,,,,1,1,0,1,0,0,0,0,0,0,0,0,0,0,,,
"May 8, 2021 2:00 AM",2,2,0,1,1,0,2,2,0,3,1,2,,,,2,,,,0,0,0,1,2,0,2,7,3,0,0,0,0,0,,,
"May 8, 2021 3:00 AM",3,1,2,0,0,0,0,0,0,0,0,0,,,,0,,,,2,2,0,1,0,0,0,0,0,0,0,0,0,0,,,
"May 8, 2021 4:00 AM",0,0,0,1,1,0,1,1,0,1,1,0,,,,0,,,,2,2,0,1,0,0,0,4,2,0,0,0,0,0,,,
"May 8, 2021 5:00 AM",2,0,2,32,24,8,26,21,5,28,22,6,,,,2,,,,1,1,0,0,10,7,3,2,2,0,0,0,0,0,,,
"May 8, 2021 6:00 AM",6,5,1,38,16,22,39,15,24,43,16,27,,,,0,,,,1,1,0,2,28,15,13,4,6,0,0,0,0,0,,,
"May 8, 2021 7:00 AM",5,0,5,3,2,1,6,4,2,5,3,2,,,,3,,,,2,2,0,1,7,3,4,4,5,0,1,1,0,1,,,
"May 8, 2021 8:00 AM",17,9,8,7,3,4,17,13,4,18,14,4,,,,3,,,,3,3,0,3,3,3,0,8,2,0,0,2,2,0,,,
"May 8, 2021 9:00 AM",23,10,13,34,26,8,40,31,9,33,28,5,,,,5,,,,3,3,0,11,13,8,5,18,18,1,2,1,1,0,,,
"May 8, 2021 10:00 AM",45,27,18,102,55,47,137,91,46,110,71,39,,,,8,,,,16,14,2,10,34,22,12,50,26,3,5,1,1,0,,,
"May 8, 2021 11:00 AM",57,30,27,141,66,75,187,93,94,144,74,70,,,,10,,,,14,12,2,15,38,17,21,48,47,10,9,6,5,1,,,
"May 8, 2021 12:00 PM",66,38,28,155,84,71,187,100,87,143,84,59,,,,18,,,,16,13,3,11,62,48,14,41,45,2,5,12,8,4,,,
"May 8, 2021 1:00 PM",66,40,26,220,121,99,229,144,85,184,109,75,,,,16,,,,11,7,4,26,69,49,20,72,50,9,12,3,0,3,,,
"May 8, 2021 2:00 PM",73,34,39,241,141,100,240,138,102,218,142,76,,,,21,,,,15,15,0,32,86,53,33,90,47,5,10,10,7,3,,,
"May 8, 2021 3:00 PM",80,37,43,282,155,127,324,177,147,311,179,132,,,,29,,,,15,13,2,35,118,60,58,95,71,7,3,19,12,7,,,
"May 8, 2021 4:00 PM",116,57,59,298,138,160,323,156,167,307,142,165,,,,48,,,,27,25,2,30,112,59,53,75,70,12,9,9,6,3,,,
"May 8, 2021 5:00 PM",80,45,35,246,122,124,244,106,138,236,97,139,,,,18,,,,23,19,4,23,110,47,63,43,93,8,5,12,8,4,,,
"May 8, 2021 6:00 PM",59,20,39,193,86,107,212,76,136,186,65,121,,,,13,,,,15,14,1,25,91,44,47,44,85,6,4,9,7,2,,,
"May 8, 2021 7:00 PM",90,49,41,98,46,52,120,37,83,83,35,48,,,,20,,,,17,14,3,18,49,12,37,27,52,5,5,2,2,0,,,
"May 8, 2021 8:00 PM",44,27,17,61,27,34,64,33,31,51,24,27,,,,22,,,,15,13,2,20,28,11,17,17,30,1,5,1,0,1,,,
"May 8, 2021 9:00 PM",36,14,22,34,19,15,40,11,29,25,10,15,,,,8,,,,5,4,1,9,17,8,9,8,20,2,0,3,1,2,,,
"May 8, 2021 10:00 PM",24,9,15,15,6,9,14,5,9,15,6,9,,,,5,,,,7,7,0,6,9,2,7,1,10,1,0,4,2,2,,,
"May 8, 2021 11:00 PM",13,6,7,4,0,4,12,4,8,10,1,9,,,,5,,,,7,6,1,5,4,3,1,7,12,0,1,0,0,0,,,
"May 9, 2021 12:00 AM",11,2,9,0,0,0,2,0,2,5,2,3,,,,3,,,,5,5,0,2,2,0,2,1,6,0,1,0,0,0,,,
"May 9, 2021 1:00 AM",3,0,3,11,8,3,7,5,2,6,6,0,,,,4,,,,3,3,0,1,2,2,0,4,1,1,0,4,1,3,,,
"May 9, 2021 2:00 AM",4,1,3,0,0,0,2,0,2,2,0,2,,,,2,,,,3,3,0,3,2,2,0,1,4,0,1,0,0,0,,,
"May 9, 2021 3:00 AM",4,0,4,1,1,0,3,2,1,2,1,1,,,,2,,,,4,3,1,0,1,1,0,0,1,0,0,0,0,0,,,
"May 9, 2021 4:00 AM",2,1,1,2,2,0,3,3,0,3,2,1,,,,1,,,,1,1,0,0,2,1,1,4,0,0,0,0,0,0,,,
"May 9, 2021 5:00 AM",2,2,0,4,3,1,12,8,4,4,2,2,,,,1,,,,0,0,0,0,1,0,1,10,2,0,0,0,0,0,,,
"May 9, 2021 6:00 AM",1,1,0,18,10,8,21,11,10,23,15,8,,,,1,,,,1,1,0,7,8,6,2,12,10,0,0,0,0,0,,,
"May 9, 2021 7:00 AM",19,9,10,42,25,17,44,21,23,37,22,15,,,,3,,,,5,4,1,8,11,8,3,16,27,0,4,1,1,0,,,
"May 9, 2021 8:00 AM",39,14,25,93,45,48,103,63,40,84,47,37,,,,6,,,,5,5,0,16,29,21,8,38,26,3,9,2,1,1,,,
"May 9, 2021 9:00 AM",58,29,29,191,131,60,219,148,71,180,130,50,,,,11,,,,15,14,1,23,50,34,16,51,53,6,12,5,4,1,,,
"May 9, 2021 10:00 AM",70,38,32,240,131,109,250,126,124,200,104,96,,,,16,,,,13,13,0,33,63,47,16,63,68,15,12,7,5,2,,,
"May 9, 2021 11:00 AM",61,39,22,206,114,92,280,159,121,204,118,86,,,,22,,,,19,16,3,30,86,47,39,81,67,14,6,5,5,0,,,
"May 9, 2021 12:00 PM",75,40,35,265,124,141,289,139,150,224,112,112,,,,31,,,,14,14,0,19,72,34,38,66,55,15,8,8,3,5,,,
"May 9, 2021 1:00 PM",47,19,28,168,75,93,219,98,121,149,72,77,,,,25,,,,22,19,3,29,86,26,60,75,68,8,4,20,13,7,,,
"May 9, 2021 2:00 PM",66,41,25,139,59,80,168,73,95,144,69,75,,,,23,,,,33,25,8,26,77,49,28,58,57,5,6,3,1,2,,,
"May 9, 2021 3:00 PM",60,21,39,135,83,52,140,77,63,124,73,51,,,,21,,,,22,20,2,28,74,47,27,46,59,5,7,1,1,0,,,
"May 9, 2021 4:00 PM",65,28,37,122,64,58,142,53,89,119,59,60,,,,44,,,,15,13,2,16,68,41,27,38,59,8,3,6,6,0,,,
"May 9, 2021 5:00 PM",60,26,34,91,39,52,143,74,69,104,53,51,,,,32,,,,17,15,2,24,61,28,33,25,42,4,1,5,4,1,,,
"May 9, 2021 6:00 PM",46,29,17,77,39,38,89,39,50,74,24,50,,,,8,,,,12,7,5,22,24,8,16,26,47,4,1,5,5,0,,,
"May 9, 2021 7:00 PM",43,19,24,55,25,30,58,23,35,46,21,25,,,,13,,,,6,6,0,12,25,12,13,11,27,1,0,9,5,4,,,
"May 9, 2021 8:00 PM",27,11,16,37,18,19,44,23,21,39,16,23,,,,6,,,,7,4,3,11,14,10,4,10,19,1,5,1,1,0,,,
"May 9, 2021 9:00 PM",22,10,12,19,10,9,36,17,19,26,13,13,,,,9,,,,4,4,0,9,9,2,7,9,11,1,0,1,1,0,,,
"May 9, 2021 10:00 PM",11,1,10,6,3,3,5,3,2,10,7,3,,,,2,,,,3,3,0,6,5,3,2,10,10,0,0,0,0,0,,,
"May 9, 2021 11:00 PM",7,1,6,1,0,1,2,2,0,4,1,3,,,,1,,,,2,2,0,1,0,0,0,4,4,1,0,0,0,0,,,
"May 10, 2021 12:00 AM",1,1,0,0,0,0,0,0,0,0,0,0,,,,0,,,,2,2,0,2,0,0,0,0,0,0,0,0,0,0,,,
"May 10, 2021 1:00 AM",1,0,1,0,0,0,0,0,0,1,1,0,,,,3,,,,1,1,0,1,1,0,1,0,0,0,0,0,0,0,,,
"May 10, 2021 2:00 AM",0,0,0,0,0,0,0,0,0,0,0,0,,,,1,,,,0,0,0,1,0,0,0,0,0,0,0,0,0,0,,,
"May 10, 2021 3:00 AM",1,0,1,0,0,0,1,1,0,0,0,0,,,,0,,,,1,1,0,1,0,0,0,1,0,0,0,0,0,0,,,
"May 10, 2021 4:00 AM",1,1,0,0,0,0,1,1,0,0,0,0,,,,0,,,,1,1,0,1,0,0,0,1,2,0,1,0,0,0,,,
"May 10, 2021 5:00 AM",6,5,1,2,1,1,4,1,3,6,3,3,,,,0,,,,0,0,0,7,0,0,0,2,4,0,1,0,0,0,,,
"May 10, 2021 6:00 AM",34,25,9,27,15,12,28,15,13,25,14,11,,,,3,,,,5,5,0,12,12,7,5,12,41,1,0,4,4,0,,,
"May 10, 2021 7:00 AM",98,57,41,90,37,53,106,42,64,83,38,45,,,,15,,,,16,15,1,54,30,13,17,43,71,5,6,5,1,4,,,
"May 10, 2021 8:00 AM",173,116,57,132,48,84,187,67,120,141,57,84,,,,27,,,,40,29,11,94,95,31,64,48,99,8,6,19,18,1,,,
"May 10, 2021 9:00 AM",72,50,22,66,31,35,87,52,35,64,36,28,,,,8,,,,22,19,3,37,27,16,11,20,43,3,3,4,2,2,,,
"May 10, 2021 10:00 AM",42,20,22,53,25,28,83,41,42,57,25,32,,,,11,,,,8,6,2,19,21,10,11,25,20,5,2,4,3,1,,,
"May 10, 2021 11:00 AM",58,36,22,42,21,21,73,46,27,54,31,23,,,,11,,,,8,8,0,14,23,16,7,21,27,2,2,3,2,1,,,
"May 10, 2021 12:00 PM",52,23,29,65,32,33,85,44,41,58,31,27,,,,7,,,,17,17,0,17,31,16,15,23,23,1,1,4,2,2,,,
"May 10, 2021 1:00 PM",51,24,27,49,25,24,92,43,49,53,28,25,,,,11,,,,10,10,0,18,25,18,7,27,21,3,1,2,1,1,,,
"May 10, 2021 2:00 PM",54,29,25,57,35,22,83,45,38,63,41,22,,,,11,,,,17,14,3,18,26,15,11,30,20,1,9,3,2,1,,,
"May 10, 2021 3:00 PM",65,20,45,48,29,19,85,47,38,56,33,23,,,,13,,,,42,30,12,25,32,19,13,35,39,4,1,9,4,5,,,
"May 10, 2021 4:00 PM",99,43,56,68,40,28,88,57,31,78,50,28,,,,11,,,,35,31,4,20,46,36,10,60,45,2,1,11,6,5,,,
"May 10, 2021 5:00 PM",114,35,79,47,25,22,76,45,31,54,29,25,,,,17,,,,55,54,1,22,29,18,11,65,46,2,8,3,1,2,,,
"May 10, 2021 6:00 PM",109,28,81,56,38,18,73,48,25,50,30,20,,,,12,,,,40,40,0,30,41,36,5,52,34,2,6,5,3,2,,,
"May 10, 2021 7:00 PM",77,25,52,48,23,25,64,32,32,51,27,24,,,,13,,,,17,17,0,9,35,18,17,33,30,0,1,3,1,2,,,
"May 10, 2021 8:00 PM",39,13,26,33,17,16,35,19,16,36,17,19,,,,7,,,,16,15,1,6,18,10,8,23,18,2,2,0,0,0,,,
"May 10, 2021 9:00 PM",24,5,19,20,11,9,20,10,10,22,7,15,,,,3,,,,7,7,0,6,9,6,3,13,9,4,1,2,2,0,,,
"May 10, 2021 10:00 PM",16,4,12,5,3,2,13,9,4,13,6,7,,,,1,,,,3,3,0,2,3,3,0,7,13,2,0,0,0,0,,,
"May 10, 2021 11:00 PM",6,0,6,2,1,1,4,3,1,4,3,1,,,,1,,,,2,2,0,2,1,0,1,1,1,0,0,0,0,0,,,
"May 11, 2021 12:00 AM",5,2,3,0,0,0,0,0,0,1,1,0,,,,0,,,,0,0,0,0,0,0,0,0,2,0,0,0,0,0,,,
"May 11, 2021 1:00 AM",1,1,0,0,0,0,0,0,0,0,0,0,,,,0,,,,0,0,0,0,1,0,1,0,0,0,0,0,0,0,,,
"May 11, 2021 2:00 AM",1,1,0,0,0,0,0,0,0,0,0,0,,,,0,,,,0,0,0,0,0,0,0,1,0,0,0,0,0,0,,,
"May 11, 2021 3:00 AM",0,0,0,0,0,0,0,0,0,0,0,0,,,,0,,,,0,0,0,0,0,0,0,0,0,0,0,0,0,0,,,
"May 11, 2021 4:00 AM",1,1,0,0,0,0,2,2,0,0,0,0,,,,0,,,,2,2,0,1,0,0,0,1,1,0,1,0,0,0,,,
"May 11, 2021 5:00 AM",8,7,1,8,6,2,11,8,3,12,10,2,,,,0,,,,3,3,0,5,2,0,2,4,7,0,0,0,0,0,,,
"May 11, 2021 6:00 AM",44,29,15,49,27,22,43,21,22,37,23,14,,,,6,,,,9,9,0,15,21,12,9,17,51,0,2,4,4,0,,,
"May 11, 2021 7:00 AM",104,62,42,136,56,80,148,68,80,126,62,64,,,,13,,,,18,17,1,69,53,29,24,57,109,6,7,9,7,2,,,
"May 11, 2021 8:00 AM",180,115,65,166,56,110,219,81,138,195,72,123,,,,41,,,,46,35,11,82,93,29,64,73,130,8,6,13,13,0,,,
"May 11, 2021 9:00 AM",84,61,23,129,66,63,145,74,71,121,64,57,,,,9,,,,22,18,4,41,55,29,26,40,66,2,2,8,4,4,,,
"May 11, 2021 10:00 AM",62,45,17,67,31,36,95,47,48,57,32,25,,,,8,,,,9,6,3,25,39,20,19,28,34,2,5,5,4,1,,,
"May 11, 2021 11:00 AM",47,18,29,96,47,49,116,61,55,79,43,36,,,,9,,,,15,13,2,24,38,20,18,31,37,3,4,4,4,0,,,
"May 11, 2021 12:00 PM",60,34,26,88,41,47,161,97,64,81,43,38,,,,19,,,,20,19,1,18,51,34,17,36,25,8,4,8,5,3,,,
"May 11, 2021 1:00 PM",68,35,33,135,71,64,184,78,106,122,60,62,,,,17,,,,22,19,3,27,57,38,19,50,59,6,1,7,1,6,,,
"May 11, 2021 2:00 PM",73,34,39,92,46,46,154,80,74,103,62,41,,,,27,,,,20,18,2,19,48,29,19,48,52,4,2,4,0,4,,,
"May 11, 2021 3:00 PM",92,36,56,90,53,37,128,79,49,92,55,37,,,,21,,,,31,24,7,28,67,55,12,49,47,7,3,14,7,7,,,
"May 11, 2021 4:00 PM",135,50,85,128,69,59,161,89,72,130,70,60,,,,30,,,,46,37,9,25,76,52,24,98,62,4,10,9,6,3,,,
"May 11, 2021 5:00 PM",171,57,114,168,103,65,222,138,84,195,116,79,,,,36,,,,55,49,6,39,104,69,35,120,89,12,8,9,3,6,,,
"May 11, 2021 6:00 PM",160,64,96,235,131,104,278,164,114,236,134,102,,,,39,,,,70,67,3,37,123,78,45,117,91,10,8,11,3,8,,,
"May 11, 2021 7:00 PM",131,49,82,249,128,121,257,147,110,228,121,107,,,,24,,,,32,32,0,39,85,51,34,92,79,7,7,18,15,3,,,
"May 11, 2021 8:00 PM",92,36,56,136,48,88,153,44,109,140,44,96,,,,24,,,,22,22,0,14,59,23,36,39,72,3,3,13,5,8,,,
"May 11, 2021 9:00 PM",47,13,34,48,20,28,63,25,38,44,18,26,,,,13,,,,19,19,0,7,42,19,23,16,20,5,0,6,3,3,,,
"May 11, 2021 10:00 PM",15,7,8,8,6,2,11,4,7,8,4,4,,,,3,,,,11,11,0,9,8,1,7,7,11,1,0,4,2,2,,,
"May 11, 2021 11:00 PM",11,6,5,12,4,8,5,2,3,5,2,3,,,,2,,,,3,3,0,5,4,3,1,3,2,0,1,2,1,1,,,
"May 12, 2021 12:00 AM",2,1,1,0,0,0,1,1,0,1,1,0,,,,0,,,,2,2,0,0,0,0,0,2,2,1,1,2,1,1,,,
"May 12, 2021 1:00 AM",3,0,3,0,0,0,1,1,0,0,0,0,,,,1,,,,3,3,0,0,1,1,0,0,1,0,0,1,0,1,,,
"May 12, 2021 2:00 AM",6,4,2,0,0,0,0,0,0,0,0,0,,,,0,,,,0,0,0,0,0,0,0,1,0,0,0,0,0,0,,,
"May 12, 2021 3:00 AM",1,0,1,0,0,0,1,1,0,0,0,0,,,,0,,,,0,0,0,0,0,0,0,1,0,0,0,0,0,0,,,
"May 12, 2021 4:00 AM",4,2,2,0,0,0,0,0,0,1,0,1,,,,0,,,,3,3,0,1,0,0,0,0,3,0,1,0,0,0,,,
"May 12, 2021 5:00 AM",5,5,0,3,2,1,9,6,3,9,6,3,,,,2,,,,0,0,0,6,0,0,0,3,5,0,1,0,0,0,,,
"May 12, 2021 6:00 AM",37,26,11,36,17,19,39,21,18,32,14,18,,,,4,,,,8,8,0,14,15,8,7,14,42,1,1,3,3,0,,,
"May 12, 2021 7:00 AM",102,60,42,99,41,58,111,41,70,88,43,45,,,,12,,,,26,24,2,65,33,13,20,48,87,0,3,6,5,1,,,
"May 12, 2021 8:00 AM",185,124,61,123,42,81,151,61,90,127,55,72,,,,28,,,,38,33,5,72,90,29,61,43,117,4,7,18,17,1,,,
"May 12, 2021 9:00 AM",85,63,22,79,43,36,80,48,32,75,45,30,,,,8,,,,18,15,3,38,36,18,18,34,51,1,7,1,0,1,,,
"May 12, 2021 10:00 AM",39,24,15,67,34,33,97,54,43,68,38,30,,,,9,,,,18,14,4,12,29,15,14,27,32,2,5,4,3,1,,,
"May 12, 2021 11:00 AM",46,28,18,83,46,37,90,50,40,65,38,27,,,,9,,,,11,10,1,13,33,23,10,26,30,8,2,4,2,2,,,
"May 12, 2021 12:00 PM",43,18,25,84,45,39,115,53,62,57,26,31,,,,15,,,,17,12,5,17,38,17,21,32,31,7,6,8,6,2,,,
"May 12, 2021 1:00 PM",72,34,38,77,43,34,129,68,61,70,45,25,,,,13,,,,24,21,3,32,59,31,28,52,48,5,2,9,5,4,,,
"May 12, 2021 2:00 PM",72,30,42,56,35,21,99,55,44,59,35,24,,,,24,,,,15,13,2,12,38,24,14,38,32,4,2,9,6,3,,,
"May 12, 2021 3:00 PM",76,31,45,44,26,18,75,40,35,45,25,20,,,,15,,,,20,17,3,25,40,22,18,24,42,4,5,7,3,4,,,
"May 12, 2021 4:00 PM",94,37,57,45,26,19,70,39,31,56,31,25,,,,15,,,,28,25,3,15,32,24,8,49,35,6,2,6,3,3,,,
"May 12, 2021 5:00 PM",122,35,87,67,41,26,85,48,37,70,41,29,,,,11,,,,43,40,3,24,33,25,8,58,46,5,5,3,1,2,,,
"May 12, 2021 6:00 PM",82,27,55,44,25,19,71,43,28,52,26,26,,,,5,,,,44,44,0,28,25,22,3,54,42,2,2,5,4,1,,,
"May 12, 2021 7:00 PM",46,18,28,45,24,21,44,29,15,42,23,19,,,,15,,,,23,22,1,12,22,15,7,31,23,5,7,5,4,1,,,
"May 12, 2021 8:00 PM",58,20,38,52,31,21,56,31,25,37,20,17,,,,12,,,,18,18,0,3,28,21,7,21,18,3,1,2,0,2,,,
"May 12, 2021 9:00 PM",29,12,17,25,13,12,27,13,14,33,17,16,,,,4,,,,10,10,0,6,17,6,11,14,16,3,3,4,3,1,,,
"May 12, 2021 10:00 PM",13,4,9,5,3,2,13,3,10,7,2,5,,,,3,,,,9,9,0,5,5,0,5,10,7,1,2,1,1,0,,,
"May 12, 2021 11:00 PM",6,0,6,2,1,1,5,3,2,2,2,0,,,,1,,,,2,2,0,1,2,2,0,3,5,0,0,2,1,1,,,
"May 13, 2021 12:00 AM",3,2,1,0,0,0,1,1,0,1,1,0,,,,0,,,,3,2,1,0,3,0,3,4,0,1,0,0,0,0,,,
"May 13, 2021 1:00 AM",0,0,0,1,1,0,0,0,0,0,0,0,,,,0,,,,1,1,0,1,2,2,0,1,0,0,1,1,1,0,,,
"May 13, 2021 2:00 AM",4,2,2,1,1,0,2,1,1,1,1,0,,,,1,,,,1,1,0,0,0,0,0,1,0,0,0,0,0,0,,,
"May 13, 2021 3:00 AM",0,0,0,1,1,0,0,0,0,0,0,0,,,,0,,,,0,0,0,0,1,1,0,0,1,0,0,0,0,0,,,
"May 13, 2021 4:00 AM",0,0,0,0,0,0,2,2,0,1,1,0,,,,0,,,,1,1,0,0,0,0,0,0,0,0,0,0,0,0,,,
"May 13, 2021 5:00 AM",5,5,0,3,2,1,5,3,2,9,7,2,,,,1,,,,1,1,0,5,1,1,0,1,6,0,0,0,0,0,,,
"May 13, 2021 6:00 AM",45,28,17,39,24,15,31,23,8,34,22,12,,,,4,,,,5,5,0,11,13,7,6,21,27,1,4,2,1,1,,,
"May 13, 2021 7:00 AM",116,71,45,96,35,61,113,41,72,83,33,50,,,,21,,,,20,19,1,68,31,16,15,43,86,7,6,8,5,3,,,
"May 13, 2021 8:00 AM",211,141,70,158,61,97,201,71,130,169,71,98,,,,32,,,,51,41,10,84,99,27,72,57,117,11,13,21,18,3,,,
"May 13, 2021 9:00 AM",89,58,31,110,49,61,134,64,70,116,57,59,,,,22,,,,23,18,5,38,46,24,22,37,85,5,5,3,2,1,,,
"May 13, 2021 10:00 AM",50,30,20,102,54,48,95,50,45,82,47,35,,,,12,,,,14,11,3,21,46,24,22,25,34,4,7,4,3,1,,,
"May 13, 2021 11:00 AM",52,32,20,92,49,43,128,79,49,94,55,39,,,,9,,,,10,8,2,30,51,35,16,41,45,7,6,1,1,0,,,
"May 13, 2021 12:00 PM",60,27,33,125,66,59,143,81,62,92,55,37,,,,18,,,,18,18,0,21,51,31,20,41,48,9,3,5,1,4,,,
"May 13, 2021 1:00 PM",78,34,44,111,56,55,175,85,90,104,51,53,,,,14,,,,24,20,4,15,50,31,19,51,53,5,3,3,3,0,,,
"May 13, 2021 2:00 PM",71,32,39,104,58,46,134,65,69,112,58,54,,,,30,,,,18,14,4,25,38,17,21,48,45,5,2,4,3,1,,,
"May 13, 2021 3:00 PM",70,34,36,72,37,35,122,72,50,79,47,32,,,,19,,,,26,21,5,32,71,45,26,46,50,8,1,8,4,4,,,
"May 13, 2021 4:00 PM",121,43,78,98,60,38,123,75,48,102,62,40,,,,18,,,,42,40,2,28,53,41,12,67,51,7,6,7,7,0,,,
"May 13, 2021 5:00 PM",173,64,109,127,69,58,173,103,70,147,87,60,,,,31,,,,52,45,7,35,51,36,15,96,64,5,7,8,3,5,,,
"May 13, 2021 6:00 PM",159,67,92,200,120,80,196,109,87,192,112,80,,,,30,,,,60,59,1,38,74,47,27,92,88,13,7,14,10,4,,,
"May 13, 2021 7:00 PM",115,46,69,150,75,75,164,91,73,148,71,77,,,,11,,,,39,38,1,24,69,46,23,63,56,8,5,9,6,3,,,
"May 13, 2021 8:00 PM",87,37,50,119,62,57,136,65,71,122,57,65,,,,17,,,,34,33,1,24,52,26,26,28,35,2,2,5,4,1,,,
"May 13, 2021 9:00 PM",53,20,33,70,30,40,63,21,42,63,22,41,,,,9,,,,10,10,0,15,28,15,13,22,35,3,5,5,1,4,,,
"May 13, 2021 10:00 PM",27,12,15,20,11,9,33,14,19,33,14,19,,,,1,,,,8,8,0,9,12,5,7,9,14,0,0,2,0,2,,,
"May 13, 2021 11:00 PM",12,1,11,13,7,6,10,3,7,11,4,7,,,,6,,,,3,3,0,1,3,1,2,4,5,0,0,1,1,0,,,
"May 14, 2021 12:00 AM",4,0,4,0,0,0,2,2,0,1,0,1,,,,0,,,,2,2,0,4,2,1,1,4,4,0,0,1,1,0,,,
"May 14, 2021 1:00 AM",4,1,3,3,3,0,0,0,0,1,1,0,,,,0,,,,2,2,0,1,0,0,0,3,0,0,0,0,0,0,,,
"May 14, 2021 2:00 AM",4,4,0,1,1,0,2,1,1,2,1,1,,,,1,,,,5,5,0,0,0,0,0,2,0,1,0,0,0,0,,,
"May 14, 2021 3:00 AM",1,0,1,0,0,0,1,1,0,2,1,1,,,,0,,,,3,1,2,0,0,0,0,0,2,0,0,0,0,0,,,
"May 14, 2021 4:00 AM",0,0,0,0,0,0,2,2,0,1,1,0,,,,0,,,,1,1,0,1,0,0,0,1,2,0,1,0,0,0,,,
"May 14, 2021 5:00 AM",5,4,1,8,7,1,12,12,0,13,12,1,,,,0,,,,3,3,0,4,5,5,0,4,6,0,0,0,0,0,,,
"May 14, 2021 6:00 AM",28,24,4,65,40,25,68,45,23,63,44,19,,,,6,,,,8,8,0,8,10,8,2,24,45,0,2,1,1,0,,,
"May 14, 2021 7:00 AM",89,49,40,130,61,69,131,43,88,110,54,56,,,,19,,,,20,17,3,61,42,21,21,51,82,3,6,5,4,1,,,
"May 14, 2021 8:00 AM",175,118,57,153,54,99,208,81,127,178,72,106,,,,41,,,,44,32,12,82,73,24,49,48,120,7,2,27,26,1,,,
"May 14, 2021 9:00 AM",82,53,29,118,71,47,146,88,58,130,86,44,,,,15,,,,23,19,4,34,56,39,17,48,61,6,6,6,4,2,,,
"May 14, 2021 10:00 AM",54,35,19,136,71,65,117,61,56,114,62,52,,,,9,,,,15,12,3,22,52,27,25,35,46,1,8,5,4,1,,,
"May 14, 2021 11:00 AM",28,14,14,82,29,53,110,56,54,73,35,38,,,,13,,,,9,8,1,16,27,18,9,37,36,4,1,4,2,2,,,
"May 14, 2021 12:00 PM",60,35,25,83,39,44,113,59,54,75,25,50,,,,12,,,,13,10,3,13,45,23,22,38,28,8,2,11,9,2,,,
"May 14, 2021 1:00 PM",99,51,48,87,44,43,142,61,81,69,32,37,,,,15,,,,23,21,2,25,44,25,19,40,39,6,3,9,8,1,,,
"May 14, 2021 2:00 PM",71,29,42,106,62,44,151,84,67,112,70,42,,,,25,,,,22,18,4,16,49,27,22,49,44,7,2,9,5,4,,,
"May 14, 2021 3:00 PM",72,32,40,105,49,56,153,83,70,103,55,48,,,,20,,,,32,27,5,34,61,41,20,55,48,5,2,7,2,5,,,
"May 14, 2021 4:00 PM",111,42,69,117,74,43,169,101,68,119,75,44,,,,24,,,,32,30,2,30,64,43,21,74,52,6,3,10,6,4,,,
"May 14, 2021 5:00 PM",163,69,94,122,67,55,175,98,77,121,64,57,,,,22,,,,55,55,0,34,55,30,25,81,51,7,6,7,5,2,,,
"May 14, 2021 6:00 PM",132,52,80,172,88,84,187,102,85,166,90,76,,,,27,,,,37,35,2,29,59,45,14,76,57,8,4,13,7,6,,,
"May 14, 2021 7:00 PM",109,47,62,126,61,65,125,68,57,116,59,57,,,,12,,,,39,37,2,34,57,33,24,35,50,5,4,4,3,1,,,
"May 14, 2021 8:00 PM",64,25,39,95,48,47,100,41,59,79,36,43,,,,10,,,,16,13,3,19,52,28,24,33,46,5,4,8,5,3,,,
"May 14, 2021 9:00 PM",55,18,37,28,15,13,50,20,30,39,14,25,,,,6,,,,11,11,0,17,18,7,11,16,15,2,1,11,7,4,,,
"May 14, 2021 10:00 PM",48,18,30,25,15,10,32,16,16,18,11,7,,,,8,,,,11,10,1,14,3,2,1,10,14,2,2,2,2,0,,,
"May 14, 2021 11:00 PM",22,5,17,8,4,4,16,5,11,15,10,5,,,,4,,,,6,5,1,6,4,1,3,5,10,0,3,1,0,1,,,
"May 15, 2021 12:00 AM",7,3,4,0,0,0,4,1,3,5,4,1,,,,1,,,,7,7,0,6,5,4,1,5,6,0,0,0,0,0,,,
"May 15, 2021 1:00 AM",10,6,4,2,1,1,2,1,1,0,0,0,,,,0,,,,8,6,2,6,2,1,1,2,2,0,1,1,0,1,,,
"May 15, 2021 2:00 AM",4,2,2,0,0,0,1,1,0,0,0,0,,,,1,,,,2,2,0,1,0,0,0,2,2,0,0,0,0,0,,,
"May 15, 2021 3:00 AM",2,2,0,0,0,0,0,0,0,0,0,0,,,,0,,,,1,1,0,0,0,0,0,2,0,0,0,0,0,0,,,
"May 15, 2021 4:00 AM",3,1,2,0,0,0,1,1,0,1,1,0,,,,0,,,,1,1,0,0,0,0,0,0,1,0,0,0,0,0,,,
"May 15, 2021 5:00 AM",1,0,1,7,2,5,5,3,2,6,2,4,,,,0,,,,1,1,0,0,1,1,0,2,6,0,0,0,0,0,,,
"May 15, 2021 6:00 AM",14,7,7,10,5,5,15,8,7,13,6,7,,,,2,,,,2,1,1,3,3,2,1,5,6,0,0,1,1,0,,,
"May 15, 2021 7:00 AM",19,9,10,8,6,2,19,12,7,18,12,6,,,,5,,,,3,3,0,8,5,3,2,10,18,0,2,0,0,0,,,
"May 15, 2021 8:00 AM",20,10,10,40,20,20,40,30,10,45,30,15,,,,5,,,,10,8,2,12,15,12,3,22,13,2,0,2,2,0,,,
"May 15, 2021 9:00 AM",27,13,14,71,47,24,62,36,26,65,43,22,,,,9,,,,11,9,2,26,23,16,7,35,22,0,6,0,0,0,,,
"May 15, 2021 10:00 AM",28,17,11,68,36,32,58,29,29,55,30,25,,,,3,,,,7,7,0,6,11,7,4,19,25,3,2,0,0,0,,,
"May 15, 2021 11:00 AM",35,18,17,62,23,39,67,34,33,62,35,27,,,,11,,,,12,8,4,10,34,22,12,17,20,11,6,2,2,0,,,
"May 15, 2021 12:00 PM",29,13,16,89,37,52,83,54,29,77,45,32,,,,12,,,,13,11,2,15,32,19,13,28,25,3,3,7,6,1,,,
"May 15, 2021 1:00 PM",62,30,32,98,51,47,115,73,42,91,55,36,,,,8,,,,11,10,1,24,33,22,11,46,39,5,0,8,6,2,,,
"May 15, 2021 2:00 PM",60,31,29,140,82,58,153,95,58,123,72,51,,,,16,,,,21,17,4,18,66,46,20,53,39,10,2,8,5,3,,,
"May 15, 2021 3:00 PM",68,39,29,145,89,56,216,120,96,141,95,46,,,,21,,,,20,15,5,27,100,58,42,59,46,7,3,8,7,1,,,
"May 15, 2021 4:00 PM",59,28,31,165,84,81,179,68,111,136,54,82,,,,15,,,,15,14,1,16,59,18,41,31,63,5,3,6,4,2,,,
"May 15, 2021 5:00 PM",30,11,19,102,51,51,104,29,75,92,24,68,,,,7,,,,19,18,1,11,28,5,23,22,39,7,0,1,0,1,,,
"May 15, 2021 6:00 PM",19,8,11,57,33,24,41,15,26,35,15,20,,,,7,,,,10,9,1,7,19,5,14,10,28,3,2,7,3,4,,,
"May 15, 2021 7:00 PM",27,11,16,29,21,8,33,18,15,27,14,13,,,,2,,,,5,3,2,14,11,5,6,7,18,1,1,0,0,0,,,
"May 15, 2021 8:00 PM",28,16,12,25,8,17,35,13,22,26,16,10,,,,7,,,,10,8,2,9,21,9,12,19,15,0,0,3,1,2,,,
"May 15, 2021 9:00 PM",33,17,16,19,9,10,31,16,15,15,8,7,,,,3,,,,5,5,0,12,14,5,9,6,6,0,2,2,1,1,,,
"May 15, 2021 10:00 PM",14,6,8,11,5,6,25,10,15,14,5,9,,,,6,,,,3,3,0,1,5,3,2,5,8,0,2,2,1,1,,,
"May 15, 2021 11:00 PM",4,3,1,5,3,2,6,1,5,4,1,3,,,,0,,,,1,1,0,4,1,1,0,1,8,0,1,3,2,1,,,
"May 16, 2021 12:00 AM",6,1,5,0,0,0,3,3,0,0,0,0,,,,0,,,,7,7,0,4,0,0,0,3,3,1,0,0,0,0,,,
"May 16, 2021 1:00 AM",5,1,4,5,3,2,10,4,6,4,3,1,,,,4,,,,6,5,1,2,1,1,0,2,2,0,0,1,1,0,,,
"May 16, 2021 2:00 AM",3,0,3,3,2,1,4,4,0,3,3,0,,,,2,,,,2,1,1,0,0,0,0,1,1,0,0,0,0,0,,,
"May 16, 2021 3:00 AM",1,1,0,0,0,0,0,0,0,0,0,0,,,,1,,,,0,0,0,2,0,0,0,0,0,0,1,1,1,0,,,
"May 16, 2021 4:00 AM",2,1,1,0,0,0,2,2,0,1,1,0,,,,0,,,,1,1,0,0,0,0,0,2,1,1,0,1,1,0,,,
"May 16, 2021 5:00 AM",1,1,0,0,0,0,1,0,1,1,0,1,,,,1,,,,2,2,0,2,1,1,0,3,2,0,0,1,1,0,,,
"May 16, 2021 6:00 AM",4,2,2,14,9,5,15,11,4,14,9,5,,,,3,,,,3,2,1,4,9,7,2,7,12,1,1,2,0,2,,,
"May 16, 2021 7:00 AM",11,2,9,53,29,24,61,38,23,47,30,17,,,,1,,,,8,8,0,12,16,12,4,23,26,2,6,6,4,2,,,
"May 16, 2021 8:00 AM",39,16,23,113,71,42,112,64,48,111,76,35,,,,9,,,,6,4,2,20,30,16,14,37,24,2,10,0,0,0,,,
"May 16, 2021 9:00 AM",45,21,24,198,123,75,180,121,59,172,120,52,,,,14,,,,16,12,4,29,66,34,32,78,63,4,21,4,2,2,,,
"May 16, 2021 10:00 AM",67,30,37,261,147,114,260,160,100,222,138,84,,,,27,,,,22,22,0,23,94,77,17,69,94,8,13,10,9,1,,,
"May 16, 2021 11:00 AM",82,34,48,322,182,140,311,169,142,274,165,109,,,,33,,,,20,19,1,32,103,61,42,69,74,12,11,9,7,2,,,
"May 16, 2021 12:00 PM",83,45,38,287,147,140,328,162,166,286,139,147,,,,27,,,,32,31,1,31,111,71,40,71,98,16,6,9,5,4,,,
"May 16, 2021 1:00 PM",86,51,35,293,151,142,333,211,122,268,169,99,,,,23,,,,22,21,1,39,133,87,46,107,73,12,5,7,6,1,,,
"May 16, 2021 2:00 PM",100,51,49,325,185,140,432,253,179,340,197,143,,,,35,,,,40,29,11,36,181,130,51,111,78,9,7,12,7,5,,,
"May 16, 2021 3:00 PM",83,46,37,343,177,166,429,224,205,350,193,157,,,,43,,,,37,30,7,31,165,85,80,103,104,8,12,11,6,5,,,
"May 16, 2021 4:00 PM",98,49,49,297,127,170,461,203,258,287,127,160,,,,42,,,,17,14,3,37,156,69,87,74,133,8,5,12,6,6,,,
"May 16, 2021 5:00 PM",66,27,39,270,134,136,368,140,228,278,116,162,,,,36,,,,26,24,2,25,101,35,66,52,106,9,3,12,8,4,,,
"May 16, 2021 6:00 PM",68,34,34,165,76,89,196,75,121,165,61,104,,,,27,,,,21,21,0,16,102,40,62,33,81,3,2,4,2,2,,,
"May 16, 2021 7:00 PM",49,16,33,98,37,61,135,34,101,99,34,65,,,,11,,,,22,18,4,15,41,12,29,27,61,3,1,10,7,3,,,
"May 16, 2021 8:00 PM",47,23,24,71,35,36,82,30,52,63,29,34,,,,9,,,,17,14,3,13,33,12,21,10,38,5,5,7,4,3,,,
"May 16, 2021 9:00 PM",19,9,10,35,13,22,50,17,33,32,8,24,,,,9,,,,9,9,0,6,22,9,13,15,22,2,4,1,0,1,,,
"May 16, 2021 10:00 PM",20,12,8,15,5,10,20,4,16,16,6,10,,,,1,,,,3,3,0,8,9,2,7,10,12,1,1,3,1,2,,,
"May 16, 2021 11:00 PM",5,3,2,1,1,0,6,4,2,1,0,1,,,,2,,,,4,4,0,5,2,0,2,6,6,0,1,1,1,0,,,
"May 17, 2021 12:00 AM",1,0,1,0,0,0,1,0,1,3,2,1,,,,1,,,,1,1,0,0,1,1,0,0,2,2,0,0,0,0,,,
"May 17, 2021 1:00 AM",1,1,0,0,0,0,3,2,1,2,2,0,,,,0,,,,0,0,0,2,0,0,0,1,6,0,1,0,0,0,,,
"May 17, 2021 2:00 AM",1,0,1,0,0,0,0,0,0,0,0,0,,,,2,,,,2,2,0,2,0,0,0,3,0,0,1,0,0,0,,,
"May 17, 2021 3:00 AM",0,0,0,2,2,0,3,3,0,2,2,0,,,,0,,,,0,0,0,0,0,0,0,1,0,0,0,0,0,0,,,
"May 17, 2021 4:00 AM",0,0,0,0,0,0,0,0,0,0,0,0,,,,0,,,,0,0,0,1,0,0,0,0,1,0,0,0,0,0,,,
"May 17, 2021 5:00 AM",8,7,1,3,1,2,9,7,2,7,4,3,,,,0,,,,3,3,0,4,0,0,0,5,13,1,0,0,0,0,,,
"May 17, 2021 6:00 AM",33,22,11,30,18,12,46,27,19,29,16,13,,,,4,,,,4,4,0,24,11,9,2,14,43,1,4,1,1,0,,,
"May 17, 2021 7:00 AM",106,66,40,81,32,49,131,49,82,80,37,43,,,,14,,,,21,18,3,73,46,24,22,44,95,2,4,2,2,0,,,
"May 17, 2021 8:00 AM",168,116,52,136,39,97,178,61,117,143,52,91,,,,33,,,,43,34,9,98,86,22,64,55,116,9,5,26,23,3,,,
"May 17, 2021 9:00 AM",84,67,17,91,50,41,117,62,55,90,49,41,,,,10,,,,18,12,6,46,41,17,24,44,43,1,4,1,0,1,,,
"May 17, 2021 10:00 AM",46,28,18,85,46,39,98,53,45,83,48,35,,,,8,,,,10,8,2,15,36,24,12,27,37,5,1,4,2,2,,,
"May 17, 2021 11:00 AM",49,29,20,72,40,32,63,31,32,69,41,28,,,,10,,,,19,16,3,26,31,15,16,14,29,5,0,2,1,1,,,
"May 17, 2021 12:00 PM",53,24,29,72,35,37,77,39,38,54,24,30,,,,22,,,,14,13,1,16,41,19,22,24,35,10,2,4,4,0,,,
"May 17, 2021 1:00 PM",71,32,39,81,41,40,94,52,42,70,37,33,,,,18,,,,21,15,6,20,36,21,15,40,41,4,4,7,4,3,,,
"May 17, 2021 2:00 PM",69,29,40,80,48,32,116,61,55,89,59,30,,,,17,,,,15,11,4,17,38,26,12,47,36,5,3,7,4,3,,,
"May 17, 2021 3:00 PM",73,28,45,66,38,28,113,57,56,66,35,31,,,,11,,,,40,35,5,25,44,28,16,58,53,5,2,12,4,8,,,
"May 17, 2021 4:00 PM",100,46,54,92,58,34,126,67,59,97,54,43,,,,20,,,,34,34,0,26,72,45,27,54,60,4,4,4,3,1,,,
"May 17, 2021 5:00 PM",148,42,106,58,34,24,107,63,44,60,29,31,,,,27,,,,47,47,0,25,35,27,8,65,67,6,7,5,3,2,,,
"May 17, 2021 6:00 PM",107,37,70,97,50,47,126,69,57,80,45,35,,,,25,,,,51,50,1,25,38,27,11,73,43,6,6,10,7,3,,,
"May 17, 2021 7:00 PM",70,26,44,77,44,33,79,42,37,69,42,27,,,,21,,,,32,32,0,17,58,37,21,43,42,1,5,4,1,3,,,
"May 17, 2021 8:00 PM",55,22,33,86,43,43,69,39,30,55,32,23,,,,11,,,,16,16,0,14,35,16,19,26,24,2,2,10,6,4,,,
"May 17, 2021 9:00 PM",33,9,24,38,21,17,50,25,25,35,16,19,,,,5,,,,7,5,2,5,20,14,6,14,14,6,0,7,6,1,,,
"May 17, 2021 10:00 PM",14,6,8,4,2,2,10,4,6,8,3,5,,,,2,,,,6,6,0,5,1,0,1,4,3,0,0,0,0,0,,,
"May 17, 2021 11:00 PM",7,2,5,0,0,0,3,1,2,0,0,0,,,,3,,,,3,3,0,0,1,0,1,4,2,0,0,1,0,1,,,
"May 18, 2021 12:00 AM",8,2,6,0,0,0,1,0,1,3,2,1,,,,1,,,,3,3,0,0,0,0,0,2,3,0,0,0,0,0,,,
"May 18, 2021 1:00 AM",3,1,2,0,0,0,1,1,0,1,1,0,,,,1,,,,0,0,0,0,1,1,0,1,0,0,0,0,0,0,,,
"May 18, 2021 2:00 AM",4,3,1,0,0,0,0,0,0,0,0,0,,,,2,,,,2,2,0,0,0,0,0,1,1,0,0,1,0,1,,,
"May 18, 2021 3:00 AM",0,0,0,0,0,0,0,0,0,0,0,0,,,,0,,,,0,0,0,0,0,0,0,0,0,0,0,0,0,0,,,
"May 18, 2021 4:00 AM",1,1,0,0,0,0,3,3,0,1,1,0,,,,0,,,,1,1,0,1,1,0,1,0,1,0,0,0,0,0,,,
"May 18, 2021 5:00 AM",7,7,0,2,1,1,14,10,4,10,7,3,,,,1,,,,1,1,0,5,2,2,0,3,13,0,0,0,0,0,,,
"May 18, 2021 6:00 AM",36,26,10,71,42,29,72,49,23,67,45,22,,,,5,,,,7,7,0,14,13,12,1,25,44,1,1,1,1,0,,,
"May 18, 2021 7:00 AM",120,75,45,115,40,75,158,56,102,106,40,66,,,,17,,,,22,20,2,78,65,31,34,48,102,2,8,5,3,2,,,
"May 18, 2021 8:00 AM",195,131,64,161,60,101,225,85,140,172,70,102,,,,18,,,,37,29,8,92,94,35,59,58,138,11,11,14,13,1,,,
"May 18, 2021 9:00 AM",85,54,31,95,51,44,124,69,55,103,59,44,,,,17,,,,25,20,5,48,45,21,24,33,61,2,5,4,2,2,,,
"May 18, 2021 10:00 AM",45,32,13,85,38,47,95,46,49,89,43,46,,,,10,,,,14,12,2,22,50,33,17,28,43,3,0,5,4,1,,,
"May 18, 2021 11:00 AM",44,26,18,81,37,44,100,49,51,85,44,41,,,,20,,,,18,15,3,19,44,25,19,29,48,5,4,3,3,0,,,
"May 18, 2021 12:00 PM",48,18,30,88,38,50,90,50,40,80,36,44,,,,11,,,,22,19,3,24,39,17,22,30,35,7,3,7,7,0,,,
"May 18, 2021 1:00 PM",74,34,40,101,53,48,115,70,45,91,45,46,,,,25,,,,24,20,4,19,33,21,12,45,46,5,3,3,2,1,,,
"May 18, 2021 2:00 PM",57,28,29,56,28,28,68,31,37,47,26,21,,,,14,,,,19,17,2,13,26,16,10,18,20,2,4,3,3,0,,,
"May 18, 2021 3:00 PM",54,20,34,39,25,14,66,50,16,36,25,11,,,,20,,,,30,27,3,20,46,31,15,31,37,3,1,7,1,6,,,
"May 18, 2021 4:00 PM",114,41,73,88,54,34,103,70,33,89,61,28,,,,29,,,,35,31,4,22,57,41,16,70,40,3,1,8,4,4,,,
"May 18, 2021 5:00 PM",137,34,103,78,47,31,127,79,48,79,41,38,,,,21,,,,45,43,2,29,53,37,16,86,70,2,4,10,7,3,,,
"May 18, 2021 6:00 PM",105,40,65,79,49,30,117,68,49,83,52,31,,,,11,,,,39,39,0,21,40,29,11,67,47,2,2,5,5,0,,,
"May 18, 2021 7:00 PM",87,31,56,54,33,21,76,42,34,55,27,28,,,,18,,,,39,38,1,19,31,20,11,46,23,2,3,3,1,2,,,
"May 18, 2021 8:00 PM",59,18,41,48,29,19,70,36,34,53,23,30,,,,18,,,,24,24,0,16,31,16,15,29,23,1,2,2,2,0,,,
"May 18, 2021 9:00 PM",21,4,17,20,9,11,40,13,27,23,10,13,,,,5,,,,13,13,0,8,14,5,9,13,15,1,0,2,2,0,,,
"May 18, 2021 10:00 PM",21,7,14,7,7,0,7,3,4,7,3,4,,,,0,,,,3,3,0,1,2,1,1,4,9,1,1,0,0,0,,,
"May 18, 2021 11:00 PM",5,2,3,4,0,4,2,2,0,1,1,0,,,,0,,,,3,3,0,1,4,4,0,3,3,1,0,0,0,0,,,
"May 19, 2021 12:00 AM",1,0,1,0,0,0,1,1,0,1,1,0,,,,3,,,,1,1,0,1,1,1,0,3,2,0,0,1,0,1,,,
"May 19, 2021 1:00 AM",3,0,3,8,4,4,0,0,0,0,0,0,,,,2,,,,1,1,0,1,1,0,1,1,0,0,0,0,0,0,,,
"May 19, 2021 2:00 AM",3,3,0,0,0,0,0,0,0,0,0,0,,,,1,,,,0,0,0,1,0,0,0,0,0,0,0,1,1,0,,,
"May 19, 2021 3:00 AM",0,0,0,0,0,0,1,1,0,0,0,0,,,,0,,,,1,1,0,1,1,0,1,2,0,0,0,0,0,0,,,
"May 19, 2021 4:00 AM",1,1,0,0,0,0,3,3,0,3,3,0,,,,1,,,,1,1,0,0,2,2,0,0,1,0,0,1,1,0,,,
"May 19, 2021 5:00 AM",5,3,2,12,7,5,15,12,3,16,10,6,,,,1,,,,3,3,0,5,2,1,1,6,5,0,1,1,1,0,,,
"May 19, 2021 6:00 AM",43,27,16,61,27,34,70,39,31,55,31,24,,,,6,,,,5,5,0,13,17,14,3,14,51,1,2,3,3,0,,,
"May 19, 2021 7:00 AM",111,69,42,123,48,75,171,70,101,100,40,60,,,,11,,,,21,19,2,72,59,24,35,59,86,2,4,7,6,1,,,
"May 19, 2021 8:00 AM",183,122,61,177,64,113,226,79,147,186,73,113,,,,34,,,,43,34,9,82,101,41,60,54,142,15,5,20,15,5,,,
"May 19, 2021 9:00 AM",101,70,31,137,73,64,150,88,62,128,78,50,,,,13,,,,19,14,5,48,46,21,25,35,66,5,6,6,4,2,,,
"May 19, 2021 10:00 AM",54,31,23,88,43,45,100,54,46,90,47,43,,,,13,,,,19,13,6,26,49,31,18,19,24,4,5,7,5,2,,,
"May 19, 2021 11:00 AM",58,29,29,83,41,42,101,41,60,98,50,48,,,,13,,,,24,22,2,17,40,15,25,28,37,2,6,6,5,1,,,
"May 19, 2021 12:00 PM",73,32,41,91,47,44,112,51,61,92,42,50,,,,17,,,,12,12,0,21,53,26,27,34,39,7,2,5,4,1,,,
"May 19, 2021 1:00 PM",78,32,46,125,72,53,140,86,54,124,83,41,,,,17,,,,27,23,4,32,48,29,19,68,43,10,5,12,5,7,,,
"May 19, 2021 2:00 PM",74,31,43,99,56,43,101,52,49,97,55,42,,,,33,,,,22,20,2,27,43,28,15,38,38,4,2,8,4,4,,,
"May 19, 2021 3:00 PM",87,34,53,95,52,43,142,95,47,82,50,32,,,,17,,,,31,25,6,32,71,48,23,47,47,9,4,4,4,0,,,
"May 19, 2021 4:00 PM",128,52,76,101,55,46,157,83,74,96,54,42,,,,11,,,,39,37,2,28,66,40,26,67,52,10,5,6,5,1,,,
"May 19, 2021 5:00 PM",175,63,112,124,63,61,208,134,74,133,80,53,,,,32,,,,49,48,1,37,75,51,24,120,80,11,14,2,1,1,,,
"May 19, 2021 6:00 PM",161,73,88,223,129,94,311,185,126,194,109,85,,,,29,,,,67,62,5,35,117,82,35,113,88,7,8,11,7,4,,,
"May 19, 2021 7:00 PM",88,38,50,202,107,95,279,137,142,197,113,84,,,,14,,,,44,42,2,24,80,42,38,96,80,7,8,10,5,5,,,
"May 19, 2021 8:00 PM",91,40,51,161,69,92,172,60,112,128,49,79,,,,15,,,,18,16,2,23,77,35,42,45,66,3,3,7,7,0,,,
"May 19, 2021 9:00 PM",55,21,34,83,38,45,104,28,76,79,23,56,,,,2,,,,22,21,1,12,44,14,30,22,46,5,7,6,4,2,,,
"May 19, 2021 10:00 PM",25,6,19,21,14,7,29,13,16,24,12,12,,,,0,,,,14,10,4,2,20,7,13,12,16,2,2,2,1,1,,,
"May 19, 2021 11:00 PM",12,1,11,4,1,3,7,1,6,3,1,2,,,,1,,,,2,1,1,1,1,0,1,3,10,0,1,4,2,2,,,
"May 20, 2021 12:00 AM",9,3,6,0,0,0,0,0,0,6,2,4,,,,2,,,,2,2,0,3,1,1,0,5,2,2,0,0,0,0,,,
"May 20, 2021 1:00 AM",3,1,2,1,1,0,5,1,4,1,1,0,,,,1,,,,2,2,0,1,1,0,1,1,0,2,1,1,1,0,,,
"May 20, 2021 2:00 AM",6,6,0,1,1,0,1,0,1,1,1,0,,,,1,,,,1,1,0,0,0,0,0,0,2,0,0,0,0,0,,,
"May 20, 2021 3:00 AM",3,1,2,0,0,0,1,1,0,1,1,0,,,,0,,,,0,0,0,0,1,1,0,0,0,0,0,0,0,0,,,
"May 20, 2021 4:00 AM",1,1,0,0,0,0,0,0,0,0,0,0,,,,0,,,,1,1,0,1,0,0,0,0,2,0,0,0,0,0,,,
"May 20, 2021 5:00 AM",4,3,1,2,1,1,2,2,0,5,3,2,,,,2,,,,2,2,0,5,0,0,0,1,4,0,0,0,0,0,,,
"May 20, 2021 6:00 AM",23,16,7,8,4,4,18,7,11,18,10,8,,,,5,,,,4,4,0,7,7,2,5,8,18,0,0,0,0,0,,,
"May 20, 2021 7:00 AM",54,32,22,22,10,12,32,12,20,24,8,16,,,,10,,,,6,5,1,34,13,4,9,19,35,2,1,1,1,0,,,
"May 20, 2021 8:00 AM",70,46,24,16,5,11,25,9,16,18,12,6,,,,10,,,,17,10,7,34,17,4,13,24,50,0,1,2,2,0,,,
"May 20, 2021 9:00 AM",33,20,13,6,3,3,10,5,5,9,6,3,,,,4,,,,8,6,2,7,7,4,3,12,14,0,0,0,0,0,,,
"May 20, 2021 10:00 AM",20,11,9,2,1,1,6,1,5,4,1,3,,,,2,,,,7,5,2,3,1,1,0,3,6,1,0,1,1,0,,,
"May 20, 2021 11:00 AM",13,6,7,5,3,2,5,4,1,3,2,1,,,,2,,,,3,3,0,1,5,4,1,2,8,0,0,0,0,0,,,
"May 20, 2021 12:00 PM",25,14,11,3,3,0,6,2,4,2,1,1,,,,4,,,,2,2,0,4,14,3,11,3,4,2,1,2,1,1,,,
"May 20, 2021 1:00 PM",20,10,10,4,2,2,9,6,3,6,4,2,,,,8,,,,3,2,1,8,4,4,0,12,11,0,0,2,1,1,,,
"May 20, 2021 2:00 PM",29,14,15,6,4,2,7,3,4,4,1,3,,,,4,,,,8,7,1,9,2,1,1,7,8,0,0,2,2,0,,,
"May 20, 2021 3:00 PM",36,12,24,15,10,5,29,23,6,14,12,2,,,,8,,,,5,5,0,14,21,14,7,17,22,0,0,5,4,1,,,
"May 20, 2021 4:00 PM",39,13,26,26,16,10,44,25,19,36,21,15,,,,13,,,,17,16,1,8,13,9,4,24,23,1,1,2,2,0,,,
"May 20, 2021 5:00 PM",80,27,53,33,16,17,55,34,21,43,22,21,,,,20,,,,27,26,1,19,25,17,8,31,28,4,0,6,4,2,,,
"May 20, 2021 6:00 PM",78,29,49,33,22,11,47,31,16,43,27,16,,,,8,,,,29,28,1,15,14,10,4,31,28,3,1,4,3,1,,,
"May 20, 2021 7:00 PM",40,16,24,29,18,11,58,29,29,28,18,10,,,,2,,,,17,16,1,8,16,12,4,22,22,0,2,4,3,1,,,
"May 20, 2021 8:00 PM",32,14,18,22,12,10,20,8,12,25,12,13,,,,6,,,,14,13,1,4,4,2,2,9,18,3,2,4,2,2,,,
"May 20, 2021 9:00 PM",23,7,16,8,2,6,16,4,12,8,2,6,,,,0,,,,0,0,0,3,3,3,0,4,13,0,0,4,2,2,,,
"May 20, 2021 10:00 PM",8,4,4,1,1,0,8,5,3,9,3,6,,,,0,,,,4,3,1,3,3,1,2,8,5,0,1,6,4,2,,,
"May 20, 2021 11:00 PM",5,1,4,2,1,1,3,2,1,3,2,1,,,,3,,,,1,1,0,3,0,0,0,0,3,0,0,0,0,0,,,
"May 21, 2021 12:00 AM",2,0,2,0,0,0,1,1,0,0,0,0,,,,1,,,,0,0,0,2,0,0,0,1,1,0,0,0,0,0,,,
"May 21, 2021 1:00 AM",0,0,0,3,3,0,0,0,0,0,0,0,,,,0,,,,0,0,0,1,0,0,0,0,0,1,0,0,0,0,,,
"May 21, 2021 2:00 AM",3,2,1,0,0,0,0,0,0,0,0,0,,,,1,,,,0,0,0,0,0,0,0,1,0,0,0,1,0,1,,,
"May 21, 2021 3:00 AM",0,0,0,0,0,0,0,0,0,0,0,0,,,,1,,,,0,0,0,0,0,0,0,0,0,0,0,0,0,0,,,
"May 21, 2021 4:00 AM",2,1,1,0,0,0,1,1,0,0,0,0,,,,0,,,,1,1,0,1,0,0,0,1,1,0,0,0,0,0,,,
"May 21, 2021 5:00 AM",6,4,2,2,2,0,14,14,0,3,3,0,,,,1,,,,1,1,0,5,0,0,0,11,2,1,0,0,0,0,,,
"May 21, 2021 6:00 AM",16,11,5,15,5,10,19,7,12,15,6,9,,,,1,,,,1,1,0,10,1,1,0,5,19,0,0,2,2,0,,,
"May 21, 2021 7:00 AM",47,29,18,18,7,11,30,8,22,21,7,14,,,,8,,,,6,5,1,32,17,7,10,22,39,0,1,3,1,2,,,
"May 21, 2021 8:00 AM",75,51,24,23,7,16,30,13,17,17,8,9,,,,7,,,,16,11,5,37,15,5,10,16,47,2,2,9,7,2,,,
"May 21, 2021 9:00 AM",50,33,17,28,13,15,24,15,9,21,14,7,,,,5,,,,8,7,1,21,17,12,5,16,23,1,0,1,1,0,,,
"May 21, 2021 10:00 AM",24,13,11,13,6,7,17,8,9,11,6,5,,,,3,,,,8,6,2,5,11,3,8,5,15,1,0,1,0,1,,,
"May 21, 2021 11:00 AM",29,13,16,9,7,2,14,9,5,15,10,5,,,,7,,,,6,2,4,5,7,7,0,7,12,1,1,0,0,0,,,
"May 21, 2021 12:00 PM",31,14,17,15,8,7,23,10,13,12,4,8,,,,4,,,,6,6,0,6,14,5,9,9,13,0,0,2,2,0,,,
"May 21, 2021 1:00 PM",39,18,21,14,9,5,19,7,12,18,9,9,,,,4,,,,11,8,3,3,13,12,1,9,6,0,1,3,3,0,,,
"May 21, 2021 2:00 PM",22,8,14,10,5,5,13,5,8,8,4,4,,,,11,,,,7,6,1,12,6,4,2,12,19,0,0,4,4,0,,,
"May 21, 2021 3:00 PM",37,17,20,26,13,13,32,17,15,18,9,9,,,,8,,,,10,10,0,9,22,15,7,14,31,2,0,6,4,2,,,
"May 21, 2021 4:00 PM",49,18,31,30,20,10,46,31,15,26,20,6,,,,2,,,,18,18,0,9,17,12,5,24,14,2,0,4,2,2,,,
"May 21, 2021 5:00 PM",94,36,58,53,34,19,60,33,27,43,21,22,,,,11,,,,30,29,1,17,19,7,12,39,30,2,1,5,3,2,,,
"May 21, 2021 6:00 PM",63,29,34,65,28,37,67,42,25,51,29,22,,,,10,,,,26,24,2,25,29,23,6,38,23,3,2,5,4,1,,,
"May 21, 2021 7:00 PM",69,24,45,34,24,10,49,24,25,36,18,18,,,,14,,,,16,15,1,12,24,12,12,30,21,1,3,2,1,1,,,
"May 21, 2021 8:00 PM",53,18,35,32,21,11,28,16,12,26,15,11,,,,9,,,,11,11,0,12,8,5,3,19,20,0,1,5,2,3,,,
"May 21, 2021 9:00 PM",40,13,27,18,13,5,17,9,8,9,4,5,,,,2,,,,6,6,0,10,9,5,4,6,15,6,0,5,4,1,,,
"May 21, 2021 10:00 PM",15,7,8,7,2,5,6,4,2,6,2,4,,,,1,,,,3,3,0,4,4,0,4,7,3,0,1,0,0,0,,,
"May 21, 2021 11:00 PM",6,3,3,7,5,2,3,2,1,4,3,1,,,,3,,,,4,4,0,1,0,0,0,6,5,0,0,1,1,0,,,
"May 22, 2021 12:00 AM",8,3,5,0,0,0,2,1,1,4,2,2,,,,2,,,,2,2,0,3,1,1,0,2,4,1,0,0,0,0,,,
"May 22, 2021 1:00 AM",3,2,1,1,1,0,0,0,0,0,0,0,,,,0,,,,4,4,0,0,0,0,0,1,1,0,0,0,0,0,,,
"May 22, 2021 2:00 AM",6,5,1,1,0,1,2,0,2,1,0,1,,,,0,,,,1,1,0,0,0,0,0,0,1,0,1,1,1,0,,,
"May 22, 2021 3:00 AM",1,0,1,0,0,0,0,0,0,0,0,0,,,,2,,,,2,1,1,0,0,0,0,0,0,0,0,0,0,0,,,
"May 22, 2021 4:00 AM",3,1,2,1,1,0,4,4,0,2,2,0,,,,0,,,,1,1,0,1,0,0,0,2,0,1,0,0,0,0,,,
"May 22, 2021 5:00 AM",2,1,1,2,1,1,5,4,1,2,1,1,,,,1,,,,0,0,0,0,0,0,0,4,1,0,0,0,0,0,,,
"May 22, 2021 6:00 AM",16,9,7,16,9,7,22,14,8,11,8,3,,,,4,,,,3,3,0,5,2,2,0,7,13,1,1,1,1,0,,,
"May 22, 2021 7:00 AM",30,10,20,58,39,19,68,43,25,54,34,20,,,,4,,,,5,4,1,17,21,16,5,26,31,2,3,0,0,0,,,
"May 22, 2021 8:00 AM",57,20,37,92,55,37,101,73,28,76,54,22,,,,10,,,,15,14,1,16,30,23,7,43,34,6,11,2,1,1,,,
"May 22, 2021 9:00 AM",69,36,33,152,92,60,198,104,94,148,87,61,,,,14,,,,21,16,5,22,52,32,20,61,49,6,15,1,0,1,,,
"May 22, 2021 10:00 AM",80,50,30,211,106,105,273,157,116,205,110,95,,,,27,,,,18,14,4,30,90,53,37,77,65,12,13,6,4,2,,,
"May 22, 2021 11:00 AM",84,45,39,255,136,119,296,142,154,241,136,105,,,,23,,,,32,28,4,33,102,52,50,72,84,16,9,11,5,6,,,
"May 22, 2021 12:00 PM",86,51,35,230,112,118,264,146,118,206,124,82,,,,21,,,,27,23,4,48,80,46,34,84,82,18,5,6,4,2,,,
"May 22, 2021 1:00 PM",85,51,34,160,74,86,211,105,106,175,95,80,,,,26,,,,34,29,5,34,66,39,27,55,82,5,6,9,7,2,,,
"May 22, 2021 2:00 PM",71,36,35,163,90,73,176,95,81,162,98,64,,,,34,,,,22,21,1,39,73,39,34,49,61,10,14,9,6,3,,,
"May 22, 2021 3:00 PM",73,46,27,204,115,89,180,86,94,177,100,77,,,,44,,,,21,15,6,23,97,61,36,54,62,11,5,9,7,2,,,
"May 22, 2021 4:00 PM",80,37,43,228,116,112,197,81,116,208,97,111,,,,40,,,,26,23,3,27,80,45,35,47,68,8,7,10,6,4,,,
"May 22, 2021 5:00 PM",79,38,41,166,98,68,146,66,80,149,70,79,,,,27,,,,17,16,1,26,87,41,46,29,50,9,3,14,10,4,,,
"May 22, 2021 6:00 PM",41,17,24,113,59,54,142,69,73,111,38,73,,,,19,,,,11,10,1,21,58,29,29,26,38,2,3,7,3,4,,,
"May 22, 2021 7:00 PM",57,35,22,70,40,30,80,47,33,67,35,32,,,,17,,,,16,13,3,14,34,18,16,20,22,3,1,3,3,0,,,
"May 22, 2021 8:00 PM",42,16,26,62,23,39,70,25,45,58,24,34,,,,8,,,,17,14,3,16,23,11,12,15,21,2,1,3,3,0,,,
"May 22, 2021 9:00 PM",28,13,15,22,11,11,45,11,34,29,11,18,,,,6,,,,7,6,1,14,22,8,14,9,13,2,1,9,7,2,,,
"May 22, 2021 10:00 PM",26,11,15,4,4,0,18,6,12,7,3,4,,,,1,,,,6,6,0,6,2,1,1,5,10,1,1,5,4,1,,,
"May 22, 2021 11:00 PM",13,6,7,2,1,1,7,3,4,6,2,4,,,,4,,,,9,8,1,0,4,1,3,4,7,0,0,1,0,1,,,
"May 23, 2021 12:00 AM",17,10,7,0,0,0,3,3,0,8,7,1,,,,2,,,,8,7,1,8,0,0,0,6,3,1,0,1,1,0,,,
"May 23, 2021 1:00 AM",4,1,3,6,0,6,7,3,4,4,1,3,,,,0,,,,9,7,2,4,2,0,2,2,5,0,1,1,0,1,,,
"May 23, 2021 2:00 AM",2,0,2,10,2,8,21,4,17,10,2,8,,,,0,,,,2,2,0,0,14,0,14,1,4,1,0,2,2,0,,,
"May 23, 2021 3:00 AM",1,1,0,0,0,0,3,1,2,2,2,0,,,,1,,,,2,2,0,2,0,0,0,0,3,2,0,2,2,0,,,
"May 23, 2021 4:00 AM",2,0,2,0,0,0,2,2,0,3,3,0,,,,0,,,,3,3,0,1,0,0,0,4,0,0,0,0,0,0,,,
"May 23, 2021 5:00 AM",2,1,1,5,3,2,6,4,2,5,3,2,,,,1,,,,1,1,0,0,2,1,1,1,1,0,0,1,1,0,,,
"May 23, 2021 6:00 AM",8,6,2,8,4,4,13,7,6,12,6,6,,,,4,,,,0,0,0,3,5,4,1,5,6,0,0,0,0,0,,,
"May 23, 2021 7:00 AM",14,3,11,25,14,11,40,23,17,26,18,8,,,,1,,,,2,1,1,9,13,6,7,13,15,0,1,0,0,0,,,
"May 23, 2021 8:00 AM",27,10,17,60,35,25,56,37,19,52,34,18,,,,4,,,,3,3,0,14,19,16,3,14,20,0,12,1,0,1,,,
"May 23, 2021 9:00 AM",31,15,16,103,68,35,86,56,30,78,52,26,,,,10,,,,11,8,3,12,27,13,14,27,22,1,8,3,3,0,,,
"May 23, 2021 10:00 AM",33,19,14,86,42,44,116,57,59,89,47,42,,,,8,,,,14,14,0,15,37,19,18,32,30,3,4,5,5,0,,,
"May 23, 2021 11:00 AM",27,13,14,38,15,23,50,20,30,33,13,20,,,,13,,,,6,5,1,11,18,8,10,11,23,10,1,0,0,0,,,
"May 23, 2021 12:00 PM",20,6,14,23,11,12,43,20,23,31,13,18,,,,5,,,,1,1,0,12,12,8,4,15,21,3,1,1,0,1,,,
"May 23, 2021 1:00 PM",33,15,18,49,21,28,37,23,14,38,27,11,,,,9,,,,6,5,1,11,10,8,2,21,15,1,2,1,1,0,,,
"May 23, 2021 2:00 PM",48,23,25,80,46,34,72,46,26,54,37,17,,,,13,,,,18,18,0,24,28,21,7,26,23,1,4,2,1,1,,,
"May 23, 2021 3:00 PM",55,37,18,105,57,48,110,61,49,94,59,35,,,,26,,,,17,14,3,19,41,20,21,24,37,8,5,4,2,2,,,
"May 23, 2021 4:00 PM",62,30,32,113,60,53,114,60,54,105,51,54,,,,18,,,,17,17,0,11,55,33,22,38,35,4,8,2,2,0,,,
"May 23, 2021 5:00 PM",38,14,24,96,49,47,121,60,61,93,43,50,,,,18,,,,19,13,6,11,66,31,35,18,42,2,1,3,2,1,,,
"May 23, 2021 6:00 PM",62,29,33,44,27,17,77,22,55,40,16,24,,,,9,,,,13,10,3,8,25,10,15,16,34,3,1,7,3,4,,,
"May 23, 2021 7:00 PM",26,12,14,15,9,6,16,3,13,9,2,7,,,,3,,,,4,4,0,8,9,4,5,17,14,3,0,1,0,1,,,
"May 23, 2021 8:00 PM",16,5,11,7,5,2,19,10,9,12,7,5,,,,4,,,,4,4,0,4,2,2,0,7,11,1,0,2,2,0,,,
"May 23, 2021 9:00 PM",12,4,8,7,2,5,9,3,6,11,3,8,,,,1,,,,2,1,1,9,2,1,1,3,5,1,0,0,0,0,,,
"May 23, 2021 10:00 PM",11,5,6,2,0,2,2,1,1,0,0,0,,,,1,,,,3,3,0,5,1,0,1,4,3,1,1,2,0,2,,,
"May 23, 2021 11:00 PM",4,2,2,0,0,0,0,0,0,0,0,0,,,,4,,,,3,3,0,0,1,1,0,1,1,0,1,2,1,1,,,
"May 24, 2021 12:00 AM",2,1,1,0,0,0,0,0,0,0,0,0,,,,2,,,,0,0,0,1,0,0,0,0,2,1,0,0,0,0,,,
"May 24, 2021 1:00 AM",0,0,0,0,0,0,0,0,0,0,0,0,,,,0,,,,0,0,0,0,0,0,0,1,1,0,0,1,1,0,,,
"May 24, 2021 2:00 AM",2,2,0,0,0,0,0,0,0,0,0,0,,,,1,,,,1,1,0,0,0,0,0,1,0,0,0,0,0,0,,,
"May 24, 2021 3:00 AM",0,0,0,0,0,0,0,0,0,0,0,0,,,,0,,,,0,0,0,0,0,0,0,0,1,0,0,1,1,0,,,
"May 24, 2021 4:00 AM",0,0,0,0,0,0,3,3,0,2,2,0,,,,0,,,,0,0,0,0,1,0,1,0,2,0,0,0,0,0,,,
"May 24, 2021 5:00 AM",6,5,1,6,3,3,6,5,1,6,4,2,,,,0,,,,2,2,0,7,3,3,0,2,8,0,0,0,0,0,,,
"May 24, 2021 6:00 AM",31,22,9,33,17,16,42,24,18,38,21,17,,,,3,,,,4,4,0,14,11,4,7,14,42,1,0,2,2,0,,,
"May 24, 2021 7:00 AM",77,43,34,64,30,34,84,29,55,66,26,40,,,,10,,,,18,15,3,71,25,11,14,38,70,3,4,7,5,2,,,
"May 24, 2021 8:00 AM",152,108,44,101,35,66,163,64,99,112,50,62,,,,31,,,,37,26,11,83,79,27,52,46,122,7,4,22,15,7,,,
"May 24, 2021 9:00 AM",91,59,32,77,36,41,104,56,48,78,37,41,,,,15,,,,22,17,5,33,47,22,25,32,47,2,2,2,1,1,,,
"May 24, 2021 10:00 AM",49,25,24,62,34,28,80,49,31,52,31,21,,,,10,,,,12,10,2,18,35,20,15,21,32,2,5,5,4,1,,,
"May 24, 2021 11:00 AM",50,32,18,86,53,33,101,58,43,73,46,27,,,,11,,,,12,9,3,17,58,33,25,24,28,4,5,3,2,1,,,
"May 24, 2021 12:00 PM",59,35,24,95,45,50,131,60,71,91,43,48,,,,16,,,,14,12,2,16,37,21,16,29,53,5,4,6,2,4,,,
"May 24, 2021 1:00 PM",62,37,25,69,37,32,98,43,55,60,27,33,,,,15,,,,25,24,1,13,31,18,13,41,36,5,3,6,5,1,,,
"May 24, 2021 2:00 PM",66,24,42,79,49,30,84,44,40,71,45,26,,,,15,,,,17,11,6,15,33,16,17,30,40,0,5,7,3,4,,,
"May 24, 2021 3:00 PM",67,21,46,85,57,28,85,51,34,75,49,26,,,,23,,,,28,23,5,18,39,26,13,27,45,2,7,5,2,3,,,
"May 24, 2021 4:00 PM",99,38,61,86,49,37,114,74,40,82,52,30,,,,14,,,,38,35,3,25,51,39,12,54,33,12,4,8,5,3,,,
"May 24, 2021 5:00 PM",151,42,109,167,94,73,163,91,72,138,76,62,,,,94,,,,54,54,0,20,63,38,25,91,66,5,13,7,1,6,,,
"May 24, 2021 6:00 PM",127,40,87,166,107,59,173,120,53,157,97,60,,,,21,,,,56,52,4,32,61,44,17,76,53,5,7,9,6,3,,,
"May 24, 2021 7:00 PM",97,43,54,163,86,77,188,88,100,178,90,88,,,,26,,,,36,36,0,25,69,42,27,55,74,9,3,8,6,2,,,
"May 24, 2021 8:00 PM",66,38,28,121,55,66,140,65,75,114,52,62,,,,8,,,,18,18,0,20,48,27,21,29,42,4,4,7,4,3,,,
"May 24, 2021 9:00 PM",36,17,19,44,22,22,64,23,41,48,19,29,,,,10,,,,14,13,1,9,19,10,9,22,18,7,2,5,4,1,,,
"May 24, 2021 10:00 PM",20,8,12,20,8,12,23,6,17,18,5,13,,,,3,,,,7,7,0,2,5,1,4,11,13,2,0,1,1,0,,,
"May 24, 2021 11:00 PM",9,1,8,1,1,0,2,2,0,1,0,1,,,,5,,,,2,2,0,1,2,1,1,3,2,0,1,3,3,0,,,
"May 25, 2021 12:00 AM",9,5,4,4,0,4,0,0,0,0,0,0,,,,0,,,,4,4,0,0,2,0,2,5,2,0,0,0,0,0,,,
"May 25, 2021 1:00 AM",3,0,3,2,0,2,2,1,1,4,1,3,,,,0,,,,0,0,0,0,2,2,0,1,1,0,0,0,0,0,,,
"May 25, 2021 2:00 AM",8,6,2,0,0,0,0,0,0,1,0,1,,,,0,,,,1,1,0,2,0,0,0,1,0,0,0,0,0,0,,,
"May 25, 2021 3:00 AM",2,0,2,0,0,0,1,0,1,2,2,0,,,,1,,,,0,0,0,1,0,0,0,0,1,0,0,0,0,0,,,
"May 25, 2021 4:00 AM",0,0,0,1,0,1,5,4,1,3,2,1,,,,0,,,,2,2,0,0,0,0,0,0,2,0,0,0,0,0,,,
"May 25, 2021 5:00 AM",5,5,0,2,2,0,5,3,2,6,4,2,,,,3,,,,2,2,0,9,0,0,0,9,7,2,0,0,0,0,,,
"May 25, 2021 6:00 AM",31,18,13,59,42,17,52,37,15,61,39,22,,,,7,,,,8,7,1,17,15,13,2,21,44,1,2,5,5,0,,,
"May 25, 2021 7:00 AM",115,73,42,117,36,81,133,45,88,107,40,67,,,,15,,,,27,21,6,65,63,26,37,49,98,5,4,8,7,1,,,
"May 25, 2021 8:00 AM",196,130,66,123,40,83,188,59,129,137,50,87,,,,41,,,,36,27,9,95,90,32,58,49,140,9,9,18,14,4,,,
"May 25, 2021 9:00 AM",91,59,32,73,38,35,95,57,38,89,52,37,,,,20,,,,22,17,5,39,32,17,15,28,44,4,5,11,8,3,,,
"May 25, 2021 10:00 AM",38,24,14,67,31,36,83,45,38,51,28,23,,,,13,,,,7,3,4,24,34,21,13,28,32,1,3,2,1,1,,,
"May 25, 2021 11:00 AM",52,29,23,72,42,30,74,43,31,57,37,20,,,,12,,,,16,14,2,25,23,14,9,14,26,5,1,3,2,1,,,
"May 25, 2021 12:00 PM",70,46,24,76,40,36,82,45,37,59,32,27,,,,18,,,,14,13,1,19,30,21,9,25,25,9,4,5,4,1,,,
"May 25, 2021 1:00 PM",74,41,33,79,46,33,100,51,49,70,40,30,,,,15,,,,16,12,4,22,42,26,16,33,37,6,2,4,2,2,,,
"May 25, 2021 2:00 PM",44,16,28,50,26,24,92,48,44,51,31,20,,,,19,,,,11,9,2,13,31,19,12,24,29,5,4,5,3,2,,,
"May 25, 2021 3:00 PM",60,23,37,43,25,18,66,46,20,49,27,22,,,,11,,,,28,26,2,10,26,19,7,30,40,3,4,9,3,6,,,
"May 25, 2021 4:00 PM",87,35,52,53,33,20,84,39,45,60,35,25,,,,16,,,,36,35,1,22,37,28,9,52,43,3,2,3,3,0,,,
"May 25, 2021 5:00 PM",154,52,102,76,36,40,98,59,39,90,49,41,,,,23,,,,55,53,2,35,34,26,8,81,68,4,8,8,7,1,,,
"May 25, 2021 6:00 PM",105,37,68,131,87,44,129,84,45,115,67,48,,,,21,,,,55,52,3,29,52,39,13,90,51,4,1,1,1,0,,,
"May 25, 2021 7:00 PM",95,32,63,73,47,26,99,61,38,82,48,34,,,,20,,,,44,42,2,27,39,26,13,59,42,5,3,4,3,1,,,
"May 25, 2021 8:00 PM",79,30,49,88,47,41,92,42,50,76,36,40,,,,16,,,,19,19,0,16,37,14,23,32,42,2,6,5,2,3,,,
"May 25, 2021 9:00 PM",34,15,19,42,26,16,43,19,24,35,19,16,,,,7,,,,17,17,0,7,14,11,3,15,23,2,1,5,2,3,,,
"May 25, 2021 10:00 PM",18,10,8,14,9,5,16,9,7,12,4,8,,,,6,,,,13,10,3,5,5,3,2,6,11,1,1,1,1,0,,,
"May 25, 2021 11:00 PM",9,5,4,5,0,5,5,0,5,4,0,4,,,,0,,,,1,1,0,0,12,4,8,1,3,0,2,2,2,0,,,
"May 26, 2021 12:00 AM",3,1,2,0,0,0,3,0,3,4,1,3,,,,0,,,,0,0,0,1,0,0,0,2,4,0,0,0,0,0,,,
"May 26, 2021 1:00 AM",1,1,0,0,0,0,0,0,0,0,0,0,,,,0,,,,0,0,0,0,0,0,0,1,1,0,0,0,0,0,,,
"May 26, 2021 2:00 AM",2,2,0,0,0,0,0,0,0,0,0,0,,,,0,,,,1,1,0,1,0,0,0,0,0,0,0,0,0,0,,,
"May 26, 2021 3:00 AM",0,0,0,0,0,0,1,1,0,0,0,0,,,,0,,,,3,2,1,1,0,0,0,1,1,0,0,0,0,0,,,
"May 26, 2021 4:00 AM",2,1,1,0,0,0,3,3,0,1,1,0,,,,0,,,,2,2,0,0,0,0,0,0,1,0,0,0,0,0,,,
"May 26, 2021 5:00 AM",6,5,1,4,1,3,7,3,4,8,5,3,,,,2,,,,1,1,0,3,0,0,0,6,8,2,0,1,1,0,,,
"May 26, 2021 6:00 AM",36,20,16,66,47,19,62,43,19,55,42,13,,,,5,,,,8,8,0,18,18,13,5,17,43,1,0,1,1,0,,,
"May 26, 2021 7:00 AM",114,70,44,128,50,78,126,54,72,128,57,71,,,,14,,,,22,18,4,64,45,20,25,56,85,5,6,5,4,1,,,
"May 26, 2021 8:00 AM",175,110,65,137,47,90,184,64,120,150,55,95,,,,30,,,,40,28,12,89,81,27,54,54,127,9,5,21,18,3,,,
"May 26, 2021 9:00 AM",89,63,26,90,40,50,118,59,59,91,51,40,,,,19,,,,21,16,5,43,54,28,26,29,65,4,8,8,4,4,,,
"May 26, 2021 10:00 AM",59,35,24,121,79,42,116,80,36,107,75,32,,,,12,,,,22,17,5,26,47,30,17,36,32,3,3,3,3,0,,,
"May 26, 2021 11:00 AM",64,38,26,130,80,50,155,89,66,124,71,53,,,,19,,,,18,17,1,23,65,38,27,49,34,4,10,2,1,1,,,
"May 26, 2021 12:00 PM",68,37,31,153,82,71,204,113,91,135,75,60,,,,24,,,,17,14,3,21,76,52,24,61,48,7,3,7,5,2,,,
"May 26, 2021 1:00 PM",97,55,42,127,68,59,196,107,89,135,78,57,,,,36,,,,17,15,2,35,109,52,57,58,52,11,6,7,4,3,,,
"May 26, 2021 2:00 PM",69,22,47,128,66,62,130,57,73,110,53,57,,,,34,,,,29,25,4,16,63,38,25,42,46,5,3,10,8,2,,,
"May 26, 2021 3:00 PM",77,28,49,103,53,50,149,88,61,96,64,32,,,,19,,,,26,22,4,24,57,37,20,35,63,12,5,9,7,2,,,
"May 26, 2021 4:00 PM",129,50,79,127,66,61,155,77,78,138,78,60,,,,30,,,,47,46,1,36,80,48,32,69,58,8,4,13,9,4,,,
"May 26, 2021 5:00 PM",188,68,120,213,116,97,240,148,92,190,115,75,,,,43,,,,61,57,4,53,93,56,37,94,92,8,10,10,9,1,,,
"May 26, 2021 6:00 PM",159,60,99,277,164,113,292,173,119,257,136,121,,,,83,,,,77,74,3,41,127,93,34,123,93,9,11,3,1,2,,,
"May 26, 2021 7:00 PM",105,41,64,245,125,120,243,129,114,229,123,106,,,,44,,,,47,46,1,28,103,53,50,82,83,12,6,9,4,5,,,
"May 26, 2021 8:00 PM",85,32,53,220,89,131,207,80,127,207,78,129,,,,18,,,,30,27,3,14,56,28,28,43,76,9,5,12,6,6,,,
"May 26, 2021 9:00 PM",45,15,30,83,39,44,124,38,86,79,31,48,,,,21,,,,20,18,2,23,49,12,37,29,39,4,3,7,6,1,,,
"May 26, 2021 10:00 PM",29,10,19,39,23,16,30,6,24,26,11,15,,,,4,,,,14,11,3,6,13,3,10,8,10,2,2,5,5,0,,,
"May 26, 2021 11:00 PM",16,7,9,13,3,10,19,5,14,9,3,6,,,,4,,,,6,6,0,3,7,4,3,2,7,0,0,1,1,0,,,
"May 27, 2021 12:00 AM",2,2,0,0,0,0,1,1,0,6,5,1,,,,2,,,,4,3,1,0,2,1,1,6,3,0,0,0,0,0,,,
"May 27, 2021 1:00 AM",1,0,1,0,0,0,3,1,2,2,2,0,,,,0,,,,2,2,0,1,0,0,0,0,1,0,2,0,0,0,,,
"May 27, 2021 2:00 AM",5,2,3,1,0,1,2,1,1,4,1,3,,,,0,,,,0,0,0,0,0,0,0,0,0,1,0,0,0,0,,,
"May 27, 2021 3:00 AM",1,0,1,0,0,0,0,0,0,0,0,0,,,,2,,,,0,0,0,0,0,0,0,1,1,0,0,0,0,0,,,
"May 27, 2021 4:00 AM",2,1,1,1,0,1,1,1,0,1,1,0,,,,0,,,,2,2,0,2,0,0,0,0,1,0,0,0,0,0,,,
"May 27, 2021 5:00 AM",3,3,0,5,2,3,7,5,2,7,6,1,,,,0,,,,1,1,0,8,0,0,0,3,5,1,0,0,0,0,,,
"May 27, 2021 6:00 AM",38,23,15,45,27,18,47,30,17,38,24,14,,,,7,,,,11,10,1,14,13,10,3,20,47,0,4,1,1,0,,,
"May 27, 2021 7:00 AM",109,66,43,121,56,65,124,49,75,110,45,65,,,,17,,,,22,18,4,62,51,25,26,45,87,6,6,7,7,0,,,
"May 27, 2021 8:00 AM",175,117,58,151,56,95,182,73,109,153,67,86,,,,32,,,,42,34,8,97,80,21,59,63,113,12,5,15,15,0,,,
"May 27, 2021 9:00 AM",73,52,21,105,58,47,118,68,50,102,58,44,,,,25,,,,29,22,7,56,49,29,20,28,61,1,5,7,5,2,,,
"May 27, 2021 10:00 AM",74,46,28,87,43,44,119,66,53,86,47,39,,,,10,,,,17,12,5,23,41,30,11,36,48,7,4,2,1,1,,,
"May 27, 2021 11:00 AM",56,28,28,111,53,58,167,92,75,120,74,46,,,,18,,,,17,15,2,22,60,35,25,33,40,3,2,7,6,1,,,
"May 27, 2021 12:00 PM",77,44,33,102,58,44,158,87,71,106,52,54,,,,29,,,,16,14,2,16,70,39,31,35,43,12,2,4,3,1,,,
"May 27, 2021 1:00 PM",85,41,44,102,43,59,181,82,99,104,45,59,,,,27,,,,24,20,4,37,62,34,28,36,50,6,1,15,9,6,,,
"May 27, 2021 2:00 PM",75,37,38,88,41,47,119,55,64,89,48,41,,,,17,,,,22,20,2,22,57,29,28,48,50,5,6,8,5,3,,,
"May 27, 2021 3:00 PM",77,33,44,82,46,36,128,66,62,93,53,40,,,,27,,,,40,37,3,24,52,33,19,51,42,5,1,4,2,2,,,
"May 27, 2021 4:00 PM",86,26,60,53,26,27,88,54,34,57,36,21,,,,16,,,,50,49,1,27,34,22,12,61,56,0,2,6,3,3,,,
"May 27, 2021 5:00 PM",139,55,84,76,29,47,90,58,32,69,47,22,,,,32,,,,40,37,3,23,35,23,12,82,45,4,4,3,1,2,,,
"May 27, 2021 6:00 PM",116,38,78,62,37,25,81,48,33,55,31,24,,,,16,,,,50,49,1,26,24,18,6,64,52,5,2,8,4,4,,,
"May 27, 2021 7:00 PM",73,21,52,42,28,14,56,33,23,54,30,24,,,,7,,,,36,35,1,19,29,23,6,37,28,4,5,8,4,4,,,
"May 27, 2021 8:00 PM",58,24,34,45,28,17,51,30,21,37,21,16,,,,10,,,,19,19,0,10,16,10,6,24,24,0,1,1,0,1,,,
"May 27, 2021 9:00 PM",33,13,20,49,36,13,31,12,19,42,19,23,,,,1,,,,16,15,1,9,14,6,8,14,18,0,1,1,0,1,,,
"May 27, 2021 10:00 PM",18,9,9,17,11,6,20,7,13,19,6,13,,,,0,,,,4,3,1,4,7,1,6,9,9,1,1,7,5,2,,,
"May 27, 2021 11:00 PM",15,7,8,2,2,0,5,3,2,4,2,2,,,,1,,,,5,5,0,2,3,3,0,3,2,0,0,2,2,0,,,
"May 28, 2021 12:00 AM",5,3,2,0,0,0,0,0,0,0,0,0,,,,0,,,,3,3,0,2,3,3,0,1,2,0,0,0,0,0,,,
"May 28, 2021 1:00 AM",0,0,0,1,0,1,1,0,1,1,0,1,,,,0,,,,0,0,0,0,0,0,0,0,1,0,0,0,0,0,,,
"May 28, 2021 2:00 AM",3,2,1,0,0,0,0,0,0,0,0,0,,,,1,,,,0,0,0,0,0,0,0,0,0,0,0,0,0,0,,,
"May 28, 2021 3:00 AM",0,0,0,0,0,0,0,0,0,0,0,0,,,,0,,,,0,0,0,0,0,0,0,0,1,0,0,1,0,1,,,
"May 28, 2021 4:00 AM",1,1,0,0,0,0,1,1,0,0,0,0,,,,0,,,,1,1,0,0,1,0,1,0,0,0,0,0,0,0,,,
"May 28, 2021 5:00 AM",6,5,1,1,0,1,4,2,2,7,2,5,,,,0,,,,2,2,0,3,0,0,0,2,5,1,0,1,1,0,,,
"May 28, 2021 6:00 AM",26,17,9,16,10,6,17,9,8,21,14,7,,,,2,,,,8,7,1,8,5,5,0,12,30,0,0,0,0,0,,,
"May 28, 2021 7:00 AM",53,33,20,34,11,23,48,15,33,38,14,24,,,,7,,,,12,10,2,29,20,5,15,33,48,1,4,3,2,1,,,
"May 28, 2021 8:00 AM",94,64,30,33,13,20,39,17,22,36,17,19,,,,12,,,,17,12,5,56,24,5,19,21,56,5,3,10,10,0,,,
"May 28, 2021 9:00 AM",49,35,14,24,11,13,31,17,14,28,17,11,,,,7,,,,15,14,1,24,17,9,8,14,28,2,1,2,1,1,,,
"May 28, 2021 10:00 AM",43,25,18,16,10,6,26,13,13,15,9,6,,,,6,,,,9,5,4,10,12,10,2,14,16,0,1,0,0,0,,,
"May 28, 2021 11:00 AM",29,18,11,22,10,12,35,21,14,17,12,5,,,,12,,,,9,6,3,12,11,7,4,15,21,3,1,2,1,1,,,
"May 28, 2021 12:00 PM",56,33,23,26,13,13,50,31,19,30,16,14,,,,12,,,,13,11,2,11,16,12,4,23,25,3,0,4,3,1,,,
"May 28, 2021 1:00 PM",73,32,41,38,27,11,66,41,25,47,29,18,,,,8,,,,18,17,1,21,20,15,5,21,22,1,2,2,2,0,,,
"May 28, 2021 2:00 PM",51,28,23,17,12,5,40,21,19,26,15,11,,,,4,,,,17,14,3,14,22,14,8,23,31,5,1,7,5,2,,,
"May 28, 2021 3:00 PM",65,24,41,28,16,12,67,46,21,39,18,21,,,,10,,,,15,14,1,15,23,18,5,29,26,7,2,8,5,3,,,
"May 28, 2021 4:00 PM",66,27,39,48,28,20,80,42,38,55,37,18,,,,21,,,,22,21,1,22,23,16,7,32,35,5,2,9,4,5,,,
"May 28, 2021 5:00 PM",119,51,68,68,34,34,82,45,37,61,35,26,,,,14,,,,30,29,1,25,40,27,13,46,41,8,4,7,7,0,,,
"May 28, 2021 6:00 PM",84,33,51,78,35,43,82,51,31,73,36,37,,,,16,,,,42,40,2,23,23,16,7,48,33,2,4,8,6,2,,,
"May 28, 2021 7:00 PM",63,24,39,47,29,18,65,35,30,46,25,21,,,,24,,,,23,23,0,15,29,18,11,36,32,1,0,6,2,4,,,
"May 28, 2021 8:00 PM",68,30,38,40,24,16,59,26,33,35,19,16,,,,15,,,,23,21,2,14,15,10,5,16,26,6,1,1,1,0,,,
"May 28, 2021 9:00 PM",33,13,20,24,12,12,37,12,25,18,5,13,,,,12,,,,14,11,3,6,19,4,15,9,15,3,2,2,2,0,,,
"May 28, 2021 10:00 PM",33,14,19,14,5,9,17,9,8,15,7,8,,,,3,,,,5,4,1,3,6,5,1,7,11,2,1,1,1,0,,,
"May 28, 2021 11:00 PM",11,2,9,12,8,4,8,4,4,4,1,3,,,,6,,,,3,3,0,2,3,1,2,7,10,2,0,2,1,1,,,
"May 29, 2021 12:00 AM",8,3,5,0,0,0,2,1,1,5,4,1,,,,3,,,,5,5,0,3,1,0,1,1,6,0,0,0,0,0,,,
"May 29, 2021 1:00 AM",2,1,1,3,3,0,3,2,1,4,3,1,,,,4,,,,3,3,0,0,1,1,0,3,3,0,0,0,0,0,,,
"May 29, 2021 2:00 AM",10,6,4,0,0,0,1,0,1,4,1,3,,,,0,,,,0,0,0,0,0,0,0,2,4,0,0,1,0,1,,,
"May 29, 2021 3:00 AM",3,0,3,1,1,0,4,1,3,4,1,3,,,,1,,,,1,1,0,3,1,1,0,0,1,0,0,0,0,0,,,
"May 29, 2021 4:00 AM",1,0,1,4,4,0,4,4,0,5,5,0,,,,0,,,,2,2,0,0,4,4,0,0,1,0,0,0,0,0,,,
"May 29, 2021 5:00 AM",3,1,2,1,1,0,4,2,2,2,1,1,,,,1,,,,3,3,0,1,1,0,1,3,3,0,1,0,0,0,,,
"May 29, 2021 6:00 AM",10,5,5,8,4,4,14,10,4,8,6,2,,,,1,,,,3,3,0,1,1,1,0,5,11,0,1,0,0,0,,,
"May 29, 2021 7:00 AM",20,7,13,58,31,27,53,32,21,51,33,18,,,,2,,,,6,5,1,14,5,3,2,23,28,0,1,0,0,0,,,
"May 29, 2021 8:00 AM",34,13,21,122,65,57,106,56,50,98,59,39,,,,10,,,,20,19,1,15,43,28,15,27,47,4,4,4,0,4,,,
"May 29, 2021 9:00 AM",56,35,21,163,90,73,139,81,58,127,77,50,,,,16,,,,19,16,3,31,47,31,16,45,49,4,13,5,4,1,,,
"May 29, 2021 10:00 AM",78,47,31,179,110,69,192,118,74,181,121,60,,,,47,,,,17,14,3,23,71,52,19,62,55,12,15,4,4,0,,,
"May 29, 2021 11:00 AM",86,46,40,198,116,82,245,150,95,186,120,66,,,,31,,,,28,22,6,29,91,56,35,87,64,14,3,13,9,4,,,
"May 29, 2021 12:00 PM",92,58,34,353,185,168,341,199,142,287,180,107,,,,34,,,,37,34,3,42,119,82,37,104,112,18,8,8,6,2,,,
"May 29, 2021 1:00 PM",129,57,72,239,112,127,359,204,155,257,154,103,,,,24,,,,28,25,3,35,126,84,42,113,91,10,9,9,5,4,,,
"May 29, 2021 2:00 PM",85,43,42,248,121,127,404,236,168,255,152,103,,,,32,,,,24,21,3,45,183,117,66,92,92,18,7,9,6,3,,,
"May 29, 2021 3:00 PM",98,50,48,264,138,126,416,207,209,279,128,151,,,,28,,,,21,21,0,36,165,94,71,91,106,10,14,8,7,1,,,
"May 29, 2021 4:00 PM",99,47,52,253,116,137,354,136,218,249,111,138,,,,29,,,,21,17,4,32,127,51,76,57,101,11,7,15,12,3,,,
"May 29, 2021 5:00 PM",80,42,38,194,112,82,258,109,149,185,81,104,,,,24,,,,24,23,1,34,104,43,61,58,75,5,5,7,6,1,,,
"May 29, 2021 6:00 PM",84,31,53,163,79,84,202,74,128,157,61,96,,,,25,,,,26,24,2,40,87,34,53,42,69,1,6,7,3,4,,,
"May 29, 2021 7:00 PM",47,25,22,134,59,75,148,48,100,127,41,86,,,,19,,,,16,13,3,25,70,25,45,28,63,4,4,5,4,1,,,
"May 29, 2021 8:00 PM",46,17,29,63,25,38,83,30,53,51,17,34,,,,20,,,,17,17,0,19,48,16,32,23,30,1,5,5,3,2,,,
"May 29, 2021 9:00 PM",44,16,28,51,17,34,56,21,35,42,17,25,,,,6,,,,13,13,0,20,19,5,14,5,21,0,4,5,4,1,,,
"May 29, 2021 10:00 PM",28,10,18,19,8,11,27,13,14,24,10,14,,,,4,,,,4,3,1,11,18,8,10,11,27,3,2,3,3,0,,,
"May 29, 2021 11:00 PM",24,10,14,10,3,7,12,3,9,8,2,6,,,,2,,,,13,13,0,7,6,2,4,8,7,1,2,2,1,1,,,
"May 30, 2021 12:00 AM",16,4,12,2,2,0,4,3,1,5,4,1,,,,7,,,,2,2,0,7,2,1,1,7,8,0,0,1,1,0,,,
"May 30, 2021 1:00 AM",7,1,6,3,2,1,8,2,6,3,0,3,,,,3,,,,5,5,0,6,1,1,0,6,3,0,0,1,1,0,,,
"May 30, 2021 2:00 AM",5,0,5,3,2,1,5,4,1,4,3,1,,,,2,,,,4,4,0,2,1,1,0,1,3,0,0,1,1,0,,,
"May 30, 2021 3:00 AM",1,0,1,0,0,0,0,0,0,0,0,0,,,,3,,,,1,1,0,0,1,1,0,2,3,0,0,0,0,0,,,
"May 30, 2021 4:00 AM",2,0,2,4,3,1,4,4,0,7,5,2,,,,1,,,,2,2,0,0,7,7,0,2,0,0,0,0,0,0,,,
"May 30, 2021 5:00 AM",1,1,0,0,0,0,9,4,5,3,1,2,,,,1,,,,2,2,0,1,4,0,4,3,6,0,0,1,1,0,,,
"May 30, 2021 6:00 AM",6,3,3,18,15,3,19,16,3,19,15,4,,,,2,,,,2,2,0,2,9,8,1,6,9,0,0,0,0,0,,,
"May 30, 2021 7:00 AM",30,14,16,87,49,38,86,50,36,74,49,25,,,,3,,,,9,5,4,20,19,9,10,29,28,0,4,2,2,0,,,
"May 30, 2021 8:00 AM",51,16,35,135,80,55,140,95,45,132,89,43,,,,13,,,,17,14,3,17,32,21,11,50,37,2,17,0,0,0,,,
"May 30, 2021 9:00 AM",69,32,37,246,156,90,199,125,74,200,138,62,,,,17,,,,18,16,2,23,79,55,24,56,77,6,13,8,5,3,,,
"May 30, 2021 10:00 AM",92,44,48,320,197,123,321,230,91,306,211,95,,,,21,,,,19,18,1,31,121,91,30,113,96,8,24,11,8,3,,,
"May 30, 2021 11:00 AM",96,52,44,350,205,145,391,220,171,340,200,140,,,,32,,,,26,24,2,33,146,86,60,120,105,13,10,7,6,1,,,
"May 30, 2021 12:00 PM",131,75,56,404,217,187,499,305,194,422,258,164,,,,34,,,,32,27,5,32,175,125,50,135,121,20,22,13,9,4,,,
"May 30, 2021 1:00 PM",106,54,52,415,260,155,494,325,169,399,275,124,,,,26,,,,37,36,1,31,189,139,50,170,114,18,11,16,13,3,,,
"May 30, 2021 2:00 PM",113,69,44,479,270,209,680,434,246,483,301,182,,,,32,,,,40,34,6,42,243,179,64,220,116,13,8,13,10,3,,,
"May 30, 2021 3:00 PM",89,41,48,460,259,201,683,416,267,414,261,153,,,,28,,,,34,31,3,28,242,162,80,158,127,15,6,17,13,4,,,
"May 30, 2021 4:00 PM",114,62,52,414,228,186,576,243,333,376,161,215,,,,41,,,,21,20,1,42,196,73,123,101,116,16,7,15,11,4,,,
"May 30, 2021 5:00 PM",67,29,38,361,132,229,520,189,331,325,118,207,,,,26,,,,20,19,1,27,188,54,134,66,190,8,2,19,15,4,,,
"May 30, 2021 6:00 PM",60,19,41,273,116,157,421,89,332,293,78,215,,,,14,,,,21,17,4,31,122,43,79,43,173,4,4,10,10,0,,,
"May 30, 2021 7:00 PM",62,30,32,147,56,91,225,71,154,157,62,95,,,,29,,,,16,15,1,25,93,33,60,32,109,6,2,15,9,6,,,
"May 30, 2021 8:00 PM",50,15,35,122,39,83,155,60,95,101,36,65,,,,7,,,,24,21,3,30,71,20,51,17,53,7,4,10,9,1,,,
"May 30, 2021 9:00 PM",54,26,28,91,37,54,92,25,67,68,27,41,,,,8,,,,8,8,0,20,40,5,35,18,51,0,1,3,3,0,,,
"May 30, 2021 10:00 PM",22,11,11,27,16,11,30,8,22,32,16,16,,,,10,,,,11,10,1,11,18,7,11,4,23,1,1,5,4,1,,,
"May 30, 2021 11:00 PM",16,8,8,4,4,0,12,2,10,5,3,2,,,,8,,,,3,3,0,4,3,0,3,4,3,2,2,1,0,1,,,
"May 31, 2021 12:00 AM",5,2,3,0,0,0,1,0,1,4,1,3,,,,2,,,,2,2,0,1,0,0,0,1,3,0,0,1,0,1,,,
"May 31, 2021 1:00 AM",3,2,1,3,3,0,4,0,4,8,3,5,,,,1,,,,3,3,0,1,0,0,0,1,0,0,1,0,0,0,,,
"May 31, 2021 2:00 AM",3,1,2,3,1,2,1,1,0,3,3,0,,,,2,,,,1,0,1,0,2,1,1,1,2,0,0,0,0,0,,,
"May 31, 2021 3:00 AM",1,0,1,0,0,0,3,2,1,2,1,1,,,,1,,,,1,1,0,0,0,0,0,1,4,0,0,0,0,0,,,
"May 31, 2021 4:00 AM",0,0,0,0,0,0,21,19,2,0,0,0,,,,0,,,,1,1,0,2,8,8,0,4,1,0,0,0,0,0,,,
"May 31, 2021 5:00 AM",4,3,1,3,3,0,10,7,3,8,7,1,,,,0,,,,0,0,0,7,1,1,0,6,8,0,0,0,0,0,,,
"May 31, 2021 6:00 AM",41,25,16,62,31,31,55,29,26,50,30,20,,,,2,,,,8,7,1,22,22,12,10,13,42,1,0,4,3,1,,,
"May 31, 2021 7:00 AM",104,65,39,112,46,66,128,51,77,100,47,53,,,,15,,,,20,18,2,69,38,16,22,46,83,4,2,6,2,4,,,
"May 31, 2021 8:00 AM",155,104,51,163,68,95,202,92,110,152,71,81,,,,33,,,,25,15,10,88,101,38,63,46,110,2,3,7,7,0,,,
"May 31, 2021 9:00 AM",105,71,34,126,59,67,139,77,62,118,64,54,,,,22,,,,22,17,5,56,60,30,30,46,60,2,0,1,1,0,,,
"May 31, 2021 10:00 AM",62,33,29,115,67,48,112,61,51,107,66,41,,,,10,,,,12,7,5,29,46,28,18,33,50,6,7,8,4,4,,,
"May 31, 2021 11:00 AM",56,36,20,149,88,61,176,115,61,137,83,54,,,,14,,,,19,18,1,22,79,60,19,44,38,10,7,12,4,8,,,
"May 31, 2021 12:00 PM",96,50,46,187,100,87,229,132,97,173,103,70,,,,35,,,,17,16,1,25,88,54,34,48,59,9,4,7,5,2,,,
"May 31, 2021 1:00 PM",89,44,45,184,102,82,239,122,117,167,93,74,,,,18,,,,25,23,2,32,98,40,58,62,42,9,7,6,5,1,,,
"May 31, 2021 2:00 PM",84,42,42,182,96,86,250,142,108,176,100,76,,,,23,,,,34,28,6,33,90,62,28,75,68,11,3,10,5,5,,,
"May 31, 2021 3:00 PM",90,39,51,177,89,88,283,182,101,197,115,82,,,,39,,,,35,35,0,27,105,68,37,73,64,6,6,9,9,0,,,
"May 31, 2021 4:00 PM",126,42,84,175,96,79,372,214,158,182,94,88,,,,38,,,,52,47,5,30,156,104,52,105,96,11,3,12,9,3,,,
"May 31, 2021 5:00 PM",199,66,133,250,142,108,550,312,238,275,169,106,,,,36,,,,79,75,4,33,208,115,93,142,97,5,11,12,7,5,,,
"May 31, 2021 6:00 PM",173,63,110,269,135,134,572,311,261,300,154,146,,,,57,,,,66,64,2,51,165,95,70,194,150,6,6,7,5,2,,,
"May 31, 2021 7:00 PM",113,54,59,280,148,132,457,206,251,243,126,117,,,,34,,,,42,41,1,39,182,92,90,92,124,5,7,7,5,2,,,
"May 31, 2021 8:00 PM",86,27,59,188,90,98,305,95,210,199,88,111,,,,21,,,,30,28,2,23,141,47,94,54,99,8,2,10,5,5,,,
"May 31, 2021 9:00 PM",53,19,34,93,44,49,110,33,77,81,30,51,,,,20,,,,16,16,0,21,45,10,35,18,48,2,2,2,1,1,,,
"May 31, 2021 10:00 PM",27,12,15,23,10,13,31,8,23,26,8,18,,,,4,,,,10,9,1,8,8,3,5,6,15,3,2,2,2,0,,,
"May 31, 2021 11:00 PM",12,2,10,9,8,1,4,3,1,6,4,2,,,,5,,,,6,6,0,1,2,2,0,3,4,0,2,0,0,0,,,
"Jun 1, 2021 12:00 AM",5,1,4,0,0,0,1,0,1,2,0,2,,,,1,,,,2,2,0,1,0,0,0,3,1,0,0,0,0,0,,,
"Jun 1, 2021 1:00 AM",4,2,2,1,0,1,1,0,1,1,1,0,,,,1,,,,1,1,0,0,1,0,1,2,1,0,0,1,0,1,,,
"Jun 1, 2021 2:00 AM",5,5,0,2,2,0,2,0,2,2,0,2,,,,1,,,,0,0,0,0,2,0,2,0,2,0,0,0,0,0,,,
"Jun 1, 2021 3:00 AM",0,0,0,0,0,0,0,0,0,0,0,0,,,,0,,,,1,1,0,1,0,0,0,0,0,0,0,0,0,0,,,
"Jun 1, 2021 4:00 AM",1,1,0,3,3,0,13,13,0,1,1,0,,,,0,,,,4,4,0,1,11,11,0,1,2,0,0,0,0,0,,,
"Jun 1, 2021 5:00 AM",4,3,1,2,2,0,34,24,10,11,8,3,,,,0,,,,2,2,0,6,3,1,2,11,14,1,1,0,0,0,,,
"Jun 1, 2021 6:00 AM",45,23,22,72,49,23,100,71,29,64,47,17,,,,2,,,,13,11,2,19,14,8,6,25,44,1,2,1,1,0,,,
"Jun 1, 2021 7:00 AM",119,74,45,103,40,63,174,78,96,114,49,65,,,,19,,,,20,17,3,78,58,29,29,67,88,6,9,4,3,1,,,
"Jun 1, 2021 8:00 AM",161,111,50,138,47,91,207,84,123,161,74,87,,,,32,,,,28,20,8,108,80,25,55,64,143,7,7,11,8,3,,,
"Jun 1, 2021 9:00 AM",107,76,31,119,59,60,148,83,65,111,61,50,,,,11,,,,23,18,5,53,49,25,24,33,67,3,7,7,3,4,,,
"Jun 1, 2021 10:00 AM",58,36,22,108,60,48,108,56,52,101,69,32,,,,14,,,,19,15,4,26,48,25,23,34,45,6,5,3,3,0,,,
"Jun 1, 2021 11:00 AM",68,37,31,130,72,58,136,87,49,105,64,41,,,,11,,,,10,9,1,18,45,33,12,35,39,8,5,4,4,0,,,
"Jun 1, 2021 12:00 PM",84,44,40,153,82,71,173,97,76,143,75,68,,,,19,,,,20,16,4,31,46,26,20,50,42,6,6,6,4,2,,,
"Jun 1, 2021 1:00 PM",94,49,45,147,69,78,199,108,91,149,78,71,,,,24,,,,30,25,5,31,54,33,21,55,48,10,4,4,3,1,,,
"Jun 1, 2021 2:00 PM",92,48,44,127,74,53,168,93,75,130,70,60,,,,13,,,,36,33,3,22,73,49,24,46,56,8,9,9,3,6,,,
"Jun 1, 2021 3:00 PM",93,50,43,150,88,62,214,133,81,141,87,54,,,,21,,,,35,32,3,31,94,64,30,62,53,4,0,9,4,5,,,
"Jun 1, 2021 4:00 PM",132,49,83,160,89,71,265,155,110,168,98,70,,,,31,,,,51,47,4,28,103,76,27,76,61,11,8,12,10,2,,,
"Jun 1, 2021 5:00 PM",205,70,135,241,137,104,439,271,168,210,122,88,,,,61,,,,94,93,1,39,167,112,55,156,100,8,10,6,3,3,,,
"Jun 1, 2021 6:00 PM",176,77,99,291,169,122,552,321,231,296,181,115,,,,33,,,,73,68,5,31,178,118,60,193,133,7,8,10,7,3,,,
"Jun 1, 2021 7:00 PM",141,59,82,307,154,153,486,232,254,286,147,139,,,,37,,,,50,46,4,42,162,84,78,100,112,10,15,7,6,1,,,
"Jun 1, 2021 8:00 PM",119,48,71,240,107,133,330,116,214,246,104,142,,,,19,,,,32,32,0,28,130,43,87,65,114,10,7,10,6,4,,,
"Jun 1, 2021 9:00 PM",55,22,33,116,45,71,191,42,149,138,42,96,,,,17,,,,20,19,1,9,74,19,55,22,62,2,1,5,3,2,,,
"Jun 1, 2021 10:00 PM",33,16,17,30,15,15,67,20,47,45,12,33,,,,3,,,,10,9,1,11,33,4,29,9,24,1,2,4,4,0,,,
"Jun 1, 2021 11:00 PM",22,4,18,14,8,6,26,7,19,22,11,11,,,,0,,,,6,5,1,2,10,3,7,3,16,0,1,3,0,3,,,
"Jun 2, 2021 12:00 AM",3,0,3,0,0,0,1,0,1,5,4,1,,,,0,,,,4,4,0,5,5,0,5,4,4,0,1,1,1,0,,,
"Jun 2, 2021 1:00 AM",2,0,2,7,1,6,6,0,6,7,1,6,,,,0,,,,2,1,1,0,0,0,0,1,3,0,0,1,1,0,,,
"Jun 2, 2021 2:00 AM",6,2,4,3,0,3,4,1,3,4,1,3,,,,2,,,,1,1,0,0,1,1,0,0,2,1,0,1,1,0,,,
"Jun 2, 2021 3:00 AM",0,0,0,2,0,2,4,2,2,9,3,6,,,,0,,,,0,0,0,0,0,0,0,1,2,0,0,0,0,0,,,
"Jun 2, 2021 4:00 AM",2,0,2,2,0,2,2,2,0,1,1,0,,,,0,,,,6,5,1,1,0,0,0,1,2,0,0,0,0,0,,,
"Jun 2, 2021 5:00 AM",3,3,0,12,8,4,18,14,4,18,14,4,,,,1,,,,1,1,0,4,2,1,1,6,10,1,0,0,0,0,,,
"Jun 2, 2021 6:00 AM",36,23,13,56,30,26,85,54,31,45,27,18,,,,1,,,,8,8,0,17,21,17,4,20,51,1,5,3,1,2,,,
"Jun 2, 2021 7:00 AM",98,56,42,118,57,61,166,76,90,107,52,55,,,,13,,,,25,19,6,72,59,29,30,50,94,5,2,5,3,2,,,
"Jun 2, 2021 8:00 AM",151,108,43,144,51,93,214,99,115,165,80,85,,,,40,,,,28,21,7,96,90,33,57,51,131,9,5,12,9,3,,,
"Jun 2, 2021 9:00 AM",97,64,33,118,62,56,134,76,58,111,65,46,,,,13,,,,18,12,6,53,55,27,28,42,65,4,4,4,0,4,,,
"Jun 2, 2021 10:00 AM",60,33,27,80,41,39,102,46,56,81,43,38,,,,8,,,,16,12,4,21,34,16,18,32,37,3,0,7,4,3,,,
"Jun 2, 2021 11:00 AM",62,29,33,91,44,47,90,44,46,73,43,30,,,,24,,,,13,12,1,22,37,15,22,30,45,8,4,1,1,0,,,
"Jun 2, 2021 12:00 PM",68,30,38,97,48,49,107,53,54,69,37,32,,,,14,,,,17,16,1,26,46,27,19,33,35,6,2,9,8,1,,,
"Jun 2, 2021 1:00 PM",78,43,35,74,41,33,83,42,41,75,35,40,,,,15,,,,20,18,2,24,38,22,16,37,50,7,4,12,11,1,,,
"Jun 2, 2021 2:00 PM",60,29,31,67,36,31,84,44,40,64,37,27,,,,15,,,,19,18,1,19,40,14,26,22,36,2,1,9,3,6,,,
"Jun 2, 2021 3:00 PM",80,39,41,49,32,17,70,44,26,49,32,17,,,,9,,,,23,22,1,17,28,20,8,32,28,3,2,5,2,3,,,
"Jun 2, 2021 4:00 PM",108,35,73,56,36,20,109,64,45,70,42,28,,,,25,,,,45,43,2,22,48,32,16,50,38,2,4,7,5,2,,,
"Jun 2, 2021 5:00 PM",166,53,113,112,63,49,170,100,70,120,70,50,,,,17,,,,76,74,2,29,80,57,23,102,56,4,9,11,4,7,,,
"Jun 2, 2021 6:00 PM",148,59,89,151,95,56,219,141,78,154,90,64,,,,20,,,,70,67,3,34,62,49,13,96,62,3,6,12,10,2,,,
"Jun 2, 2021 7:00 PM",85,35,50,103,62,41,208,115,93,106,72,34,,,,14,,,,43,37,6,18,73,42,31,53,62,3,4,5,4,1,,,
"Jun 2, 2021 8:00 PM",75,27,48,95,46,49,150,55,95,101,42,59,,,,8,,,,30,28,2,16,55,27,28,38,41,6,5,9,3,6,,,
"Jun 2, 2021 9:00 PM",38,15,23,37,14,23,58,25,33,39,21,18,,,,6,,,,17,17,0,14,23,10,13,15,27,7,4,3,3,0,,,
"Jun 2, 2021 10:00 PM",26,9,17,13,4,9,11,5,6,11,5,6,,,,5,,,,15,14,1,8,5,2,3,7,8,2,0,2,1,1,,,
"Jun 2, 2021 11:00 PM",10,3,7,4,2,2,19,7,12,10,5,5,,,,4,,,,4,4,0,1,11,2,9,3,8,0,1,1,1,0,,,
"Jun 3, 2021 12:00 AM",3,0,3,1,1,0,1,1,0,2,1,1,,,,3,,,,0,0,0,5,0,0,0,6,1,0,0,0,0,0,,,
"Jun 3, 2021 1:00 AM",1,0,1,1,0,1,2,0,2,3,1,2,,,,0,,,,0,0,0,1,0,0,0,1,0,0,0,0,0,0,,,
"Jun 3, 2021 2:00 AM",2,2,0,1,1,0,1,0,1,1,0,1,,,,0,,,,1,1,0,0,0,0,0,2,0,0,0,0,0,0,,,
"Jun 3, 2021 3:00 AM",1,1,0,0,0,0,0,0,0,0,0,0,,,,1,,,,0,0,0,1,0,0,0,0,1,0,0,0,0,0,,,
"Jun 3, 2021 4:00 AM",1,1,0,2,2,0,12,11,1,2,2,0,,,,0,,,,1,1,0,1,8,7,1,0,2,0,0,0,0,0,,,
"Jun 3, 2021 5:00 AM",13,10,3,8,5,3,17,12,5,9,8,1,,,,1,,,,1,1,0,5,3,2,1,7,11,1,2,0,0,0,,,
"Jun 3, 2021 6:00 AM",49,30,19,48,29,19,77,56,21,54,36,18,,,,4,,,,14,13,1,17,22,12,10,27,36,3,3,2,2,0,,,
"Jun 3, 2021 7:00 AM",120,73,47,123,61,62,209,104,105,114,55,59,,,,20,,,,21,19,2,64,59,27,32,53,105,1,4,4,2,2,,,
"Jun 3, 2021 8:00 AM",173,115,58,172,59,113,234,108,126,180,83,97,,,,39,,,,31,18,13,97,97,50,47,51,132,5,6,7,6,1,,,
"Jun 3, 2021 9:00 AM",95,65,30,141,70,71,196,111,85,127,74,53,,,,21,,,,21,15,6,52,67,36,31,47,70,4,5,4,3,1,,,
"Jun 3, 2021 10:00 AM",56,37,19,92,51,41,142,80,62,103,66,37,,,,8,,,,13,11,2,22,56,33,23,32,39,4,8,3,1,2,,,
"Jun 3, 2021 11:00 AM",61,36,25,114,61,53,131,68,63,102,52,50,,,,20,,,,15,14,1,18,56,29,27,42,36,1,2,7,4,3,,,
"Jun 3, 2021 12:00 PM",80,37,43,142,68,74,159,86,73,122,65,57,,,,27,,,,22,18,4,26,66,41,25,39,38,7,2,5,2,3,,,
"Jun 3, 2021 1:00 PM",87,45,42,137,72,65,174,102,72,118,60,58,,,,15,,,,22,21,1,29,82,51,31,53,44,8,1,5,2,3,,,
"Jun 3, 2021 2:00 PM",99,52,47,109,53,56,169,98,71,151,94,57,,,,22,,,,28,27,1,20,66,40,26,45,50,7,9,10,5,5,,,
"Jun 3, 2021 3:00 PM",86,40,46,138,68,70,177,98,79,130,63,67,,,,18,,,,27,25,2,25,88,54,34,44,60,4,7,15,8,7,,,
"Jun 3, 2021 4:00 PM",135,48,87,132,72,60,201,101,100,181,101,80,,,,28,,,,38,35,3,32,80,49,31,62,73,10,5,5,3,2,,,
"Jun 3, 2021 5:00 PM",177,68,109,187,86,101,306,186,120,193,109,84,,,,33,,,,68,66,2,45,96,63,33,120,68,9,7,11,8,3,,,
"Jun 3, 2021 6:00 PM",161,57,104,226,147,79,376,233,143,219,145,74,,,,32,,,,71,67,4,31,168,126,42,142,91,9,10,5,4,1,,,
"Jun 3, 2021 7:00 PM",118,55,63,235,136,99,388,210,178,207,110,97,,,,30,,,,42,40,2,33,136,79,57,85,75,4,4,19,15,4,,,
"Jun 3, 2021 8:00 PM",83,30,53,144,70,74,219,81,138,121,45,76,,,,24,,,,28,27,1,23,114,53,61,45,77,10,9,1,0,1,,,
"Jun 3, 2021 9:00 PM",64,21,43,87,28,59,157,41,116,93,28,65,,,,12,,,,21,19,2,10,71,17,54,22,67,3,1,2,2,0,,,
"Jun 3, 2021 10:00 PM",43,20,23,30,16,14,60,11,49,38,10,28,,,,10,,,,9,8,1,7,25,8,17,15,36,2,1,5,4,1,,,
"Jun 3, 2021 11:00 PM",16,4,12,9,7,2,16,4,12,13,8,5,,,,1,,,,13,12,1,1,9,3,6,8,4,0,0,1,0,1,,,
"Jun 4, 2021 12:00 AM",4,1,3,4,1,3,5,3,2,8,2,6,,,,2,,,,3,3,0,5,1,0,1,6,2,0,0,1,1,0,,,
"Jun 4, 2021 1:00 AM",1,0,1,1,0,1,3,0,3,1,0,1,,,,0,,,,1,1,0,2,2,1,1,1,3,0,0,0,0,0,,,
"Jun 4, 2021 2:00 AM",3,3,0,0,0,0,2,1,1,1,1,0,,,,0,,,,1,1,0,0,0,0,0,0,2,0,0,0,0,0,,,
"Jun 4, 2021 3:00 AM",1,0,1,1,1,0,0,0,0,0,0,0,,,,0,,,,0,0,0,0,0,0,0,1,0,0,0,0,0,0,,,
"Jun 4, 2021 4:00 AM",1,1,0,3,3,0,4,4,0,2,2,0,,,,0,,,,1,1,0,0,0,0,0,2,2,1,0,0,0,0,,,
"Jun 4, 2021 5:00 AM",4,3,1,8,3,5,11,9,2,10,9,1,,,,3,,,,2,2,0,5,4,2,2,5,8,0,0,0,0,0,,,
"Jun 4, 2021 6:00 AM",42,29,13,32,19,13,54,35,19,28,15,13,,,,3,,,,6,6,0,12,27,22,5,26,41,0,3,1,1,0,,,
"Jun 4, 2021 7:00 AM",80,40,40,100,48,52,150,76,74,82,41,41,,,,13,,,,21,17,4,55,48,22,26,52,88,3,4,6,4,2,,,
"Jun 4, 2021 8:00 AM",134,82,52,151,53,98,230,98,132,150,67,83,,,,31,,,,25,17,8,90,94,37,57,50,107,5,6,7,6,1,,,
"Jun 4, 2021 9:00 AM",84,64,20,122,54,68,158,91,67,103,56,47,,,,13,,,,19,15,4,51,65,33,32,53,57,2,5,5,1,4,,,
"Jun 4, 2021 10:00 AM",57,34,23,98,57,41,174,94,80,103,63,40,,,,14,,,,15,11,4,33,49,29,20,31,50,3,4,10,7,3,,,
"Jun 4, 2021 11:00 AM",68,35,33,126,61,65,155,69,86,106,56,50,,,,21,,,,20,14,6,16,52,28,24,38,62,6,2,7,5,2,,,
"Jun 4, 2021 12:00 PM",65,25,40,145,78,67,160,85,75,129,74,55,,,,20,,,,32,27,5,27,76,48,28,56,44,9,3,6,6,0,,,
"Jun 4, 2021 1:00 PM",77,33,44,131,69,62,146,80,66,120,68,52,,,,21,,,,23,22,1,33,52,28,24,38,50,10,1,12,7,5,,,
"Jun 4, 2021 2:00 PM",80,45,35,145,79,66,120,69,51,128,74,54,,,,37,,,,20,19,1,23,66,36,30,28,45,4,6,13,9,4,,,
"Jun 4, 2021 3:00 PM",93,44,49,115,67,48,132,66,66,132,77,55,,,,18,,,,26,23,3,26,69,42,27,64,56,10,2,7,6,1,,,
"Jun 4, 2021 4:00 PM",112,38,74,133,70,63,145,79,66,143,67,76,,,,20,,,,39,35,4,24,56,38,18,60,66,3,7,5,2,3,,,
"Jun 4, 2021 5:00 PM",124,41,83,156,85,71,196,100,96,136,67,69,,,,23,,,,68,65,3,38,75,44,31,80,54,2,10,12,8,4,,,
"Jun 4, 2021 6:00 PM",119,55,64,149,89,60,205,131,74,151,90,61,,,,19,,,,46,44,2,21,99,75,24,99,63,10,3,8,7,1,,,
"Jun 4, 2021 7:00 PM",83,54,29,101,56,45,193,104,89,104,59,45,,,,22,,,,17,17,0,22,83,45,38,64,48,10,5,5,4,1,,,
"Jun 4, 2021 8:00 PM",84,30,54,77,36,41,144,54,90,91,43,48,,,,22,,,,18,17,1,13,70,30,40,28,59,6,5,3,3,0,,,
"Jun 4, 2021 9:00 PM",46,14,32,55,22,33,80,28,52,47,20,27,,,,12,,,,15,13,2,16,27,5,22,15,33,5,0,2,1,1,,,
"Jun 4, 2021 10:00 PM",33,7,26,24,14,10,36,14,22,24,8,16,,,,8,,,,10,9,1,6,11,5,6,18,24,3,0,3,2,1,,,
"Jun 4, 2021 11:00 PM",18,7,11,10,6,4,23,10,13,12,5,7,,,,6,,,,4,4,0,6,5,3,2,9,11,0,1,2,1,1,,,
"Jun 5, 2021 12:00 AM",9,4,5,0,0,0,0,0,0,5,4,1,,,,1,,,,9,9,0,3,4,0,4,4,8,2,3,1,1,0,,,
"Jun 5, 2021 1:00 AM",6,0,6,5,3,2,2,1,1,4,3,1,,,,1,,,,4,4,0,2,0,0,0,2,0,0,0,1,0,1,,,
"Jun 5, 2021 2:00 AM",9,5,4,5,3,2,3,2,1,5,3,2,,,,0,,,,0,0,0,1,0,0,0,2,1,0,2,0,0,0,,,
"Jun 5, 2021 3:00 AM",3,0,3,2,1,1,4,2,2,3,1,2,,,,1,,,,2,2,0,1,2,1,1,1,2,0,2,0,0,0,,,
"Jun 5, 2021 4:00 AM",2,1,1,0,0,0,10,10,0,3,1,2,,,,0,,,,7,6,1,0,0,0,0,2,1,0,0,1,1,0,,,
"Jun 5, 2021 5:00 AM",0,0,0,1,1,0,19,15,4,0,0,0,,,,0,,,,0,0,0,2,2,1,1,1,5,0,0,0,0,0,,,
"Jun 5, 2021 6:00 AM",15,7,8,9,4,5,24,11,13,8,5,3,,,,2,,,,4,4,0,3,5,5,0,10,13,2,1,0,0,0,,,
"Jun 5, 2021 7:00 AM",25,5,20,42,24,18,59,30,29,47,29,18,,,,7,,,,2,2,0,16,22,15,7,19,28,3,3,4,4,0,,,
"Jun 5, 2021 8:00 AM",32,15,17,70,40,30,87,56,31,67,46,21,,,,13,,,,9,9,0,25,34,20,14,30,31,3,4,4,3,1,,,
"Jun 5, 2021 9:00 AM",43,28,15,134,79,55,206,125,81,140,93,47,,,,11,,,,13,12,1,29,61,39,22,59,48,4,10,1,0,1,,,
"Jun 5, 2021 10:00 AM",68,39,29,176,95,81,211,107,104,146,85,61,,,,18,,,,11,9,2,25,59,38,21,51,69,3,12,2,2,0,,,
"Jun 5, 2021 11:00 AM",63,31,32,182,84,98,232,128,104,162,85,77,,,,22,,,,15,13,2,22,65,42,23,66,77,7,5,6,3,3,,,
"Jun 5, 2021 12:00 PM",58,25,33,156,57,99,208,96,112,165,83,82,,,,12,,,,15,15,0,22,77,39,38,61,60,12,1,11,9,2,,,
"Jun 5, 2021 1:00 PM",55,26,29,143,86,57,173,102,71,148,98,50,,,,19,,,,19,16,3,27,66,43,23,78,49,8,0,6,4,2,,,
"Jun 5, 2021 2:00 PM",68,39,29,164,85,79,151,81,70,174,87,87,,,,18,,,,17,17,0,23,64,43,21,39,43,7,8,18,12,6,,,
"Jun 5, 2021 3:00 PM",79,45,34,142,81,61,149,75,74,128,69,59,,,,25,,,,22,18,4,32,73,39,34,39,58,5,3,5,3,2,,,
"Jun 5, 2021 4:00 PM",53,26,27,142,72,70,116,49,67,129,62,67,,,,30,,,,22,19,3,23,47,20,27,32,34,3,3,4,2,2,,,
"Jun 5, 2021 5:00 PM",55,21,34,142,85,57,150,56,94,142,62,80,,,,27,,,,17,13,4,13,69,32,37,31,47,3,0,2,1,1,,,
"Jun 5, 2021 6:00 PM",47,22,25,97,49,48,89,32,57,90,35,55,,,,12,,,,19,18,1,11,51,21,30,21,46,2,1,5,4,1,,,
"Jun 5, 2021 7:00 PM",59,22,37,72,31,41,87,35,52,68,29,39,,,,11,,,,8,6,2,16,40,20,20,15,28,2,2,6,2,4,,,
"Jun 5, 2021 8:00 PM",38,21,17,38,24,14,48,19,29,43,19,24,,,,16,,,,11,10,1,6,21,10,11,17,24,2,2,4,3,1,,,
"Jun 5, 2021 9:00 PM",24,12,12,27,12,15,45,24,21,28,14,14,,,,18,,,,10,8,2,10,10,5,5,16,21,0,0,3,1,2,,,
"Jun 5, 2021 10:00 PM",20,8,12,12,6,6,28,8,20,17,3,14,,,,7,,,,3,3,0,7,10,6,4,8,8,2,4,4,4,0,,,
"Jun 5, 2021 11:00 PM",15,7,8,10,4,6,19,8,11,8,6,2,,,,4,,,,5,5,0,2,5,2,3,6,7,0,3,1,1,0,,,
"Jun 6, 2021 12:00 AM",12,6,6,0,0,0,1,0,1,4,1,3,,,,3,,,,5,5,0,3,1,0,1,0,13,0,1,1,0,1,,,
"Jun 6, 2021 1:00 AM",1,0,1,1,0,1,6,2,4,4,2,2,,,,1,,,,2,2,0,2,0,0,0,1,5,1,0,2,0,2,,,
"Jun 6, 2021 2:00 AM",3,1,2,2,0,2,2,1,1,4,0,4,,,,0,,,,2,2,0,4,0,0,0,1,4,0,0,1,0,1,,,
"Jun 6, 2021 3:00 AM",11,5,6,2,2,0,0,0,0,2,2,0,,,,0,,,,1,1,0,2,0,0,0,2,2,0,0,0,0,0,,,
"Jun 6, 2021 4:00 AM",1,0,1,1,1,0,3,3,0,4,3,1,,,,3,,,,2,2,0,1,2,1,1,1,1,0,0,0,0,0,,,
"Jun 6, 2021 5:00 AM",1,0,1,6,5,1,6,4,2,5,4,1,,,,2,,,,0,0,0,0,0,0,0,3,4,0,0,0,0,0,,,
"Jun 6, 2021 6:00 AM",9,6,3,13,8,5,24,15,9,13,10,3,,,,2,,,,1,1,0,4,11,8,3,10,15,1,1,0,0,0,,,
"Jun 6, 2021 7:00 AM",24,10,14,57,33,24,57,35,22,54,32,22,,,,1,,,,6,4,2,15,13,6,7,18,23,0,8,0,0,0,,,
"Jun 6, 2021 8:00 AM",39,13,26,123,83,40,133,95,38,104,80,24,,,,3,,,,13,10,3,29,39,26,13,26,28,0,16,1,1,0,,,
"Jun 6, 2021 9:00 AM",49,25,24,198,125,73,236,159,77,174,110,64,,,,12,,,,24,20,4,15,78,52,26,64,49,7,16,3,1,2,,,
"Jun 6, 2021 10:00 AM",61,30,31,256,140,116,382,217,165,235,133,102,,,,23,,,,20,18,2,34,97,71,26,101,51,12,2,6,4,2,,,
"Jun 6, 2021 11:00 AM",72,36,36,251,134,117,380,217,163,237,147,90,,,,22,,,,28,25,3,29,120,73,47,81,88,7,12,16,12,4,,,
"Jun 6, 2021 12:00 PM",89,51,38,317,158,159,400,178,222,266,143,123,,,,18,,,,28,23,5,25,158,90,68,82,120,15,12,13,8,5,,,
"Jun 6, 2021 1:00 PM",85,42,43,253,116,137,285,124,161,248,124,124,,,,31,,,,22,19,3,33,91,44,47,79,88,15,3,15,13,2,,,
"Jun 6, 2021 2:00 PM",70,35,35,234,104,130,250,117,133,230,119,111,,,,26,,,,23,21,2,14,77,46,31,64,97,6,4,6,4,2,,,
"Jun 6, 2021 3:00 PM",54,29,25,203,88,115,232,115,117,219,110,109,,,,22,,,,22,21,1,26,116,57,59,53,73,7,6,10,7,3,,,
"Jun 6, 2021 4:00 PM",71,34,37,198,103,95,226,99,127,185,86,99,,,,25,,,,28,22,6,23,101,46,55,46,59,4,1,7,6,1,,,
"Jun 6, 2021 5:00 PM",67,27,40,188,87,101,171,69,102,179,68,111,,,,23,,,,18,15,3,23,54,24,30,29,49,11,1,3,2,1,,,
"Jun 6, 2021 6:00 PM",40,18,22,112,62,50,105,37,68,86,39,47,,,,16,,,,8,8,0,27,42,17,25,19,41,0,1,5,4,1,,,
"Jun 6, 2021 7:00 PM",48,23,25,82,31,51,92,34,58,59,23,36,,,,19,,,,12,9,3,21,28,15,13,23,48,1,2,4,3,1,,,
"Jun 6, 2021 8:00 PM",33,19,14,58,24,34,62,21,41,47,14,33,,,,3,,,,15,14,1,13,30,5,25,21,19,7,6,2,1,1,,,
"Jun 6, 2021 9:00 PM",22,13,9,29,18,11,29,15,14,27,14,13,,,,4,,,,4,2,2,7,16,9,7,8,14,1,2,4,2,2,,,
"Jun 6, 2021 10:00 PM",15,6,9,9,3,6,10,3,7,9,2,7,,,,8,,,,3,3,0,9,6,4,2,5,7,3,1,4,3,1,,,
"Jun 6, 2021 11:00 PM",18,6,12,4,0,4,13,9,4,6,4,2,,,,2,,,,5,5,0,4,3,1,2,4,5,0,1,0,0,0,,,
"Jun 7, 2021 12:00 AM",10,4,6,2,2,0,2,1,1,5,3,2,,,,2,,,,6,5,1,2,6,1,5,7,6,1,0,1,1,0,,,
"Jun 7, 2021 1:00 AM",4,2,2,2,1,1,3,1,2,1,1,0,,,,5,,,,2,2,0,0,0,0,0,3,3,1,0,0,0,0,,,
"Jun 7, 2021 2:00 AM",5,2,3,2,1,1,2,1,1,1,0,1,,,,2,,,,2,2,0,0,1,0,1,1,0,0,0,0,0,0,,,
"Jun 7, 2021 3:00 AM",1,0,1,0,0,0,3,0,3,0,0,0,,,,0,,,,1,1,0,1,0,0,0,1,2,0,0,2,0,2,,,
"Jun 7, 2021 4:00 AM",4,2,2,0,0,0,4,2,2,2,1,1,,,,0,,,,0,0,0,0,1,1,0,1,1,0,0,0,0,0,,,
"Jun 7, 2021 5:00 AM",8,3,5,0,0,0,2,2,0,9,5,4,,,,0,,,,2,2,0,3,4,2,2,1,5,1,0,2,2,0,,,
"Jun 7, 2021 6:00 AM",10,8,2,10,5,5,20,12,8,16,7,9,,,,3,,,,0,0,0,5,5,4,1,5,15,1,1,0,0,0,,,
"Jun 7, 2021 7:00 AM",23,12,11,47,27,20,44,33,11,50,35,15,,,,3,,,,14,11,3,16,12,6,6,19,20,2,6,3,2,1,,,
"Jun 7, 2021 8:00 AM",38,18,20,89,52,37,89,56,33,72,49,23,,,,8,,,,9,8,1,12,22,12,10,30,30,1,5,3,2,1,,,
"Jun 7, 2021 9:00 AM",51,21,30,123,60,63,157,104,53,115,64,51,,,,11,,,,14,14,0,20,53,45,8,32,37,8,13,4,4,0,,,
"Jun 7, 2021 10:00 AM",44,25,19,188,108,80,264,164,100,176,119,57,,,,14,,,,9,9,0,23,93,68,25,56,59,6,7,4,3,1,,,
"Jun 7, 2021 11:00 AM",73,38,35,260,133,127,276,144,132,187,105,82,,,,21,,,,28,20,8,26,105,68,37,65,76,20,6,8,5,3,,,
"Jun 7, 2021 12:00 PM",68,44,24,181,96,85,292,149,143,202,107,95,,,,22,,,,18,13,5,44,112,58,54,75,74,10,10,11,9,2,,,
"Jun 7, 2021 1:00 PM",62,29,33,202,109,93,253,136,117,211,122,89,,,,39,,,,22,17,5,19,126,70,56,44,67,8,4,12,7,5,,,
"Jun 7, 2021 2:00 PM",64,34,30,192,103,89,241,141,100,204,123,81,,,,27,,,,20,18,2,27,94,50,44,64,62,8,12,14,7,7,,,
"Jun 7, 2021 3:00 PM",77,37,40,184,109,75,251,144,107,205,121,84,,,,29,,,,30,25,5,32,149,97,52,64,51,3,1,4,3,1,,,
"Jun 7, 2021 4:00 PM",86,32,54,259,130,129,286,125,161,225,102,123,,,,20,,,,23,21,2,33,114,54,60,61,68,14,8,11,4,7,,,
"Jun 7, 2021 5:00 PM",84,42,42,210,110,100,225,98,127,191,86,105,,,,21,,,,27,24,3,34,84,35,49,46,83,8,3,10,7,3,,,
"Jun 7, 2021 6:00 PM",70,37,33,186,85,101,209,84,125,179,80,99,,,,15,,,,13,11,2,16,74,36,38,49,53,4,3,2,1,1,,,
"Jun 7, 2021 7:00 PM",75,36,39,156,69,87,168,65,103,115,46,69,,,,21,,,,18,17,1,20,65,26,39,36,57,3,1,8,5,3,,,
"Jun 7, 2021 8:00 PM",46,28,18,93,32,61,119,36,83,98,29,69,,,,6,,,,15,14,1,13,65,22,43,25,38,4,2,3,3,0,,,
"Jun 7, 2021 9:00 PM",37,14,23,41,23,18,75,34,41,44,19,25,,,,19,,,,11,10,1,8,31,14,17,13,34,1,1,3,1,2,,,
"Jun 7, 2021 10:00 PM",22,9,13,24,12,12,39,13,26,34,5,29,,,,15,,,,7,7,0,8,15,2,13,7,17,3,1,5,4,1,,,
"Jun 7, 2021 11:00 PM",13,5,8,17,14,3,21,6,15,19,9,10,,,,2,,,,3,3,0,6,1,0,1,4,10,0,4,1,0,1,,,
"Jun 8, 2021 12:00 AM",6,4,2,0,0,0,2,0,2,5,1,4,,,,2,,,,1,1,0,3,0,0,0,2,5,0,0,0,0,0,,,
"Jun 8, 2021 1:00 AM",3,0,3,6,1,5,4,0,4,5,1,4,,,,0,,,,1,1,0,0,0,0,0,1,3,0,0,0,0,0,,,
"Jun 8, 2021 2:00 AM",6,3,3,0,0,0,3,0,3,0,0,0,,,,1,,,,0,0,0,0,0,0,0,1,2,0,0,0,0,0,,,
"Jun 8, 2021 3:00 AM",0,0,0,0,0,0,2,1,1,2,2,0,,,,2,,,,0,0,0,0,0,0,0,2,0,0,0,0,0,0,,,
"Jun 8, 2021 4:00 AM",2,1,1,2,2,0,7,7,0,2,2,0,,,,0,,,,1,1,0,1,0,0,0,1,3,0,0,0,0,0,,,
"Jun 8, 2021 5:00 AM",10,8,2,4,3,1,16,6,10,6,4,2,,,,5,,,,3,1,2,6,4,2,2,4,13,0,0,1,1,0,,,
"Jun 8, 2021 6:00 AM",50,30,20,21,14,7,30,19,11,28,18,10,,,,11,,,,6,5,1,10,16,12,4,18,36,0,3,7,6,1,,,
"Jun 8, 2021 7:00 AM",101,60,41,78,30,48,105,45,60,86,39,47,,,,12,,,,12,6,6,72,36,14,22,39,95,4,4,3,1,2,,,
"Jun 8, 2021 8:00 AM",163,116,47,124,43,81,135,72,63,131,58,73,,,,33,,,,24,20,4,90,60,21,39,52,113,7,5,1,1,0,,,
"Jun 8, 2021 9:00 AM",96,66,30,85,42,43,112,64,48,84,56,28,,,,20,,,,10,7,3,39,40,20,20,33,51,4,7,5,3,2,,,
"Jun 8, 2021 10:00 AM",59,40,19,67,31,36,79,55,24,60,35,25,,,,6,,,,12,8,4,28,39,31,8,20,22,3,2,7,4,3,,,
"Jun 8, 2021 11:00 AM",58,36,22,77,42,35,114,64,50,76,43,33,,,,24,,,,10,10,0,20,33,20,13,25,41,2,1,1,1,0,,,
"Jun 8, 2021 12:00 PM",58,36,22,97,35,62,143,68,75,91,37,54,,,,20,,,,11,10,1,22,41,22,19,35,23,9,6,7,4,3,,,
"Jun 8, 2021 1:00 PM",84,43,41,88,49,39,109,69,40,85,47,38,,,,16,,,,15,14,1,26,37,22,15,31,32,10,4,10,8,2,,,
"Jun 8, 2021 2:00 PM",59,29,30,77,38,39,134,69,65,84,44,40,,,,17,,,,20,19,1,16,42,20,22,29,43,3,4,3,1,2,,,
"Jun 8, 2021 3:00 PM",80,36,44,98,56,42,112,55,57,72,41,31,,,,29,,,,24,23,1,21,36,21,15,29,33,6,5,5,3,2,,,
"Jun 8, 2021 4:00 PM",112,41,71,103,50,53,115,51,64,98,48,50,,,,20,,,,37,37,0,23,43,25,18,48,52,9,5,8,4,4,,,
"Jun 8, 2021 5:00 PM",160,51,109,144,70,74,168,85,83,128,69,59,,,,40,,,,59,58,1,38,76,52,24,79,59,4,10,8,4,4,,,
"Jun 8, 2021 6:00 PM",155,60,95,113,77,36,139,84,55,116,71,45,,,,26,,,,61,55,6,40,57,37,20,77,46,5,8,6,4,2,,,
"Jun 8, 2021 7:00 PM",110,41,69,104,56,48,109,64,45,83,43,40,,,,23,,,,43,41,2,26,69,48,21,45,29,6,6,5,2,3,,,
"Jun 8, 2021 8:00 PM",76,27,49,119,60,59,112,53,59,88,39,49,,,,13,,,,32,32,0,19,44,22,22,30,28,5,5,7,2,5,,,
"Jun 8, 2021 9:00 PM",46,16,30,52,27,25,78,33,45,59,26,33,,,,14,,,,29,27,2,20,25,9,16,19,28,0,2,3,2,1,,,
"Jun 8, 2021 10:00 PM",36,17,19,27,20,7,37,9,28,27,8,19,,,,4,,,,20,18,2,5,12,5,7,11,10,2,3,3,1,2,,,
"Jun 8, 2021 11:00 PM",16,4,12,5,5,0,10,3,7,5,2,3,,,,1,,,,3,3,0,1,0,0,0,6,6,1,2,2,1,1,,,
"Jun 9, 2021 12:00 AM",2,0,2,0,0,0,3,1,2,3,2,1,,,,2,,,,4,4,0,2,1,1,0,4,1,1,0,1,1,0,,,
"Jun 9, 2021 1:00 AM",1,0,1,0,0,0,0,0,0,0,0,0,,,,3,,,,3,2,1,0,0,0,0,2,0,0,0,0,0,0,,,
"Jun 9, 2021 2:00 AM",3,3,0,0,0,0,0,0,0,0,0,0,,,,1,,,,0,0,0,0,0,0,0,0,1,0,0,0,0,0,,,
"Jun 9, 2021 3:00 AM",1,0,1,1,1,0,4,2,2,0,0,0,,,,0,,,,1,1,0,0,0,0,0,5,1,0,0,0,0,0,,,
"Jun 9, 2021 4:00 AM",2,1,1,2,2,0,3,2,1,3,2,1,,,,0,,,,2,2,0,1,0,0,0,0,1,0,0,0,0,0,,,
"Jun 9, 2021 5:00 AM",7,6,1,2,1,1,4,2,2,5,3,2,,,,3,,,,1,1,0,8,2,1,1,2,7,0,0,2,1,1,,,
"Jun 9, 2021 6:00 AM",45,29,16,36,16,20,40,20,20,35,20,15,,,,7,,,,11,10,1,20,14,12,2,18,42,1,1,3,2,1,,,
"Jun 9, 2021 7:00 AM",101,58,43,79,27,52,85,34,51,78,33,45,,,,17,,,,23,14,9,70,31,13,18,34,88,8,8,8,5,3,,,
"Jun 9, 2021 8:00 AM",153,102,51,104,35,69,132,73,59,118,57,61,,,,28,,,,30,22,8,95,47,20,27,53,117,3,3,3,3,0,,,
"Jun 9, 2021 9:00 AM",81,56,25,58,21,37,64,35,29,48,24,24,,,,12,,,,14,9,5,37,22,11,11,21,61,4,8,7,4,3,,,
"Jun 9, 2021 10:00 AM",48,34,14,36,19,17,49,33,16,36,23,13,,,,5,,,,10,6,4,8,24,16,8,26,19,3,1,2,1,1,,,
"Jun 9, 2021 11:00 AM",49,30,19,53,26,27,70,40,30,42,26,16,,,,14,,,,14,12,2,12,25,9,16,23,20,4,4,4,4,0,,,
"Jun 9, 2021 12:00 PM",84,41,43,80,35,45,91,45,46,59,28,31,,,,16,,,,17,16,1,25,34,18,16,25,24,8,3,15,10,5,,,
"Jun 9, 2021 1:00 PM",96,49,47,74,42,32,126,70,56,68,44,24,,,,18,,,,17,14,3,30,40,19,21,31,40,10,2,8,7,1,,,
"Jun 9, 2021 2:00 PM",66,31,35,66,40,26,100,56,44,76,49,27,,,,26,,,,25,22,3,21,33,25,8,23,36,2,10,9,3,6,,,
"Jun 9, 2021 3:00 PM",72,30,42,65,45,20,82,48,34,61,40,21,,,,24,,,,22,18,4,14,42,24,18,34,30,10,1,9,7,2,,,
"Jun 9, 2021 4:00 PM",125,51,74,114,75,39,128,65,63,96,48,48,,,,28,,,,47,41,6,25,43,28,15,49,53,9,9,6,4,2,,,
"Jun 9, 2021 5:00 PM",182,61,121,129,64,65,150,87,63,135,65,70,,,,33,,,,74,70,4,25,68,50,18,91,63,6,8,8,6,2,,,
"Jun 9, 2021 6:00 PM",142,67,75,185,112,73,196,118,78,159,93,66,,,,27,,,,72,68,4,33,84,61,23,102,56,5,10,4,0,4,,,
"Jun 9, 2021 7:00 PM",113,51,62,187,125,62,184,110,74,162,103,59,,,,26,,,,41,40,1,28,70,48,22,69,65,6,11,15,8,7,,,
"Jun 9, 2021 8:00 PM",94,32,62,180,63,117,212,101,111,173,63,110,,,,30,,,,37,32,5,29,73,40,33,53,57,7,2,5,1,4,,,
"Jun 9, 2021 9:00 PM",76,26,50,127,60,67,152,49,103,102,34,68,,,,21,,,,20,20,0,10,55,17,38,21,47,6,4,11,6,5,,,
"Jun 9, 2021 10:00 PM",30,9,21,43,24,19,53,18,35,33,10,23,,,,5,,,,11,11,0,8,24,7,17,16,23,2,0,1,1,0,,,
"Jun 9, 2021 11:00 PM",19,4,15,9,5,4,19,4,15,16,6,10,,,,2,,,,6,5,1,4,3,1,2,6,6,4,4,2,2,0,,,
"Jun 10, 2021 12:00 AM",4,1,3,0,0,0,0,0,0,5,2,3,,,,1,,,,6,6,0,1,3,2,1,2,5,1,0,0,0,0,,,
"Jun 10, 2021 1:00 AM",5,2,3,0,0,0,3,3,0,4,4,0,,,,0,,,,4,3,1,1,0,0,0,1,3,0,0,0,0,0,,,
"Jun 10, 2021 2:00 AM",3,3,0,2,2,0,0,0,0,0,0,0,,,,1,,,,1,0,1,0,0,0,0,0,0,0,0,0,0,0,,,
"Jun 10, 2021 3:00 AM",2,0,2,0,0,0,0,0,0,0,0,0,,,,0,,,,0,0,0,0,0,0,0,0,0,0,0,0,0,0,,,
"Jun 10, 2021 4:00 AM",2,1,1,0,0,0,2,2,0,1,1,0,,,,0,,,,2,1,1,3,0,0,0,0,1,0,0,0,0,0,,,
"Jun 10, 2021 5:00 AM",7,7,0,3,3,0,8,5,3,8,6,2,,,,1,,,,3,1,2,8,6,3,3,1,11,0,0,0,0,0,,,
"Jun 10, 2021 6:00 AM",56,36,20,41,24,17,42,28,14,43,29,14,,,,5,,,,6,6,0,15,18,14,4,19,38,0,8,3,3,0,,,
"Jun 10, 2021 7:00 AM",103,60,43,120,53,67,141,65,76,115,57,58,,,,17,,,,20,16,4,61,54,24,30,47,83,6,5,6,4,2,,,
"Jun 10, 2021 8:00 AM",152,112,40,157,52,105,179,78,101,170,71,99,,,,31,,,,32,21,11,85,61,19,42,47,120,3,8,11,10,1,,,
"Jun 10, 2021 9:00 AM",101,66,35,99,36,63,127,71,56,93,52,41,,,,23,,,,18,11,7,50,44,22,22,36,54,4,4,5,4,1,,,
"Jun 10, 2021 10:00 AM",67,43,24,98,47,51,133,86,47,99,62,37,,,,13,,,,10,8,2,32,53,35,18,27,42,5,2,4,2,2,,,
"Jun 10, 2021 11:00 AM",65,44,21,98,47,51,150,87,63,102,54,48,,,,10,,,,11,7,4,16,64,41,23,28,48,5,5,6,5,1,,,
"Jun 10, 2021 12:00 PM",72,34,38,126,59,67,186,105,81,106,52,54,,,,26,,,,19,17,2,24,67,43,24,42,45,5,5,6,4,2,,,
"Jun 10, 2021 1:00 PM",84,46,38,146,86,60,219,110,109,121,68,53,,,,24,,,,17,14,3,26,83,48,35,35,48,10,4,9,6,3,,,
"Jun 10, 2021 2:00 PM",79,33,46,104,49,55,162,86,76,93,45,48,,,,23,,,,24,23,1,21,78,43,35,50,46,5,8,9,5,4,,,
"Jun 10, 2021 3:00 PM",76,38,38,84,55,29,154,90,64,83,58,25,,,,30,,,,28,28,0,19,45,27,18,55,49,6,5,9,5,4,,,
"Jun 10, 2021 4:00 PM",112,44,68,110,69,41,171,88,83,137,83,54,,,,24,,,,39,38,1,25,71,37,34,51,54,12,7,11,10,1,,,
"Jun 10, 2021 5:00 PM",170,61,109,170,86,84,227,145,82,210,135,75,,,,26,,,,60,54,6,27,83,62,21,100,76,6,3,8,6,2,,,
"Jun 10, 2021 6:00 PM",149,67,82,179,112,67,240,166,74,175,116,59,,,,32,,,,81,77,4,43,114,98,16,110,74,9,5,8,6,2,,,
"Jun 10, 2021 7:00 PM",134,59,75,236,108,128,255,130,125,211,104,107,,,,32,,,,48,46,2,38,94,62,32,79,84,8,2,13,7,6,,,
"Jun 10, 2021 8:00 PM",106,35,71,142,73,69,200,63,137,125,58,67,,,,35,,,,41,35,6,27,74,32,42,35,71,6,6,8,6,2,,,
"Jun 10, 2021 9:00 PM",44,20,24,87,47,40,114,37,77,85,21,64,,,,11,,,,31,28,3,20,53,19,34,27,38,5,0,9,6,3,,,
"Jun 10, 2021 10:00 PM",35,13,22,60,34,26,74,20,54,46,11,35,,,,7,,,,18,14,4,11,23,4,19,19,35,3,2,9,4,5,,,
"Jun 10, 2021 11:00 PM",33,8,25,18,10,8,34,9,25,16,1,15,,,,6,,,,17,17,0,5,6,4,2,14,22,2,1,2,1,1,,,
"Jun 11, 2021 12:00 AM",8,1,7,0,0,0,1,0,1,10,1,9,,,,1,,,,3,3,0,8,6,2,4,8,14,0,0,1,0,1,,,
"Jun 11, 2021 1:00 AM",2,0,2,1,1,0,1,0,1,0,0,0,,,,0,,,,4,3,1,1,2,1,1,2,0,0,0,0,0,0,,,
"Jun 11, 2021 2:00 AM",2,1,1,0,0,0,2,1,1,1,1,0,,,,1,,,,2,2,0,0,0,0,0,0,0,0,0,0,0,0,,,
"Jun 11, 2021 3:00 AM",1,1,0,3,3,0,0,0,0,0,0,0,,,,0,,,,0,0,0,1,0,0,0,0,1,0,0,0,0,0,,,
"Jun 11, 2021 4:00 AM",1,1,0,2,1,1,8,8,0,5,4,1,,,,0,,,,1,1,0,1,2,2,0,3,3,0,0,0,0,0,,,
"Jun 11, 2021 5:00 AM",12,8,4,6,5,1,3,3,0,6,6,0,,,,1,,,,5,4,1,7,1,1,0,3,7,0,0,2,2,0,,,
"Jun 11, 2021 6:00 AM",40,27,13,42,24,18,43,22,21,38,23,15,,,,3,,,,4,4,0,18,16,9,7,21,41,0,3,4,4,0,,,
"Jun 11, 2021 7:00 AM",79,44,35,103,43,60,102,52,50,86,42,44,,,,18,,,,20,13,7,57,37,17,20,43,77,8,6,4,4,0,,,
"Jun 11, 2021 8:00 AM",131,90,41,125,55,70,144,70,74,128,69,59,,,,23,,,,30,20,10,76,48,17,31,48,112,1,9,16,11,5,,,
"Jun 11, 2021 9:00 AM",102,70,32,116,42,74,107,60,47,104,56,48,,,,9,,,,18,11,7,41,48,31,17,22,75,5,4,8,5,3,,,
"Jun 11, 2021 10:00 AM",65,35,30,87,56,31,111,77,34,74,55,19,,,,15,,,,14,10,4,26,38,26,12,22,27,4,4,8,7,1,,,
"Jun 11, 2021 11:00 AM",53,22,31,83,35,48,114,57,57,83,39,44,,,,6,,,,21,19,2,27,41,28,13,33,38,8,1,14,7,7,,,
"Jun 11, 2021 12:00 PM",80,49,31,99,44,55,144,71,73,85,42,43,,,,23,,,,23,20,3,20,54,30,24,35,44,8,2,5,4,1,,,
"Jun 11, 2021 1:00 PM",119,57,62,103,53,50,155,86,69,104,58,46,,,,16,,,,26,22,4,28,58,38,20,54,41,7,1,9,4,5,,,
"Jun 11, 2021 2:00 PM",83,37,46,98,52,46,136,63,73,100,48,52,,,,20,,,,22,20,2,35,46,24,22,29,51,8,5,13,7,6,,,
"Jun 11, 2021 3:00 PM",94,49,45,104,54,50,161,81,80,92,60,32,,,,20,,,,36,29,7,26,67,39,28,62,42,5,6,3,0,3,,,
"Jun 11, 2021 4:00 PM",135,62,73,126,92,34,174,98,76,138,84,54,,,,23,,,,43,39,4,21,70,43,27,69,45,9,8,13,7,6,,,
"Jun 11, 2021 5:00 PM",157,59,98,159,74,85,209,100,109,151,71,80,,,,27,,,,63,62,1,30,75,46,29,76,77,8,15,6,3,3,,,
"Jun 11, 2021 6:00 PM",123,42,81,144,96,48,153,92,61,129,78,51,,,,19,,,,53,51,2,41,67,47,20,81,57,4,4,11,6,5,,,
"Jun 11, 2021 7:00 PM",104,45,59,112,59,53,138,73,65,105,57,48,,,,20,,,,33,30,3,31,53,36,17,41,39,5,1,5,2,3,,,
"Jun 11, 2021 8:00 PM",81,27,54,86,39,47,100,45,55,76,32,44,,,,22,,,,34,31,3,17,38,26,12,26,31,5,5,9,5,4,,,
"Jun 11, 2021 9:00 PM",46,18,28,52,32,20,87,38,49,54,20,34,,,,9,,,,12,12,0,14,34,9,25,22,27,6,2,1,1,0,,,
"Jun 11, 2021 10:00 PM",26,10,16,40,18,22,33,3,30,23,6,17,,,,6,,,,13,12,1,14,11,0,11,17,20,4,4,6,4,2,,,
"Jun 11, 2021 11:00 PM",36,12,24,11,6,5,18,4,14,18,6,12,,,,13,,,,7,7,0,11,11,4,7,12,22,0,0,2,1,1,,,
"Jun 12, 2021 12:00 AM",16,5,11,0,0,0,2,1,1,6,3,3,,,,2,,,,11,11,0,5,4,2,2,8,6,1,1,1,0,1,,,
"Jun 12, 2021 1:00 AM",10,3,7,1,1,0,6,2,4,1,0,1,,,,1,,,,3,2,1,3,0,0,0,6,9,0,0,1,1,0,,,
"Jun 12, 2021 2:00 AM",11,7,4,6,6,0,13,11,2,8,8,0,,,,0,,,,4,4,0,1,2,2,0,11,3,0,0,0,0,0,,,
"Jun 12, 2021 3:00 AM",3,1,2,0,0,0,1,1,0,0,0,0,,,,0,,,,0,0,0,0,0,0,0,1,1,0,0,1,1,0,,,
"Jun 12, 2021 4:00 AM",3,2,1,1,1,0,7,6,1,3,3,0,,,,1,,,,2,2,0,0,1,1,0,1,2,0,0,0,0,0,,,
"Jun 12, 2021 5:00 AM",2,0,2,11,1,10,3,2,1,3,1,2,,,,1,,,,2,2,0,2,3,3,0,3,3,0,0,0,0,0,,,
"Jun 12, 2021 6:00 AM",13,5,8,24,15,9,25,18,7,21,15,6,,,,2,,,,5,5,0,4,5,4,1,14,11,0,3,1,0,1,,,
"Jun 12, 2021 7:00 AM",28,12,16,54,33,21,44,30,14,49,33,16,,,,7,,,,4,4,0,15,11,7,4,16,24,3,7,0,0,0,,,
"Jun 12, 2021 8:00 AM",45,21,24,79,45,34,86,50,36,77,50,27,,,,4,,,,18,16,2,30,27,15,12,31,29,4,8,3,2,1,,,
"Jun 12, 2021 9:00 AM",52,23,29,108,43,65,98,59,39,101,59,42,,,,16,,,,19,17,2,24,32,26,6,38,37,12,8,7,7,0,,,
"Jun 12, 2021 10:00 AM",72,43,29,156,91,65,169,112,57,154,100,54,,,,18,,,,14,12,2,31,62,45,17,50,45,12,10,6,6,0,,,
"Jun 12, 2021 11:00 AM",77,42,35,190,100,90,229,145,84,196,110,86,,,,27,,,,17,11,6,26,57,40,17,71,71,9,4,5,4,1,,,
"Jun 12, 2021 12:00 PM",83,41,42,208,90,118,272,153,119,219,140,79,,,,19,,,,22,18,4,38,104,62,42,62,58,12,11,10,6,4,,,
"Jun 12, 2021 1:00 PM",87,49,38,177,79,98,276,155,121,184,102,82,,,,19,,,,24,18,6,29,91,58,33,75,76,1,1,5,0,5,,,
"Jun 12, 2021 2:00 PM",75,41,34,152,77,75,281,147,134,149,80,69,,,,33,,,,22,19,3,42,111,59,52,76,67,8,7,10,8,2,,,
"Jun 12, 2021 3:00 PM",82,47,35,155,96,59,259,126,133,152,87,65,,,,18,,,,21,18,3,24,79,49,30,69,71,8,5,9,7,2,,,
"Jun 12, 2021 4:00 PM",87,49,38,212,104,108,257,116,141,168,77,91,,,,19,,,,26,24,2,21,100,47,53,55,87,6,8,3,2,1,,,
"Jun 12, 2021 5:00 PM",78,32,46,196,108,88,202,72,130,158,64,94,,,,30,,,,20,14,6,33,72,24,48,54,85,8,3,2,2,0,,,
"Jun 12, 2021 6:00 PM",66,23,43,142,80,62,143,52,91,120,54,66,,,,26,,,,26,24,2,32,71,33,38,37,53,2,3,4,3,1,,,
"Jun 12, 2021 7:00 PM",69,33,36,93,52,41,109,54,55,83,32,51,,,,17,,,,20,18,2,19,44,22,22,23,31,4,2,6,3,3,,,
"Jun 12, 2021 8:00 PM",48,18,30,53,18,35,64,24,40,52,19,33,,,,15,,,,10,8,2,8,28,15,13,14,26,2,4,4,2,2,,,
"Jun 12, 2021 9:00 PM",35,15,20,58,31,27,56,24,32,52,23,29,,,,7,,,,13,9,4,7,14,2,12,15,24,2,1,3,3,0,,,
"Jun 12, 2021 10:00 PM",33,14,19,37,18,19,34,10,24,25,9,16,,,,6,,,,13,12,1,11,8,0,8,10,9,5,0,5,2,3,,,
"Jun 12, 2021 11:00 PM",31,14,17,20,12,8,18,5,13,15,3,12,,,,3,,,,6,6,0,10,7,4,3,10,16,0,3,0,0,0,,,
"Jun 13, 2021 12:00 AM",11,6,5,3,2,1,0,0,0,8,3,5,,,,0,,,,5,5,0,9,4,0,4,8,8,3,0,2,0,2,,,
"Jun 13, 2021 1:00 AM",9,5,4,6,2,4,8,4,4,10,4,6,,,,3,,,,3,3,0,3,1,1,0,7,10,0,0,1,1,0,,,
"Jun 13, 2021 2:00 AM",7,3,4,2,2,0,2,1,1,5,2,3,,,,0,,,,6,3,3,0,1,0,1,3,5,1,0,0,0,0,,,
"Jun 13, 2021 3:00 AM",4,1,3,2,0,2,4,2,2,4,3,1,,,,0,,,,1,1,0,1,1,0,1,1,2,0,2,0,0,0,,,
"Jun 13, 2021 4:00 AM",0,0,0,1,1,0,3,3,0,2,2,0,,,,0,,,,3,3,0,0,1,1,0,2,1,1,1,0,0,0,,,
"Jun 13, 2021 5:00 AM",5,3,2,8,5,3,6,4,2,7,5,2,,,,0,,,,1,1,0,0,0,0,0,3,0,0,0,0,0,0,,,
"Jun 13, 2021 6:00 AM",5,3,2,13,5,8,17,10,7,13,5,8,,,,1,,,,1,1,0,3,8,5,3,7,15,0,0,1,1,0,,,
"Jun 13, 2021 7:00 AM",25,12,13,59,33,26,58,37,21,62,37,25,,,,7,,,,9,5,4,14,12,6,6,27,16,2,4,2,1,1,,,
"Jun 13, 2021 8:00 AM",42,12,30,131,92,39,123,82,41,120,92,28,,,,5,,,,13,7,6,17,41,31,10,48,37,1,12,2,0,2,,,
"Jun 13, 2021 9:00 AM",71,39,32,188,96,92,203,115,88,185,103,82,,,,18,,,,9,7,2,27,64,40,24,54,69,6,16,5,1,4,,,
"Jun 13, 2021 10:00 AM",64,42,22,211,114,97,241,144,97,190,110,80,,,,14,,,,23,19,4,33,97,68,29,84,70,7,8,9,4,5,,,
"Jun 13, 2021 11:00 AM",89,51,38,348,181,167,369,231,138,310,185,125,,,,29,,,,23,19,4,24,124,81,43,105,75,20,11,17,11,6,,,
"Jun 13, 2021 12:00 PM",97,50,47,333,176,157,413,251,162,302,176,126,,,,32,,,,34,32,2,36,109,78,31,133,84,10,5,15,11,4,,,
"Jun 13, 2021 1:00 PM",75,32,43,326,207,119,411,254,157,297,192,105,,,,28,,,,34,28,6,30,145,94,51,121,76,10,10,11,6,5,,,
"Jun 13, 2021 2:00 PM",64,29,35,294,147,147,497,285,212,300,168,132,,,,23,,,,22,21,1,27,194,121,73,127,95,8,4,6,5,1,,,
"Jun 13, 2021 3:00 PM",76,40,36,278,143,135,436,222,214,286,156,130,,,,16,,,,23,21,2,26,163,95,68,91,77,9,6,8,4,4,,,
"Jun 13, 2021 4:00 PM",75,41,34,280,128,152,488,221,267,283,119,164,,,,16,,,,20,20,0,34,162,72,90,66,116,5,8,8,8,0,,,
"Jun 13, 2021 5:00 PM",72,18,54,235,102,133,408,115,293,240,81,159,,,,20,,,,25,22,3,39,141,43,98,59,127,9,3,7,6,1,,,
"Jun 13, 2021 6:00 PM",67,37,30,190,91,99,258,89,169,161,60,101,,,,30,,,,20,17,3,31,119,39,80,38,103,7,7,9,7,2,,,
"Jun 13, 2021 7:00 PM",67,27,40,150,57,93,187,69,118,127,55,72,,,,21,,,,17,13,4,21,74,23,51,25,71,4,6,6,6,0,,,
"Jun 13, 2021 8:00 PM",53,22,31,92,50,42,124,49,75,99,43,56,,,,14,,,,15,12,3,9,45,13,32,20,53,2,3,3,2,1,,,
"Jun 13, 2021 9:00 PM",31,14,17,41,17,24,74,24,50,47,13,34,,,,8,,,,11,9,2,22,25,14,11,5,33,2,0,1,1,0,,,
"Jun 13, 2021 10:00 PM",12,6,6,23,6,17,44,13,31,28,8,20,,,,6,,,,4,3,1,11,17,11,6,7,14,1,0,3,1,2,,,
"Jun 13, 2021 11:00 PM",14,5,9,7,2,5,23,5,18,9,2,7,,,,2,,,,5,4,1,11,6,0,6,6,16,0,0,1,0,1,,,
"Jun 14, 2021 12:00 AM",7,3,4,0,0,0,0,0,0,6,2,4,0,0,0,0,,,,4,3,1,2,6,0,6,4,3,0,0,1,0,1,,,
"Jun 14, 2021 1:00 AM",2,0,2,4,1,3,6,0,6,4,0,4,0,0,0,1,,,,3,3,0,0,0,0,0,3,0,0,0,0,0,0,,,
"Jun 14, 2021 2:00 AM",3,3,0,1,1,0,0,0,0,0,0,0,,,,1,,,,0,0,0,3,0,0,0,0,0,0,0,0,0,0,,,
"Jun 14, 2021 3:00 AM",0,0,0,1,1,0,1,0,1,2,0,2,,,,0,,,,0,0,0,0,0,0,0,0,0,0,0,0,0,0,,,
"Jun 14, 2021 4:00 AM",1,0,1,0,0,0,9,7,2,2,0,2,,,,0,,,,0,0,0,1,0,0,0,1,3,1,1,0,0,0,,,
"Jun 14, 2021 5:00 AM",6,6,0,3,3,0,8,5,3,13,8,5,,,,2,,,,4,2,2,5,1,0,1,2,5,0,0,2,2,0,,,
"Jun 14, 2021 6:00 AM",43,32,11,24,10,14,31,12,19,30,15,15,,,,3,,,,5,5,0,19,18,12,6,20,39,0,2,4,4,0,,,
"Jun 14, 2021 7:00 AM",89,42,47,69,27,42,86,33,53,72,30,42,,,,12,,,,19,16,3,74,25,13,12,42,84,2,4,5,4,1,,,
"Jun 14, 2021 8:00 AM",136,96,40,100,40,60,131,72,59,118,65,53,,,,42,,,,23,17,6,89,62,26,36,54,128,6,4,6,5,1,,,
"Jun 14, 2021 9:00 AM",86,67,19,85,32,53,99,57,42,82,46,36,,,,15,,,,32,21,11,50,52,23,29,30,51,6,0,2,1,1,,,
"Jun 14, 2021 10:00 AM",50,27,23,63,35,28,69,34,35,59,33,26,,,,18,,,,15,14,1,20,36,21,15,21,36,4,3,4,2,2,,,
"Jun 14, 2021 11:00 AM",43,26,17,73,42,31,101,53,48,85,44,41,,,,18,,,,11,10,1,18,45,25,20,19,33,4,5,4,2,2,,,
"Jun 14, 2021 12:00 PM",66,38,28,83,46,37,114,58,56,82,43,39,,,,23,,,,15,13,2,23,43,27,16,32,48,4,5,9,5,4,,,
"Jun 14, 2021 1:00 PM",79,37,42,105,50,55,116,63,53,90,46,44,,,,15,,,,21,18,3,22,40,32,8,27,46,7,7,8,5,3,,,
"Jun 14, 2021 2:00 PM",64,32,32,110,51,59,102,48,54,103,51,52,15,3,12,25,,,,24,23,1,22,46,24,22,31,35,6,0,10,4,6,,,
"Jun 14, 2021 3:00 PM",66,26,40,80,41,39,114,70,44,79,43,36,28,17,11,11,,,,23,21,2,21,48,34,14,35,42,8,7,5,3,2,,,
"Jun 14, 2021 4:00 PM",102,39,63,86,54,32,175,97,78,94,49,45,16,5,11,37,,,,37,36,1,31,78,46,32,61,46,10,5,5,4,1,,,
"Jun 14, 2021 5:00 PM",158,47,111,100,56,44,200,109,91,129,67,62,23,9,14,30,,,,64,62,2,31,62,40,22,101,73,3,13,5,3,2,,,
"Jun 14, 2021 6:00 PM",124,46,78,130,83,47,217,117,100,142,82,60,22,11,11,46,,,,63,59,4,30,78,48,30,103,92,2,6,5,4,1,,,
"Jun 14, 2021 7:00 PM",106,47,59,139,68,71,184,84,100,144,71,73,12,7,5,48,,,,39,36,3,24,85,53,32,52,49,10,3,4,1,3,,,
"Jun 14, 2021 8:00 PM",77,38,39,113,63,50,106,42,64,103,48,55,15,5,10,20,,,,31,29,2,17,41,23,18,27,54,9,2,11,4,7,,,
"Jun 14, 2021 9:00 PM",53,20,33,68,36,32,77,29,48,58,28,30,7,0,7,14,,,,16,16,0,14,46,10,36,25,26,3,1,3,2,1,,,
"Jun 14, 2021 10:00 PM",29,11,18,19,10,9,37,12,25,34,14,20,3,2,1,11,,,,15,15,0,3,14,7,7,15,12,2,0,0,0,0,,,
"Jun 14, 2021 11:00 PM",15,6,9,5,1,4,11,3,8,7,2,5,1,1,0,4,,,,7,7,0,5,6,4,2,6,9,3,1,0,0,0,,,
"Jun 15, 2021 12:00 AM",5,0,5,0,0,0,1,0,1,8,0,8,1,1,0,0,0,0,0,4,3,1,2,4,1,3,1,5,1,0,0,0,0,,,
"Jun 15, 2021 1:00 AM",2,2,0,3,2,1,2,1,1,2,1,1,0,0,0,0,0,0,0,2,2,0,0,0,0,0,0,3,0,0,0,0,0,,,
"Jun 15, 2021 2:00 AM",4,3,1,0,0,0,0,0,0,0,0,0,1,1,0,0,0,0,0,1,1,0,0,0,0,0,0,2,0,1,0,0,0,,,
"Jun 15, 2021 3:00 AM",1,0,1,0,0,0,0,0,0,0,0,0,0,0,0,0,,,,0,0,0,0,0,0,0,0,0,0,0,0,0,0,,,
"Jun 15, 2021 4:00 AM",3,1,2,0,0,0,2,1,1,2,1,1,0,0,0,0,,,,1,1,0,1,0,0,0,0,1,0,0,0,0,0,,,
"Jun 15, 2021 5:00 AM",6,5,1,8,5,3,12,10,2,10,7,3,1,1,0,5,,,,4,2,2,7,1,0,1,5,11,0,1,0,0,0,,,
"Jun 15, 2021 6:00 AM",49,29,20,45,25,20,65,38,27,41,25,16,5,3,2,6,,,,8,7,1,22,21,12,9,20,51,4,4,6,5,1,,,
"Jun 15, 2021 7:00 AM",116,69,47,116,46,70,134,45,89,99,43,56,10,6,4,23,,,,22,17,5,70,40,21,19,46,97,6,6,4,4,0,,,
"Jun 15, 2021 8:00 AM",183,132,51,122,39,83,152,79,73,133,59,74,39,19,20,34,,,,36,24,12,106,62,31,31,53,127,4,10,9,7,2,,,
"Jun 15, 2021 9:00 AM",109,79,30,121,69,52,122,70,52,113,74,39,23,14,9,27,,,,16,9,7,57,46,24,22,37,63,7,3,11,7,4,,,
"Jun 15, 2021 10:00 AM",65,39,26,97,41,56,92,41,51,74,34,40,13,9,4,15,,,,18,11,7,27,83,39,44,30,28,2,4,2,2,0,,,
"Jun 15, 2021 11:00 AM",48,29,19,109,56,53,126,86,40,115,70,45,11,6,5,17,,,,13,11,2,23,41,23,18,33,35,2,4,3,1,2,,,
"Jun 15, 2021 12:00 PM",92,45,47,85,41,44,127,69,58,80,45,35,18,8,10,22,,,,18,11,7,23,44,31,13,26,50,12,3,14,11,3,,,
"Jun 15, 2021 1:00 PM",89,36,53,104,56,48,164,86,78,118,70,48,27,15,12,16,5,3,2,32,29,3,36,52,33,19,39,36,7,5,6,5,1,,,
"Jun 15, 2021 2:00 PM",75,33,42,109,53,56,151,79,72,121,74,47,27,11,16,27,21,19,2,23,22,1,19,69,37,32,44,44,6,5,12,5,7,,,
"Jun 15, 2021 3:00 PM",97,44,53,98,68,30,173,102,71,96,58,38,34,12,22,17,24,24,0,23,21,2,24,96,64,32,62,61,5,3,9,7,2,,,
"Jun 15, 2021 4:00 PM",146,58,88,134,70,64,270,165,105,127,73,54,30,16,14,35,27,27,0,48,46,2,28,117,75,42,100,62,6,6,11,8,3,,,
"Jun 15, 2021 5:00 PM",221,76,145,194,114,80,434,258,176,233,140,93,46,23,23,29,53,52,1,76,72,4,53,190,134,56,140,98,14,6,7,6,1,,,
"Jun 15, 2021 6:00 PM",186,77,109,229,131,98,506,291,215,246,144,102,39,23,16,32,36,35,1,89,82,7,36,160,97,63,159,120,5,10,12,8,4,,,
"Jun 15, 2021 7:00 PM",167,70,97,254,146,108,381,182,199,226,123,103,27,19,8,27,34,34,0,52,47,5,38,156,87,69,101,98,6,9,6,4,2,,,
"Jun 15, 2021 8:00 PM",89,42,47,194,85,109,259,87,172,169,68,101,39,25,14,11,30,29,1,38,37,1,29,117,41,76,48,81,10,7,6,2,4,,,
"Jun 15, 2021 9:00 PM",56,13,43,115,59,56,148,36,112,124,37,87,22,12,10,17,26,25,1,26,25,1,25,49,12,37,23,65,6,2,5,3,2,,,
"Jun 15, 2021 10:00 PM",32,13,19,42,22,20,68,26,42,33,11,22,7,5,2,5,9,9,0,24,20,4,8,26,5,21,23,28,3,1,5,2,3,,,
"Jun 15, 2021 11:00 PM",16,6,10,13,7,6,27,11,16,12,6,6,2,0,2,2,2,2,0,8,8,0,2,10,6,4,10,11,3,2,2,1,1,,,
"Jun 16, 2021 12:00 AM",9,4,5,0,0,0,3,3,0,10,6,4,4,0,4,0,4,4,0,5,5,0,4,1,0,1,7,7,1,0,1,0,1,,,
"Jun 16, 2021 1:00 AM",4,1,3,4,2,2,4,2,2,3,1,2,0,0,0,0,0,0,0,1,1,0,0,1,0,1,0,3,0,0,1,1,0,,,
"Jun 16, 2021 2:00 AM",4,4,0,0,0,0,0,0,0,0,0,0,0,0,0,1,0,0,0,0,0,0,0,0,0,0,0,1,0,0,0,0,0,,,
"Jun 16, 2021 3:00 AM",1,0,1,2,1,1,7,7,0,2,2,0,0,0,0,0,0,0,0,1,1,0,0,5,5,0,1,0,0,0,0,0,0,,,
"Jun 16, 2021 4:00 AM",2,0,2,0,0,0,2,2,0,1,1,0,2,0,2,0,0,0,0,2,2,0,0,0,0,0,2,0,0,0,0,0,0,,,
"Jun 16, 2021 5:00 AM",9,6,3,8,4,4,8,6,2,10,5,5,0,0,0,3,7,7,0,3,2,1,6,1,1,0,5,13,0,0,0,0,0,,,
"Jun 16, 2021 6:00 AM",36,24,12,29,14,15,41,23,18,30,17,13,4,3,1,6,14,14,0,12,10,2,14,12,6,6,16,46,1,1,4,4,0,,,
"Jun 16, 2021 7:00 AM",92,55,37,102,38,64,106,43,63,74,35,39,6,5,1,14,58,57,1,18,11,7,59,31,19,12,39,98,6,9,4,2,2,,,
"Jun 16, 2021 8:00 AM",142,99,43,91,36,55,127,59,68,104,50,54,31,18,13,21,85,84,1,25,18,7,89,41,18,23,45,123,8,2,11,7,4,,,
"Jun 16, 2021 9:00 AM",87,61,26,70,27,43,87,48,39,75,39,36,19,8,11,21,45,44,1,21,15,6,46,43,23,20,35,57,6,4,11,7,4,,,
"Jun 16, 2021 10:00 AM",53,33,20,55,24,31,50,27,23,52,31,21,16,6,10,12,29,29,0,16,14,2,30,25,10,15,20,27,1,1,1,0,1,,,
"Jun 16, 2021 11:00 AM",51,28,23,55,30,25,61,35,26,51,32,19,13,1,12,9,15,14,1,11,10,1,16,17,5,12,24,29,2,1,2,1,1,,,
"Jun 16, 2021 12:00 PM",57,34,23,67,34,33,79,37,42,65,30,35,21,10,11,14,16,16,0,21,18,3,15,25,14,11,23,29,6,2,7,5,2,,,
"Jun 16, 2021 1:00 PM",84,43,41,87,48,39,101,63,38,79,47,32,25,13,12,12,21,21,0,22,20,2,22,35,19,16,44,34,3,5,9,7,2,,,
"Jun 16, 2021 2:00 PM",81,47,34,44,26,18,78,37,41,64,36,28,35,17,18,25,24,22,2,27,26,1,22,30,17,13,31,39,4,4,9,4,5,,,
"Jun 16, 2021 3:00 PM",73,36,37,74,39,35,107,67,40,74,45,29,18,13,5,23,23,23,0,15,14,1,24,40,27,13,31,39,6,3,6,5,1,,,
"Jun 16, 2021 4:00 PM",121,54,67,149,83,66,117,73,44,107,62,45,21,9,12,33,20,19,1,35,32,3,17,57,41,16,48,45,6,3,9,7,2,,,
"Jun 16, 2021 5:00 PM",177,56,121,108,58,50,220,114,106,147,63,84,29,12,17,37,41,41,0,59,54,5,39,84,52,32,89,69,4,8,8,5,3,,,
"Jun 16, 2021 6:00 PM",147,59,88,136,76,60,227,126,101,135,82,53,25,13,12,38,34,33,1,69,67,2,30,96,64,32,95,77,8,6,12,6,6,,,
"Jun 16, 2021 7:00 PM",123,57,66,184,110,74,235,132,103,175,116,59,28,13,15,26,18,18,0,48,44,4,18,95,66,29,79,62,8,7,8,4,4,,,
"Jun 16, 2021 8:00 PM",97,40,57,160,71,89,155,78,77,131,56,75,23,9,14,29,19,18,1,21,20,1,19,47,21,26,43,47,12,7,14,8,6,,,
"Jun 16, 2021 9:00 PM",57,16,41,75,34,41,89,37,52,67,32,35,16,5,11,18,17,17,0,12,11,1,18,36,16,20,22,24,3,3,6,5,1,,,
"Jun 16, 2021 10:00 PM",37,7,30,33,18,15,43,11,32,39,12,27,5,3,2,6,9,8,1,17,16,1,6,14,2,12,24,14,7,3,4,2,2,,,
"Jun 16, 2021 11:00 PM",27,10,17,17,12,5,31,6,25,22,4,18,2,0,2,0,3,2,1,12,11,1,3,6,1,5,11,17,2,0,3,3,0,,,
"Jun 17, 2021 12:00 AM",7,1,6,0,0,0,0,0,0,2,0,2,0,0,0,2,3,3,0,4,4,0,3,3,3,0,4,6,0,0,0,0,0,,,
"Jun 17, 2021 1:00 AM",5,2,3,5,1,4,8,2,6,4,0,4,1,1,0,2,1,1,0,3,3,0,1,0,0,0,4,2,0,0,0,0,0,,,
"Jun 17, 2021 2:00 AM",4,4,0,4,1,3,3,1,2,5,2,3,0,0,0,1,0,0,0,0,0,0,0,1,0,1,0,0,0,1,0,0,0,,,
"Jun 17, 2021 3:00 AM",0,0,0,0,0,0,0,0,0,0,0,0,0,0,0,0,0,0,0,0,0,0,1,0,0,0,0,1,0,0,0,0,0,,,
"Jun 17, 2021 4:00 AM",2,1,1,3,2,1,2,2,0,4,3,1,0,0,0,0,0,0,0,2,2,0,0,0,0,0,0,2,0,0,0,0,0,,,
"Jun 17, 2021 5:00 AM",10,8,2,3,1,2,13,8,5,11,6,5,0,0,0,1,5,5,0,4,3,1,5,2,2,0,5,12,0,0,0,0,0,,,
"Jun 17, 2021 6:00 AM",53,36,17,52,26,26,68,38,30,46,27,19,8,7,1,6,21,21,0,11,10,1,21,23,17,6,15,46,2,1,2,2,0,,,
"Jun 17, 2021 7:00 AM",109,61,48,96,36,60,118,45,73,83,32,51,7,5,2,20,61,60,1,23,19,4,63,47,16,31,46,80,7,4,3,3,0,,,
"Jun 17, 2021 8:00 AM",157,109,48,128,59,69,168,90,78,137,71,66,42,19,23,34,94,94,0,31,23,8,100,51,29,22,56,146,6,10,11,9,2,,,
"Jun 17, 2021 9:00 AM",87,67,20,89,38,51,109,61,48,86,57,29,30,20,10,22,50,49,1,18,18,0,52,41,25,16,32,61,3,9,5,3,2,,,
"Jun 17, 2021 10:00 AM",69,40,29,99,55,44,109,62,47,91,53,38,24,12,12,8,31,29,2,11,11,0,32,40,29,11,30,38,5,1,7,6,1,,,
"Jun 17, 2021 11:00 AM",55,32,23,106,51,55,118,58,60,92,49,43,30,15,15,18,17,17,0,19,19,0,18,35,18,17,24,36,4,2,6,5,1,,,
"Jun 17, 2021 12:00 PM",80,39,41,104,50,54,107,53,54,94,52,42,37,21,16,17,26,24,2,14,14,0,25,49,32,17,45,42,7,5,5,2,3,,,
"Jun 17, 2021 1:00 PM",102,56,46,101,43,58,129,67,62,101,46,55,22,11,11,26,34,34,0,25,24,1,32,54,26,28,43,33,15,4,7,5,2,,,
"Jun 17, 2021 2:00 PM",100,57,43,106,59,47,128,68,60,110,62,48,37,21,16,20,16,16,0,27,27,0,21,48,28,20,31,47,9,7,13,11,2,,,
"Jun 17, 2021 3:00 PM",85,27,58,87,57,30,127,67,60,92,58,34,35,17,18,20,26,26,0,32,32,0,24,49,24,25,41,49,6,4,9,7,2,,,
"Jun 17, 2021 4:00 PM",135,53,82,134,68,66,197,115,82,127,73,54,29,18,11,39,31,31,0,42,42,0,35,76,57,19,71,60,10,5,9,6,3,,,
"Jun 17, 2021 5:00 PM",185,55,130,188,81,107,283,172,111,203,114,89,35,18,17,32,45,45,0,55,55,0,46,98,66,32,118,80,4,10,11,6,5,,,
"Jun 17, 2021 6:00 PM",143,67,76,129,79,50,235,133,102,140,88,52,25,10,15,29,38,38,0,71,70,1,37,90,56,34,109,74,7,11,8,8,0,,,
"Jun 17, 2021 7:00 PM",135,67,68,104,58,46,192,109,83,135,76,59,22,13,9,16,37,36,1,35,30,5,37,77,50,27,65,50,7,4,11,7,4,,,
"Jun 17, 2021 8:00 PM",92,43,49,80,48,32,149,57,92,87,37,50,15,4,11,26,24,23,1,26,25,1,26,44,21,23,40,65,7,4,2,1,1,,,
"Jun 17, 2021 9:00 PM",64,19,45,74,44,30,100,34,66,80,21,59,17,6,11,11,18,17,1,20,20,0,19,41,19,22,21,43,6,1,2,1,1,,,
"Jun 17, 2021 10:00 PM",42,13,29,36,27,9,45,9,36,48,13,35,18,9,9,12,8,5,3,24,21,3,5,14,3,11,11,24,6,1,3,2,1,,,
"Jun 17, 2021 11:00 PM",26,9,17,12,11,1,16,1,15,14,4,10,3,2,1,2,5,4,1,10,10,0,4,1,1,0,6,18,2,1,2,2,0,,,
"Jun 18, 2021 12:00 AM",23,7,16,0,0,0,2,0,2,3,0,3,0,0,0,3,5,5,0,6,6,0,3,3,2,1,9,7,0,0,0,0,0,,,
"Jun 18, 2021 1:00 AM",2,0,2,2,2,0,6,5,1,3,2,1,0,0,0,1,1,1,0,2,2,0,1,0,0,0,6,3,0,1,0,0,0,,,
"Jun 18, 2021 2:00 AM",10,6,4,0,0,0,0,0,0,0,0,0,0,0,0,0,0,0,0,2,0,2,1,1,1,0,0,0,0,1,1,0,1,,,
"Jun 18, 2021 3:00 AM",1,0,1,0,0,0,2,1,1,2,1,1,0,0,0,0,0,0,0,1,1,0,2,0,0,0,1,2,0,0,0,0,0,,,
"Jun 18, 2021 4:00 AM",3,2,1,0,0,0,3,2,1,2,1,1,0,0,0,0,0,0,0,1,1,0,0,0,0,0,3,2,0,0,0,0,0,,,
"Jun 18, 2021 5:00 AM",11,8,3,8,6,2,13,10,3,11,7,4,3,0,3,1,6,6,0,4,3,1,5,0,0,0,8,7,0,0,1,1,0,,,
"Jun 18, 2021 6:00 AM",37,27,10,37,14,23,67,36,31,42,22,20,6,6,0,10,22,22,0,9,9,0,22,22,16,6,14,43,0,4,2,2,0,,,
"Jun 18, 2021 7:00 AM",85,42,43,87,44,43,131,59,72,76,44,32,11,9,2,10,46,45,1,24,19,5,50,48,27,21,43,74,3,7,6,4,2,,,
"Jun 18, 2021 8:00 AM",138,85,53,150,45,105,166,82,84,129,63,66,28,12,16,19,65,65,0,29,21,8,69,77,32,45,50,120,3,2,7,6,1,,,
"Jun 18, 2021 9:00 AM",89,65,24,131,73,58,146,85,61,101,65,36,22,14,8,21,49,47,2,26,17,9,48,42,24,18,44,67,1,6,5,1,4,,,
"Jun 18, 2021 10:00 AM",61,28,33,112,65,47,120,60,60,108,62,46,23,12,11,12,30,29,1,20,16,4,29,49,32,17,24,35,2,4,6,5,1,,,
"Jun 18, 2021 11:00 AM",61,37,24,117,65,52,117,68,49,94,54,40,26,9,17,19,16,16,0,15,13,2,14,53,29,24,26,49,11,3,6,4,2,,,
"Jun 18, 2021 12:00 PM",53,28,25,112,56,56,130,68,62,103,55,48,39,16,23,30,16,16,0,21,20,1,15,40,30,10,34,41,7,2,7,5,2,,,
"Jun 18, 2021 1:00 PM",78,34,44,110,51,59,122,63,59,94,49,45,24,12,12,21,21,21,0,21,18,3,19,35,18,17,38,45,7,8,11,8,3,,,
"Jun 18, 2021 2:00 PM",97,47,50,122,62,60,136,82,54,128,74,54,27,17,10,22,17,17,0,26,23,3,18,51,32,19,32,32,6,3,15,12,3,,,
"Jun 18, 2021 3:00 PM",91,44,47,117,64,53,162,94,68,109,55,54,33,21,12,23,34,34,0,23,22,1,36,58,34,24,67,35,4,8,8,4,4,,,
"Jun 18, 2021 4:00 PM",125,54,71,145,87,58,215,116,99,139,88,51,38,13,25,19,35,33,2,43,41,2,37,78,42,36,74,45,9,4,8,4,4,,,
"Jun 18, 2021 5:00 PM",157,60,97,149,82,67,220,114,106,129,73,56,14,6,8,29,35,34,1,51,48,3,35,65,36,29,91,67,15,13,14,8,6,,,
"Jun 18, 2021 6:00 PM",146,76,70,162,88,74,235,149,86,152,84,68,22,10,12,25,42,38,4,54,50,4,36,96,61,35,92,68,6,5,12,8,4,,,
"Jun 18, 2021 7:00 PM",89,44,45,111,76,35,189,92,97,117,59,58,19,16,3,21,24,24,0,26,26,0,24,61,35,26,57,42,10,6,7,4,3,,,
"Jun 18, 2021 8:00 PM",82,41,41,90,44,46,112,44,68,80,37,43,23,13,10,15,20,18,2,14,11,3,18,63,28,35,27,46,5,7,8,5,3,,,
"Jun 18, 2021 9:00 PM",37,12,25,49,26,23,94,31,63,66,27,39,5,1,4,21,12,12,0,16,16,0,10,23,9,14,17,30,5,5,4,4,0,,,
"Jun 18, 2021 10:00 PM",40,15,25,24,15,9,38,17,21,41,15,26,12,4,8,8,12,12,0,12,10,2,12,20,4,16,9,26,2,0,3,2,1,,,
"Jun 18, 2021 11:00 PM",46,12,34,29,8,21,31,4,27,21,3,18,3,2,1,4,8,8,0,15,15,0,7,9,1,8,15,15,1,1,3,2,1,,,
"Jun 19, 2021 12:00 AM",16,7,9,0,0,0,5,0,5,9,4,5,1,1,0,1,11,11,0,8,8,0,12,11,6,5,7,11,1,0,1,0,1,,,
"Jun 19, 2021 1:00 AM",8,4,4,4,3,1,9,3,6,7,1,6,3,0,3,2,1,1,0,4,3,1,1,0,0,0,1,6,0,0,0,0,0,,,
"Jun 19, 2021 2:00 AM",8,5,3,4,2,2,5,3,2,3,1,2,0,0,0,0,4,4,0,4,2,2,4,0,0,0,2,4,0,1,0,0,0,,,
"Jun 19, 2021 3:00 AM",4,3,1,0,0,0,2,0,2,0,0,0,0,0,0,1,0,0,0,2,2,0,1,0,0,0,7,0,0,0,0,0,0,,,
"Jun 19, 2021 4:00 AM",6,1,5,2,2,0,3,3,0,2,2,0,0,0,0,1,3,3,0,2,2,0,2,1,1,0,4,1,0,1,0,0,0,,,
"Jun 19, 2021 5:00 AM",3,0,3,4,2,2,16,13,3,7,5,2,0,0,0,0,1,1,0,1,1,0,1,5,4,1,4,3,1,1,2,2,0,,,
"Jun 19, 2021 6:00 AM",22,13,9,13,7,6,15,10,5,14,10,4,1,0,1,3,5,4,1,2,2,0,4,7,5,2,11,13,0,3,0,0,0,,,
"Jun 19, 2021 7:00 AM",26,13,13,37,22,15,66,48,18,39,26,13,7,2,5,5,17,17,0,7,6,1,16,23,19,4,26,23,1,4,4,2,2,,,
"Jun 19, 2021 8:00 AM",54,25,29,93,54,39,137,83,54,79,51,28,23,12,11,16,19,19,0,20,18,2,24,59,32,27,29,32,4,7,6,3,3,,,
"Jun 19, 2021 9:00 AM",52,25,27,109,56,53,150,77,73,103,52,51,20,17,3,18,21,21,0,10,9,1,23,45,32,13,30,39,10,4,8,8,0,,,
"Jun 19, 2021 10:00 AM",59,28,31,137,78,59,168,93,75,133,87,46,36,21,15,22,26,26,0,16,14,2,26,63,40,23,50,66,7,8,3,3,0,,,
"Jun 19, 2021 11:00 AM",76,44,32,181,83,98,176,96,80,163,90,73,35,17,18,19,34,34,0,23,17,6,34,59,38,21,78,59,10,10,11,9,2,,,
"Jun 19, 2021 12:00 PM",90,46,44,222,96,126,219,128,91,220,139,81,57,33,24,24,28,27,1,27,25,2,25,76,47,29,67,72,17,4,7,5,2,,,
"Jun 19, 2021 1:00 PM",78,43,35,191,97,94,203,110,93,199,117,82,47,29,18,24,30,30,0,19,17,2,30,67,32,35,75,72,10,12,13,7,6,,,
"Jun 19, 2021 2:00 PM",83,48,35,148,75,73,182,108,74,170,92,78,16,4,12,30,40,39,1,34,32,2,37,78,57,21,64,62,8,5,5,4,1,,,
"Jun 19, 2021 3:00 PM",80,37,43,186,109,77,215,117,98,162,85,77,46,24,22,28,38,37,1,19,18,1,40,95,68,27,51,51,5,4,9,7,2,,,
"Jun 19, 2021 4:00 PM",89,54,35,184,89,95,260,140,120,203,112,91,36,14,22,32,39,37,2,21,18,3,38,99,53,46,68,61,14,5,9,7,2,,,
"Jun 19, 2021 5:00 PM",88,36,52,186,109,77,303,139,164,197,85,112,31,12,19,25,31,31,0,21,20,1,30,69,36,33,55,90,4,7,7,6,1,,,
"Jun 19, 2021 6:00 PM",73,33,40,122,60,62,219,77,142,112,38,74,23,11,12,18,23,23,0,24,21,3,21,92,33,59,37,73,4,7,4,3,1,,,
"Jun 19, 2021 7:00 PM",44,22,22,81,46,35,132,48,84,89,37,52,32,15,17,18,13,13,0,15,15,0,14,43,16,27,28,52,3,1,7,4,3,,,
"Jun 19, 2021 8:00 PM",40,19,21,37,19,18,63,25,38,47,14,33,10,4,6,13,7,6,1,17,17,0,9,27,10,17,30,35,4,1,5,3,2,,,
"Jun 19, 2021 9:00 PM",35,20,15,27,10,17,57,15,42,35,12,23,9,3,6,9,12,12,0,8,7,1,12,18,4,14,14,26,1,1,1,0,1,,,
"Jun 19, 2021 10:00 PM",23,11,12,11,6,5,19,8,11,16,7,9,8,2,6,10,13,13,0,12,7,5,11,9,5,4,7,15,2,1,1,1,0,,,
"Jun 19, 2021 11:00 PM",28,16,12,4,4,0,16,6,10,7,3,4,1,0,1,5,13,13,0,10,10,0,14,3,1,2,10,15,0,1,0,0,0,,,
"Jun 20, 2021 12:00 AM",9,1,8,1,0,1,5,3,2,7,4,3,8,3,5,2,2,2,0,7,7,0,4,1,1,0,6,14,2,1,2,1,1,,,
"Jun 20, 2021 1:00 AM",4,0,4,2,0,2,2,0,2,5,3,2,0,0,0,0,3,3,0,4,3,1,2,3,1,2,4,6,0,0,0,0,0,,,
"Jun 20, 2021 2:00 AM",10,3,7,0,0,0,1,0,1,1,0,1,0,0,0,0,2,2,0,1,1,0,2,0,0,0,2,3,0,0,1,0,1,,,
"Jun 20, 2021 3:00 AM",4,2,2,2,2,0,6,4,2,2,2,0,0,0,0,1,0,0,0,1,0,1,1,2,1,1,2,1,0,0,0,0,0,,,
"Jun 20, 2021 4:00 AM",0,0,0,1,1,0,1,1,0,2,1,1,0,0,0,0,0,0,0,2,2,0,0,2,1,1,1,1,0,0,0,0,0,,,
"Jun 20, 2021 5:00 AM",3,1,2,0,0,0,3,2,1,1,1,0,2,2,0,0,3,3,0,0,0,0,3,2,0,2,4,5,0,0,0,0,0,,,
"Jun 20, 2021 6:00 AM",8,5,3,14,6,8,15,11,4,16,9,7,1,0,1,0,1,1,0,1,1,0,2,4,4,0,14,14,0,0,0,0,0,,,
"Jun 20, 2021 7:00 AM",27,16,11,53,28,25,47,25,22,41,26,15,3,1,2,6,18,18,0,6,4,2,20,14,8,6,14,19,3,5,1,1,0,,,
"Jun 20, 2021 8:00 AM",41,10,31,74,48,26,98,69,29,71,47,24,3,1,2,11,13,13,0,5,3,2,11,30,26,4,18,30,1,8,1,0,1,,,
"Jun 20, 2021 9:00 AM",45,22,23,150,85,65,176,103,73,119,67,52,18,6,12,19,21,21,0,6,6,0,21,44,27,17,35,39,5,8,3,2,1,,,
"Jun 20, 2021 10:00 AM",52,34,18,156,100,56,200,114,86,134,92,42,20,6,14,15,20,18,2,14,12,2,20,74,44,30,51,72,7,1,2,1,1,,,
"Jun 20, 2021 11:00 AM",74,47,27,167,69,98,196,105,91,151,87,64,36,21,15,37,16,16,0,17,16,1,18,75,43,32,56,49,7,10,7,4,3,,,
"Jun 20, 2021 12:00 PM",79,37,42,220,118,102,218,116,102,191,100,91,31,11,20,19,25,25,0,24,21,3,25,82,49,33,74,69,11,5,4,3,1,,,
"Jun 20, 2021 1:00 PM",103,52,51,192,108,84,199,117,82,191,108,83,31,16,15,27,28,28,0,24,23,1,27,68,46,22,80,35,13,2,7,6,1,,,
"Jun 20, 2021 2:00 PM",66,33,33,210,104,106,217,107,110,199,98,101,53,27,26,16,26,24,2,31,28,3,23,101,54,47,63,68,7,4,14,10,4,,,
"Jun 20, 2021 3:00 PM",69,39,30,229,133,96,246,123,123,189,97,92,37,18,19,26,34,31,3,20,17,3,31,105,58,47,58,61,6,5,7,3,4,,,
"Jun 20, 2021 4:00 PM",71,26,45,234,128,106,255,129,126,198,94,104,42,20,22,27,25,24,1,16,13,3,26,122,67,55,58,70,9,7,4,3,1,,,
"Jun 20, 2021 5:00 PM",82,41,41,188,96,92,229,125,104,147,80,67,36,20,16,21,24,24,0,25,24,1,23,84,51,33,53,74,10,7,3,0,3,,,
"Jun 20, 2021 6:00 PM",48,19,29,133,52,81,188,68,120,117,50,67,29,10,19,15,16,14,2,16,14,2,15,71,28,43,35,66,8,2,4,3,1,,,
"Jun 20, 2021 7:00 PM",63,27,36,114,58,56,169,70,99,110,46,64,13,9,4,19,19,19,0,11,9,2,15,77,34,43,32,52,2,2,9,5,4,,,
"Jun 20, 2021 8:00 PM",36,13,23,76,35,41,119,48,71,74,28,46,17,12,5,9,17,15,2,11,10,1,14,47,22,25,24,34,7,3,7,5,2,,,
"Jun 20, 2021 9:00 PM",38,14,24,42,18,24,83,24,59,40,15,25,11,1,10,2,15,15,0,11,10,1,17,37,13,24,11,31,0,3,4,3,1,,,
"Jun 20, 2021 10:00 PM",16,6,10,28,10,18,23,4,19,18,4,14,9,8,1,6,6,6,0,9,8,1,7,10,3,7,8,12,1,0,3,2,1,,,
"Jun 20, 2021 11:00 PM",19,13,6,5,1,4,14,3,11,6,2,4,1,1,0,4,7,6,1,9,9,0,5,6,0,6,5,12,2,0,4,2,2,,,
"Jun 21, 2021 12:00 AM",6,0,6,1,1,0,4,1,3,1,0,1,1,1,0,4,3,3,0,1,1,0,3,1,1,0,2,2,0,0,0,0,0,,,
"Jun 21, 2021 1:00 AM",3,3,0,2,2,0,3,2,1,1,1,0,1,0,1,0,0,0,0,2,2,0,0,0,0,0,1,2,0,0,2,1,1,,,
"Jun 21, 2021 2:00 AM",1,1,0,0,0,0,0,0,0,0,0,0,0,0,0,1,0,0,0,0,0,0,0,1,0,1,0,2,0,1,2,1,1,,,
"Jun 21, 2021 3:00 AM",1,0,1,0,0,0,5,4,1,4,2,2,2,2,0,0,0,0,0,0,0,0,0,0,0,0,1,0,0,0,0,0,0,,,
"Jun 21, 2021 4:00 AM",0,0,0,3,3,0,7,7,0,4,4,0,1,1,0,1,3,3,0,1,1,0,3,0,0,0,5,2,0,0,0,0,0,,,
"Jun 21, 2021 5:00 AM",6,5,1,4,2,2,15,7,8,12,7,5,3,1,2,0,6,6,0,2,2,0,6,0,0,0,4,10,0,0,1,1,0,,,
"Jun 21, 2021 6:00 AM",48,38,10,28,13,15,47,20,27,27,12,15,9,8,1,5,13,13,0,6,3,3,14,14,6,8,12,47,0,1,2,1,1,,,
"Jun 21, 2021 7:00 AM",92,41,51,53,25,28,82,35,47,60,34,26,4,1,3,9,59,58,1,23,19,4,61,32,16,16,44,79,5,7,6,5,1,,,
"Jun 21, 2021 8:00 AM",150,108,42,101,31,70,134,60,74,108,45,63,39,22,17,22,90,90,0,19,11,8,95,68,29,39,43,108,2,3,10,7,3,,,
"Jun 21, 2021 9:00 AM",101,76,25,72,33,39,103,53,50,71,37,34,22,17,5,17,50,50,0,20,17,3,51,27,10,17,25,48,4,2,1,1,0,,,
"Jun 21, 2021 10:00 AM",46,27,19,45,17,28,80,46,34,52,29,23,18,12,6,10,23,22,1,13,11,2,25,27,16,11,14,30,5,1,3,3,0,,,
"Jun 21, 2021 11:00 AM",40,25,15,64,30,34,96,46,50,62,27,35,19,15,4,17,18,18,0,13,10,3,19,45,26,19,25,27,5,3,1,0,1,,,
"Jun 21, 2021 12:00 PM",54,28,26,94,54,40,114,58,56,84,51,33,30,19,11,19,21,21,0,15,14,1,22,34,22,12,33,34,3,9,7,3,4,,,
"Jun 21, 2021 1:00 PM",77,39,38,111,60,51,134,63,71,105,59,46,35,16,19,24,26,26,0,21,17,4,29,44,25,19,41,30,13,12,10,7,3,,,
"Jun 21, 2021 2:00 PM",69,34,35,120,72,48,127,87,40,108,74,34,40,22,18,28,25,24,1,25,21,4,22,54,33,21,33,38,7,2,14,8,6,,,
"Jun 21, 2021 3:00 PM",97,37,60,110,58,52,130,74,56,118,67,51,27,12,15,33,19,19,0,29,24,5,23,44,31,13,56,39,7,5,5,0,5,,,
"Jun 21, 2021 4:00 PM",92,44,48,125,66,59,168,83,85,143,75,68,35,21,14,30,26,26,0,46,45,1,25,66,39,27,45,55,9,4,13,7,6,,,
"Jun 21, 2021 5:00 PM",182,63,119,132,74,58,217,135,82,144,80,64,30,9,21,31,24,24,0,75,74,1,27,114,81,33,75,71,9,9,11,6,5,,,
"Jun 21, 2021 6:00 PM",157,67,90,176,100,76,273,160,113,157,89,68,22,9,13,28,44,43,1,62,59,3,40,119,75,44,123,71,8,11,7,4,3,,,
"Jun 21, 2021 7:00 PM",102,39,63,141,75,66,279,171,108,142,88,54,30,11,19,35,28,27,1,35,31,4,27,96,59,37,85,78,6,9,5,3,2,,,
"Jun 21, 2021 8:00 PM",87,35,52,131,70,61,298,154,144,146,80,66,18,9,9,18,33,33,0,28,25,3,29,101,58,43,55,69,10,2,5,5,0,,,
"Jun 21, 2021 9:00 PM",52,19,33,101,51,50,171,69,102,97,45,52,18,6,12,14,11,11,0,18,17,1,11,73,22,51,34,45,4,3,3,1,2,,,
"Jun 21, 2021 10:00 PM",43,12,31,43,18,25,113,26,87,61,16,45,8,6,2,2,12,11,1,10,10,0,11,39,13,26,19,38,1,1,3,3,0,,,
"Jun 21, 2021 11:00 PM",9,7,2,8,1,7,18,2,16,10,1,9,4,2,2,6,2,2,0,8,8,0,2,10,1,9,2,10,1,3,1,1,0,,,
"Jun 22, 2021 12:00 AM",8,4,4,0,0,0,0,0,0,4,2,2,1,0,1,1,1,1,0,3,3,0,1,0,0,0,2,1,2,1,0,0,0,,,
"Jun 22, 2021 1:00 AM",3,2,1,1,1,0,0,0,0,0,0,0,1,1,0,0,1,1,0,0,0,0,1,0,0,0,1,1,0,2,0,0,0,,,
"Jun 22, 2021 2:00 AM",5,4,1,3,2,1,2,2,0,2,2,0,0,0,0,1,0,0,0,0,0,0,0,0,0,0,2,1,0,0,0,0,0,,,
"Jun 22, 2021 3:00 AM",1,0,1,0,0,0,3,3,0,1,1,0,0,0,0,0,1,1,0,0,0,0,1,0,0,0,2,0,0,0,0,0,0,,,
"Jun 22, 2021 4:00 AM",1,1,0,7,7,0,5,5,0,8,7,1,0,0,0,0,2,2,0,1,1,0,2,1,1,0,5,2,0,0,0,0,0,,,
"Jun 22, 2021 5:00 AM",9,7,2,13,2,11,12,6,6,13,8,5,3,2,1,2,6,6,0,2,1,1,6,6,5,1,4,11,0,0,1,1,0,,,
"Jun 22, 2021 6:00 AM",49,36,13,43,27,16,50,29,21,43,26,17,2,1,1,7,20,19,1,6,4,2,18,19,10,9,19,44,1,2,2,1,1,,,
"Jun 22, 2021 7:00 AM",112,65,47,103,39,64,118,54,64,103,49,54,11,8,3,18,63,61,2,17,14,3,68,32,17,15,50,101,6,7,5,4,1,,,
"Jun 22, 2021 8:00 AM",180,133,47,128,54,74,196,90,106,142,68,74,35,20,15,34,95,95,0,30,20,10,97,64,27,37,57,132,7,6,15,11,4,,,
"Jun 22, 2021 9:00 AM",100,66,34,115,56,59,138,77,61,98,58,40,23,14,9,14,53,52,1,20,16,4,54,59,32,27,40,65,5,3,6,1,5,,,
"Jun 22, 2021 10:00 AM",66,43,23,84,38,46,112,63,49,71,32,39,21,9,12,15,38,36,2,18,16,2,37,45,25,20,33,40,2,7,5,2,3,,,
"Jun 22, 2021 11:00 AM",68,39,29,104,64,40,137,85,52,94,64,30,16,3,13,17,26,25,1,16,13,3,25,48,30,18,37,46,11,3,3,2,1,,,
"Jun 22, 2021 12:00 PM",76,41,35,120,50,70,169,89,80,129,70,59,41,18,23,22,23,23,0,16,13,3,21,60,32,28,47,43,8,7,10,6,4,,,
"Jun 22, 2021 1:00 PM",87,43,44,137,75,62,173,91,82,104,58,46,31,18,13,17,16,16,0,21,19,2,18,64,34,30,49,38,14,1,8,3,5,,,
"Jun 22, 2021 2:00 PM",75,26,49,104,62,42,162,81,81,121,70,51,31,18,13,24,17,17,0,26,25,1,16,60,29,31,41,50,6,3,5,3,2,,,
"Jun 22, 2021 3:00 PM",90,45,45,143,71,72,159,85,74,124,70,54,37,24,13,11,16,15,1,30,29,1,17,76,47,29,41,55,6,6,9,7,2,,,
"Jun 22, 2021 4:00 PM",121,46,75,125,54,71,139,63,76,137,67,70,29,12,17,27,21,20,1,37,35,2,20,55,32,23,67,54,7,1,17,12,5,,,
"Jun 22, 2021 5:00 PM",185,57,128,151,79,72,213,116,97,203,106,97,47,23,24,22,37,36,1,71,68,3,36,100,65,35,115,90,9,12,16,14,2,,,
"Jun 22, 2021 6:00 PM",167,68,99,203,121,82,237,161,76,192,118,74,32,10,22,33,27,26,1,70,65,5,25,91,65,26,106,70,9,5,10,5,5,,,
"Jun 22, 2021 7:00 PM",125,47,78,144,67,77,217,96,121,166,87,79,25,22,3,29,36,34,2,46,45,1,35,74,44,30,60,76,4,8,12,7,5,,,
"Jun 22, 2021 8:00 PM",98,35,63,91,51,40,153,68,85,109,46,63,38,24,14,12,19,18,1,30,29,1,19,47,22,25,41,36,10,8,3,2,1,,,
"Jun 22, 2021 9:00 PM",62,19,43,58,36,22,78,31,47,58,18,40,23,6,17,7,19,19,0,30,29,1,20,31,17,14,13,45,1,1,2,1,1,,,
"Jun 22, 2021 10:00 PM",26,9,17,20,13,7,38,8,30,32,10,22,2,0,2,2,9,9,0,10,9,1,11,10,4,6,7,20,3,1,1,1,0,,,
"Jun 22, 2021 11:00 PM",17,11,6,9,8,1,9,2,7,9,5,4,2,1,1,1,7,7,0,9,9,0,7,1,1,0,6,4,0,0,0,0,0,,,
"Jun 23, 2021 12:00 AM",5,3,2,0,0,0,1,0,1,3,1,2,2,0,2,1,2,2,0,2,2,0,2,0,0,0,7,1,2,0,1,1,0,,,
"Jun 23, 2021 1:00 AM",1,1,0,0,0,0,2,2,0,2,2,0,0,0,0,0,1,1,0,3,3,0,1,0,0,0,3,2,0,0,0,0,0,,,
"Jun 23, 2021 2:00 AM",5,4,1,0,0,0,0,0,0,0,0,0,0,0,0,0,1,1,0,0,0,0,1,0,0,0,1,3,0,0,0,0,0,,,
"Jun 23, 2021 3:00 AM",1,1,0,0,0,0,1,1,0,0,0,0,0,0,0,0,1,1,0,0,0,0,1,0,0,0,1,0,0,0,0,0,0,,,
"Jun 23, 2021 4:00 AM",0,0,0,0,0,0,2,2,0,0,0,0,0,0,0,0,0,0,0,0,0,0,0,2,2,0,0,0,0,0,0,0,0,,,
"Jun 23, 2021 5:00 AM",7,7,0,0,0,0,4,4,0,6,5,1,1,1,0,0,5,5,0,3,1,2,6,0,0,0,1,13,0,1,0,0,0,,,
"Jun 23, 2021 6:00 AM",23,15,8,11,7,4,9,4,5,6,5,1,2,2,0,3,11,10,1,4,4,0,8,5,4,1,6,25,1,0,1,1,0,,,
"Jun 23, 2021 7:00 AM",55,33,22,27,9,18,35,11,24,30,12,18,2,1,1,10,39,39,0,14,8,6,41,14,7,7,21,37,3,3,2,2,0,,,
"Jun 23, 2021 8:00 AM",99,74,25,25,11,14,46,27,19,42,25,17,4,3,1,15,53,53,0,21,13,8,53,18,8,10,44,73,3,2,8,5,3,,,
"Jun 23, 2021 9:00 AM",71,51,20,25,9,16,47,29,18,38,20,18,9,7,2,7,34,33,1,10,7,3,32,12,6,6,18,40,4,0,4,2,2,,,
"Jun 23, 2021 10:00 AM",46,28,18,27,9,18,39,23,16,26,19,7,11,5,6,5,14,13,1,6,4,2,15,18,13,5,14,12,1,4,1,1,0,,,
"Jun 23, 2021 11:00 AM",38,21,17,26,9,17,53,29,24,36,16,20,6,3,3,7,13,12,1,10,10,0,10,16,9,7,13,11,1,0,9,5,4,,,
"Jun 23, 2021 12:00 PM",52,25,27,26,16,10,42,19,23,33,18,15,11,7,4,7,14,14,0,10,9,1,13,21,11,10,15,14,2,2,3,3,0,,,
"Jun 23, 2021 1:00 PM",51,25,26,25,17,8,35,27,8,37,25,12,10,3,7,4,16,16,0,14,11,3,18,22,10,12,14,19,2,2,11,8,3,,,
"Jun 23, 2021 2:00 PM",42,20,22,18,10,8,32,16,16,29,17,12,7,3,4,11,13,13,0,12,12,0,13,15,9,6,11,19,4,2,1,1,0,,,
"Jun 23, 2021 3:00 PM",58,23,35,38,17,21,42,22,20,41,22,19,15,9,6,11,19,19,0,14,12,2,17,14,9,5,24,21,6,0,5,2,3,,,
"Jun 23, 2021 4:00 PM",73,29,44,42,22,20,66,29,37,45,18,27,20,9,11,19,13,13,0,25,25,0,17,23,14,9,39,31,5,5,3,0,3,,,
"Jun 23, 2021 5:00 PM",139,51,88,62,33,29,110,60,50,98,51,47,10,2,8,25,34,34,0,54,52,2,34,40,25,15,54,46,4,4,4,3,1,,,
"Jun 23, 2021 6:00 PM",105,42,63,84,50,34,96,58,38,96,60,36,17,8,9,18,27,26,1,47,41,6,25,53,35,18,66,46,4,7,4,3,1,,,
"Jun 23, 2021 7:00 PM",94,34,60,83,38,45,93,48,45,81,43,38,15,9,6,14,22,22,0,21,19,2,22,24,17,7,33,30,11,2,6,6,0,,,
"Jun 23, 2021 8:00 PM",56,21,35,70,32,38,99,49,50,72,33,39,14,4,10,12,19,19,0,18,17,1,19,45,24,21,25,22,4,7,2,1,1,,,
"Jun 23, 2021 9:00 PM",43,19,24,23,11,12,48,20,28,36,15,21,3,2,1,8,15,15,0,14,13,1,14,22,14,8,14,20,1,5,4,4,0,,,
"Jun 23, 2021 10:00 PM",29,8,21,20,16,4,52,18,34,33,10,23,6,2,4,5,7,6,1,12,11,1,6,15,6,9,13,14,3,0,3,0,3,,,
"Jun 23, 2021 11:00 PM",13,6,7,12,9,3,7,4,3,13,7,6,5,3,2,1,4,4,0,6,6,0,4,3,1,2,10,9,1,1,0,0,0,,,
"Jun 24, 2021 12:00 AM",3,1,2,0,0,0,0,0,0,2,1,1,1,0,1,1,2,1,1,8,8,0,1,0,0,0,1,2,2,0,1,0,1,,,
"Jun 24, 2021 1:00 AM",5,1,4,3,1,2,2,0,2,4,1,3,0,0,0,0,2,2,0,1,1,0,2,1,0,1,2,2,0,1,0,0,0,,,
"Jun 24, 2021 2:00 AM",6,4,2,1,0,1,2,1,1,2,1,1,0,0,0,1,1,1,0,0,0,0,1,0,0,0,1,1,0,0,1,0,1,,,
"Jun 24, 2021 3:00 AM",1,1,0,1,1,0,3,2,1,3,2,1,0,0,0,0,0,0,0,0,0,0,0,2,1,1,1,0,0,0,0,0,0,,,
"Jun 24, 2021 4:00 AM",1,1,0,0,0,0,1,1,0,0,0,0,0,0,0,1,0,0,0,0,0,0,0,1,1,0,1,0,0,0,0,0,0,,,
"Jun 24, 2021 5:00 AM",8,6,2,3,1,2,14,10,4,10,7,3,0,0,0,1,6,6,0,1,0,1,4,1,1,0,11,9,0,0,0,0,0,,,
"Jun 24, 2021 6:00 AM",43,27,16,47,30,17,45,34,11,42,30,12,5,4,1,7,20,19,1,7,7,0,19,10,9,1,12,37,4,3,4,4,0,,,
"Jun 24, 2021 7:00 AM",102,58,44,118,50,68,126,49,77,123,52,71,9,6,3,23,47,46,1,25,19,6,50,35,18,17,34,87,3,8,4,2,2,,,
"Jun 24, 2021 8:00 AM",159,109,50,118,41,77,138,64,74,122,55,67,30,19,11,22,75,75,0,23,16,7,84,49,22,27,42,116,5,9,8,7,1,,,
"Jun 24, 2021 9:00 AM",91,62,29,98,41,57,123,70,53,96,52,44,25,14,11,12,52,52,0,16,13,3,52,44,19,25,41,60,5,2,4,3,1,,,
"Jun 24, 2021 10:00 AM",49,37,12,74,38,36,117,68,49,83,46,37,12,6,6,15,28,28,0,17,15,2,29,40,27,13,26,42,4,4,2,2,0,,,
"Jun 24, 2021 11:00 AM",62,26,36,87,39,48,130,74,56,87,56,31,21,16,5,19,24,23,1,10,10,0,23,51,30,21,39,40,4,2,2,0,2,,,
"Jun 24, 2021 12:00 PM",60,32,28,122,59,63,213,110,103,126,66,60,32,12,20,13,24,24,0,17,16,1,24,76,44,32,37,38,5,6,8,5,3,,,
"Jun 24, 2021 1:00 PM",90,42,48,96,43,53,173,76,97,101,50,51,24,10,14,24,21,21,0,12,11,1,21,55,28,27,44,49,10,5,11,8,3,,,
"Jun 24, 2021 2:00 PM",66,30,36,75,43,32,120,55,65,100,54,46,29,16,13,17,29,27,2,20,18,2,24,43,22,21,29,42,10,6,6,4,2,,,
"Jun 24, 2021 3:00 PM",86,31,55,75,38,37,119,53,66,79,43,36,29,10,19,15,17,13,4,26,21,5,15,40,25,15,28,41,6,3,6,4,2,,,
"Jun 24, 2021 4:00 PM",108,42,66,67,32,35,92,43,49,98,42,56,37,24,13,45,18,17,1,29,28,1,18,48,29,19,40,37,3,1,8,4,4,,,
"Jun 24, 2021 5:00 PM",168,56,112,110,58,52,139,81,58,115,77,38,32,17,15,23,31,31,0,45,42,3,35,52,36,16,75,58,6,5,8,7,1,,,
"Jun 24, 2021 6:00 PM",147,58,89,81,45,36,89,65,24,89,56,33,18,8,10,17,28,25,3,57,57,0,23,23,20,3,66,44,3,6,5,3,2,,,
"Jun 24, 2021 7:00 PM",69,31,38,38,24,14,56,37,19,47,27,20,12,5,7,12,9,9,0,34,30,4,8,20,14,6,39,18,4,1,6,2,4,,,
"Jun 24, 2021 8:00 PM",40,13,27,37,24,13,36,11,25,42,17,25,14,10,4,12,6,6,0,27,24,3,11,5,3,2,22,17,2,3,5,2,3,,,
"Jun 24, 2021 9:00 PM",36,15,21,34,25,9,34,12,22,33,12,21,10,3,7,2,7,6,1,16,16,0,7,13,7,6,14,20,1,1,6,6,0,,,
"Jun 24, 2021 10:00 PM",26,6,20,22,17,5,28,7,21,22,0,22,8,3,5,1,6,6,0,9,8,1,6,6,2,4,14,15,3,2,0,0,0,,,
"Jun 24, 2021 11:00 PM",21,9,12,10,6,4,8,0,8,11,0,11,6,1,5,5,1,1,0,5,5,0,1,2,0,2,2,8,1,0,2,2,0,,,
"Jun 25, 2021 12:00 AM",10,3,7,0,0,0,4,2,2,3,0,3,3,2,1,2,4,4,0,4,4,0,4,1,0,1,8,2,1,0,1,1,0,,,
"Jun 25, 2021 1:00 AM",1,1,0,3,2,1,6,4,2,3,3,0,0,0,0,0,0,0,0,1,1,0,0,2,0,2,2,3,0,0,0,0,0,,,
"Jun 25, 2021 2:00 AM",3,2,1,1,1,0,2,1,1,2,1,1,0,0,0,0,0,0,0,1,0,1,0,0,0,0,1,0,1,0,0,0,0,,,
"Jun 25, 2021 3:00 AM",2,0,2,0,0,0,0,0,0,0,0,0,0,0,0,0,0,0,0,0,0,0,0,0,0,0,0,1,0,0,0,0,0,,,
"Jun 25, 2021 4:00 AM",1,1,0,2,2,0,3,3,0,2,2,0,2,0,2,0,2,2,0,0,0,0,1,0,0,0,3,1,0,0,1,0,1,,,
"Jun 25, 2021 5:00 AM",9,8,1,4,3,1,8,4,4,10,6,4,1,1,0,2,7,7,0,3,3,0,8,0,0,0,3,8,0,0,0,0,0,,,
"Jun 25, 2021 6:00 AM",36,26,10,24,18,6,27,17,10,23,16,7,1,1,0,4,15,15,0,3,3,0,15,14,12,2,11,29,3,3,3,3,0,,,
"Jun 25, 2021 7:00 AM",61,33,28,67,30,37,68,27,41,56,29,27,9,4,5,5,42,41,1,17,11,6,41,27,11,16,25,70,3,5,6,5,1,,,
"Jun 25, 2021 8:00 AM",119,80,39,78,26,52,80,39,41,74,31,43,20,15,5,16,71,70,1,30,22,8,75,40,19,21,31,77,3,2,3,2,1,,,
"Jun 25, 2021 9:00 AM",72,53,19,47,15,32,66,34,32,48,23,25,12,8,4,16,24,24,0,22,13,9,29,22,9,13,20,37,2,3,5,0,5,,,
"Jun 25, 2021 10:00 AM",45,27,18,42,27,15,52,27,25,39,27,12,6,6,0,7,19,19,0,17,12,5,19,17,10,7,16,33,4,3,7,6,1,,,
"Jun 25, 2021 11:00 AM",50,30,20,43,21,22,52,30,22,43,29,14,7,3,4,13,13,13,0,6,6,0,14,22,16,6,13,16,4,2,4,2,2,,,
"Jun 25, 2021 12:00 PM",49,21,28,51,28,23,68,38,30,60,36,24,20,14,6,13,16,16,0,13,13,0,15,21,8,13,21,16,2,3,4,2,2,,,
"Jun 25, 2021 1:00 PM",62,31,31,35,16,19,70,35,35,37,12,25,14,9,5,12,18,18,0,17,17,0,17,41,28,13,22,23,5,2,4,4,0,,,
"Jun 25, 2021 2:00 PM",67,38,29,40,27,13,70,35,35,45,29,16,15,6,9,16,17,15,2,20,20,0,15,24,17,7,22,41,2,2,3,2,1,,,
"Jun 25, 2021 3:00 PM",88,39,49,46,31,15,47,27,20,39,26,13,8,6,2,21,23,22,1,25,24,1,22,10,5,5,28,30,4,1,7,3,4,,,
"Jun 25, 2021 4:00 PM",100,48,52,60,35,25,85,47,38,75,41,34,13,4,9,15,22,21,1,33,30,3,20,39,23,16,52,52,3,5,5,3,2,,,
"Jun 25, 2021 5:00 PM",134,56,78,85,51,34,90,51,39,68,39,29,28,12,16,20,27,26,1,50,47,3,26,45,29,16,59,51,5,5,7,4,3,,,
"Jun 25, 2021 6:00 PM",102,47,55,65,43,22,91,58,33,71,39,32,11,5,6,23,28,27,1,43,41,2,29,44,32,12,60,27,8,3,12,8,4,,,
"Jun 25, 2021 7:00 PM",59,24,35,79,38,41,81,44,37,74,35,39,19,7,12,17,25,23,2,31,28,3,22,40,29,11,34,38,5,4,6,5,1,,,
"Jun 25, 2021 8:00 PM",36,14,22,33,21,12,53,28,25,39,25,14,14,10,4,10,16,15,1,20,17,3,15,23,13,10,22,17,3,1,7,5,2,,,
"Jun 25, 2021 9:00 PM",35,10,25,25,13,12,40,8,32,28,11,17,5,3,2,13,6,5,1,5,5,0,4,26,8,18,8,17,2,2,9,6,3,,,
"Jun 25, 2021 10:00 PM",22,4,18,8,7,1,15,8,7,10,5,5,5,4,1,1,9,9,0,11,10,1,9,8,6,2,8,9,3,0,5,3,2,,,
"Jun 25, 2021 11:00 PM",19,5,14,10,5,5,14,6,8,9,1,8,3,2,1,2,4,4,0,10,10,0,4,4,3,1,8,10,0,1,0,0,0,,,
"Jun 26, 2021 12:00 AM",8,2,6,0,0,0,2,1,1,3,2,1,6,1,5,1,4,4,0,7,6,1,4,2,2,0,6,11,0,0,0,0,0,,,
"Jun 26, 2021 1:00 AM",4,4,0,1,0,1,8,0,8,2,1,1,1,0,1,1,3,3,0,7,5,2,2,3,2,1,2,5,0,0,0,0,0,,,
"Jun 26, 2021 2:00 AM",4,2,2,2,1,1,2,2,0,2,1,1,0,0,0,3,0,0,0,0,0,0,0,0,0,0,1,5,0,0,1,0,1,,,
"Jun 26, 2021 3:00 AM",4,1,3,0,0,0,2,1,1,2,1,1,0,0,0,1,0,0,0,3,3,0,0,1,1,0,3,0,0,0,0,0,0,,,
"Jun 26, 2021 4:00 AM",2,1,1,1,1,0,1,1,0,0,0,0,0,0,0,0,0,0,0,1,1,0,0,0,0,0,1,4,0,0,0,0,0,,,
"Jun 26, 2021 5:00 AM",4,1,3,1,0,1,9,5,4,6,5,1,0,0,0,1,5,5,0,2,2,0,6,4,2,2,4,0,1,0,0,0,0,,,
"Jun 26, 2021 6:00 AM",12,7,5,15,11,4,14,9,5,12,8,4,1,0,1,2,2,2,0,4,4,0,1,5,3,2,7,17,0,1,1,0,1,,,
"Jun 26, 2021 7:00 AM",24,10,14,35,25,10,26,20,6,35,28,7,2,1,1,3,10,10,0,4,1,3,10,8,6,2,15,13,2,8,0,0,0,,,
"Jun 26, 2021 8:00 AM",48,21,27,50,33,17,43,27,16,52,33,19,20,5,15,13,22,22,0,14,13,1,24,20,12,8,21,27,2,6,3,0,3,,,
"Jun 26, 2021 9:00 AM",56,26,30,77,42,35,81,51,30,66,36,30,22,8,14,23,22,21,1,11,10,1,20,30,19,11,32,36,12,6,4,2,2,,,
"Jun 26, 2021 10:00 AM",64,31,33,100,56,44,121,74,47,86,55,31,40,20,20,16,26,26,0,18,17,1,24,35,27,8,36,43,7,7,8,7,1,,,
"Jun 26, 2021 11:00 AM",65,39,26,130,46,84,150,77,73,132,71,61,34,27,7,13,26,26,0,16,12,4,26,48,26,22,45,56,9,8,13,5,8,,,
"Jun 26, 2021 12:00 PM",86,63,23,169,91,78,193,106,87,162,97,65,38,22,16,30,18,17,1,24,20,4,18,72,44,28,51,35,11,7,1,1,0,,,
"Jun 26, 2021 1:00 PM",69,35,34,134,69,65,167,102,65,129,80,49,36,25,11,28,27,25,2,19,19,0,25,56,27,29,54,49,9,3,11,7,4,,,
"Jun 26, 2021 2:00 PM",73,40,33,94,49,45,148,69,79,103,59,44,30,17,13,16,26,25,1,26,22,4,24,60,37,23,25,37,8,2,8,4,4,,,
"Jun 26, 2021 3:00 PM",48,18,30,90,49,41,144,67,77,112,60,52,34,18,16,16,27,25,2,19,18,1,27,52,24,28,40,44,9,7,11,8,3,,,
"Jun 26, 2021 4:00 PM",65,32,33,122,58,64,103,45,58,105,42,63,47,24,23,17,16,16,0,14,13,1,15,51,28,23,25,32,6,1,6,4,2,,,
"Jun 26, 2021 5:00 PM",54,27,27,79,42,37,107,36,71,81,32,49,22,10,12,20,23,23,0,18,15,3,22,54,17,37,24,36,1,1,7,3,4,,,
"Jun 26, 2021 6:00 PM",56,19,37,66,38,28,74,35,39,77,35,42,21,3,18,20,15,15,0,15,14,1,16,21,12,9,23,45,7,1,0,0,0,,,
"Jun 26, 2021 7:00 PM",55,24,31,61,38,23,67,42,25,55,26,29,11,7,4,12,20,20,0,11,9,2,19,27,16,11,26,31,3,7,4,3,1,,,
"Jun 26, 2021 8:00 PM",44,20,24,34,20,14,38,16,22,30,17,13,15,5,10,5,8,8,0,4,4,0,9,25,9,16,10,18,5,1,0,0,0,,,
"Jun 26, 2021 9:00 PM",26,15,11,15,4,11,32,9,23,20,6,14,2,2,0,2,11,9,2,6,6,0,8,19,8,11,3,12,0,0,3,1,2,,,
"Jun 26, 2021 10:00 PM",37,16,21,19,12,7,32,16,16,26,13,13,9,3,6,2,7,6,1,4,3,1,8,6,3,3,9,15,0,0,2,1,1,,,
"Jun 26, 2021 11:00 PM",19,5,14,23,12,11,9,6,3,7,3,4,3,1,2,2,5,5,0,10,10,0,6,4,3,1,9,6,0,1,2,2,0,,,
"Jun 27, 2021 12:00 AM",14,8,6,1,0,1,4,2,2,13,4,9,1,1,0,2,3,3,0,4,4,0,3,4,4,0,6,5,1,2,0,0,0,,,
"Jun 27, 2021 1:00 AM",7,2,5,0,0,0,3,0,3,2,0,2,1,1,0,0,1,1,0,5,5,0,1,1,1,0,2,5,0,0,0,0,0,,,
"Jun 27, 2021 2:00 AM",5,3,2,1,0,1,6,5,1,3,2,1,1,0,1,0,4,4,0,5,3,2,3,0,0,0,4,2,0,0,0,0,0,,,
"Jun 27, 2021 3:00 AM",3,1,2,0,0,0,0,0,0,3,2,1,0,0,0,1,0,0,0,4,4,0,0,0,0,0,0,1,0,0,0,0,0,,,
"Jun 27, 2021 4:00 AM",3,0,3,1,1,0,3,3,0,0,0,0,0,0,0,0,2,2,0,2,2,0,3,0,0,0,2,2,0,0,0,0,0,,,
"Jun 27, 2021 5:00 AM",3,2,1,1,1,0,9,6,3,2,1,1,0,0,0,0,3,3,0,2,2,0,3,0,0,0,2,5,0,0,0,0,0,,,
"Jun 27, 2021 6:00 AM",9,6,3,14,7,7,12,6,6,12,8,4,0,0,0,0,4,4,0,3,3,0,2,6,5,1,8,15,0,1,0,0,0,,,
"Jun 27, 2021 7:00 AM",17,7,10,59,33,26,52,36,16,48,30,18,3,3,0,3,9,9,0,6,4,2,12,9,3,6,18,24,2,3,1,1,0,,,
"Jun 27, 2021 8:00 AM",41,12,29,83,51,32,87,53,34,71,43,28,5,2,3,8,23,23,0,8,6,2,24,40,28,12,32,30,2,10,1,0,1,,,
"Jun 27, 2021 9:00 AM",34,17,17,130,77,53,124,70,54,122,73,49,14,11,3,24,13,13,0,14,9,5,12,36,24,12,31,58,9,13,6,5,1,,,
"Jun 27, 2021 10:00 AM",52,28,24,145,72,73,143,67,76,157,78,79,8,3,5,12,27,26,1,16,15,1,24,55,25,30,36,59,14,4,6,1,5,,,
"Jun 27, 2021 11:00 AM",66,39,27,174,86,88,179,104,75,164,100,64,20,7,13,25,23,23,0,24,19,5,24,63,38,25,61,50,12,15,11,9,2,,,
"Jun 27, 2021 12:00 PM",89,54,35,191,89,102,209,116,93,173,98,75,34,24,10,28,38,37,1,22,17,5,34,88,62,26,69,54,12,8,8,3,5,,,
"Jun 27, 2021 1:00 PM",77,43,34,198,126,72,227,144,83,184,112,72,51,22,29,29,35,35,0,27,22,5,30,94,72,22,82,69,8,8,10,5,5,,,
"Jun 27, 2021 2:00 PM",75,42,33,218,123,95,264,163,101,177,103,74,45,27,18,20,22,22,0,30,28,2,22,125,84,41,70,55,10,8,6,2,4,,,
"Jun 27, 2021 3:00 PM",89,56,33,257,129,128,367,216,151,206,118,88,66,29,37,27,49,47,2,38,30,8,44,135,85,50,85,60,11,5,12,4,8,,,
"Jun 27, 2021 4:00 PM",83,43,40,233,125,108,383,202,181,217,123,94,57,29,28,16,34,31,3,23,21,2,34,109,57,52,66,94,12,10,10,4,6,,,
"Jun 27, 2021 5:00 PM",85,45,40,210,80,130,293,106,187,187,66,121,29,18,11,23,21,21,0,22,22,0,25,110,53,57,58,78,12,4,9,4,5,,,
"Jun 27, 2021 6:00 PM",64,34,30,160,76,84,234,83,151,171,69,102,21,11,10,21,23,23,0,20,19,1,23,86,31,55,41,67,6,3,11,6,5,,,
"Jun 27, 2021 7:00 PM",68,27,41,121,57,64,127,44,83,101,44,57,30,16,14,11,21,19,2,15,14,1,18,55,17,38,28,58,4,4,6,5,1,,,
"Jun 27, 2021 8:00 PM",53,23,30,77,36,41,92,24,68,84,26,58,8,1,7,26,21,20,1,12,12,0,19,32,9,23,19,30,5,2,3,2,1,,,
"Jun 27, 2021 9:00 PM",27,17,10,52,21,31,47,11,36,42,13,29,8,5,3,4,11,11,0,7,7,0,12,23,5,18,6,26,0,2,0,0,0,,,
"Jun 27, 2021 10:00 PM",24,9,15,22,10,12,23,7,16,19,7,12,4,2,2,5,17,17,0,7,6,1,13,18,6,12,9,20,1,2,1,1,0,,,
"Jun 27, 2021 11:00 PM",13,6,7,6,3,3,10,3,7,10,3,7,3,2,1,4,5,5,0,8,8,0,6,3,1,2,5,6,1,0,0,0,0,,,
"Jun 28, 2021 12:00 AM",11,2,9,0,0,0,1,1,0,3,2,1,2,2,0,0,2,1,1,2,2,0,1,2,2,0,0,3,0,0,1,1,0,,,
"Jun 28, 2021 1:00 AM",5,3,2,2,1,1,5,2,3,4,2,2,0,0,0,3,2,2,0,5,4,1,2,0,0,0,4,1,0,1,0,0,0,,,
"Jun 28, 2021 2:00 AM",3,2,1,0,0,0,0,0,0,0,0,0,0,0,0,1,1,0,1,1,1,0,0,0,0,0,0,2,0,0,0,0,0,,,
"Jun 28, 2021 3:00 AM",1,0,1,0,0,0,1,1,0,0,0,0,0,0,0,0,0,0,0,0,0,0,0,0,0,0,1,3,0,0,0,0,0,,,
"Jun 28, 2021 4:00 AM",2,1,1,0,0,0,2,2,0,4,2,2,0,0,0,1,1,1,0,0,0,0,1,1,0,1,0,1,0,0,0,0,0,,,
"Jun 28, 2021 5:00 AM",12,9,3,2,1,1,14,12,2,8,6,2,1,0,1,3,8,8,0,5,3,2,7,8,8,0,3,9,0,0,0,0,0,,,
"Jun 28, 2021 6:00 AM",37,28,9,35,21,14,33,13,20,28,17,11,14,6,8,2,19,19,0,7,7,0,21,9,4,5,15,37,2,3,1,1,0,,,
"Jun 28, 2021 7:00 AM",97,60,37,76,33,43,77,33,44,62,27,35,3,2,1,12,64,61,3,16,10,6,62,25,12,13,40,80,4,7,4,4,0,,,
"Jun 28, 2021 8:00 AM",148,103,45,99,39,60,107,51,56,105,52,53,27,21,6,29,80,80,0,22,16,6,86,46,16,30,38,99,2,1,7,5,2,,,
"Jun 28, 2021 9:00 AM",103,78,25,81,35,46,87,49,38,70,43,27,18,10,8,17,51,50,1,26,23,3,54,37,19,18,26,54,6,6,3,0,3,,,
"Jun 28, 2021 10:00 AM",62,42,20,60,29,31,69,38,31,62,41,21,23,17,6,16,21,20,1,9,8,1,22,35,22,13,21,38,6,6,7,7,0,,,
"Jun 28, 2021 11:00 AM",50,25,25,60,30,30,80,46,34,67,35,32,23,12,11,16,20,20,0,15,15,0,20,34,17,17,18,36,6,3,8,4,4,,,
"Jun 28, 2021 12:00 PM",79,37,42,88,30,58,103,55,48,76,41,35,26,13,13,20,34,33,1,23,19,4,30,52,30,22,37,36,7,1,3,3,0,,,
"Jun 28, 2021 1:00 PM",87,42,45,102,59,43,120,69,51,89,51,38,36,18,18,17,26,24,2,15,13,2,28,45,25,20,30,30,7,2,6,4,2,,,
"Jun 28, 2021 2:00 PM",69,40,29,93,52,41,122,71,51,85,48,37,33,16,17,32,20,19,1,24,21,3,20,67,43,24,30,32,11,9,8,3,5,,,
"Jun 28, 2021 3:00 PM",87,38,49,101,57,44,147,71,76,95,55,40,29,10,19,12,17,16,1,22,20,2,19,76,33,43,37,52,7,5,7,2,5,,,
"Jun 28, 2021 4:00 PM",158,69,89,98,60,38,171,93,78,105,60,45,15,7,8,25,28,27,1,36,34,2,26,82,51,31,61,61,10,4,9,5,4,,,
"Jun 28, 2021 5:00 PM",164,54,110,136,74,62,217,111,106,148,77,71,29,10,19,17,32,32,0,72,67,5,29,82,49,33,79,88,10,7,11,8,3,,,
"Jun 28, 2021 6:00 PM",159,55,104,140,93,47,199,126,73,127,86,41,24,8,16,26,39,33,6,68,67,1,34,77,54,23,100,56,6,6,6,5,1,,,
"Jun 28, 2021 7:00 PM",107,44,63,147,69,78,196,105,91,148,78,70,19,11,8,27,36,33,3,38,36,2,32,67,42,25,86,63,2,4,12,10,2,,,
"Jun 28, 2021 8:00 PM",98,32,66,130,72,58,123,55,68,116,54,62,17,7,10,16,20,19,1,22,22,0,19,50,23,27,33,40,5,6,10,5,5,,,
"Jun 28, 2021 9:00 PM",63,14,49,66,26,40,83,37,46,63,27,36,10,5,5,20,12,10,2,21,20,1,11,30,14,16,36,30,5,2,7,5,2,,,
"Jun 28, 2021 10:00 PM",35,9,26,25,13,12,28,6,22,27,10,17,4,1,3,3,10,10,0,11,11,0,9,10,4,6,8,14,0,1,1,1,0,,,
"Jun 28, 2021 11:00 PM",22,9,13,6,6,0,11,3,8,10,3,7,5,0,5,3,5,5,0,6,6,0,3,6,3,3,5,7,2,0,3,3,0,,,
"Jun 29, 2021 12:00 AM",8,1,7,0,0,0,1,0,1,3,0,3,1,0,1,3,3,3,0,3,3,0,4,2,0,2,4,4,3,0,1,1,0,,,
"Jun 29, 2021 1:00 AM",5,1,4,0,0,0,3,2,1,2,1,1,1,0,1,0,0,0,0,3,2,1,1,0,0,0,1,2,0,0,0,0,0,,,
"Jun 29, 2021 2:00 AM",6,6,0,0,0,0,1,0,1,0,0,0,0,0,0,0,1,1,0,2,2,0,1,0,0,0,0,1,0,0,0,0,0,,,
"Jun 29, 2021 3:00 AM",1,1,0,2,0,2,1,1,0,1,1,0,0,0,0,1,0,0,0,0,0,0,0,0,0,0,1,3,0,0,0,0,0,,,
"Jun 29, 2021 4:00 AM",3,2,1,0,0,0,6,4,2,3,1,2,0,0,0,0,0,0,0,0,0,0,0,1,0,1,5,2,0,1,0,0,0,,,
"Jun 29, 2021 5:00 AM",9,7,2,8,6,2,11,9,2,11,9,2,1,1,0,2,9,9,0,4,2,2,9,0,0,0,6,12,0,0,0,0,0,,,
"Jun 29, 2021 6:00 AM",48,34,14,37,22,15,45,28,17,33,20,13,2,2,0,6,22,21,1,9,9,0,18,20,13,7,18,43,1,7,5,5,0,,,
"Jun 29, 2021 7:00 AM",105,68,37,95,29,66,133,48,85,100,38,62,2,2,0,17,53,51,2,18,14,4,54,44,21,23,43,95,3,11,7,6,1,,,
"Jun 29, 2021 8:00 AM",170,118,52,107,44,63,132,65,67,115,58,57,29,23,6,32,89,89,0,22,17,5,96,54,23,31,55,117,6,6,6,2,4,,,
"Jun 29, 2021 9:00 AM",109,66,43,91,37,54,97,57,40,100,64,36,25,18,7,13,50,50,0,22,18,4,54,52,26,26,38,72,4,5,7,3,4,,,
"Jun 29, 2021 10:00 AM",64,34,30,77,36,41,99,53,46,72,43,29,23,16,7,14,27,27,0,22,18,4,26,47,27,20,34,46,5,4,4,3,1,,,
"Jun 29, 2021 11:00 AM",72,36,36,100,56,44,106,62,44,95,61,34,27,15,12,17,26,26,0,14,14,0,26,50,25,25,39,43,5,4,4,3,1,,,
"Jun 29, 2021 12:00 PM",77,42,35,106,60,46,128,71,57,100,56,44,21,8,13,23,30,28,2,25,23,2,28,59,33,26,38,54,11,5,6,4,2,,,
"Jun 29, 2021 1:00 PM",81,40,41,151,76,75,183,94,89,146,70,76,35,19,16,33,20,19,1,28,21,7,23,58,38,20,51,49,7,3,6,5,1,,,
"Jun 29, 2021 2:00 PM",93,45,48,176,99,77,216,137,79,146,100,46,32,14,18,29,29,28,1,31,29,2,28,97,62,35,63,34,6,5,5,5,0,,,
"Jun 29, 2021 3:00 PM",87,38,49,157,92,65,216,126,90,146,87,59,45,12,33,25,35,35,0,31,30,1,36,89,57,32,70,69,9,4,13,7,6,,,
"Jun 29, 2021 4:00 PM",148,50,98,183,105,78,271,143,128,165,95,70,33,15,18,26,38,37,1,43,38,5,39,108,50,58,93,81,5,3,7,4,3,,,
"Jun 29, 2021 5:00 PM",170,48,122,206,107,99,304,180,124,203,121,82,44,18,26,28,50,49,1,70,68,2,50,121,81,40,136,93,8,6,9,5,4,,,
"Jun 29, 2021 6:00 PM",137,51,86,205,116,89,327,201,126,191,113,78,38,22,16,40,45,44,1,71,69,2,46,131,97,34,145,90,9,6,16,10,6,,,
"Jun 29, 2021 7:00 PM",121,62,59,228,106,122,328,158,170,212,121,91,26,14,12,28,32,31,1,48,37,11,30,103,56,47,77,114,6,4,8,5,3,,,
"Jun 29, 2021 8:00 PM",101,39,62,184,95,89,238,107,131,189,97,92,28,9,19,29,26,26,0,33,30,3,26,105,42,63,57,78,10,9,4,1,3,,,
"Jun 29, 2021 9:00 PM",82,33,49,117,45,72,139,35,104,103,26,77,16,10,6,9,9,9,0,19,19,0,9,56,13,43,34,72,6,2,4,4,0,,,
"Jun 29, 2021 10:00 PM",42,14,28,54,31,23,64,17,47,50,14,36,15,3,12,5,8,7,1,21,20,1,9,24,5,19,18,25,2,1,3,3,0,,,
"Jun 29, 2021 11:00 PM",21,10,11,22,14,8,27,9,18,26,7,19,9,8,1,1,4,4,0,7,7,0,4,14,3,11,3,7,0,0,3,2,1,,,
"Jun 30, 2021 12:00 AM",4,0,4,1,1,0,6,1,5,7,2,5,2,0,2,1,4,4,0,3,3,0,4,2,1,1,3,11,2,1,0,0,0,,,
"Jun 30, 2021 1:00 AM",8,4,4,3,2,1,5,3,2,3,2,1,0,0,0,0,0,0,0,2,2,0,0,1,0,1,1,3,0,1,0,0,0,,,
"Jun 30, 2021 2:00 AM",7,7,0,4,1,3,2,2,0,1,1,0,0,0,0,0,0,0,0,0,0,0,0,1,1,0,2,1,0,0,0,0,0,,,
"Jun 30, 2021 3:00 AM",4,3,1,2,0,2,1,1,0,0,0,0,0,0,0,1,0,0,0,0,0,0,0,0,0,0,1,2,0,0,0,0,0,,,
"Jun 30, 2021 4:00 AM",0,0,0,0,0,0,2,2,0,0,0,0,0,0,0,1,1,1,0,0,0,0,1,0,0,0,2,1,0,0,0,0,0,,,
"Jun 30, 2021 5:00 AM",12,9,3,1,1,0,10,6,4,9,6,3,2,1,1,1,8,8,0,2,1,1,8,0,0,0,10,11,0,0,0,0,0,,,
"Jun 30, 2021 6:00 AM",48,36,12,25,12,13,32,13,19,29,13,16,4,4,0,5,19,18,1,9,8,1,20,7,6,1,16,44,1,3,2,2,0,,,
"Jun 30, 2021 7:00 AM",95,54,41,74,35,39,102,50,52,71,36,35,8,7,1,11,49,48,1,16,12,4,50,31,14,17,42,91,4,6,8,6,2,,,
"Jun 30, 2021 8:00 AM",159,112,47,109,35,74,138,55,83,109,59,50,18,12,6,20,75,75,0,30,22,8,80,55,21,34,47,99,4,4,4,3,1,,,
"Jun 30, 2021 9:00 AM",100,64,36,102,48,54,110,66,44,98,59,39,30,23,7,19,55,55,0,19,13,6,56,48,20,28,46,72,7,4,9,5,4,,,
"Jun 30, 2021 10:00 AM",62,44,18,87,39,48,73,34,39,82,37,45,19,10,9,11,17,17,0,19,16,3,17,42,28,14,20,37,3,0,4,3,1,,,
"Jun 30, 2021 11:00 AM",66,33,33,71,39,32,66,34,32,53,36,17,21,8,13,13,17,16,1,26,23,3,15,43,24,19,29,28,4,5,5,3,2,,,
"Jun 30, 2021 12:00 PM",68,40,28,103,49,54,109,60,49,90,55,35,23,15,8,16,27,27,0,23,21,2,27,45,18,27,36,34,10,8,8,4,4,,,
"Jun 30, 2021 1:00 PM",82,36,46,90,51,39,106,59,47,104,51,53,35,19,16,23,30,30,0,18,14,4,31,40,13,27,42,31,10,3,5,5,0,,,
"Jun 30, 2021 2:00 PM",63,26,37,89,50,39,118,72,46,79,51,28,31,15,16,17,28,26,2,25,23,2,26,48,32,16,37,41,14,4,9,6,3,,,
"Jun 30, 2021 3:00 PM",76,33,43,92,50,42,148,93,55,91,52,39,22,14,8,26,19,19,0,33,28,5,19,62,42,20,41,46,6,5,9,8,1,,,
"Jun 30, 2021 4:00 PM",114,49,65,157,88,69,235,142,93,119,58,61,31,14,17,28,31,29,2,37,37,0,31,88,65,23,68,65,8,3,8,4,4,,,
"Jun 30, 2021 5:00 PM",165,57,108,196,123,73,364,212,152,214,128,86,25,9,16,47,41,39,2,75,73,2,48,150,99,51,122,92,9,10,8,7,1,,,
"Jun 30, 2021 6:00 PM",166,64,102,232,144,88,440,277,163,192,128,64,27,11,16,38,49,49,0,65,61,4,45,170,105,65,140,94,13,6,11,7,4,,,
"Jun 30, 2021 7:00 PM",125,55,70,202,104,98,353,178,175,188,102,86,26,16,10,11,30,28,2,46,42,4,30,133,62,71,85,97,7,6,10,7,3,,,
"Jun 30, 2021 8:00 PM",93,42,51,184,90,94,283,99,184,171,70,101,21,9,12,17,29,28,1,32,30,2,26,113,43,70,65,82,7,5,10,3,7,,,
"Jun 30, 2021 9:00 PM",86,30,56,110,38,72,143,48,95,107,38,69,12,1,11,17,19,19,0,23,22,1,22,52,14,38,37,66,5,2,8,4,4,,,
"Jun 30, 2021 10:00 PM",57,13,44,45,20,25,53,13,40,52,11,41,14,2,12,5,13,13,0,21,19,2,12,21,8,13,14,34,7,1,4,4,0,,,
"Jun 30, 2021 11:00 PM",22,8,14,11,3,8,26,8,18,17,4,13,3,0,3,6,10,10,0,11,11,0,10,17,4,13,11,6,1,2,0,0,0,,,
"Jul 1, 2021 12:00 AM",7,2,5,0,0,0,1,0,1,7,3,4,1,1,0,1,2,1,1,9,8,1,1,2,0,2,7,7,0,2,0,0,0,,,
"Jul 1, 2021 1:00 AM",2,1,1,0,0,0,2,1,1,0,0,0,0,0,0,1,1,1,0,3,3,0,1,0,0,0,0,1,0,0,2,0,2,,,
"Jul 1, 2021 2:00 AM",6,5,1,0,0,0,0,0,0,0,0,0,0,0,0,0,0,0,0,1,1,0,0,0,0,0,2,1,0,2,1,0,1,,,
"Jul 1, 2021 3:00 AM",2,0,2,0,0,0,3,3,0,2,2,0,0,0,0,0,0,0,0,0,0,0,1,0,0,0,4,1,0,0,0,0,0,,,
"Jul 1, 2021 4:00 AM",1,1,0,0,0,0,7,5,2,2,0,2,2,2,0,1,0,0,0,1,1,0,0,0,0,0,1,2,0,0,0,0,0,,,
"Jul 1, 2021 5:00 AM",10,8,2,1,1,0,5,3,2,10,7,3,0,0,0,2,6,6,0,2,2,0,7,5,5,0,6,7,0,1,0,0,0,,,
"Jul 1, 2021 6:00 AM",39,28,11,27,14,13,41,26,15,29,16,13,12,6,6,8,20,19,1,7,6,1,19,13,11,2,16,29,0,3,1,0,1,,,
"Jul 1, 2021 7:00 AM",93,60,33,82,31,51,108,40,68,65,25,40,7,4,3,14,39,39,0,16,11,5,37,34,17,17,50,89,2,8,3,3,0,,,
"Jul 1, 2021 8:00 AM",143,95,48,75,28,47,126,61,65,82,51,31,14,8,6,14,80,79,1,19,14,5,80,61,26,35,42,96,5,3,5,3,2,,,
"Jul 1, 2021 9:00 AM",88,64,24,65,26,39,82,45,37,81,43,38,26,16,10,17,48,48,0,11,8,3,49,41,18,23,34,60,0,3,2,2,0,,,
"Jul 1, 2021 10:00 AM",58,39,19,68,32,36,72,39,33,62,38,24,14,8,6,9,31,30,1,11,10,1,35,28,15,13,15,29,2,3,3,2,1,,,
"Jul 1, 2021 11:00 AM",69,35,34,61,30,31,83,43,40,76,46,30,22,11,11,13,24,23,1,11,11,0,21,28,18,10,11,31,2,1,13,11,2,,,
"Jul 1, 2021 12:00 PM",64,33,31,66,32,34,80,37,43,70,33,37,28,8,20,21,13,13,0,22,19,3,16,34,19,15,26,36,4,4,2,2,0,,,
"Jul 1, 2021 1:00 PM",81,41,40,79,36,43,100,57,43,86,44,42,23,6,17,14,23,23,0,19,13,6,25,41,27,14,29,36,8,6,7,6,1,,,
"Jul 1, 2021 2:00 PM",76,38,38,86,44,42,98,52,46,76,44,32,29,14,15,34,18,18,0,28,28,0,21,47,28,19,31,30,5,4,6,2,4,,,
"Jul 1, 2021 3:00 PM",95,45,50,111,60,51,159,99,60,111,63,48,35,24,11,14,31,29,2,18,14,4,31,45,28,17,58,39,3,6,7,4,3,,,
"Jul 1, 2021 4:00 PM",128,52,76,118,66,52,202,117,85,119,57,62,34,13,21,32,33,32,1,41,40,1,31,72,41,31,71,60,9,2,5,5,0,,,
"Jul 1, 2021 5:00 PM",174,60,114,198,105,93,340,207,133,224,147,77,47,27,20,24,43,42,1,66,64,2,40,114,79,35,136,74,15,3,10,8,2,,,
"Jul 1, 2021 6:00 PM",155,58,97,191,101,90,396,240,156,185,121,64,30,14,16,24,46,45,1,59,57,2,46,147,98,49,127,110,2,6,7,4,3,,,
"Jul 1, 2021 7:00 PM",123,62,61,188,105,83,322,151,171,178,93,85,26,13,13,53,26,23,3,58,56,2,23,100,56,44,83,89,5,8,7,2,5,,,
"Jul 1, 2021 8:00 PM",88,45,43,115,58,57,205,73,132,120,49,71,28,13,15,18,27,25,2,32,31,1,27,68,21,47,42,74,4,10,10,6,4,,,
"Jul 1, 2021 9:00 PM",78,21,57,97,63,34,110,31,79,90,34,56,9,3,6,6,22,22,0,30,29,1,20,46,18,28,24,53,2,2,4,1,3,,,
"Jul 1, 2021 10:00 PM",42,17,25,58,47,11,69,24,45,65,19,46,15,9,6,2,8,8,0,16,15,1,7,19,4,15,14,26,3,1,4,3,1,,,
"Jul 1, 2021 11:00 PM",32,10,22,11,9,2,21,4,17,22,3,19,5,3,2,4,3,2,1,16,16,0,3,4,0,4,12,16,3,1,1,1,0,,,
"Jul 2, 2021 12:00 AM",18,5,13,1,0,1,2,1,1,9,4,5,5,1,4,1,1,1,0,6,6,0,2,5,2,3,10,4,0,0,0,0,0,,,
"Jul 2, 2021 1:00 AM",5,0,5,0,0,0,3,2,1,2,2,0,2,0,2,0,1,1,0,3,3,0,2,1,1,0,3,1,0,0,0,0,0,,,
"Jul 2, 2021 2:00 AM",9,4,5,0,0,0,0,0,0,2,0,2,0,0,0,0,1,1,0,0,0,0,1,0,0,0,2,0,0,1,1,0,1,,,
"Jul 2, 2021 3:00 AM",3,1,2,0,0,0,1,1,0,0,0,0,0,0,0,0,0,0,0,0,0,0,2,0,0,0,0,1,0,0,0,0,0,,,
"Jul 2, 2021 4:00 AM",1,1,0,4,4,0,8,7,1,5,4,1,0,0,0,1,1,1,0,0,0,0,1,4,2,2,3,2,0,1,0,0,0,,,
"Jul 2, 2021 5:00 AM",12,10,2,4,2,2,9,8,1,6,6,0,2,0,2,3,6,6,0,3,2,1,6,2,2,0,4,6,0,1,0,0,0,,,
"Jul 2, 2021 6:00 AM",40,28,12,40,19,21,61,34,27,38,20,18,7,5,2,4,20,19,1,8,6,2,18,14,10,4,14,45,2,2,3,3,0,,,
"Jul 2, 2021 7:00 AM",71,41,30,89,43,46,131,61,70,93,47,46,7,6,1,13,43,43,0,14,11,3,46,56,28,28,51,74,4,5,2,2,0,,,
"Jul 2, 2021 8:00 AM",124,84,40,103,32,71,128,60,68,103,49,54,14,12,2,10,69,68,1,26,19,7,74,56,28,28,43,110,4,4,3,2,1,,,
"Jul 2, 2021 9:00 AM",82,54,28,94,47,47,120,65,55,92,56,36,21,15,6,6,41,41,0,18,12,6,45,55,35,20,38,57,6,8,6,3,3,,,
"Jul 2, 2021 10:00 AM",67,43,24,103,57,46,100,60,40,94,65,29,22,13,9,6,23,21,2,9,8,1,21,37,25,12,26,38,4,5,7,6,1,,,
"Jul 2, 2021 11:00 AM",54,31,23,83,28,55,85,39,46,67,36,31,14,8,6,24,16,16,0,15,14,1,16,39,23,16,31,27,6,1,5,2,3,,,
"Jul 2, 2021 12:00 PM",63,34,29,96,55,41,101,53,48,102,54,48,15,6,9,21,22,22,0,25,23,2,24,54,33,21,27,40,7,1,8,6,2,,,
"Jul 2, 2021 1:00 PM",91,51,40,99,46,53,119,59,60,99,45,54,30,17,13,17,25,25,0,19,17,2,26,44,29,15,31,50,10,7,6,5,1,,,
"Jul 2, 2021 2:00 PM",100,38,62,104,51,53,100,56,44,92,55,37,23,16,7,20,23,22,1,35,31,4,22,56,34,22,42,34,6,3,7,5,2,,,
"Jul 2, 2021 3:00 PM",104,55,49,127,76,51,160,104,56,114,62,52,37,18,19,23,31,31,0,23,21,2,29,61,37,24,43,43,10,7,2,2,0,,,
"Jul 2, 2021 4:00 PM",103,49,54,133,76,57,180,104,76,148,82,66,23,6,17,40,38,36,2,29,28,1,37,68,35,33,74,57,5,6,3,0,3,,,
"Jul 2, 2021 5:00 PM",147,46,101,142,86,56,209,106,103,164,82,82,27,11,16,25,26,23,3,43,42,1,22,72,39,33,68,63,4,6,5,4,1,,,
"Jul 2, 2021 6:00 PM",123,53,70,107,60,47,213,106,107,137,72,65,26,11,15,18,29,28,1,59,54,5,28,78,45,33,76,53,2,7,9,6,3,,,
"Jul 2, 2021 7:00 PM",90,43,47,90,54,36,145,76,69,95,49,46,23,4,19,24,18,18,0,21,18,3,21,56,33,23,43,43,9,2,12,10,2,,,
"Jul 2, 2021 8:00 PM",54,21,33,76,40,36,108,39,69,70,36,34,14,6,8,15,12,12,0,24,21,3,10,44,25,19,26,35,4,1,5,3,2,,,
"Jul 2, 2021 9:00 PM",41,12,29,31,20,11,78,29,49,46,15,31,11,6,5,10,8,8,0,13,13,0,8,29,15,14,18,22,2,5,3,3,0,,,
"Jul 2, 2021 10:00 PM",29,11,18,20,12,8,37,17,20,18,9,9,4,3,1,6,8,8,0,15,13,2,8,14,9,5,13,17,4,2,1,1,0,,,
"Jul 2, 2021 11:00 PM",22,9,13,18,11,7,25,5,20,24,3,21,9,5,4,1,9,9,0,11,11,0,10,6,3,3,11,18,1,1,1,1,0,,,
"Jul 3, 2021 12:00 AM",19,7,12,1,1,0,4,3,1,9,3,6,4,2,2,3,7,7,0,8,8,0,6,11,1,10,10,5,1,0,2,1,1,,,
"Jul 3, 2021 1:00 AM",8,3,5,8,3,5,12,4,8,8,1,7,1,1,0,1,3,3,0,1,1,0,3,3,1,2,4,10,0,1,1,0,1,,,
"Jul 3, 2021 2:00 AM",5,4,1,2,2,0,1,1,0,2,2,0,0,0,0,1,1,1,0,4,3,1,1,1,1,0,2,2,0,0,0,0,0,,,
"Jul 3, 2021 3:00 AM",0,0,0,2,1,1,2,0,2,0,0,0,0,0,0,0,0,0,0,2,2,0,0,0,0,0,0,0,0,0,0,0,0,,,
"Jul 3, 2021 4:00 AM",3,0,3,0,0,0,3,3,0,1,0,1,0,0,0,0,0,0,0,2,2,0,0,1,1,0,0,1,0,0,1,0,1,,,
"Jul 3, 2021 5:00 AM",1,0,1,1,1,0,9,7,2,4,4,0,0,0,0,2,1,1,0,1,1,0,0,2,2,0,2,4,0,0,1,1,0,,,
"Jul 3, 2021 6:00 AM",8,5,3,9,5,4,16,7,9,9,4,5,0,0,0,5,3,1,2,2,2,0,3,4,2,2,4,12,0,0,0,0,0,,,
"Jul 3, 2021 7:00 AM",25,12,13,28,12,16,35,20,15,34,21,13,4,1,3,1,12,12,0,3,2,1,11,9,6,3,8,17,2,2,1,1,0,,,
"Jul 3, 2021 8:00 AM",25,13,12,68,33,35,70,36,34,47,29,18,11,4,7,5,17,17,0,10,10,0,21,22,18,4,23,16,2,5,2,1,1,,,
"Jul 3, 2021 9:00 AM",36,21,15,71,37,34,89,53,36,75,41,34,12,10,2,19,17,17,0,12,12,0,17,31,21,10,28,21,4,6,2,2,0,,,
"Jul 3, 2021 10:00 AM",35,19,16,76,38,38,83,34,49,64,41,23,28,18,10,14,14,14,0,11,9,2,15,18,7,11,29,24,1,5,5,5,0,,,
"Jul 3, 2021 11:00 AM",49,33,16,62,27,35,70,40,30,66,40,26,21,14,7,11,10,10,0,12,8,4,11,16,12,4,23,30,5,4,3,1,2,,,
"Jul 3, 2021 12:00 PM",49,20,29,118,68,50,87,51,36,99,66,33,19,7,12,15,14,14,0,13,12,1,17,29,21,8,26,37,18,4,8,2,6,,,
"Jul 3, 2021 1:00 PM",52,26,26,81,22,59,78,41,37,78,34,44,18,9,9,15,19,17,2,13,13,0,17,38,22,16,21,30,8,4,4,3,1,,,
"Jul 3, 2021 2:00 PM",54,28,26,46,23,23,66,30,36,59,34,25,18,12,6,11,16,16,0,9,7,2,13,34,18,16,23,22,4,3,4,4,0,,,
"Jul 3, 2021 3:00 PM",52,29,23,55,33,22,90,56,34,86,55,31,16,8,8,14,22,21,1,16,12,4,22,27,18,9,28,29,4,0,3,1,2,,,
"Jul 3, 2021 4:00 PM",35,20,15,82,48,34,105,48,57,94,46,48,17,8,9,17,12,12,0,13,12,1,11,41,28,13,33,30,6,2,4,3,1,,,
"Jul 3, 2021 5:00 PM",51,26,25,115,61,54,129,70,59,110,53,57,12,6,6,17,18,18,0,12,12,0,21,45,26,19,26,30,6,2,10,6,4,,,
"Jul 3, 2021 6:00 PM",64,26,38,101,64,37,110,56,54,87,44,43,14,8,6,11,14,13,1,16,13,3,15,46,26,20,23,40,2,4,9,5,4,,,
"Jul 3, 2021 7:00 PM",44,28,16,78,46,32,77,41,36,65,34,31,16,4,12,19,20,17,3,8,8,0,16,44,24,20,21,24,5,0,6,3,3,,,
"Jul 3, 2021 8:00 PM",32,13,19,65,32,33,87,35,52,56,18,38,9,4,5,13,9,9,0,7,7,0,10,39,8,31,11,18,2,1,3,1,2,,,
"Jul 3, 2021 9:00 PM",41,17,24,36,10,26,45,14,31,21,8,13,5,2,3,4,5,5,0,4,2,2,5,24,12,12,7,17,0,0,3,0,3,,,
"Jul 3, 2021 10:00 PM",32,14,18,22,11,11,25,7,18,18,5,13,7,4,3,8,9,9,0,14,12,2,10,18,8,10,15,12,1,1,3,2,1,,,
"Jul 3, 2021 11:00 PM",32,20,12,15,11,4,8,4,4,10,4,6,3,1,2,3,6,6,0,10,9,1,5,5,4,1,6,5,0,0,0,0,0,,,
"Jul 4, 2021 12:00 AM",20,8,12,1,1,0,5,1,4,4,1,3,2,0,2,6,2,2,0,3,3,0,2,4,2,2,4,8,0,0,1,0,1,,,
"Jul 4, 2021 1:00 AM",5,1,4,2,0,2,7,1,6,5,1,4,5,2,3,1,0,0,0,3,3,0,0,0,0,0,5,2,0,0,1,1,0,,,
"Jul 4, 2021 2:00 AM",7,4,3,1,1,0,0,0,0,0,0,0,0,0,0,0,2,2,0,3,3,0,2,0,0,0,2,4,0,1,0,0,0,,,
"Jul 4, 2021 3:00 AM",0,0,0,0,0,0,1,0,1,2,0,2,0,0,0,0,0,0,0,1,1,0,0,1,1,0,1,3,0,0,0,0,0,,,
"Jul 4, 2021 4:00 AM",4,4,0,0,0,0,5,4,1,1,0,1,0,0,0,1,0,0,0,1,1,0,0,3,3,0,1,2,0,0,0,0,0,,,
"Jul 4, 2021 5:00 AM",3,2,1,0,0,0,1,1,0,0,0,0,0,0,0,1,2,2,0,0,0,0,2,1,1,0,2,2,1,1,0,0,0,,,
"Jul 4, 2021 6:00 AM",5,3,2,6,3,3,19,13,6,10,6,4,0,0,0,2,4,4,0,3,3,0,4,3,3,0,9,8,0,2,1,0,1,,,
"Jul 4, 2021 7:00 AM",20,7,13,35,16,19,35,17,18,36,18,18,4,2,2,4,13,12,1,5,4,1,12,10,4,6,10,18,1,1,1,1,0,,,
"Jul 4, 2021 8:00 AM",30,18,12,99,59,40,90,60,30,79,55,24,13,5,8,7,18,15,3,6,4,2,15,26,12,14,26,54,1,11,2,0,2,,,
"Jul 4, 2021 9:00 AM",32,16,16,124,66,58,165,107,58,118,83,35,9,4,5,19,13,13,0,13,11,2,13,66,44,22,48,25,5,16,3,2,1,,,
"Jul 4, 2021 10:00 AM",59,33,26,195,112,83,226,128,98,161,95,66,15,5,10,21,29,25,4,27,23,4,25,75,47,28,43,42,9,6,7,6,1,,,
"Jul 4, 2021 11:00 AM",75,34,41,184,73,111,205,108,97,173,92,81,54,40,14,31,31,29,2,20,17,3,29,69,50,19,57,70,13,11,13,9,4,,,
"Jul 4, 2021 12:00 PM",74,45,29,209,105,104,202,99,103,169,87,82,22,14,8,24,20,19,1,22,19,3,20,90,53,37,57,79,15,5,7,6,1,,,
"Jul 4, 2021 1:00 PM",59,23,36,181,92,89,212,118,94,186,105,81,37,21,16,22,27,27,0,30,28,2,26,71,33,38,55,54,9,6,15,8,7,,,
"Jul 4, 2021 2:00 PM",53,23,30,159,75,84,167,75,92,159,74,85,44,25,19,11,21,21,0,20,14,6,20,67,44,23,42,55,9,5,13,12,1,,,
"Jul 4, 2021 3:00 PM",66,40,26,136,60,76,134,59,75,120,59,61,21,9,12,25,20,20,0,17,12,5,21,60,29,31,25,53,2,9,1,0,1,,,
"Jul 4, 2021 4:00 PM",65,43,22,105,56,49,117,48,69,97,39,58,25,11,14,16,18,18,0,17,17,0,20,55,28,27,30,32,2,4,4,1,3,,,
"Jul 4, 2021 5:00 PM",55,18,37,78,42,36,100,44,56,72,28,44,23,9,14,10,14,13,1,14,14,0,13,33,15,18,27,45,4,3,7,7,0,,,
"Jul 4, 2021 6:00 PM",26,6,20,25,14,11,33,13,20,23,7,16,13,4,9,7,7,7,0,12,11,1,7,16,7,9,16,22,3,2,3,3,0,,,
"Jul 4, 2021 7:00 PM",22,13,9,5,4,1,15,5,10,8,5,3,5,1,4,3,11,11,0,2,2,0,9,10,6,4,11,13,1,0,1,0,1,,,
"Jul 4, 2021 8:00 PM",23,11,12,11,9,2,21,10,11,11,5,6,3,0,3,2,6,4,2,4,4,0,4,1,0,1,7,11,1,0,2,2,0,,,
"Jul 4, 2021 9:00 PM",8,4,4,5,2,3,2,0,2,3,1,2,1,0,1,4,4,4,0,3,3,0,4,1,1,0,7,4,0,0,1,1,0,,,
"Jul 4, 2021 10:00 PM",8,5,3,4,4,0,6,3,3,6,3,3,1,1,0,1,2,2,0,0,0,0,2,0,0,0,2,8,1,0,4,2,2,,,
"Jul 4, 2021 11:00 PM",7,5,2,0,0,0,3,0,3,1,0,1,1,0,1,0,2,2,0,4,4,0,3,2,0,2,2,1,0,0,0,0,0,,,
"Jul 5, 2021 12:00 AM",5,1,4,0,0,0,0,0,0,0,0,0,0,0,0,1,1,1,0,1,1,0,1,0,0,0,1,2,0,0,0,0,0,,,
"Jul 5, 2021 1:00 AM",3,1,2,1,0,1,1,0,1,2,0,2,1,1,0,1,0,0,0,1,1,0,0,0,0,0,0,1,0,0,0,0,0,,,
"Jul 5, 2021 2:00 AM",3,2,1,0,0,0,0,0,0,0,0,0,0,0,0,0,1,1,0,0,0,0,1,0,0,0,0,0,0,0,0,0,0,,,
"Jul 5, 2021 3:00 AM",0,0,0,0,0,0,0,0,0,0,0,0,0,0,0,0,1,1,0,0,0,0,1,1,0,1,1,0,0,0,0,0,0,,,
"Jul 5, 2021 4:00 AM",0,0,0,0,0,0,1,1,0,0,0,0,0,0,0,0,1,1,0,1,1,0,1,0,0,0,0,1,0,0,0,0,0,,,
"Jul 5, 2021 5:00 AM",7,6,1,6,4,2,10,4,6,14,7,7,1,0,1,2,5,5,0,2,1,1,6,1,0,1,3,7,0,0,0,0,0,,,
"Jul 5, 2021 6:00 AM",23,15,8,15,8,7,22,11,11,17,9,8,7,6,1,5,25,25,0,7,7,0,22,8,4,4,12,30,1,2,4,4,0,,,
"Jul 5, 2021 7:00 AM",85,49,36,58,24,34,80,35,45,59,28,31,6,6,0,13,62,61,1,14,12,2,65,40,19,21,43,70,4,8,2,2,0,,,
"Jul 5, 2021 8:00 AM",139,99,40,75,31,44,124,71,53,81,51,30,15,11,4,10,83,82,1,26,20,6,93,48,16,32,37,104,3,3,4,4,0,,,
"Jul 5, 2021 9:00 AM",92,61,31,73,32,41,113,56,57,75,40,35,34,17,17,6,52,51,1,22,15,7,54,44,29,15,22,53,2,7,5,3,2,,,
"Jul 5, 2021 10:00 AM",66,36,30,83,38,45,125,69,56,74,39,35,21,14,7,21,30,29,1,10,8,2,27,39,22,17,29,32,9,7,9,6,3,,,
"Jul 5, 2021 11:00 AM",81,44,37,85,41,44,133,76,57,83,43,40,31,19,12,13,12,10,2,11,9,2,12,56,37,19,26,36,6,4,4,1,3,,,
"Jul 5, 2021 12:00 PM",71,34,37,95,53,42,139,71,68,86,47,39,25,14,11,19,22,22,0,23,18,5,22,44,22,22,21,38,6,4,6,6,0,,,
"Jul 5, 2021 1:00 PM",66,31,35,127,53,74,127,58,69,110,61,49,35,12,23,16,22,22,0,18,16,2,25,45,22,23,34,31,9,8,6,4,2,,,
"Jul 5, 2021 2:00 PM",82,41,41,77,36,41,110,51,59,99,54,45,73,47,26,20,30,27,3,28,26,2,25,52,33,19,30,41,7,5,7,5,2,,,
"Jul 5, 2021 3:00 PM",104,40,64,90,52,38,133,64,69,101,61,40,23,8,15,27,11,10,1,25,22,3,11,47,31,16,36,43,2,5,2,1,1,,,
"Jul 5, 2021 4:00 PM",114,43,71,107,61,46,108,60,48,89,41,48,36,13,23,20,19,18,1,35,34,1,17,46,21,25,48,57,10,4,15,8,7,,,
"Jul 5, 2021 5:00 PM",155,56,99,103,66,37,133,73,60,105,55,50,31,11,20,59,27,27,0,64,62,2,27,60,37,23,91,56,6,12,8,4,4,,,
"Jul 5, 2021 6:00 PM",145,64,81,162,93,69,209,119,90,158,90,68,44,18,26,27,45,41,4,65,62,3,40,70,54,16,78,56,11,3,9,5,4,,,
"Jul 5, 2021 7:00 PM",88,40,48,149,69,80,194,105,89,138,74,64,29,17,12,27,20,20,0,45,41,4,25,73,51,22,59,54,8,6,9,4,5,,,
"Jul 5, 2021 8:00 PM",75,26,49,118,64,54,152,64,88,115,58,57,20,9,11,30,28,26,2,28,26,2,28,68,24,44,31,49,6,4,3,1,2,,,
"Jul 5, 2021 9:00 PM",60,20,40,68,38,30,86,35,51,60,25,35,11,6,5,14,11,10,1,26,25,1,9,20,7,13,23,29,6,5,3,1,2,,,
"Jul 5, 2021 10:00 PM",37,7,30,21,11,10,22,8,14,17,4,13,6,1,5,14,11,9,2,15,12,3,10,25,9,16,15,11,2,3,1,1,0,,,
"Jul 5, 2021 11:00 PM",10,7,3,5,4,1,13,9,4,6,3,3,3,0,3,3,3,3,0,7,4,3,2,1,1,0,1,5,1,0,1,1,0,,,
"Jul 6, 2021 12:00 AM",6,1,5,0,0,0,1,0,1,3,0,3,1,0,1,1,3,3,0,3,3,0,4,1,0,1,2,1,0,1,1,0,1,,,
"Jul 6, 2021 1:00 AM",1,0,1,0,0,0,1,1,0,0,0,0,1,0,1,0,3,3,0,1,0,1,2,0,0,0,0,0,0,0,0,0,0,,,
"Jul 6, 2021 2:00 AM",3,1,2,1,1,0,2,1,1,2,2,0,0,0,0,0,0,0,0,1,1,0,0,1,0,1,0,0,0,0,0,0,0,,,
"Jul 6, 2021 3:00 AM",0,0,0,0,0,0,0,0,0,0,0,0,0,0,0,0,0,0,0,0,0,0,2,0,0,0,1,1,0,0,0,0,0,,,
"Jul 6, 2021 4:00 AM",2,1,1,2,1,1,3,3,0,4,3,1,0,0,0,0,1,1,0,1,1,0,1,2,2,0,2,1,0,0,0,0,0,,,
"Jul 6, 2021 5:00 AM",9,7,2,10,4,6,14,8,6,14,9,5,3,2,1,2,4,4,0,3,2,1,4,2,0,2,7,11,0,0,0,0,0,,,
"Jul 6, 2021 6:00 AM",42,29,13,41,23,18,52,28,24,38,24,14,3,3,0,7,21,20,1,5,4,1,22,13,10,3,18,33,1,3,5,4,1,,,
"Jul 6, 2021 7:00 AM",106,62,44,98,34,64,113,49,64,99,42,57,6,4,2,21,59,59,0,15,14,1,57,48,22,26,53,87,4,8,1,1,0,,,
"Jul 6, 2021 8:00 AM",142,99,43,109,43,66,169,86,83,112,59,53,27,20,7,22,82,81,1,30,23,7,85,61,18,43,45,120,3,7,7,6,1,,,
"Jul 6, 2021 9:00 AM",112,76,36,84,36,48,90,47,43,62,41,21,47,22,25,11,54,54,0,21,14,7,57,24,13,11,30,64,2,5,5,3,2,,,
"Jul 6, 2021 10:00 AM",54,37,17,75,40,35,98,57,41,59,33,26,16,10,6,12,22,21,1,10,10,0,21,20,12,8,30,21,2,3,5,2,3,,,
"Jul 6, 2021 11:00 AM",62,34,28,71,39,32,112,63,49,70,39,31,26,16,10,12,12,11,1,15,14,1,12,21,14,7,23,33,6,5,6,5,1,,,
"Jul 6, 2021 12:00 PM",57,29,28,71,31,40,110,49,61,75,31,44,35,9,26,25,27,27,0,18,15,3,27,11,7,4,41,38,5,0,6,1,5,,,
"Jul 6, 2021 1:00 PM",64,22,42,56,26,30,76,37,39,47,21,26,27,8,19,20,20,18,2,18,17,1,15,10,6,4,28,20,2,6,9,5,4,,,
"Jul 6, 2021 2:00 PM",46,23,23,32,19,13,52,25,27,32,15,17,30,18,12,6,16,15,1,14,14,0,15,22,14,8,18,16,3,3,1,1,0,,,
"Jul 6, 2021 3:00 PM",58,23,35,31,18,13,47,25,22,34,19,15,13,4,9,10,15,15,0,18,17,1,15,17,11,6,32,24,3,1,3,2,1,,,
"Jul 6, 2021 4:00 PM",51,21,30,25,15,10,20,14,6,20,14,6,14,6,8,10,14,13,1,20,19,1,12,8,8,0,30,19,2,2,3,1,2,,,
"Jul 6, 2021 5:00 PM",100,26,74,38,28,10,59,29,30,38,21,17,12,4,8,9,14,14,0,46,46,0,12,9,8,1,55,29,3,3,0,0,0,,,
"Jul 6, 2021 6:00 PM",84,28,56,30,21,9,55,33,22,36,19,17,5,3,2,7,15,15,0,43,42,1,16,13,11,2,46,28,1,1,1,0,1,,,
"Jul 6, 2021 7:00 PM",53,20,33,19,14,5,37,23,14,26,18,8,8,4,4,3,3,1,2,34,33,1,2,14,8,6,30,17,1,1,4,2,2,,,
"Jul 6, 2021 8:00 PM",28,11,17,17,14,3,22,13,9,15,9,6,0,0,0,6,5,5,0,13,12,1,5,5,2,3,19,18,0,3,1,1,0,,,
"Jul 6, 2021 9:00 PM",17,3,14,12,7,5,13,8,5,14,4,10,4,1,3,0,3,3,0,9,7,2,2,0,0,0,8,9,2,1,3,2,1,,,
"Jul 6, 2021 10:00 PM",13,4,9,9,5,4,14,5,9,10,2,8,1,1,0,2,1,1,0,9,8,1,2,1,1,0,11,8,1,0,2,2,0,,,
"Jul 6, 2021 11:00 PM",12,5,7,2,1,1,6,1,5,6,2,4,3,1,2,1,8,8,0,5,5,0,9,1,1,0,4,5,1,1,1,1,0,,,
"Jul 7, 2021 12:00 AM",3,2,1,0,0,0,3,2,1,5,2,3,0,0,0,1,1,1,0,3,3,0,1,0,0,0,5,2,0,0,0,0,0,,,
"Jul 7, 2021 1:00 AM",1,0,1,0,0,0,3,1,2,0,0,0,0,0,0,0,0,0,0,1,0,1,0,0,0,0,1,0,0,0,0,0,0,,,
"Jul 7, 2021 2:00 AM",0,0,0,2,2,0,0,0,0,1,1,0,0,0,0,0,1,1,0,0,0,0,1,0,0,0,0,0,0,0,0,0,0,,,
"Jul 7, 2021 3:00 AM",0,0,0,0,0,0,0,0,0,0,0,0,0,0,0,0,0,0,0,0,0,0,0,1,0,1,0,0,0,0,0,0,0,,,
"Jul 7, 2021 4:00 AM",2,1,1,0,0,0,0,0,0,0,0,0,0,0,0,1,0,0,0,0,0,0,0,0,0,0,0,0,0,0,0,0,0,,,
"Jul 7, 2021 5:00 AM",4,4,0,2,2,0,7,6,1,6,5,1,2,0,2,1,6,6,0,2,0,2,6,1,0,1,5,9,0,0,0,0,0,,,
"Jul 7, 2021 6:00 AM",40,26,14,25,11,14,26,15,11,23,12,11,8,5,3,6,15,15,0,5,5,0,19,4,3,1,18,37,2,2,2,2,0,,,
"Jul 7, 2021 7:00 AM",74,40,34,72,37,35,89,44,45,78,44,34,9,9,0,14,48,48,0,16,14,2,49,16,7,9,35,75,4,9,3,3,0,,,
"Jul 7, 2021 8:00 AM",117,85,32,75,28,47,100,56,44,68,36,32,22,13,9,15,74,71,3,18,13,5,74,23,7,16,51,90,6,4,3,2,1,,,
"Jul 7, 2021 9:00 AM",73,44,29,61,20,41,86,40,46,57,31,26,35,14,21,9,43,43,0,20,13,7,45,28,21,7,31,51,3,4,7,4,3,,,
"Jul 7, 2021 10:00 AM",60,38,22,73,36,37,53,34,19,55,36,19,22,16,6,8,19,19,0,9,8,1,21,21,14,7,31,26,1,5,3,3,0,,,
"Jul 7, 2021 11:00 AM",42,21,21,78,46,32,63,45,18,75,44,31,16,8,8,18,27,27,0,10,10,0,27,20,16,4,23,20,11,1,9,8,1,,,
"Jul 7, 2021 12:00 PM",48,26,22,89,51,38,94,40,54,70,38,32,28,18,10,8,24,23,1,12,11,1,25,39,23,16,29,34,5,12,8,4,4,,,
"Jul 7, 2021 1:00 PM",61,36,25,120,50,70,88,41,47,83,37,46,40,23,17,11,29,28,1,21,19,2,27,25,9,16,32,31,3,8,6,3,3,,,
"Jul 7, 2021 2:00 PM",62,34,28,57,27,30,76,46,30,56,35,21,30,24,6,22,16,15,1,18,16,2,15,24,12,12,36,27,7,3,7,3,4,,,
"Jul 7, 2021 3:00 PM",69,32,37,78,45,33,103,47,56,87,47,40,25,15,10,16,13,11,2,26,21,5,13,15,9,6,39,34,4,2,6,3,3,,,
"Jul 7, 2021 4:00 PM",97,37,60,88,54,34,93,52,41,76,38,38,22,11,11,34,29,27,2,31,30,1,28,33,15,18,48,44,11,5,5,4,1,,,
"Jul 7, 2021 5:00 PM",144,47,97,147,80,67,142,70,72,149,69,80,45,17,28,33,37,35,2,58,56,2,32,24,15,9,102,60,9,13,6,4,2,,,
"Jul 7, 2021 6:00 PM",143,62,81,133,81,52,179,104,75,138,80,58,37,13,24,29,38,37,1,65,62,3,35,23,16,7,105,59,6,11,8,6,2,,,
"Jul 7, 2021 7:00 PM",97,41,56,120,67,53,147,86,61,105,60,45,24,14,10,21,38,36,2,39,36,3,35,25,14,11,86,47,5,1,5,3,2,,,
"Jul 7, 2021 8:00 PM",71,19,52,68,30,38,111,51,60,87,33,54,14,7,7,17,13,12,1,27,26,1,12,22,11,11,42,34,7,1,4,4,0,,,
"Jul 7, 2021 9:00 PM",33,13,20,55,27,28,70,19,51,47,14,33,10,3,7,10,14,14,0,16,15,1,14,11,5,6,26,30,1,2,7,3,4,,,
"Jul 7, 2021 10:00 PM",27,12,15,30,26,4,37,20,17,39,20,19,10,2,8,6,17,16,1,15,12,3,11,4,2,2,22,10,2,2,2,1,1,,,
"Jul 7, 2021 11:00 PM",22,11,11,10,5,5,16,5,11,11,3,8,3,0,3,5,4,4,0,10,10,0,6,6,1,5,9,17,1,0,2,1,1,,,
"Jul 8, 2021 12:00 AM",10,4,6,0,0,0,7,4,3,7,2,5,5,5,0,1,3,3,0,3,3,0,3,2,1,1,4,1,0,0,0,0,0,,,
"Jul 8, 2021 1:00 AM",3,1,2,2,1,1,3,0,3,4,0,4,1,0,1,0,0,0,0,4,4,0,0,0,0,0,1,2,0,0,0,0,0,,,
"Jul 8, 2021 2:00 AM",1,1,0,0,0,0,5,1,4,0,0,0,0,0,0,1,0,0,0,2,2,0,0,0,0,0,1,2,0,0,0,0,0,,,
"Jul 8, 2021 3:00 AM",1,1,0,0,0,0,0,0,0,0,0,0,0,0,0,0,0,0,0,0,0,0,1,0,0,0,1,2,0,1,0,0,0,,,
"Jul 8, 2021 4:00 AM",1,1,0,0,0,0,1,1,0,4,3,1,0,0,0,1,1,1,0,1,1,0,2,0,0,0,0,3,0,1,0,0,0,,,
"Jul 8, 2021 5:00 AM",13,10,3,3,2,1,9,5,4,12,10,2,2,0,2,2,3,3,0,2,1,1,3,9,6,3,5,10,0,0,0,0,0,,,
"Jul 8, 2021 6:00 AM",35,27,8,39,23,16,54,31,23,46,26,20,8,4,4,7,21,20,1,11,8,3,20,3,3,0,25,33,2,0,1,1,0,,,
"Jul 8, 2021 7:00 AM",94,50,44,92,50,42,93,42,51,73,39,34,7,6,1,7,49,49,0,13,13,0,48,12,8,4,48,78,2,9,1,0,1,,,
"Jul 8, 2021 8:00 AM",136,97,39,98,32,66,117,63,54,96,48,48,18,11,7,20,75,73,2,19,13,6,79,16,4,12,56,103,3,3,6,4,2,,,
"Jul 8, 2021 9:00 AM",83,52,31,78,27,51,95,37,58,65,28,37,40,19,21,11,41,41,0,18,14,4,43,27,12,15,41,59,4,4,4,3,1,,,
"Jul 8, 2021 10:00 AM",68,42,26,48,22,26,95,58,37,63,39,24,21,13,8,9,29,29,0,18,12,6,30,15,9,6,34,38,5,3,3,3,0,,,
"Jul 8, 2021 11:00 AM",41,22,19,66,27,39,107,60,47,62,34,28,18,10,8,11,19,19,0,13,12,1,19,13,11,2,38,30,2,3,3,0,3,,,
"Jul 8, 2021 12:00 PM",62,37,25,83,45,38,110,58,52,66,35,31,20,11,9,16,19,19,0,17,15,2,21,35,21,14,34,36,10,4,4,4,0,,,
"Jul 8, 2021 1:00 PM",72,39,33,104,61,43,146,76,70,108,62,46,34,15,19,17,15,15,0,23,20,3,14,22,11,11,50,33,9,5,7,6,1,,,
"Jul 8, 2021 2:00 PM",88,46,42,69,27,42,99,50,49,60,28,32,21,14,7,15,17,17,0,24,20,4,17,21,11,10,36,41,4,6,9,8,1,,,
"Jul 8, 2021 3:00 PM",90,43,47,82,45,37,131,76,55,104,64,40,27,8,19,24,22,22,0,24,22,2,23,24,17,7,49,40,9,2,6,5,1,,,
"Jul 8, 2021 4:00 PM",109,41,68,105,59,46,115,62,53,117,68,49,34,19,15,22,34,34,0,36,35,1,37,22,13,9,71,43,3,2,9,7,2,,,
"Jul 8, 2021 5:00 PM",144,51,93,161,73,88,192,109,83,184,122,62,24,7,17,40,30,28,2,56,55,1,29,36,16,20,100,61,5,14,13,5,8,,,
"Jul 8, 2021 6:00 PM",133,64,69,115,67,48,189,103,86,142,75,67,25,13,12,22,42,42,0,61,55,6,40,43,30,13,105,71,7,11,18,11,7,,,
"Jul 8, 2021 7:00 PM",109,53,56,135,76,59,135,86,49,104,60,44,15,9,6,18,31,29,2,54,53,1,30,24,12,12,79,32,6,9,12,4,8,,,
"Jul 8, 2021 8:00 PM",86,32,54,86,32,54,104,40,64,95,34,61,14,6,8,13,24,22,2,33,28,5,21,23,12,11,47,36,6,7,4,2,2,,,
"Jul 8, 2021 9:00 PM",55,22,33,63,46,17,103,34,69,65,24,41,16,7,9,11,18,16,2,22,21,1,12,11,6,5,30,32,4,3,1,1,0,,,
"Jul 8, 2021 10:00 PM",26,11,15,54,46,8,37,9,28,47,12,35,11,2,9,6,7,6,1,19,17,2,5,12,1,11,16,19,1,0,0,0,0,,,
"Jul 8, 2021 11:00 PM",19,4,15,25,22,3,24,9,15,27,10,17,9,3,6,8,7,7,0,11,10,1,7,12,4,8,9,7,2,0,1,1,0,,,
"Jul 9, 2021 12:00 AM",18,4,14,1,0,1,3,2,1,12,3,9,7,4,3,1,4,4,0,3,3,0,2,2,2,0,7,8,0,0,0,0,0,,,
"Jul 9, 2021 1:00 AM",5,1,4,2,1,1,5,2,3,3,1,2,0,0,0,1,2,2,0,2,2,0,2,0,0,0,2,4,1,0,0,0,0,,,
"Jul 9, 2021 2:00 AM",5,4,1,1,1,0,1,0,1,1,1,0,1,0,1,0,0,0,0,0,0,0,0,0,0,0,1,0,0,0,1,1,0,,,
"Jul 9, 2021 3:00 AM",3,0,3,2,0,2,0,0,0,0,0,0,2,0,2,1,0,0,0,1,1,0,0,0,0,0,1,1,0,0,0,0,0,,,
"Jul 9, 2021 4:00 AM",4,1,3,0,0,0,1,1,0,2,0,2,0,0,0,0,1,1,0,0,0,0,1,1,0,1,1,1,0,0,0,0,0,,,
"Jul 9, 2021 5:00 AM",9,9,0,5,4,1,11,10,1,8,6,2,2,0,2,0,6,6,0,2,1,1,6,1,0,1,5,5,0,1,0,0,0,,,
"Jul 9, 2021 6:00 AM",36,24,12,31,13,18,36,17,19,26,13,13,5,2,3,8,23,22,1,5,5,0,20,8,7,1,15,44,0,2,0,0,0,,,
"Jul 9, 2021 7:00 AM",73,40,33,90,45,45,75,33,42,83,46,37,11,10,1,14,41,40,1,14,10,4,45,20,14,6,47,64,3,8,0,0,0,,,
"Jul 9, 2021 8:00 AM",134,85,49,114,37,77,113,53,60,99,43,56,31,21,10,15,80,79,1,18,17,1,79,15,7,8,43,90,2,2,7,5,2,,,
"Jul 9, 2021 9:00 AM",88,63,25,90,37,53,104,52,52,84,40,44,32,20,12,15,33,33,0,20,12,8,32,21,11,10,40,56,4,7,4,1,3,,,
"Jul 9, 2021 10:00 AM",63,42,21,75,31,44,83,41,42,62,34,28,25,20,5,7,29,29,0,11,7,4,33,25,16,9,29,39,6,5,4,3,1,,,
"Jul 9, 2021 11:00 AM",64,34,30,63,30,33,90,49,41,64,35,29,24,10,14,20,19,18,1,9,8,1,19,27,15,12,42,37,4,1,9,4,5,,,
"Jul 9, 2021 12:00 PM",76,37,39,91,52,39,138,81,57,82,55,27,24,10,14,31,18,17,1,18,17,1,16,26,18,8,62,38,7,3,5,4,1,,,
"Jul 9, 2021 1:00 PM",81,41,40,91,44,47,127,68,59,92,47,45,30,14,16,14,23,21,2,14,12,2,22,20,10,10,50,45,6,4,8,5,3,,,
"Jul 9, 2021 2:00 PM",78,36,42,66,25,41,119,62,57,75,41,34,37,19,18,17,27,27,0,24,22,2,27,23,14,9,48,34,3,4,7,7,0,,,
"Jul 9, 2021 3:00 PM",106,52,54,61,45,16,84,34,50,57,36,21,26,14,12,19,30,29,1,29,27,2,29,16,11,5,43,60,4,7,10,8,2,,,
"Jul 9, 2021 4:00 PM",120,39,81,77,39,38,89,49,40,74,41,33,28,11,17,28,33,32,1,35,35,0,31,29,17,12,58,44,5,5,3,2,1,,,
"Jul 9, 2021 5:00 PM",130,57,73,104,60,44,118,68,50,110,56,54,14,8,6,25,32,29,3,50,48,2,31,22,12,10,76,58,0,2,5,1,4,,,
"Jul 9, 2021 6:00 PM",129,53,76,102,67,35,148,92,56,124,73,51,22,9,13,24,22,21,1,49,47,2,19,27,23,4,78,53,5,5,4,3,1,,,
"Jul 9, 2021 7:00 PM",84,31,53,73,46,27,97,55,42,72,48,24,13,3,10,16,24,23,1,32,29,3,25,23,17,6,52,39,4,0,10,8,2,,,
"Jul 9, 2021 8:00 PM",62,23,39,52,31,21,69,31,38,48,18,30,15,7,8,9,10,10,0,16,15,1,10,15,6,9,28,27,4,4,8,5,3,,,
"Jul 9, 2021 9:00 PM",43,18,25,43,20,23,64,13,51,40,7,33,21,12,9,11,13,13,0,17,15,2,12,10,4,6,15,30,0,2,2,1,1,,,
"Jul 9, 2021 10:00 PM",32,8,24,28,16,12,39,22,17,27,12,15,11,6,5,3,10,10,0,7,6,1,10,13,8,5,10,13,1,1,3,2,1,,,
"Jul 9, 2021 11:00 PM",24,5,19,12,6,6,28,10,18,24,7,17,11,5,6,3,8,8,0,9,8,1,8,4,0,4,7,10,0,1,1,1,0,,,
"Jul 10, 2021 12:00 AM",21,6,15,2,0,2,6,3,3,5,3,2,9,5,4,8,4,4,0,8,8,0,6,1,0,1,10,16,1,0,0,0,0,,,
"Jul 10, 2021 1:00 AM",12,7,5,1,1,0,4,1,3,3,1,2,4,3,1,1,6,6,0,5,5,0,6,1,1,0,3,1,0,0,0,0,0,,,
"Jul 10, 2021 2:00 AM",7,3,4,1,0,1,5,3,2,2,0,2,0,0,0,1,2,2,0,1,1,0,1,4,2,2,3,1,0,0,0,0,0,,,
"Jul 10, 2021 3:00 AM",2,1,1,3,3,0,4,3,1,3,2,1,2,0,2,0,0,0,0,3,3,0,2,0,0,0,1,1,0,0,0,0,0,,,
"Jul 10, 2021 4:00 AM",1,1,0,0,0,0,3,3,0,2,2,0,0,0,0,0,0,0,0,1,1,0,0,0,0,0,2,1,1,0,0,0,0,,,
"Jul 10, 2021 5:00 AM",4,1,3,3,3,0,5,4,1,4,3,1,0,0,0,0,3,3,0,1,1,0,3,5,5,0,4,6,0,1,1,1,0,,,
"Jul 10, 2021 6:00 AM",8,5,3,16,11,5,19,16,3,16,13,3,5,0,5,2,5,4,1,1,1,0,5,0,0,0,6,11,1,1,4,2,2,,,
"Jul 10, 2021 7:00 AM",27,10,17,53,35,18,41,26,15,40,28,12,3,1,2,2,8,8,0,3,0,3,8,6,3,3,25,15,2,2,1,1,0,,,
"Jul 10, 2021 8:00 AM",33,15,18,58,27,31,65,37,28,61,37,24,19,13,6,15,17,17,0,12,6,6,18,10,9,1,17,27,3,5,2,1,1,,,
"Jul 10, 2021 9:00 AM",42,26,16,117,65,52,113,72,41,106,64,42,17,11,6,14,22,22,0,9,9,0,23,21,13,8,43,37,2,7,5,4,1,,,
"Jul 10, 2021 10:00 AM",60,32,28,151,83,68,207,114,93,154,88,66,21,13,8,6,27,27,0,16,14,2,29,29,16,13,72,39,6,5,3,3,0,,,
"Jul 10, 2021 11:00 AM",73,35,38,206,112,94,248,159,89,190,117,73,31,19,12,10,29,29,0,23,19,4,30,36,25,11,100,55,15,8,6,3,3,,,
"Jul 10, 2021 12:00 PM",70,39,31,232,101,131,287,167,120,220,137,83,37,26,11,15,24,22,2,26,21,5,25,49,37,12,102,64,11,8,5,2,3,,,
"Jul 10, 2021 1:00 PM",99,56,43,220,106,114,300,173,127,192,111,81,19,10,9,29,30,29,1,22,21,1,26,49,35,14,112,66,10,12,11,11,0,,,
"Jul 10, 2021 2:00 PM",84,43,41,226,115,111,308,169,139,197,120,77,25,11,14,23,20,20,0,21,18,3,21,75,51,24,106,92,12,15,6,4,2,,,
"Jul 10, 2021 3:00 PM",81,43,38,156,89,67,276,141,135,162,90,72,34,16,18,14,38,36,2,16,13,3,34,58,44,14,88,63,10,5,1,1,0,,,
"Jul 10, 2021 4:00 PM",67,43,24,204,105,99,226,96,130,184,85,99,52,18,34,20,24,24,0,20,15,5,23,46,20,26,49,79,12,5,11,11,0,,,
"Jul 10, 2021 5:00 PM",68,27,41,192,87,105,208,79,129,147,55,92,38,13,25,22,19,19,0,21,17,4,19,51,19,32,52,59,3,4,9,8,1,,,
"Jul 10, 2021 6:00 PM",58,25,33,131,58,73,146,56,90,122,41,81,42,20,22,14,20,20,0,22,20,2,23,24,7,17,41,66,4,7,6,4,2,,,
"Jul 10, 2021 7:00 PM",59,29,30,87,45,42,88,27,61,80,38,42,18,6,12,17,17,17,0,15,14,1,14,36,21,15,26,36,2,3,6,4,2,,,
"Jul 10, 2021 8:00 PM",40,19,21,58,25,33,77,21,56,66,22,44,14,5,9,5,5,5,0,15,14,1,4,14,7,7,23,32,2,5,2,0,2,,,
"Jul 10, 2021 9:00 PM",29,13,16,45,24,21,67,22,45,43,17,26,14,12,2,5,9,9,0,7,7,0,7,14,11,3,15,21,1,2,0,0,0,,,
"Jul 10, 2021 10:00 PM",17,6,11,31,16,15,39,13,26,26,5,21,6,2,4,4,7,7,0,3,2,1,7,9,3,6,5,18,1,1,2,0,2,,,
"Jul 10, 2021 11:00 PM",25,6,19,17,9,8,17,6,11,19,7,12,7,4,3,1,7,7,0,3,3,0,8,1,0,1,12,15,1,1,1,1,0,,,
"Jul 11, 2021 12:00 AM",20,8,12,0,0,0,3,0,3,7,2,5,2,1,1,1,9,8,1,5,5,0,9,2,2,0,9,6,1,0,3,1,2,,,
"Jul 11, 2021 1:00 AM",14,0,14,4,1,3,6,4,2,7,4,3,3,1,2,2,3,3,0,3,1,2,4,1,0,1,6,6,1,1,0,0,0,,,
"Jul 11, 2021 2:00 AM",7,2,5,0,0,0,0,0,0,1,0,1,0,0,0,0,1,1,0,3,2,1,1,1,1,0,1,2,3,2,4,3,1,,,
"Jul 11, 2021 3:00 AM",0,0,0,0,0,0,2,0,2,2,1,1,0,0,0,0,0,0,0,1,1,0,2,0,0,0,0,0,0,0,2,0,2,,,
"Jul 11, 2021 4:00 AM",2,0,2,0,0,0,0,0,0,0,0,0,5,3,2,1,2,2,0,2,2,0,2,1,1,0,2,2,0,0,0,0,0,,,
"Jul 11, 2021 5:00 AM",4,1,3,0,0,0,1,1,0,1,1,0,0,0,0,0,6,5,1,1,1,0,5,1,1,0,5,4,0,0,0,0,0,,,
"Jul 11, 2021 6:00 AM",8,4,4,11,5,6,12,9,3,8,6,2,0,0,0,2,6,6,0,1,1,0,5,2,2,0,9,6,0,1,0,0,0,,,
"Jul 11, 2021 7:00 AM",26,13,13,42,26,16,36,22,14,38,26,12,8,6,2,5,21,20,1,2,1,1,19,2,2,0,20,25,2,2,1,0,1,,,
"Jul 11, 2021 8:00 AM",34,14,20,69,39,30,66,37,29,69,44,25,4,3,1,6,10,10,0,6,4,2,10,15,7,8,30,29,2,7,1,0,1,,,
"Jul 11, 2021 9:00 AM",24,10,14,77,32,45,80,47,33,71,34,37,9,5,4,7,10,10,0,13,12,1,9,7,6,1,32,40,4,7,2,0,2,,,
"Jul 11, 2021 10:00 AM",47,24,23,84,48,36,88,56,32,67,47,20,8,7,1,10,21,21,0,9,9,0,21,15,11,4,49,30,0,2,0,0,0,,,
"Jul 11, 2021 11:00 AM",54,32,22,103,49,54,92,49,43,72,38,34,23,11,12,6,21,20,1,10,9,1,25,23,13,10,33,43,5,4,4,0,4,,,
"Jul 11, 2021 12:00 PM",46,22,24,91,42,49,107,58,49,61,28,33,31,22,9,11,21,21,0,13,10,3,22,24,14,10,39,30,13,3,3,2,1,,,
"Jul 11, 2021 1:00 PM",51,29,22,96,60,36,101,46,55,82,44,38,31,18,13,18,14,14,0,21,19,2,13,25,19,6,26,32,3,3,3,2,1,,,
"Jul 11, 2021 2:00 PM",35,18,17,45,18,27,67,18,49,43,12,31,8,5,3,11,7,6,1,14,12,2,8,14,8,6,33,36,3,1,2,2,0,,,
"Jul 11, 2021 3:00 PM",30,17,13,33,16,17,47,25,22,39,18,21,5,3,2,9,7,7,0,11,11,0,7,16,7,9,8,16,1,0,4,2,2,,,
"Jul 11, 2021 4:00 PM",21,10,11,24,9,15,38,8,30,31,9,22,8,4,4,10,7,7,0,8,6,2,7,9,4,5,16,22,4,3,0,0,0,,,
"Jul 11, 2021 5:00 PM",19,12,7,20,8,12,36,14,22,25,9,16,4,3,1,5,2,2,0,6,6,0,3,3,1,2,11,15,4,3,4,1,3,,,
"Jul 11, 2021 6:00 PM",24,10,14,12,6,6,30,12,18,13,10,3,3,1,2,6,6,6,0,6,6,0,7,2,2,0,10,14,1,0,3,3,0,,,
"Jul 11, 2021 7:00 PM",24,14,10,9,7,2,6,2,4,5,1,4,1,0,1,7,8,7,1,5,4,1,8,3,2,1,7,8,0,0,2,1,1,,,
"Jul 11, 2021 8:00 PM",17,7,10,5,3,2,5,4,1,7,6,1,0,0,0,2,2,2,0,2,2,0,2,2,2,0,10,5,1,0,1,1,0,,,
"Jul 11, 2021 9:00 PM",13,6,7,9,4,5,9,5,4,5,3,2,0,0,0,4,2,2,0,1,1,0,2,5,4,1,3,5,0,0,3,1,2,,,
"Jul 11, 2021 10:00 PM",9,1,8,2,1,1,4,1,3,2,0,2,0,0,0,4,1,1,0,2,2,0,1,2,1,1,4,9,2,1,2,1,1,,,
"Jul 11, 2021 11:00 PM",20,13,7,5,1,4,9,2,7,7,0,7,2,1,1,2,7,7,0,6,6,0,8,3,0,3,3,6,1,0,0,0,0,,,
"Jul 12, 2021 12:00 AM",6,2,4,0,0,0,2,2,0,3,3,0,1,0,1,3,2,2,0,2,2,0,2,0,0,0,10,5,0,0,1,1,0,,,
"Jul 12, 2021 1:00 AM",3,1,2,4,3,1,0,0,0,1,1,0,0,0,0,0,1,1,0,0,0,0,1,0,0,0,0,0,0,0,0,0,0,,,
"Jul 12, 2021 2:00 AM",1,0,1,1,1,0,3,2,1,0,0,0,0,0,0,1,0,0,0,0,0,0,0,0,0,0,1,2,0,0,0,0,0,,,
"Jul 12, 2021 3:00 AM",0,0,0,0,0,0,2,0,2,2,1,1,0,0,0,0,0,0,0,0,0,0,2,0,0,0,1,0,0,0,0,0,0,,,
"Jul 12, 2021 4:00 AM",2,1,1,0,0,0,3,3,0,0,0,0,0,0,0,0,1,1,0,1,1,0,1,0,0,0,2,2,0,1,0,0,0,,,
"Jul 12, 2021 5:00 AM",5,5,0,0,0,0,3,3,0,5,5,0,0,0,0,1,3,3,0,3,2,1,3,0,0,0,4,3,1,0,0,0,0,,,
"Jul 12, 2021 6:00 AM",34,25,9,9,5,4,14,6,8,9,5,4,4,2,2,5,19,18,1,3,3,0,18,0,0,0,10,26,0,3,4,3,1,,,
"Jul 12, 2021 7:00 AM",75,46,29,40,20,20,48,19,29,41,21,20,5,5,0,11,57,57,0,14,7,7,60,6,4,2,32,54,4,6,2,1,1,,,
"Jul 12, 2021 8:00 AM",118,89,29,57,25,32,85,43,42,67,38,29,13,7,6,10,58,58,0,18,12,6,64,20,7,13,45,87,1,2,3,3,0,,,
"Jul 12, 2021 9:00 AM",66,46,20,58,16,42,49,28,21,49,28,21,20,9,11,8,30,30,0,15,12,3,31,17,9,8,28,37,4,3,6,3,3,,,
"Jul 12, 2021 10:00 AM",34,23,11,23,6,17,27,9,18,16,6,10,17,12,5,11,10,10,0,10,7,3,12,7,6,1,17,25,1,1,0,0,0,,,
"Jul 12, 2021 11:00 AM",48,23,25,30,16,14,44,25,19,41,26,15,29,19,10,7,9,8,1,3,3,0,9,7,6,1,15,12,5,1,3,1,2,,,
"Jul 12, 2021 12:00 PM",49,22,27,50,27,23,57,34,23,49,28,21,22,7,15,12,22,22,0,10,10,0,22,27,17,10,23,27,3,5,9,3,6,,,
"Jul 12, 2021 1:00 PM",57,35,22,90,48,42,83,43,40,65,31,34,39,18,21,17,17,16,1,20,18,2,17,16,7,9,36,21,4,3,3,2,1,,,
"Jul 12, 2021 2:00 PM",64,30,34,83,40,43,70,31,39,47,26,21,23,14,9,14,14,12,2,14,12,2,13,18,11,7,26,28,8,3,3,1,2,,,
"Jul 12, 2021 3:00 PM",70,29,41,56,31,25,86,52,34,62,35,27,19,10,9,15,15,15,0,25,23,2,14,21,12,9,40,21,4,7,9,6,3,,,
"Jul 12, 2021 4:00 PM",83,32,51,73,44,29,106,52,54,59,32,27,22,8,14,15,22,22,0,28,26,2,20,26,19,7,50,45,5,5,6,4,2,,,
"Jul 12, 2021 5:00 PM",129,31,98,102,54,48,149,75,74,105,47,58,23,11,12,20,24,24,0,50,48,2,24,23,13,10,73,61,4,9,6,4,2,,,
"Jul 12, 2021 6:00 PM",119,41,78,143,86,57,139,90,49,135,86,49,13,6,7,25,26,25,1,67,65,2,23,46,27,19,79,42,12,6,9,6,3,,,
"Jul 12, 2021 7:00 PM",104,49,55,168,85,83,171,88,83,138,73,65,13,4,9,18,15,14,1,30,27,3,18,45,31,14,61,42,7,6,6,1,5,,,
"Jul 12, 2021 8:00 PM",85,32,53,119,54,65,137,58,79,109,52,57,11,7,4,22,20,18,2,18,16,2,15,17,9,8,36,37,5,5,8,4,4,,,
"Jul 12, 2021 9:00 PM",52,17,35,94,47,47,97,43,54,79,38,41,8,3,5,16,9,9,0,11,9,2,6,29,15,14,23,24,4,5,10,7,3,,,
"Jul 12, 2021 10:00 PM",31,11,20,27,10,17,26,10,16,25,8,17,7,3,4,27,10,9,1,14,13,1,9,7,5,2,15,13,1,5,3,1,2,,,
"Jul 12, 2021 11:00 PM",7,4,3,12,11,1,13,5,8,10,6,4,5,3,2,5,4,3,1,10,10,0,4,3,3,0,7,6,0,0,1,0,1,,,
"Jul 13, 2021 12:00 AM",14,4,10,0,0,0,1,1,0,3,2,1,0,0,0,1,2,2,0,2,2,0,2,0,0,0,6,1,2,0,1,1,0,,,
"Jul 13, 2021 1:00 AM",1,0,1,3,2,1,1,1,0,2,1,1,0,0,0,2,0,0,0,2,2,0,0,0,0,0,2,0,0,0,0,0,0,,,
"Jul 13, 2021 2:00 AM",6,4,2,4,1,3,2,0,2,1,0,1,0,0,0,1,0,0,0,3,3,0,0,0,0,0,0,2,0,0,0,0,0,,,
"Jul 13, 2021 3:00 AM",0,0,0,0,0,0,1,0,1,0,0,0,0,0,0,1,0,0,0,0,0,0,1,0,0,0,0,0,0,0,0,0,0,,,
"Jul 13, 2021 4:00 AM",0,0,0,0,0,0,7,7,0,0,0,0,0,0,0,0,1,1,0,1,1,0,1,0,0,0,3,2,0,0,0,0,0,,,
"Jul 13, 2021 5:00 AM",9,8,1,4,3,1,10,8,2,14,12,2,0,0,0,0,2,2,0,3,2,1,2,2,1,1,8,8,0,1,1,1,0,,,
"Jul 13, 2021 6:00 AM",44,27,17,38,27,11,43,27,16,37,25,12,3,2,1,7,25,24,1,5,4,1,23,5,3,2,18,44,3,3,3,2,1,,,
"Jul 13, 2021 7:00 AM",104,65,39,113,44,69,99,32,67,95,39,56,7,5,2,9,55,55,0,17,13,4,55,19,10,9,59,78,1,6,2,0,2,,,
"Jul 13, 2021 8:00 AM",140,96,44,106,32,74,136,64,72,116,54,62,19,10,9,13,90,89,1,18,13,5,101,21,11,10,57,123,4,8,6,5,1,,,
"Jul 13, 2021 9:00 AM",94,66,28,95,41,54,86,49,37,78,48,30,29,14,15,9,49,49,0,12,7,5,52,20,10,10,50,75,5,4,8,4,4,,,
"Jul 13, 2021 10:00 AM",68,51,17,67,30,37,77,36,41,54,28,26,20,17,3,9,21,21,0,16,13,3,23,29,17,12,32,44,4,2,6,4,2,,,
"Jul 13, 2021 11:00 AM",56,32,24,91,50,41,91,53,38,81,48,33,25,20,5,24,23,23,0,16,10,6,22,20,11,9,39,20,4,2,6,3,3,,,
"Jul 13, 2021 12:00 PM",59,37,22,98,48,50,120,66,54,81,41,40,34,20,14,25,24,22,2,22,21,1,24,24,15,9,35,29,8,1,4,3,1,,,
"Jul 13, 2021 1:00 PM",75,34,41,119,61,58,131,71,60,94,48,46,20,7,13,30,22,22,0,22,22,0,24,30,22,8,52,38,5,5,7,4,3,,,
"Jul 13, 2021 2:00 PM",77,42,35,79,39,40,127,72,55,92,50,42,19,9,10,30,28,27,1,29,28,1,27,39,32,7,60,33,6,5,6,4,2,,,
"Jul 13, 2021 3:00 PM",98,42,56,88,50,38,143,87,56,83,48,35,20,13,7,16,28,27,1,22,22,0,29,49,24,25,66,52,4,1,8,6,2,,,
"Jul 13, 2021 4:00 PM",116,40,76,108,52,56,160,75,85,89,47,42,19,8,11,19,22,21,1,42,41,1,22,39,20,19,55,54,10,4,9,5,4,,,
"Jul 13, 2021 5:00 PM",168,55,113,156,79,77,194,105,89,157,90,67,35,11,24,45,33,32,1,58,57,1,29,31,20,11,105,78,6,6,11,7,4,,,
"Jul 13, 2021 6:00 PM",145,58,87,206,122,84,237,150,87,185,122,63,36,15,21,27,47,45,2,66,62,4,46,42,32,10,140,63,3,5,8,5,3,,,
"Jul 13, 2021 7:00 PM",125,50,75,175,94,81,220,123,97,160,72,88,19,8,11,31,24,23,1,51,46,5,25,38,25,13,99,55,4,4,8,5,3,,,
"Jul 13, 2021 8:00 PM",83,35,48,170,86,84,132,54,78,110,52,58,26,15,11,19,32,32,0,27,24,3,34,44,16,28,48,50,4,6,10,5,5,,,
"Jul 13, 2021 9:00 PM",65,26,39,88,51,37,111,25,86,84,28,56,15,6,9,9,10,10,0,22,21,1,11,13,1,12,27,48,5,2,8,3,5,,,
"Jul 13, 2021 10:00 PM",44,14,30,51,30,21,55,22,33,54,21,33,11,7,4,6,10,9,1,14,11,3,7,13,6,7,20,12,1,1,0,0,0,,,
"Jul 13, 2021 11:00 PM",13,4,9,10,6,4,14,3,11,12,3,9,6,2,4,2,3,3,0,9,9,0,5,0,0,0,4,6,0,1,0,0,0,,,
"Jul 14, 2021 12:00 AM",10,1,9,3,2,1,0,0,0,10,3,7,5,1,4,3,1,1,0,4,4,0,1,1,1,0,6,7,1,0,1,0,1,,,
"Jul 14, 2021 1:00 AM",2,0,2,1,0,1,6,2,4,0,0,0,3,0,3,1,0,0,0,0,0,0,0,0,0,0,1,6,0,0,0,0,0,,,
"Jul 14, 2021 2:00 AM",3,2,1,0,0,0,0,0,0,0,0,0,0,0,0,0,0,0,0,1,1,0,0,0,0,0,0,1,0,0,1,1,0,,,
"Jul 14, 2021 3:00 AM",2,0,2,0,0,0,0,0,0,0,0,0,0,0,0,1,0,0,0,1,1,0,0,0,0,0,0,0,1,0,0,0,0,,,
"Jul 14, 2021 4:00 AM",1,1,0,0,0,0,6,5,1,1,0,1,0,0,0,1,1,1,0,0,0,0,1,0,0,0,1,3,0,0,0,0,0,,,
"Jul 14, 2021 5:00 AM",7,6,1,7,6,1,15,12,3,14,11,3,1,0,1,0,2,2,0,8,5,3,3,1,0,1,4,10,2,0,0,0,0,,,
"Jul 14, 2021 6:00 AM",41,29,12,30,17,13,34,20,14,33,18,15,2,2,0,5,23,21,2,9,9,0,22,3,2,1,23,46,1,2,2,2,0,,,
"Jul 14, 2021 7:00 AM",82,45,37,97,52,45,93,45,48,83,51,32,7,3,4,9,56,56,0,12,9,3,57,11,8,3,46,95,3,5,3,3,0,,,
"Jul 14, 2021 8:00 AM",157,124,33,103,29,74,126,59,67,100,48,52,21,13,8,12,73,71,2,28,22,6,80,14,4,10,51,116,0,5,7,6,1,,,
"Jul 14, 2021 9:00 AM",108,66,42,79,28,51,65,33,32,66,38,28,20,13,7,12,44,42,2,14,9,5,46,17,12,5,49,64,6,10,10,5,5,,,
"Jul 14, 2021 10:00 AM",61,41,20,65,33,32,72,43,29,61,40,21,20,18,2,12,30,30,0,18,12,6,29,21,13,8,30,24,6,2,6,4,2,,,
"Jul 14, 2021 11:00 AM",46,27,19,88,45,43,102,59,43,91,56,35,21,14,7,14,16,16,0,13,8,5,17,21,15,6,38,33,2,3,1,1,0,,,
"Jul 14, 2021 12:00 PM",72,40,32,103,53,50,120,67,53,91,48,43,24,7,17,20,24,23,1,11,10,1,21,22,16,6,44,38,9,5,10,4,6,,,
"Jul 14, 2021 1:00 PM",73,30,43,146,96,50,149,97,52,123,75,48,37,16,21,23,27,26,1,14,14,0,28,38,25,13,63,43,6,6,10,6,4,,,
"Jul 14, 2021 2:00 PM",73,40,33,108,59,49,118,71,47,65,35,30,27,19,8,31,22,22,0,37,32,5,23,35,26,9,49,48,6,4,8,6,2,,,
"Jul 14, 2021 3:00 PM",91,39,52,164,95,69,187,117,70,136,75,61,23,10,13,21,28,27,1,28,26,2,28,55,30,25,85,28,8,2,11,6,5,,,
"Jul 14, 2021 4:00 PM",116,49,67,193,95,98,230,118,112,126,68,58,36,17,19,30,24,23,1,30,30,0,23,60,44,16,75,75,4,8,8,4,4,,,
"Jul 14, 2021 5:00 PM",172,59,113,210,128,82,370,186,184,213,117,96,43,14,29,27,40,40,0,63,63,0,39,77,50,27,131,108,5,7,10,6,4,,,
"Jul 14, 2021 6:00 PM",156,69,87,240,130,110,319,178,141,231,130,101,33,14,19,21,40,38,2,69,65,4,37,85,53,32,159,95,7,10,7,1,6,,,
"Jul 14, 2021 7:00 PM",123,57,66,224,124,100,258,130,128,205,127,78,16,10,6,36,27,26,1,47,44,3,28,42,20,22,110,78,12,10,8,4,4,,,
"Jul 14, 2021 8:00 PM",95,36,59,172,72,100,220,76,144,183,70,113,17,7,10,23,21,21,0,19,18,1,22,34,18,16,61,83,9,5,8,6,2,,,
"Jul 14, 2021 9:00 PM",59,20,39,103,45,58,109,31,78,73,21,52,14,3,11,20,15,15,0,27,23,4,16,30,15,15,30,40,6,1,4,4,0,,,
"Jul 14, 2021 10:00 PM",42,13,29,29,20,9,54,22,32,37,14,23,10,1,9,3,7,7,0,13,12,1,8,11,5,6,23,22,3,2,6,3,3,,,
"Jul 14, 2021 11:00 PM",19,5,14,15,10,5,19,9,10,20,11,9,6,5,1,0,6,5,1,15,14,1,6,8,4,4,11,16,2,1,2,2,0,,,
"Jul 15, 2021 12:00 AM",13,5,8,0,0,0,3,1,2,2,2,0,1,1,0,4,3,3,0,10,9,1,2,1,0,1,4,4,0,0,1,1,0,,,
"Jul 15, 2021 1:00 AM",6,5,1,2,1,1,4,2,2,4,3,1,0,0,0,0,2,2,0,1,1,0,2,0,0,0,3,2,0,0,1,0,1,,,
"Jul 15, 2021 2:00 AM",5,4,1,1,0,1,2,0,2,1,0,1,0,0,0,1,3,3,0,2,2,0,4,0,0,0,3,1,0,0,0,0,0,,,
"Jul 15, 2021 3:00 AM",0,0,0,1,0,1,0,0,0,0,0,0,0,0,0,0,1,1,0,0,0,0,1,0,0,0,3,0,0,0,0,0,0,,,
"Jul 15, 2021 4:00 AM",1,1,0,1,1,0,1,1,0,1,1,0,0,0,0,0,1,1,0,3,3,0,1,0,0,0,2,2,0,0,0,0,0,,,
"Jul 15, 2021 5:00 AM",10,9,1,4,2,2,28,24,4,7,6,1,2,2,0,0,7,6,1,3,2,1,6,13,9,4,11,11,0,0,0,0,0,,,
"Jul 15, 2021 6:00 AM",37,26,11,32,21,11,44,24,20,40,30,10,10,1,9,3,20,20,0,3,3,0,20,8,4,4,18,27,2,3,1,1,0,,,
"Jul 15, 2021 7:00 AM",86,50,36,89,45,44,84,37,47,83,41,42,12,10,2,9,44,44,0,23,16,7,42,13,6,7,53,76,1,5,2,2,0,,,
"Jul 15, 2021 8:00 AM",128,92,36,99,35,64,110,57,53,93,50,43,20,13,7,9,74,74,0,23,15,8,82,21,14,7,52,111,2,5,10,8,2,,,
"Jul 15, 2021 9:00 AM",99,71,28,60,19,41,73,38,35,76,44,32,31,15,16,17,43,43,0,12,8,4,42,10,8,2,36,55,7,3,3,2,1,,,
"Jul 15, 2021 10:00 AM",57,37,20,53,25,28,76,44,32,69,37,32,19,8,11,13,28,28,0,8,3,5,28,12,9,3,27,31,4,1,2,2,0,,,
"Jul 15, 2021 11:00 AM",57,26,31,76,39,37,114,79,35,84,52,32,20,11,9,13,30,30,0,15,13,2,31,23,17,6,22,29,3,4,7,2,5,,,
"Jul 15, 2021 12:00 PM",72,38,34,100,56,44,119,61,58,90,53,37,18,9,9,14,20,20,0,15,12,3,22,25,18,7,48,31,7,1,5,4,1,,,
"Jul 15, 2021 1:00 PM",78,30,48,114,69,45,154,99,55,106,68,38,25,10,15,12,25,25,0,27,27,0,26,22,21,1,47,40,10,4,9,5,4,,,
"Jul 15, 2021 2:00 PM",101,48,53,115,55,60,152,90,62,95,53,42,31,13,18,17,27,27,0,29,28,1,27,43,23,20,61,48,3,12,4,2,2,,,
"Jul 15, 2021 3:00 PM",94,45,49,142,87,55,223,131,92,132,76,56,27,16,11,13,29,28,1,32,27,5,23,32,24,8,83,49,6,1,4,1,3,,,
"Jul 15, 2021 4:00 PM",113,49,64,177,99,78,295,160,135,152,84,68,21,9,12,18,44,40,4,36,35,1,35,62,39,23,114,73,10,6,15,9,6,,,
"Jul 15, 2021 5:00 PM",190,64,126,229,102,127,376,233,143,232,144,88,44,23,21,28,46,46,0,59,56,3,51,76,54,22,183,78,7,13,9,6,3,,,
"Jul 15, 2021 6:00 PM",170,81,89,234,123,111,437,237,200,213,128,85,40,18,22,25,49,47,2,62,60,2,51,120,80,40,155,103,5,11,9,7,2,,,
"Jul 15, 2021 7:00 PM",122,48,74,198,101,97,325,138,187,187,101,86,12,2,10,13,33,32,1,43,40,3,37,41,23,18,105,111,8,7,11,6,5,,,
"Jul 15, 2021 8:00 PM",97,30,67,190,89,101,192,63,129,141,62,79,18,7,11,37,16,16,0,33,30,3,16,45,12,33,62,75,6,6,4,1,3,,,
"Jul 15, 2021 9:00 PM",58,28,30,88,42,46,135,40,95,89,26,63,7,1,6,15,12,12,0,30,30,0,12,24,9,15,28,68,5,2,5,4,1,,,
"Jul 15, 2021 10:00 PM",52,19,33,65,48,17,74,20,54,68,20,48,16,4,12,6,14,14,0,11,10,1,12,22,9,13,26,27,2,2,3,1,2,,,
"Jul 15, 2021 11:00 PM",32,12,20,28,21,7,38,9,29,27,5,22,12,7,5,1,10,7,3,16,14,2,10,9,3,6,22,21,1,0,0,0,0,,,
"Jul 16, 2021 12:00 AM",18,6,12,0,0,0,6,0,6,15,3,12,1,0,1,2,2,2,0,5,5,0,4,4,0,4,10,12,1,0,0,0,0,,,
"Jul 16, 2021 1:00 AM",3,0,3,6,3,3,9,1,8,8,3,5,5,2,3,4,0,0,0,7,5,2,1,0,0,0,4,2,1,0,0,0,0,,,
"Jul 16, 2021 2:00 AM",5,5,0,4,3,1,3,1,2,3,1,2,0,0,0,0,0,0,0,0,0,0,0,0,0,0,1,4,0,1,0,0,0,,,
"Jul 16, 2021 3:00 AM",3,0,3,1,0,1,1,0,1,0,0,0,1,1,0,1,0,0,0,0,0,0,0,0,0,0,1,0,0,0,0,0,0,,,
"Jul 16, 2021 4:00 AM",1,1,0,0,0,0,1,1,0,0,0,0,0,0,0,1,0,0,0,0,0,0,0,0,0,0,2,2,0,0,0,0,0,,,
"Jul 16, 2021 5:00 AM",7,5,2,6,5,1,10,7,3,10,8,2,1,0,1,1,5,4,1,3,3,0,4,4,1,3,4,6,0,0,0,0,0,,,
"Jul 16, 2021 6:00 AM",41,28,13,27,14,13,41,23,18,25,13,12,2,2,0,4,17,17,0,5,4,1,19,3,2,1,17,39,0,2,0,0,0,,,
"Jul 16, 2021 7:00 AM",69,43,26,77,36,41,86,49,37,61,37,24,6,5,1,9,38,38,0,17,12,5,39,12,8,4,55,72,3,6,0,0,0,,,
"Jul 16, 2021 8:00 AM",135,99,36,90,50,40,120,65,55,100,61,39,13,8,5,11,72,69,3,22,14,8,72,25,6,19,58,93,2,8,3,2,1,,,
"Jul 16, 2021 9:00 AM",86,56,30,117,52,65,94,48,46,100,61,39,29,19,10,9,36,35,1,19,13,6,39,12,6,6,41,63,7,6,4,1,3,,,
"Jul 16, 2021 10:00 AM",72,49,23,80,37,43,106,62,44,89,47,42,16,13,3,9,31,31,0,25,19,6,31,26,21,5,28,44,7,10,9,6,3,,,
"Jul 16, 2021 11:00 AM",62,37,25,90,50,40,129,72,57,97,58,39,32,20,12,13,32,31,1,29,28,1,30,29,17,12,54,37,11,4,9,8,1,,,
"Jul 16, 2021 12:00 PM",61,25,36,162,85,77,161,87,74,135,78,57,40,11,29,8,27,27,0,13,13,0,28,46,35,11,53,35,11,3,12,10,2,,,
"Jul 16, 2021 1:00 PM",103,44,59,159,89,70,164,92,72,136,80,56,26,9,17,24,27,27,0,24,23,1,28,49,25,24,66,39,10,5,5,3,2,,,
"Jul 16, 2021 2:00 PM",90,48,42,174,81,93,246,141,105,163,81,82,30,16,14,21,23,23,0,36,34,2,21,49,37,12,72,63,12,4,2,0,2,,,
"Jul 16, 2021 3:00 PM",89,37,52,123,77,46,208,127,81,159,93,66,24,16,8,26,28,27,1,23,21,2,33,35,22,13,86,56,9,5,7,2,5,,,
"Jul 16, 2021 4:00 PM",114,38,76,201,104,97,299,190,109,180,99,81,34,13,21,40,35,33,2,43,40,3,32,54,34,20,131,77,8,10,11,8,3,,,
"Jul 16, 2021 5:00 PM",143,60,83,211,104,107,437,256,181,241,119,122,25,6,19,29,35,33,2,62,59,3,39,107,70,37,148,101,9,8,7,4,3,,,
"Jul 16, 2021 6:00 PM",117,48,69,239,130,109,496,310,186,212,133,79,31,11,20,20,35,34,1,44,41,3,35,95,69,26,193,81,3,3,8,5,3,,,
"Jul 16, 2021 7:00 PM",114,54,60,199,99,100,341,115,226,195,96,99,28,12,16,24,26,26,0,41,37,4,25,60,34,26,104,84,1,8,7,6,1,,,
"Jul 16, 2021 8:00 PM",55,27,28,122,59,63,199,73,126,118,60,58,31,20,11,14,23,23,0,19,17,2,25,47,16,31,42,90,8,2,8,8,0,,,
"Jul 16, 2021 9:00 PM",53,19,34,98,35,63,152,32,120,103,29,74,13,7,6,15,14,13,1,12,10,2,13,18,1,17,24,66,2,4,6,2,4,,,
"Jul 16, 2021 10:00 PM",37,16,21,68,29,39,77,14,63,54,21,33,16,7,9,7,13,13,0,17,15,2,12,23,12,11,10,39,3,3,5,2,3,,,
"Jul 16, 2021 11:00 PM",39,12,27,32,12,20,39,5,34,29,9,20,8,2,6,0,11,11,0,11,10,1,12,8,3,5,16,26,2,3,1,1,0,,,
"Jul 17, 2021 12:00 AM",20,10,10,0,0,0,1,0,1,21,7,14,4,1,3,2,10,7,3,10,9,1,7,5,2,3,8,9,0,1,3,1,2,,,
"Jul 17, 2021 1:00 AM",13,3,10,5,0,5,10,0,10,5,0,5,0,0,0,4,2,2,0,4,3,1,3,4,0,4,3,8,0,0,1,0,1,,,
"Jul 17, 2021 2:00 AM",8,4,4,2,0,2,3,0,3,3,0,3,0,0,0,1,3,3,0,3,3,0,2,2,2,0,2,1,1,0,1,0,1,,,
"Jul 17, 2021 3:00 AM",3,1,2,0,0,0,1,1,0,2,1,1,3,3,0,1,0,0,0,0,0,0,0,0,0,0,1,1,1,0,0,0,0,,,
"Jul 17, 2021 4:00 AM",2,2,0,2,0,2,10,8,2,2,0,2,2,0,2,1,0,0,0,2,2,0,0,1,0,1,2,0,0,1,0,0,0,,,
"Jul 17, 2021 5:00 AM",4,1,3,11,9,2,21,20,1,12,10,2,0,0,0,1,2,2,0,0,0,0,2,3,3,0,6,4,0,0,1,1,0,,,
"Jul 17, 2021 6:00 AM",18,13,5,15,6,9,31,13,18,17,10,7,2,0,2,2,10,8,2,2,2,0,8,5,4,1,9,21,0,0,1,0,1,,,
"Jul 17, 2021 7:00 AM",29,11,18,67,42,25,90,59,31,51,29,22,3,1,2,1,18,17,1,7,4,3,19,10,9,1,34,24,1,5,0,0,0,,,
"Jul 17, 2021 8:00 AM",42,14,28,110,63,47,116,69,47,91,63,28,12,9,3,17,16,16,0,8,7,1,18,16,13,3,46,27,3,5,3,2,1,,,
"Jul 17, 2021 9:00 AM",51,29,22,159,87,72,168,100,68,146,84,62,16,12,4,10,18,18,0,14,12,2,21,38,19,19,67,52,7,5,1,1,0,,,
"Jul 17, 2021 10:00 AM",60,31,29,236,140,96,254,160,94,204,142,62,21,11,10,19,27,24,3,16,13,3,27,41,27,14,99,60,9,8,2,2,0,,,
"Jul 17, 2021 11:00 AM",94,45,49,251,131,120,299,191,108,235,147,88,36,20,16,25,26,26,0,26,24,2,28,56,45,11,127,57,12,12,11,5,6,,,
"Jul 17, 2021 12:00 PM",82,38,44,316,156,160,332,195,137,270,166,104,37,21,16,16,25,24,1,25,23,2,23,55,36,19,120,85,13,10,9,8,1,,,
"Jul 17, 2021 1:00 PM",97,56,41,275,156,119,404,258,146,281,188,93,29,15,14,24,28,25,3,20,18,2,29,78,61,17,142,81,9,9,9,6,3,,,
"Jul 17, 2021 2:00 PM",93,44,49,289,161,128,417,267,150,287,178,109,23,10,13,30,24,21,3,32,31,1,18,82,65,17,150,76,15,4,15,8,7,,,
"Jul 17, 2021 3:00 PM",70,43,27,304,167,137,460,266,194,282,158,124,36,17,19,12,27,27,0,24,22,2,26,114,78,36,128,67,9,8,11,7,4,,,
"Jul 17, 2021 4:00 PM",83,43,40,286,146,140,465,242,223,258,136,122,32,9,23,18,31,31,0,14,13,1,28,107,57,50,105,116,14,8,9,4,5,,,
"Jul 17, 2021 5:00 PM",76,35,41,242,110,132,472,199,273,262,94,168,32,9,23,20,38,38,0,20,16,4,41,99,56,43,81,118,9,2,7,4,3,,,
"Jul 17, 2021 6:00 PM",70,28,42,217,102,115,373,142,231,201,85,116,35,21,14,9,30,30,0,12,11,1,30,102,46,56,80,97,9,3,6,3,3,,,
"Jul 17, 2021 7:00 PM",46,25,21,193,83,110,305,109,196,141,61,80,29,25,4,19,21,20,1,22,15,7,22,60,24,36,49,86,0,6,5,5,0,,,
"Jul 17, 2021 8:00 PM",53,24,29,152,67,85,221,59,162,154,54,100,20,6,14,7,18,18,0,8,8,0,20,37,17,20,30,108,5,9,7,7,0,,,
"Jul 17, 2021 9:00 PM",40,15,25,63,27,36,135,27,108,72,19,53,5,3,2,17,18,17,1,12,12,0,18,24,3,21,17,46,1,3,3,2,1,,,
"Jul 17, 2021 10:00 PM",25,9,16,50,13,37,70,13,57,41,11,30,4,2,2,5,10,9,1,7,7,0,10,21,7,14,17,45,2,1,4,3,1,,,
"Jul 17, 2021 11:00 PM",25,10,15,24,16,8,24,6,18,16,5,11,5,1,4,2,7,5,2,11,10,1,5,1,1,0,11,20,0,0,0,0,0,,,
"Jul 18, 2021 12:00 AM",12,5,7,3,0,3,10,1,9,22,5,17,7,2,5,4,13,12,1,5,4,1,14,1,1,0,7,11,2,1,1,1,0,,,
"Jul 18, 2021 1:00 AM",10,3,7,2,2,0,17,3,14,7,1,6,2,0,2,1,2,2,0,4,4,0,3,6,5,1,6,10,0,2,0,0,0,,,
"Jul 18, 2021 2:00 AM",2,1,1,1,0,1,5,2,3,2,0,2,0,0,0,1,3,3,0,3,2,1,2,2,2,0,4,2,1,0,0,0,0,,,
"Jul 18, 2021 3:00 AM",2,1,1,3,2,1,4,2,2,6,3,3,0,0,0,1,0,0,0,0,0,0,1,1,0,1,1,0,0,0,0,0,0,,,
"Jul 18, 2021 4:00 AM",1,0,1,3,1,2,1,1,0,1,0,1,0,0,0,1,1,1,0,0,0,0,1,0,0,0,1,1,0,0,0,0,0,,,
"Jul 18, 2021 5:00 AM",2,0,2,4,0,4,7,6,1,5,1,4,4,3,1,1,0,0,0,0,0,0,0,0,0,0,8,4,0,0,0,0,0,,,
"Jul 18, 2021 6:00 AM",9,8,1,15,7,8,23,15,8,12,8,4,1,0,1,4,3,3,0,1,1,0,3,5,4,1,13,10,0,1,1,1,0,,,
"Jul 18, 2021 7:00 AM",27,11,16,48,29,19,57,35,22,36,22,14,8,3,5,4,14,14,0,5,4,1,14,9,7,2,31,27,2,4,1,1,0,,,
"Jul 18, 2021 8:00 AM",35,12,23,118,83,35,145,98,47,105,79,26,5,4,1,22,14,13,1,6,5,1,15,21,16,5,63,28,2,7,1,0,1,,,
"Jul 18, 2021 9:00 AM",60,15,45,174,106,68,258,153,105,152,93,59,9,5,4,16,23,22,1,15,13,2,24,42,33,9,84,58,8,6,5,2,3,,,
"Jul 18, 2021 10:00 AM",62,41,21,265,162,103,282,162,120,218,145,73,9,7,2,14,21,21,0,18,17,1,22,47,35,12,84,74,6,11,14,9,5,,,
"Jul 18, 2021 11:00 AM",89,43,46,248,122,126,292,173,119,233,144,89,32,15,17,17,35,35,0,26,24,2,36,51,32,19,131,70,10,6,13,9,4,,,
"Jul 18, 2021 12:00 PM",107,53,54,332,181,151,367,204,163,314,198,116,39,20,19,21,23,23,0,20,16,4,27,61,44,17,116,87,11,10,14,10,4,,,
"Jul 18, 2021 1:00 PM",66,37,29,323,167,156,361,218,143,296,193,103,42,20,22,20,25,25,0,16,16,0,26,79,49,30,157,90,8,7,5,2,3,,,
"Jul 18, 2021 2:00 PM",91,42,49,304,172,132,349,220,129,258,149,109,32,13,19,19,27,27,0,30,26,4,29,87,57,30,128,70,14,12,8,4,4,,,
"Jul 18, 2021 3:00 PM",60,29,31,327,162,165,392,193,199,305,153,152,37,24,13,15,20,20,0,27,22,5,26,78,48,30,83,96,10,1,11,5,6,,,
"Jul 18, 2021 4:00 PM",74,29,45,297,155,142,409,195,214,289,142,147,24,9,15,15,34,33,1,19,17,2,35,77,52,25,92,86,2,5,12,10,2,,,
"Jul 18, 2021 5:00 PM",62,25,37,244,108,136,352,166,186,218,88,130,36,17,19,24,23,22,1,22,21,1,25,90,42,48,102,97,6,8,12,6,6,,,
"Jul 18, 2021 6:00 PM",61,23,38,189,89,100,383,150,233,206,91,115,19,6,13,13,22,22,0,27,25,2,23,87,48,39,84,104,2,5,14,8,6,,,
"Jul 18, 2021 7:00 PM",67,32,35,154,52,102,279,107,172,125,43,82,22,14,8,22,17,16,1,10,8,2,16,72,34,38,48,99,1,4,3,3,0,,,
"Jul 18, 2021 8:00 PM",43,12,31,95,30,65,166,53,113,77,27,50,18,7,11,9,39,39,0,9,8,1,32,42,8,34,32,64,0,5,2,2,0,,,
"Jul 18, 2021 9:00 PM",35,16,19,76,30,46,123,26,97,67,21,46,11,6,5,25,12,12,0,4,3,1,14,33,8,25,15,40,0,5,2,2,0,,,
"Jul 18, 2021 10:00 PM",23,14,9,22,6,16,54,16,38,32,10,22,2,0,2,10,12,12,0,8,7,1,13,11,6,5,9,28,2,1,6,3,3,,,
"Jul 18, 2021 11:00 PM",16,6,10,10,4,6,15,4,11,14,4,10,4,3,1,9,14,11,3,4,3,1,15,6,5,1,5,6,0,0,1,1,0,,,
"Jul 19, 2021 12:00 AM",9,1,8,1,0,1,3,0,3,8,0,8,1,1,0,3,0,0,0,4,4,0,0,0,0,0,2,3,1,0,1,1,0,,,
"Jul 19, 2021 1:00 AM",4,0,4,1,1,0,3,1,2,1,1,0,0,0,0,0,2,2,0,2,2,0,2,1,1,0,6,5,0,0,0,0,0,,,
"Jul 19, 2021 2:00 AM",3,3,0,0,0,0,0,0,0,0,0,0,0,0,0,1,1,1,0,1,1,0,1,0,0,0,0,1,0,0,0,0,0,,,
"Jul 19, 2021 3:00 AM",0,0,0,0,0,0,1,1,0,0,0,0,0,0,0,0,0,0,0,0,0,0,2,0,0,0,0,0,0,0,0,0,0,,,
"Jul 19, 2021 4:00 AM",2,1,1,2,2,0,4,3,1,2,2,0,0,0,0,4,1,1,0,0,0,0,1,1,0,1,1,1,0,0,1,1,0,,,
"Jul 19, 2021 5:00 AM",8,8,0,8,6,2,13,11,2,15,12,3,0,0,0,1,3,3,0,2,2,0,3,1,0,1,6,11,0,0,0,0,0,,,
"Jul 19, 2021 6:00 AM",37,25,12,24,14,10,44,25,19,25,13,12,8,4,4,3,23,23,0,5,4,1,23,5,2,3,28,40,2,3,3,3,0,,,
"Jul 19, 2021 7:00 AM",88,49,39,86,34,52,116,60,56,62,28,34,3,3,0,11,63,63,0,15,14,1,64,25,15,10,54,87,1,6,6,4,2,,,
"Jul 19, 2021 8:00 AM",125,96,29,105,34,71,149,60,89,85,39,46,20,13,7,9,93,91,2,26,20,6,98,31,10,21,60,102,5,4,6,5,1,,,
"Jul 19, 2021 9:00 AM",81,57,24,100,45,55,125,65,60,89,54,35,36,15,21,12,40,40,0,22,17,5,43,34,19,15,38,54,5,4,5,4,1,,,
"Jul 19, 2021 10:00 AM",61,43,18,96,55,41,116,78,38,77,53,24,20,11,9,14,16,14,2,14,12,2,17,19,17,2,29,31,2,4,5,3,2,,,
"Jul 19, 2021 11:00 AM",51,28,23,95,50,45,131,75,56,85,50,35,23,18,5,22,21,21,0,13,8,5,25,25,14,11,45,43,5,5,4,3,1,,,
"Jul 19, 2021 12:00 PM",73,36,37,116,67,49,133,71,62,97,57,40,25,14,11,13,17,17,0,18,17,1,17,17,13,4,48,41,5,11,9,6,3,,,
"Jul 19, 2021 1:00 PM",74,39,35,140,78,62,173,90,83,137,81,56,22,7,15,21,19,19,0,16,13,3,18,24,16,8,60,43,9,6,8,5,3,,,
"Jul 19, 2021 2:00 PM",77,40,37,144,84,60,147,90,57,134,82,52,27,11,16,14,28,26,2,27,19,8,26,29,21,8,52,38,5,5,5,3,2,,,
"Jul 19, 2021 3:00 PM",73,32,41,155,78,77,191,122,69,118,70,48,33,23,10,17,18,18,0,22,19,3,17,41,30,11,81,45,4,2,5,4,1,,,
"Jul 19, 2021 4:00 PM",111,40,71,196,115,81,226,131,95,175,92,83,33,14,19,30,27,25,2,40,39,1,27,53,36,17,102,68,7,8,16,11,5,,,
"Jul 19, 2021 5:00 PM",152,55,97,196,116,80,340,200,140,194,101,93,34,16,18,24,38,38,0,65,61,4,36,82,58,24,132,90,9,9,2,0,2,,,
"Jul 19, 2021 6:00 PM",165,65,100,216,114,102,445,287,158,210,122,88,23,13,10,26,28,27,1,64,64,0,29,108,75,33,217,72,12,1,10,8,2,,,
"Jul 19, 2021 7:00 PM",136,51,85,223,98,125,481,248,233,199,119,80,27,9,18,27,34,33,1,33,27,6,34,71,39,32,141,129,12,8,8,7,1,,,
"Jul 19, 2021 8:00 PM",102,41,61,209,102,107,436,185,251,190,97,93,30,17,13,18,26,26,0,30,30,0,29,70,30,40,86,118,5,5,8,8,0,,,
"Jul 19, 2021 9:00 PM",65,23,42,114,47,67,215,44,171,135,39,96,16,9,7,8,25,20,5,18,18,0,22,47,3,44,22,74,5,4,12,7,5,,,
"Jul 19, 2021 10:00 PM",28,7,21,28,5,23,58,8,50,30,7,23,3,0,3,4,17,17,0,8,7,1,17,10,6,4,10,32,2,2,7,2,5,,,
"Jul 19, 2021 11:00 PM",12,6,6,8,5,3,12,6,6,6,3,3,1,0,1,4,5,5,0,5,5,0,0,3,1,2,8,6,1,0,1,1,0,,,
"Jul 20, 2021 12:00 AM",11,3,8,0,0,0,0,0,0,2,1,1,7,4,3,1,1,1,0,5,5,0,1,1,0,1,2,4,1,0,1,0,1,,,
"Jul 20, 2021 1:00 AM",3,0,3,2,1,1,2,0,2,1,0,1,0,0,0,0,2,2,0,1,1,0,3,1,0,1,2,2,0,0,0,0,0,,,
"Jul 20, 2021 2:00 AM",3,3,0,0,0,0,0,0,0,0,0,0,0,0,0,0,0,0,0,1,1,0,0,0,0,0,0,0,0,0,0,0,0,,,
"Jul 20, 2021 3:00 AM",1,1,0,0,0,0,2,2,0,0,0,0,0,0,0,0,0,0,0,0,0,0,1,0,0,0,1,0,0,0,0,0,0,,,
"Jul 20, 2021 4:00 AM",2,1,1,4,4,0,8,7,1,6,6,0,0,0,0,2,0,0,0,0,0,0,0,0,0,0,2,1,0,0,0,0,0,,,
"Jul 20, 2021 5:00 AM",10,7,3,8,4,4,21,13,8,22,15,7,3,1,2,1,4,4,0,1,1,0,4,2,1,1,7,11,0,1,1,1,0,,,
"Jul 20, 2021 6:00 AM",44,30,14,52,34,18,75,52,23,50,36,14,6,4,2,2,27,26,1,7,7,0,28,16,16,0,26,44,0,3,3,2,1,,,
"Jul 20, 2021 7:00 AM",100,59,41,122,56,66,185,105,80,101,51,50,6,6,0,14,74,74,0,22,19,3,76,44,19,25,74,91,5,8,5,4,1,,,
"Jul 20, 2021 8:00 AM",144,95,49,146,57,89,250,106,144,125,57,68,28,16,12,21,79,78,1,36,26,10,78,44,18,26,65,117,7,5,7,6,1,,,
"Jul 20, 2021 9:00 AM",106,73,33,98,47,51,156,81,75,107,65,42,34,8,26,14,55,53,2,12,8,4,59,38,23,15,54,64,4,10,6,3,3,,,
"Jul 20, 2021 10:00 AM",79,47,32,94,49,45,152,91,61,100,56,44,17,15,2,8,35,34,1,11,9,2,33,28,15,13,53,33,5,2,6,4,2,,,
"Jul 20, 2021 11:00 AM",66,33,33,93,39,54,125,67,58,99,56,43,17,15,2,21,33,32,1,12,11,1,33,35,24,11,44,36,6,4,2,2,0,,,
"Jul 20, 2021 12:00 PM",78,44,34,130,69,61,195,105,90,122,63,59,28,15,13,12,27,27,0,19,19,0,28,22,12,10,62,39,7,1,3,3,0,,,
"Jul 20, 2021 1:00 PM",82,34,48,137,82,55,187,101,86,131,79,52,30,15,15,17,28,27,1,32,30,2,24,46,30,16,64,39,4,6,8,4,4,,,
"Jul 20, 2021 2:00 PM",53,21,32,154,81,73,196,117,79,139,91,48,57,35,22,20,27,27,0,35,32,3,25,28,19,9,54,50,4,1,9,4,5,,,
"Jul 20, 2021 3:00 PM",88,29,59,131,69,62,210,108,102,143,72,71,26,20,6,9,29,28,1,20,20,0,27,44,30,14,56,40,15,7,10,4,6,,,
"Jul 20, 2021 4:00 PM",103,43,60,144,72,72,196,114,82,128,73,55,28,5,23,19,27,24,3,28,27,1,22,54,38,16,95,67,6,6,8,6,2,,,
"Jul 20, 2021 5:00 PM",165,46,119,230,140,90,362,240,122,242,161,81,33,11,22,70,40,40,0,82,81,1,39,82,70,12,175,87,9,9,10,8,2,,,
"Jul 20, 2021 6:00 PM",147,60,87,291,153,138,494,317,177,282,174,108,43,18,25,37,25,23,2,58,56,2,26,129,93,36,206,109,2,11,7,7,0,,,
"Jul 20, 2021 7:00 PM",111,52,59,256,132,124,598,352,246,263,155,108,29,13,16,26,34,31,3,36,32,4,32,118,81,37,200,131,6,5,13,6,7,,,
"Jul 20, 2021 8:00 PM",95,37,58,244,108,136,493,168,325,235,102,133,32,29,3,18,36,36,0,33,30,3,34,98,32,66,87,128,5,9,14,7,7,,,
"Jul 20, 2021 9:00 PM",64,18,46,166,66,100,312,82,230,153,47,106,11,8,3,17,21,21,0,23,21,2,19,65,19,46,48,102,4,4,7,6,1,,,
"Jul 20, 2021 10:00 PM",34,10,24,47,29,18,142,31,111,60,12,48,17,8,9,7,22,22,0,9,7,2,24,27,13,14,26,45,4,3,4,3,1,,,
"Jul 20, 2021 11:00 PM",21,7,14,9,6,3,26,5,21,16,3,13,3,1,2,2,9,9,0,2,2,0,9,16,4,12,13,14,2,2,4,3,1,,,
"Jul 21, 2021 12:00 AM",5,1,4,0,0,0,1,0,1,7,2,5,2,1,1,1,0,0,0,9,7,2,0,2,1,1,7,9,0,0,0,0,0,,,
"Jul 21, 2021 1:00 AM",2,0,2,4,1,3,10,0,10,2,0,2,0,0,0,0,1,1,0,2,2,0,1,5,0,5,0,2,0,0,0,0,0,,,
"Jul 21, 2021 2:00 AM",4,3,1,0,0,0,5,1,4,2,0,2,0,0,0,2,0,0,0,2,2,0,0,0,0,0,1,2,0,0,0,0,0,,,
"Jul 21, 2021 3:00 AM",1,0,1,1,1,0,5,2,3,2,2,0,1,0,1,1,0,0,0,1,0,1,1,0,0,0,2,1,0,0,0,0,0,,,
"Jul 21, 2021 4:00 AM",1,1,0,5,5,0,8,8,0,6,6,0,2,0,2,1,0,0,0,0,0,0,0,0,0,0,2,3,0,0,0,0,0,,,
"Jul 21, 2021 5:00 AM",9,8,1,7,6,1,27,23,4,9,7,2,0,0,0,0,4,4,0,3,3,0,4,3,2,1,13,8,1,1,0,0,0,,,
"Jul 21, 2021 6:00 AM",40,28,12,43,23,20,73,41,32,45,28,17,6,4,2,7,34,33,1,7,5,2,33,8,8,0,28,55,0,3,2,2,0,,,
"Jul 21, 2021 7:00 AM",99,61,38,118,49,69,188,93,95,117,53,64,8,7,1,15,62,62,0,16,14,2,63,32,16,16,61,91,9,10,4,1,3,,,
"Jul 21, 2021 8:00 AM",149,107,42,136,49,87,213,95,118,101,52,49,25,21,4,12,86,84,2,28,18,10,94,28,8,20,78,129,6,6,2,1,1,,,
"Jul 21, 2021 9:00 AM",101,74,27,109,58,51,195,112,83,116,69,47,46,14,32,14,45,45,0,20,16,4,45,33,20,13,72,60,8,3,6,3,3,,,
"Jul 21, 2021 10:00 AM",64,43,21,107,55,52,181,105,76,102,66,36,18,12,6,11,22,22,0,22,18,4,22,30,21,9,64,36,4,1,4,1,3,,,
"Jul 21, 2021 11:00 AM",58,37,21,131,66,65,182,106,76,112,71,41,31,16,15,10,34,34,0,20,20,0,34,47,28,19,50,47,4,4,7,6,1,,,
"Jul 21, 2021 12:00 PM",71,35,36,141,71,70,229,122,107,145,76,69,25,14,11,18,26,26,0,21,18,3,26,58,42,16,64,49,7,6,8,4,4,,,
"Jul 21, 2021 1:00 PM",103,56,47,146,73,73,203,97,106,141,79,62,31,20,11,14,29,29,0,26,25,1,28,38,14,24,61,43,7,4,9,8,1,,,
"Jul 21, 2021 2:00 PM",75,30,45,163,94,69,203,98,105,140,81,59,34,29,5,12,27,26,1,26,22,4,29,55,33,22,71,57,7,4,6,2,4,,,
"Jul 21, 2021 3:00 PM",65,31,34,170,106,64,178,113,65,135,87,48,33,11,22,20,30,29,1,31,30,1,27,33,20,13,77,45,4,5,9,6,3,,,
"Jul 21, 2021 4:00 PM",111,40,71,164,78,86,210,121,89,154,72,82,38,17,21,17,29,27,2,43,42,1,30,63,37,26,85,77,7,5,4,3,1,,,
"Jul 21, 2021 5:00 PM",168,47,121,273,163,110,397,241,156,270,154,116,55,28,27,30,36,36,0,56,50,6,35,112,80,32,159,94,7,10,11,7,4,,,
"Jul 21, 2021 6:00 PM",151,59,92,294,166,128,467,288,179,268,152,116,31,17,14,19,37,36,1,76,75,1,40,159,93,66,195,105,9,9,7,6,1,,,
"Jul 21, 2021 7:00 PM",114,45,69,359,197,162,614,383,231,316,183,133,37,23,14,30,41,41,0,50,46,4,40,155,93,62,201,102,4,8,8,5,3,,,
"Jul 21, 2021 8:00 PM",89,33,56,289,147,142,573,252,321,273,137,136,45,27,18,25,21,21,0,34,32,2,22,157,72,85,123,132,5,2,11,6,5,,,
"Jul 21, 2021 9:00 PM",69,29,40,180,65,115,400,69,331,189,49,140,32,23,9,19,29,28,1,19,18,1,28,118,17,101,37,138,8,5,6,6,0,,,
"Jul 21, 2021 10:00 PM",50,21,29,57,22,35,119,25,94,62,15,47,12,1,11,16,17,16,1,16,16,0,17,76,33,43,25,78,3,2,5,3,2,,,
"Jul 21, 2021 11:00 PM",25,3,22,22,14,8,41,12,29,24,9,15,4,4,0,1,3,3,0,6,6,0,3,7,1,6,9,26,0,1,2,1,1,,,
"Jul 22, 2021 12:00 AM",13,5,8,1,1,0,5,2,3,9,4,5,5,5,0,8,1,1,0,8,8,0,0,5,1,4,6,11,0,0,1,0,1,,,
"Jul 22, 2021 1:00 AM",3,0,3,6,3,3,9,4,5,6,4,2,2,0,2,0,1,1,0,5,5,0,1,0,0,0,2,3,0,1,0,0,0,,,
"Jul 22, 2021 2:00 AM",2,2,0,0,0,0,0,0,0,0,0,0,0,0,0,0,0,0,0,0,0,0,0,0,0,0,0,0,0,0,1,0,1,,,
"Jul 22, 2021 3:00 AM",1,0,1,0,0,0,1,0,1,2,1,1,0,0,0,0,0,0,0,0,0,0,0,1,1,0,0,0,0,0,0,0,0,,,
"Jul 22, 2021 4:00 AM",1,1,0,0,0,0,2,2,0,0,0,0,0,0,0,2,0,0,0,0,0,0,0,0,0,0,1,0,0,0,0,0,0,,,
"Jul 22, 2021 5:00 AM",7,7,0,5,3,2,13,9,4,11,9,2,2,0,2,1,5,5,0,2,2,0,5,2,1,1,4,9,0,0,0,0,0,,,
"Jul 22, 2021 6:00 AM",39,26,13,50,28,22,53,26,27,52,30,22,6,4,2,6,25,24,1,9,6,3,27,18,12,6,25,43,0,1,1,1,0,,,
"Jul 22, 2021 7:00 AM",86,47,39,123,58,65,170,94,76,110,59,51,8,7,1,10,59,59,0,21,21,0,57,41,20,21,64,92,6,8,4,3,1,,,
"Jul 22, 2021 8:00 AM",145,99,46,136,53,83,209,94,115,140,67,73,20,17,3,12,70,68,2,26,18,8,78,56,18,38,49,122,4,5,3,3,0,,,
"Jul 22, 2021 9:00 AM",88,65,23,84,46,38,160,86,74,93,55,38,26,7,19,9,44,44,0,30,22,8,49,44,20,24,51,70,6,7,8,4,4,,,
"Jul 22, 2021 10:00 AM",57,32,25,95,53,42,168,99,69,93,52,41,19,15,4,13,28,28,0,8,6,2,29,27,14,13,57,33,4,3,2,1,1,,,
"Jul 22, 2021 11:00 AM",50,29,21,102,52,50,147,83,64,99,70,29,15,10,5,23,17,17,0,10,9,1,16,48,29,19,44,37,10,0,5,2,3,,,
"Jul 22, 2021 12:00 PM",70,34,36,108,54,54,214,109,105,126,65,61,26,13,13,7,23,22,1,27,24,3,21,57,27,30,51,42,6,7,5,4,1,,,
"Jul 22, 2021 1:00 PM",71,31,40,118,60,58,198,91,107,98,50,48,26,12,14,16,35,35,0,23,21,2,37,60,30,30,43,57,5,4,11,7,4,,,
"Jul 22, 2021 2:00 PM",77,43,34,99,57,42,140,73,67,109,63,46,32,15,17,9,22,21,1,25,24,1,20,56,26,30,55,45,7,2,7,5,2,,,
"Jul 22, 2021 3:00 PM",76,29,47,90,38,52,157,86,71,87,43,44,36,25,11,24,30,29,1,23,20,3,29,44,30,14,63,55,5,3,6,2,4,,,
"Jul 22, 2021 4:00 PM",108,41,67,130,72,58,186,107,79,140,85,55,38,12,26,14,34,33,1,42,37,5,30,59,31,28,86,65,4,4,8,2,6,,,
"Jul 22, 2021 5:00 PM",172,58,114,213,108,105,312,199,113,252,153,99,32,15,17,16,42,41,1,70,67,3,43,76,48,28,135,83,9,7,12,7,5,,,
"Jul 22, 2021 6:00 PM",165,64,101,220,129,91,339,227,112,209,130,79,29,20,9,20,44,43,1,58,57,1,49,109,84,25,140,88,6,8,10,7,3,,,
"Jul 22, 2021 7:00 PM",107,49,58,205,112,93,362,208,154,214,120,94,26,13,13,15,35,35,0,52,49,3,37,104,57,47,132,84,5,8,10,4,6,,,
"Jul 22, 2021 8:00 PM",85,36,49,203,92,111,303,112,191,185,83,102,20,10,10,16,19,18,1,39,34,5,16,96,42,54,68,76,6,4,11,6,5,,,
"Jul 22, 2021 9:00 PM",59,20,39,122,54,68,251,68,183,159,45,114,15,2,13,11,18,18,0,21,20,1,14,67,20,47,29,76,5,4,3,2,1,,,
"Jul 22, 2021 10:00 PM",46,17,29,68,33,35,113,18,95,75,19,56,7,4,3,4,8,8,0,15,14,1,11,40,19,21,25,50,1,0,3,3,0,,,
"Jul 22, 2021 11:00 PM",37,16,21,23,16,7,38,8,30,27,6,21,7,1,6,3,6,6,0,13,13,0,5,22,4,18,6,29,1,3,1,1,0,,,
"Jul 23, 2021 12:00 AM",15,3,12,2,1,1,4,3,1,18,8,10,3,2,1,4,5,5,0,8,8,0,5,6,3,3,3,7,3,0,0,0,0,,,
"Jul 23, 2021 1:00 AM",4,0,4,3,3,0,6,4,2,4,4,0,0,0,0,1,0,0,0,3,3,0,0,2,1,1,7,2,1,1,0,0,0,,,
"Jul 23, 2021 2:00 AM",8,4,4,0,0,0,6,5,1,2,1,1,0,0,0,0,2,2,0,1,1,0,2,4,0,4,1,2,1,0,1,0,1,,,
"Jul 23, 2021 3:00 AM",1,0,1,1,1,0,0,0,0,0,0,0,0,0,0,0,0,0,0,1,1,0,2,0,0,0,1,0,0,0,0,0,0,,,
"Jul 23, 2021 4:00 AM",0,0,0,1,0,1,3,3,0,1,0,1,1,0,1,0,2,2,0,0,0,0,2,2,2,0,2,1,0,1,0,0,0,,,
"Jul 23, 2021 5:00 AM",10,6,4,9,7,2,20,16,4,15,13,2,4,0,4,2,5,5,0,2,2,0,5,5,2,3,6,8,1,0,0,0,0,,,
"Jul 23, 2021 6:00 AM",37,24,13,36,27,9,35,22,13,37,25,12,9,5,4,2,25,24,1,7,6,1,24,11,8,3,19,30,2,3,2,2,0,,,
"Jul 23, 2021 7:00 AM",92,55,37,101,48,53,114,61,53,100,55,45,10,9,1,6,38,38,0,18,13,5,43,34,12,22,52,64,4,6,5,3,2,,,
"Jul 23, 2021 8:00 AM",139,84,55,135,52,83,171,91,80,108,62,46,15,9,6,16,68,66,2,28,22,6,72,41,14,27,47,103,6,5,6,5,1,,,
"Jul 23, 2021 9:00 AM",97,67,30,102,54,48,131,70,61,95,57,38,26,12,14,13,37,37,0,17,13,4,37,33,14,19,47,70,4,6,5,3,2,,,
"Jul 23, 2021 10:00 AM",56,35,21,82,43,39,150,97,53,65,39,26,23,15,8,10,29,27,2,9,7,2,27,57,39,18,45,36,3,4,3,3,0,,,
"Jul 23, 2021 11:00 AM",51,30,21,85,53,32,169,90,79,98,56,42,29,18,11,16,16,16,0,15,10,5,14,51,22,29,43,38,7,5,6,4,2,,,
"Jul 23, 2021 12:00 PM",62,34,28,120,65,55,213,124,89,103,60,43,30,13,17,15,14,14,0,16,16,0,16,64,34,30,57,37,9,5,11,5,6,,,
"Jul 23, 2021 1:00 PM",85,39,46,147,77,70,216,106,110,131,81,50,26,10,16,21,24,23,1,20,17,3,22,81,42,39,51,35,4,3,5,5,0,,,
"Jul 23, 2021 2:00 PM",85,42,43,122,58,64,191,103,88,114,63,51,28,17,11,21,34,34,0,34,28,6,34,67,38,29,52,46,11,4,9,7,2,,,
"Jul 23, 2021 3:00 PM",77,38,39,107,53,54,174,91,83,110,48,62,35,25,10,14,25,24,1,33,29,4,29,65,28,37,61,47,1,7,7,1,6,,,
"Jul 23, 2021 4:00 PM",112,39,73,116,62,54,199,96,103,157,81,76,37,20,17,28,25,24,1,35,31,4,26,64,33,31,68,65,9,7,17,10,7,,,
"Jul 23, 2021 5:00 PM",134,43,91,180,106,74,251,144,107,170,100,70,23,11,12,22,28,27,1,48,47,1,26,95,57,38,103,90,7,6,4,2,2,,,
"Jul 23, 2021 6:00 PM",112,43,69,186,118,68,236,133,103,172,96,76,42,16,26,17,29,27,2,53,51,2,28,68,42,26,101,74,6,7,14,7,7,,,
"Jul 23, 2021 7:00 PM",90,32,58,150,73,77,208,123,85,130,74,56,20,13,7,21,22,22,0,35,32,3,24,72,47,25,72,68,4,4,7,3,4,,,
"Jul 23, 2021 8:00 PM",72,33,39,127,62,65,228,100,128,108,56,52,22,10,12,15,14,14,0,17,16,1,13,62,29,33,58,58,5,2,6,2,4,,,
"Jul 23, 2021 9:00 PM",50,21,29,95,36,59,162,56,106,101,34,67,14,11,3,9,14,13,1,16,13,3,15,54,22,32,34,57,1,2,5,5,0,,,
"Jul 23, 2021 10:00 PM",32,15,17,45,20,25,80,16,64,51,13,38,8,4,4,2,11,10,1,9,8,1,11,29,15,14,16,40,5,8,4,3,1,,,
"Jul 23, 2021 11:00 PM",35,11,24,19,9,10,56,9,47,29,7,22,9,6,3,3,10,10,0,9,7,2,10,23,9,14,7,26,0,1,3,1,2,,,
"Jul 24, 2021 12:00 AM",18,4,14,0,0,0,6,2,4,20,10,10,5,3,2,1,4,4,0,9,9,0,4,5,4,1,9,18,0,0,3,3,0,,,
"Jul 24, 2021 1:00 AM",16,4,12,9,3,6,18,3,15,7,1,6,3,1,2,2,0,0,0,4,3,1,0,9,2,7,4,9,0,0,2,2,0,,,
"Jul 24, 2021 2:00 AM",6,5,1,3,2,1,4,2,2,4,1,3,0,0,0,1,2,2,0,1,1,0,3,2,0,2,4,7,0,0,1,0,1,,,
"Jul 24, 2021 3:00 AM",4,1,3,0,0,0,1,0,1,1,0,1,0,0,0,0,0,0,0,2,2,0,0,0,0,0,0,0,0,0,1,1,0,,,
"Jul 24, 2021 4:00 AM",3,1,2,0,0,0,2,2,0,0,0,0,1,0,1,1,1,1,0,4,3,1,1,0,0,0,1,0,0,0,2,1,1,,,
"Jul 24, 2021 5:00 AM",7,5,2,0,0,0,7,6,1,2,2,0,0,0,0,2,0,0,0,3,2,1,1,2,1,1,5,3,0,0,1,1,0,,,
"Jul 24, 2021 6:00 AM",11,3,8,11,3,8,22,10,12,10,5,5,0,0,0,1,7,6,1,2,1,1,6,2,1,1,10,17,0,1,0,0,0,,,
"Jul 24, 2021 7:00 AM",20,9,11,54,39,15,46,33,13,44,34,10,3,3,0,5,9,9,0,10,8,2,11,12,9,3,21,15,5,4,1,0,1,,,
"Jul 24, 2021 8:00 AM",40,19,21,77,47,30,98,60,38,81,50,31,11,7,4,12,16,16,0,12,9,3,15,33,22,11,33,24,6,8,4,2,2,,,
"Jul 24, 2021 9:00 AM",38,18,20,152,92,60,167,102,65,141,88,53,19,14,5,9,15,15,0,19,17,2,14,53,31,22,57,38,6,8,3,2,1,,,
"Jul 24, 2021 10:00 AM",44,24,20,170,105,65,211,149,62,159,119,40,29,13,16,18,19,18,1,12,11,1,18,54,32,22,75,39,6,4,4,4,0,,,
"Jul 24, 2021 11:00 AM",63,34,29,187,83,104,289,162,127,190,98,92,23,15,8,14,28,28,0,19,12,7,27,76,53,23,85,78,7,8,5,4,1,,,
"Jul 24, 2021 12:00 PM",73,30,43,212,74,138,347,199,148,230,134,96,44,32,12,21,33,30,3,16,12,4,33,128,78,50,103,52,10,10,11,10,1,,,
"Jul 24, 2021 1:00 PM",62,33,29,186,106,80,316,184,132,166,105,61,44,23,21,24,26,26,0,28,23,5,27,114,69,45,82,70,11,7,4,2,2,,,
"Jul 24, 2021 2:00 PM",65,31,34,208,96,112,252,145,107,171,105,66,25,13,12,22,23,23,0,28,25,3,28,79,45,34,82,77,7,5,6,5,1,,,
"Jul 24, 2021 3:00 PM",69,36,33,195,112,83,290,114,176,197,103,94,32,15,17,30,34,33,1,20,18,2,31,106,51,55,62,88,12,6,11,9,2,,,
"Jul 24, 2021 4:00 PM",77,37,40,158,64,94,194,72,122,174,74,100,36,14,22,25,26,26,0,27,24,3,26,82,34,48,58,79,5,5,10,7,3,,,
"Jul 24, 2021 5:00 PM",59,26,33,135,73,62,177,74,103,150,61,89,27,11,16,24,23,21,2,13,13,0,23,63,23,40,46,68,8,5,7,3,4,,,
"Jul 24, 2021 6:00 PM",71,31,40,124,75,49,147,55,92,108,38,70,24,3,21,20,26,24,2,22,19,3,25,41,16,25,41,63,3,5,4,3,1,,,
"Jul 24, 2021 7:00 PM",62,31,31,115,60,55,110,46,64,90,44,46,18,12,6,31,20,20,0,8,7,1,19,41,19,22,38,45,3,5,2,1,1,,,
"Jul 24, 2021 8:00 PM",42,23,19,87,34,53,97,31,66,82,25,57,12,10,2,7,11,11,0,12,8,4,12,39,12,27,14,33,3,2,8,2,6,,,
"Jul 24, 2021 9:00 PM",30,14,16,50,22,28,72,25,47,41,16,25,12,9,3,5,8,8,0,13,12,1,9,19,3,16,12,33,0,2,6,4,2,,,
"Jul 24, 2021 10:00 PM",22,9,13,39,14,25,30,12,18,17,5,12,7,2,5,5,9,9,0,9,9,0,9,18,11,7,10,8,0,2,2,1,1,,,
"Jul 24, 2021 11:00 PM",22,10,12,12,7,5,25,3,22,25,2,23,5,2,3,5,11,10,1,7,7,0,8,7,4,3,6,22,1,1,1,1,0,,,
"Jul 25, 2021 12:00 AM",15,2,13,1,0,1,4,3,1,10,5,5,5,5,0,4,7,6,1,9,9,0,5,5,3,2,7,9,1,0,1,1,0,,,
"Jul 25, 2021 1:00 AM",7,0,7,4,3,1,7,4,3,5,3,2,1,1,0,2,5,5,0,3,3,0,5,0,0,0,5,2,0,1,0,0,0,,,
"Jul 25, 2021 2:00 AM",9,4,5,4,4,0,6,5,1,5,4,1,0,0,0,0,1,1,0,2,2,0,1,0,0,0,2,4,0,0,0,0,0,,,
"Jul 25, 2021 3:00 AM",1,0,1,0,0,0,0,0,0,0,0,0,1,1,0,1,0,0,0,1,1,0,4,0,0,0,1,3,0,1,0,0,0,,,
"Jul 25, 2021 4:00 AM",6,0,6,2,0,2,1,1,0,2,0,2,0,0,0,0,2,2,0,1,1,0,2,1,1,0,0,1,0,0,0,0,0,,,
"Jul 25, 2021 5:00 AM",3,1,2,5,3,2,6,6,0,4,4,0,0,0,0,1,0,0,0,2,2,0,0,0,0,0,4,6,0,0,1,1,0,,,
"Jul 25, 2021 6:00 AM",8,2,6,17,10,7,24,14,10,13,7,6,1,0,1,2,7,7,0,1,1,0,8,6,5,1,8,13,0,1,0,0,0,,,
"Jul 25, 2021 7:00 AM",28,18,10,44,24,20,40,31,9,39,26,13,0,0,0,1,16,16,0,5,5,0,17,27,16,11,19,25,2,2,0,0,0,,,
"Jul 25, 2021 8:00 AM",32,16,16,111,68,43,98,61,37,90,57,33,12,6,6,2,12,12,0,12,11,1,14,36,21,15,31,52,2,9,1,0,1,,,
"Jul 25, 2021 9:00 AM",44,23,21,147,83,64,151,104,47,136,86,50,13,9,4,9,18,18,0,19,16,3,19,46,22,24,64,44,2,11,1,0,1,,,
"Jul 25, 2021 10:00 AM",57,34,23,197,108,89,222,132,90,200,122,78,20,9,11,23,14,14,0,26,25,1,19,63,37,26,82,54,9,8,5,2,3,,,
"Jul 25, 2021 11:00 AM",74,37,37,234,118,116,320,210,110,228,138,90,25,7,18,19,24,24,0,21,16,5,26,89,62,27,81,41,11,2,4,3,1,,,
"Jul 25, 2021 12:00 PM",74,40,34,247,145,102,390,243,147,240,170,70,31,21,10,18,26,25,1,23,18,5,25,144,97,47,102,72,10,11,3,2,1,,,
"Jul 25, 2021 1:00 PM",73,32,41,301,165,136,460,281,179,263,165,98,32,11,21,23,11,11,0,26,24,2,16,162,110,52,138,53,10,5,8,3,5,,,
"Jul 25, 2021 2:00 PM",63,35,28,263,141,122,481,258,223,275,161,114,33,10,23,21,23,23,0,22,19,3,24,176,99,77,133,85,11,6,11,3,8,,,
"Jul 25, 2021 3:00 PM",85,39,46,307,171,136,516,289,227,282,163,119,39,22,17,15,26,26,0,24,23,1,25,150,77,73,105,103,9,6,16,9,7,,,
"Jul 25, 2021 4:00 PM",66,38,28,274,134,140,405,175,230,269,125,144,43,19,24,26,33,32,1,18,15,3,32,130,63,67,78,87,10,5,16,16,0,,,
"Jul 25, 2021 5:00 PM",62,35,27,261,126,135,365,142,223,253,111,142,41,31,10,11,31,29,2,15,15,0,31,125,44,81,58,113,9,5,12,6,6,,,
"Jul 25, 2021 6:00 PM",62,28,34,181,81,100,311,91,220,191,68,123,39,21,18,21,29,26,3,26,22,4,24,103,34,69,53,114,5,4,16,15,1,,,
"Jul 25, 2021 7:00 PM",61,21,40,159,64,95,195,64,131,153,50,103,28,23,5,27,33,32,1,9,6,3,30,81,19,62,30,70,7,5,8,6,2,,,
"Jul 25, 2021 8:00 PM",38,14,24,115,48,67,152,45,107,106,33,73,17,9,8,16,12,12,0,13,13,0,12,49,18,31,23,64,1,3,6,3,3,,,
"Jul 25, 2021 9:00 PM",28,12,16,66,22,44,92,25,67,60,14,46,6,4,2,0,12,12,0,12,10,2,11,49,16,33,19,42,2,2,2,2,0,,,
"Jul 25, 2021 10:00 PM",19,10,9,27,9,18,41,8,33,24,10,14,1,1,0,12,8,8,0,9,9,0,8,19,10,9,10,15,2,1,4,2,2,,,
"Jul 25, 2021 11:00 PM",15,2,13,10,7,3,9,5,4,11,6,5,5,2,3,5,4,4,0,6,6,0,3,3,0,3,6,6,0,3,0,0,0,,,
"Jul 26, 2021 12:00 AM",5,1,4,0,0,0,9,7,2,7,1,6,1,1,0,1,4,4,0,5,5,0,4,6,3,3,4,7,1,1,0,0,0,,,
"Jul 26, 2021 1:00 AM",1,0,1,0,0,0,1,1,0,2,2,0,0,0,0,0,0,0,0,3,2,1,0,0,0,0,0,1,0,1,0,0,0,,,
"Jul 26, 2021 2:00 AM",1,1,0,1,1,0,0,0,0,0,0,0,0,0,0,1,0,0,0,1,1,0,0,0,0,0,0,1,0,0,0,0,0,,,
"Jul 26, 2021 3:00 AM",2,1,1,0,0,0,4,2,2,0,0,0,0,0,0,0,0,0,0,1,1,0,0,0,0,0,2,0,0,0,0,0,0,,,
"Jul 26, 2021 4:00 AM",2,1,1,3,2,1,1,1,0,1,1,0,0,0,0,1,2,2,0,0,0,0,2,0,0,0,1,1,0,0,0,0,0,,,
"Jul 26, 2021 5:00 AM",9,8,1,4,3,1,11,9,2,11,10,1,2,1,1,1,2,2,0,3,2,1,2,2,1,1,5,12,1,0,0,0,0,,,
"Jul 26, 2021 6:00 AM",36,27,9,26,11,15,33,13,20,28,12,16,7,6,1,5,27,27,0,8,7,1,26,7,2,5,17,39,0,0,2,2,0,,,
"Jul 26, 2021 7:00 AM",81,50,31,79,33,46,79,29,50,70,34,36,9,7,2,7,53,53,0,16,14,2,56,15,7,8,35,79,6,4,3,1,2,,,
"Jul 26, 2021 8:00 AM",127,82,45,82,31,51,113,63,50,86,49,37,15,9,6,12,85,83,2,23,15,8,90,43,17,26,54,87,4,3,6,4,2,,,
"Jul 26, 2021 9:00 AM",89,56,33,85,41,44,91,48,43,81,51,30,30,15,15,10,45,44,1,20,15,5,44,35,16,19,38,56,2,6,3,2,1,,,
"Jul 26, 2021 10:00 AM",51,34,17,75,33,42,59,30,29,53,25,28,28,14,14,11,24,24,0,8,6,2,25,22,15,7,18,26,2,3,6,6,0,,,
"Jul 26, 2021 11:00 AM",66,41,25,71,40,31,78,39,39,46,31,15,33,12,21,14,16,15,1,9,7,2,17,36,19,17,34,26,3,2,5,2,3,,,
"Jul 26, 2021 12:00 PM",72,34,38,90,44,46,106,60,46,85,51,34,26,20,6,11,24,24,0,18,18,0,24,36,17,19,34,31,4,3,3,2,1,,,
"Jul 26, 2021 1:00 PM",66,31,35,97,47,50,125,67,58,86,46,40,25,7,18,15,23,22,1,21,20,1,23,47,25,22,26,37,5,2,5,2,3,,,
"Jul 26, 2021 2:00 PM",64,28,36,85,54,31,109,62,47,68,48,20,22,11,11,6,20,20,0,18,17,1,23,34,23,11,25,30,5,4,2,1,1,,,
"Jul 26, 2021 3:00 PM",56,29,27,88,52,36,115,60,55,100,56,44,43,33,10,28,15,13,2,17,15,2,14,37,18,19,34,41,5,2,10,8,2,,,
"Jul 26, 2021 4:00 PM",96,34,62,89,53,36,143,75,68,97,54,43,42,21,21,26,25,25,0,39,39,0,25,48,30,18,52,41,5,4,8,4,4,,,
"Jul 26, 2021 5:00 PM",152,41,111,91,49,42,139,72,67,114,46,68,31,10,21,26,40,40,0,54,52,2,41,54,27,27,89,55,5,6,12,7,5,,,
"Jul 26, 2021 6:00 PM",136,52,84,141,97,44,165,99,66,143,92,51,27,9,18,20,24,24,0,77,70,7,23,41,26,15,98,60,4,7,9,6,3,,,
"Jul 26, 2021 7:00 PM",85,38,47,102,52,50,126,68,58,109,58,51,11,5,6,19,21,21,0,41,38,3,21,51,35,16,55,57,6,6,4,3,1,,,
"Jul 26, 2021 8:00 PM",71,27,44,98,48,50,91,34,57,87,45,42,7,4,3,15,12,12,0,22,21,1,13,35,14,21,29,32,4,8,4,3,1,,,
"Jul 26, 2021 9:00 PM",41,15,26,40,17,23,33,12,21,35,10,25,7,2,5,19,9,8,1,18,17,1,8,14,6,8,15,20,3,4,2,1,1,,,
"Jul 26, 2021 10:00 PM",26,8,18,14,11,3,17,7,10,11,6,5,0,0,0,2,6,6,0,7,6,1,6,2,2,0,6,13,2,5,2,1,1,,,
"Jul 26, 2021 11:00 PM",12,8,4,5,1,4,9,4,5,6,1,5,1,1,0,0,1,1,0,6,6,0,1,5,1,4,6,10,1,1,0,0,0,,,
"Jul 27, 2021 12:00 AM",5,1,4,0,0,0,0,0,0,5,0,5,0,0,0,1,6,6,0,7,6,1,6,1,1,0,1,4,0,1,1,1,0,,,
"Jul 27, 2021 1:00 AM",1,0,1,1,1,0,3,3,0,5,5,0,2,2,0,1,0,0,0,1,1,0,0,3,3,0,2,0,0,0,1,1,0,,,
"Jul 27, 2021 2:00 AM",2,2,0,1,1,0,1,0,1,0,0,0,0,0,0,0,0,0,0,3,3,0,0,0,0,0,0,1,2,0,0,0,0,,,
"Jul 27, 2021 3:00 AM",1,0,1,1,1,0,2,2,0,8,6,2,0,0,0,1,0,0,0,0,0,0,0,0,0,0,0,0,0,0,0,0,0,,,
"Jul 27, 2021 4:00 AM",1,0,1,0,0,0,1,1,0,0,0,0,0,0,0,1,2,2,0,1,1,0,2,0,0,0,2,2,0,0,0,0,0,,,
"Jul 27, 2021 5:00 AM",5,5,0,4,2,2,8,5,3,5,4,1,1,1,0,2,5,5,0,2,2,0,5,4,1,3,3,10,1,0,1,1,0,,,
"Jul 27, 2021 6:00 AM",35,26,9,32,19,13,35,15,20,43,26,17,5,4,1,5,14,13,1,10,8,2,13,9,4,5,18,40,2,3,4,4,0,,,
"Jul 27, 2021 7:00 AM",81,50,31,86,40,46,61,26,35,54,23,31,10,6,4,7,53,53,0,14,10,4,53,24,11,13,41,66,5,5,3,2,1,,,
"Jul 27, 2021 8:00 AM",108,74,34,90,27,63,97,44,53,82,35,47,18,15,3,16,78,77,1,23,19,4,82,38,16,22,40,88,3,6,7,5,2,,,
"Jul 27, 2021 9:00 AM",73,52,21,80,29,51,65,39,26,56,40,16,31,19,12,10,39,39,0,23,17,6,42,42,18,24,29,46,5,1,8,4,4,,,
"Jul 27, 2021 10:00 AM",57,36,21,79,44,35,92,63,29,70,49,21,15,8,7,10,21,21,0,16,13,3,21,28,19,9,29,26,2,3,1,0,1,,,
"Jul 27, 2021 11:00 AM",49,27,22,88,45,43,92,51,41,83,45,38,28,11,17,16,23,23,0,17,15,2,24,27,13,14,22,29,3,0,4,1,3,,,
"Jul 27, 2021 12:00 PM",69,37,32,84,38,46,105,49,56,71,30,41,19,8,11,24,21,20,1,25,19,6,22,30,21,9,35,34,2,3,8,4,4,,,
"Jul 27, 2021 1:00 PM",69,37,32,112,56,56,116,61,55,65,36,29,27,13,14,22,18,16,2,11,10,1,19,42,20,22,38,43,7,2,6,2,4,,,
"Jul 27, 2021 2:00 PM",60,28,32,48,28,20,119,57,62,64,32,32,15,7,8,15,22,22,0,19,16,3,24,43,25,18,29,34,11,1,5,4,1,,,
"Jul 27, 2021 3:00 PM",75,35,40,53,26,27,64,36,28,50,31,19,14,8,6,12,27,27,0,27,25,2,27,29,13,16,32,34,1,1,2,1,1,,,
"Jul 27, 2021 4:00 PM",89,32,57,52,34,18,88,50,38,47,25,22,20,8,12,17,23,20,3,31,30,1,19,22,15,7,61,29,4,1,5,4,1,,,
"Jul 27, 2021 5:00 PM",97,23,74,78,49,29,98,54,44,71,41,30,24,8,16,11,26,26,0,49,47,2,26,28,17,11,63,55,1,2,6,3,3,,,
"Jul 27, 2021 6:00 PM",93,28,65,30,20,10,53,31,22,31,16,15,7,2,5,5,14,13,1,47,45,2,13,28,19,9,46,31,6,5,4,4,0,,,
"Jul 27, 2021 7:00 PM",51,17,34,36,24,12,38,26,12,38,30,8,9,4,5,11,12,11,1,22,21,1,9,12,7,5,34,17,0,0,6,2,4,,,
"Jul 27, 2021 8:00 PM",38,15,23,22,18,4,25,11,14,24,13,11,4,2,2,3,7,7,0,21,20,1,8,12,7,5,16,15,1,0,0,0,0,,,
"Jul 27, 2021 9:00 PM",34,15,19,39,21,18,23,10,13,22,7,15,5,2,3,2,12,11,1,15,15,0,10,8,2,6,7,7,1,0,5,4,1,,,
"Jul 27, 2021 10:00 PM",13,4,9,15,9,6,11,4,7,11,3,8,6,3,3,0,6,6,0,10,8,2,6,3,1,2,9,11,3,1,2,1,1,,,
"Jul 27, 2021 11:00 PM",8,4,4,4,3,1,10,7,3,12,6,6,0,0,0,0,2,2,0,10,10,0,2,5,2,3,3,6,0,0,0,0,0,,,
"Jul 28, 2021 12:00 AM",7,1,6,0,0,0,2,1,1,1,0,1,0,0,0,1,0,0,0,2,2,0,0,2,1,1,3,2,2,4,3,3,0,,,
"Jul 28, 2021 1:00 AM",3,0,3,3,2,1,3,1,2,1,0,1,1,1,0,0,1,1,0,3,2,1,1,0,0,0,3,1,0,0,0,0,0,,,
"Jul 28, 2021 2:00 AM",5,4,1,1,0,1,0,0,0,0,0,0,0,0,0,0,0,0,0,1,1,0,0,0,0,0,0,1,0,0,0,0,0,,,
"Jul 28, 2021 3:00 AM",2,0,2,0,0,0,1,1,0,0,0,0,0,0,0,0,0,0,0,1,1,0,0,0,0,0,2,0,0,0,0,0,0,,,
"Jul 28, 2021 4:00 AM",2,0,2,0,0,0,2,2,0,1,1,0,0,0,0,1,0,0,0,0,0,0,0,0,0,0,1,0,0,0,1,1,0,,,
"Jul 28, 2021 5:00 AM",7,6,1,6,5,1,11,9,2,8,7,1,2,0,2,1,7,7,0,1,1,0,7,4,3,1,5,6,0,0,0,0,0,,,
"Jul 28, 2021 6:00 AM",29,21,8,21,7,14,28,12,16,18,7,11,2,2,0,6,18,17,1,8,6,2,16,3,3,0,12,28,0,0,1,1,0,,,
"Jul 28, 2021 7:00 AM",43,22,21,50,22,28,39,11,28,38,18,20,3,3,0,5,34,34,0,6,5,1,35,12,6,6,25,59,3,5,3,2,1,,,
"Jul 28, 2021 8:00 AM",87,61,26,41,12,29,53,27,26,47,22,25,6,4,2,5,64,63,1,24,15,9,65,20,11,9,30,55,1,2,1,1,0,,,
"Jul 28, 2021 9:00 AM",68,54,14,11,4,7,35,17,18,41,26,15,16,10,6,12,26,26,0,16,12,4,28,18,8,10,35,44,3,2,3,3,0,,,
"Jul 28, 2021 10:00 AM",53,39,14,45,25,20,57,32,25,52,32,20,18,14,4,5,19,19,0,9,7,2,22,21,14,7,16,22,0,1,2,2,0,,,
"Jul 28, 2021 11:00 AM",37,16,21,37,15,22,44,26,18,43,24,19,16,8,8,6,16,16,0,14,12,2,17,22,11,11,18,32,3,4,3,3,0,,,
"Jul 28, 2021 12:00 PM",31,15,16,58,33,25,58,28,30,50,23,27,17,6,11,9,16,15,1,10,10,0,16,19,12,7,22,17,0,3,4,2,2,,,
"Jul 28, 2021 1:00 PM",27,12,15,33,13,20,32,20,12,33,18,15,12,9,3,7,16,15,1,14,12,2,17,5,4,1,17,20,4,3,2,0,2,,,
"Jul 28, 2021 2:00 PM",27,13,14,37,16,21,52,19,33,31,15,16,12,10,2,16,17,17,0,21,18,3,16,8,6,2,18,21,4,1,8,6,2,,,
"Jul 28, 2021 3:00 PM",43,24,19,29,18,11,44,26,18,29,15,14,10,3,7,12,8,8,0,12,11,1,7,18,13,5,15,25,0,3,1,0,1,,,
"Jul 28, 2021 4:00 PM",68,32,36,40,27,13,53,29,24,49,27,22,15,4,11,18,12,12,0,17,15,2,13,33,17,16,31,21,5,3,1,0,1,,,
"Jul 28, 2021 5:00 PM",107,27,80,63,43,20,56,32,24,47,29,18,20,8,12,15,23,23,0,32,32,0,22,18,12,6,51,30,0,2,2,2,0,,,
"Jul 28, 2021 6:00 PM",78,32,46,53,32,21,72,39,33,47,28,19,12,7,5,16,13,13,0,36,31,5,15,25,19,6,51,39,3,6,4,0,4,,,
"Jul 28, 2021 7:00 PM",65,23,42,33,21,12,54,36,18,56,37,19,12,9,3,9,15,15,0,29,27,2,16,21,13,8,33,26,3,3,3,3,0,,,
"Jul 28, 2021 8:00 PM",58,22,36,69,45,24,67,35,32,51,33,18,10,3,7,14,12,12,0,27,22,5,11,20,10,10,36,25,3,0,8,5,3,,,
"Jul 28, 2021 9:00 PM",40,9,31,27,13,14,39,13,26,30,9,21,7,4,3,8,6,6,0,17,16,1,6,8,4,4,11,19,3,2,3,2,1,,,
"Jul 28, 2021 10:00 PM",26,3,23,11,8,3,23,9,14,21,9,12,0,0,0,8,4,4,0,12,12,0,5,8,4,4,12,12,1,0,1,1,0,,,
"Jul 28, 2021 11:00 PM",11,4,7,1,1,0,4,1,3,4,1,3,3,0,3,4,3,3,0,6,6,0,5,0,0,0,5,2,1,0,4,3,1,,,
"Jul 29, 2021 12:00 AM",6,0,6,0,0,0,1,0,1,2,0,2,3,3,0,1,1,1,0,6,6,0,2,1,0,1,3,4,0,0,0,0,0,,,
"Jul 29, 2021 1:00 AM",5,1,4,1,1,0,1,0,1,1,1,0,1,0,1,1,0,0,0,2,1,1,0,0,0,0,1,2,0,1,0,0,0,,,
"Jul 29, 2021 2:00 AM",2,2,0,1,0,1,0,0,0,1,0,1,0,0,0,0,0,0,0,2,2,0,0,0,0,0,1,1,0,1,0,0,0,,,
"Jul 29, 2021 3:00 AM",2,1,1,1,0,1,1,0,1,1,0,1,0,0,0,1,0,0,0,0,0,0,1,0,0,0,0,0,0,0,1,0,1,,,
"Jul 29, 2021 4:00 AM",0,0,0,0,0,0,0,0,0,0,0,0,0,0,0,1,0,0,0,0,0,0,0,0,0,0,1,0,0,0,1,1,0,,,
"Jul 29, 2021 5:00 AM",5,5,0,3,3,0,9,7,2,7,6,1,3,3,0,0,3,3,0,1,1,0,4,5,1,4,3,8,0,0,0,0,0,,,
"Jul 29, 2021 6:00 AM",33,25,8,26,12,14,37,17,20,31,17,14,7,5,2,3,21,20,1,7,6,1,19,10,5,5,16,33,0,2,3,2,1,,,
"Jul 29, 2021 7:00 AM",71,39,32,65,35,30,77,42,35,62,34,28,8,7,1,9,47,47,0,16,14,2,50,21,14,7,36,68,3,7,2,1,1,,,
"Jul 29, 2021 8:00 AM",115,78,37,80,22,58,97,42,55,83,41,42,14,10,4,13,64,63,1,19,12,7,69,34,15,19,38,84,4,4,6,5,1,,,
"Jul 29, 2021 9:00 AM",74,53,21,70,36,34,66,42,24,68,50,18,30,18,12,4,52,52,0,26,20,6,55,26,10,16,31,51,0,8,3,2,1,,,
"Jul 29, 2021 10:00 AM",60,46,14,57,34,23,59,36,23,67,41,26,9,8,1,12,34,32,2,16,10,6,33,15,11,4,22,27,8,4,3,2,1,,,
"Jul 29, 2021 11:00 AM",51,23,28,64,31,33,65,33,32,59,30,29,21,14,7,15,20,19,1,14,14,0,17,17,8,9,25,30,7,2,2,2,0,,,
"Jul 29, 2021 12:00 PM",55,27,28,86,47,39,91,52,39,59,33,26,24,12,12,10,24,24,0,18,16,2,25,32,24,8,30,32,3,9,6,3,3,,,
"Jul 29, 2021 1:00 PM",68,35,33,85,51,34,108,66,42,83,61,22,27,11,16,13,14,14,0,19,17,2,13,50,32,18,36,22,5,2,8,5,3,,,
"Jul 29, 2021 2:00 PM",65,31,34,74,34,40,112,58,54,73,37,36,25,13,12,16,22,21,1,19,15,4,26,48,22,26,22,31,13,4,8,6,2,,,
"Jul 29, 2021 3:00 PM",77,33,44,69,40,29,105,56,49,74,38,36,25,15,10,14,22,21,1,20,16,4,20,34,21,13,40,39,2,5,2,2,0,,,
"Jul 29, 2021 4:00 PM",108,46,62,112,68,44,123,59,64,90,48,42,21,6,15,25,35,35,0,34,31,3,34,40,16,24,41,27,8,6,9,5,4,,,
"Jul 29, 2021 5:00 PM",161,50,111,145,55,90,191,115,76,141,91,50,31,13,18,27,38,37,1,50,48,2,38,67,36,31,91,71,6,12,9,7,2,,,
"Jul 29, 2021 6:00 PM",153,66,87,132,81,51,173,93,80,140,70,70,24,7,17,16,39,39,0,51,49,2,38,56,30,26,84,65,3,11,3,2,1,,,
"Jul 29, 2021 7:00 PM",95,40,55,91,65,26,124,66,58,91,52,39,18,9,9,18,19,19,0,36,33,3,17,52,31,21,59,32,11,1,6,4,2,,,
"Jul 29, 2021 8:00 PM",70,26,44,93,58,35,96,42,54,83,36,47,33,8,25,6,18,17,1,21,19,2,20,38,15,23,47,38,6,3,1,1,0,,,
"Jul 29, 2021 9:00 PM",51,19,32,35,17,18,54,16,38,40,15,25,7,3,4,6,14,14,0,20,20,0,13,16,5,11,18,27,2,4,6,4,2,,,
"Jul 29, 2021 10:00 PM",16,6,10,19,9,10,29,14,15,21,8,13,5,2,3,4,4,4,0,15,14,1,3,4,4,0,20,12,1,2,6,4,2,,,
"Jul 29, 2021 11:00 PM",24,10,14,8,4,4,11,3,8,13,4,9,3,3,0,1,4,2,2,11,11,0,4,7,1,6,6,7,2,0,0,0,0,,,
"Jul 30, 2021 12:00 AM",19,3,16,1,0,1,1,0,1,5,0,5,7,7,0,1,3,2,1,3,3,0,3,1,0,1,3,4,2,0,0,0,0,,,
"Jul 30, 2021 1:00 AM",3,0,3,2,2,0,1,0,1,0,0,0,1,0,1,0,1,1,0,1,1,0,1,1,1,0,3,3,0,1,1,1,0,,,
"Jul 30, 2021 2:00 AM",1,0,1,2,0,2,0,0,0,0,0,0,0,0,0,0,1,1,0,0,0,0,1,0,0,0,1,1,0,0,0,0,0,,,
"Jul 30, 2021 3:00 AM",1,0,1,0,0,0,1,1,0,0,0,0,0,0,0,2,0,0,0,0,0,0,0,1,1,0,1,0,0,0,1,0,1,,,
"Jul 30, 2021 4:00 AM",1,0,1,0,0,0,0,0,0,0,0,0,0,0,0,0,1,1,0,1,1,0,1,1,0,1,0,0,0,0,0,0,0,,,
"Jul 30, 2021 5:00 AM",5,5,0,8,8,0,10,9,1,11,10,1,0,0,0,0,6,5,1,1,1,0,5,2,1,1,4,6,0,0,0,0,0,,,
"Jul 30, 2021 6:00 AM",21,18,3,11,2,9,8,4,4,6,3,3,1,1,0,6,7,6,1,4,3,1,6,3,2,1,7,19,0,1,0,0,0,,,
"Jul 30, 2021 7:00 AM",42,27,15,13,3,10,13,3,10,8,2,6,3,3,0,5,21,21,0,7,4,3,26,3,1,2,15,32,2,5,3,2,1,,,
"Jul 30, 2021 8:00 AM",42,24,18,18,3,15,18,8,10,13,5,8,5,2,3,2,28,28,0,16,9,7,32,5,2,3,9,28,0,1,3,3,0,,,
"Jul 30, 2021 9:00 AM",34,28,6,10,3,7,13,8,5,10,6,4,8,7,1,3,8,8,0,15,9,6,11,5,3,2,15,13,2,2,2,0,2,,,
"Jul 30, 2021 10:00 AM",28,20,8,14,8,6,15,8,7,9,3,6,4,3,1,5,11,11,0,4,2,2,11,3,2,1,8,16,0,0,3,2,1,,,
"Jul 30, 2021 11:00 AM",20,16,4,20,10,10,20,11,9,16,10,6,4,4,0,5,5,5,0,5,4,1,3,5,3,2,9,13,3,1,3,1,2,,,
"Jul 30, 2021 12:00 PM",39,18,21,24,14,10,39,25,14,30,18,12,5,2,3,9,15,13,2,4,4,0,14,11,7,4,19,16,2,0,6,3,3,,,
"Jul 30, 2021 1:00 PM",46,16,30,38,21,17,35,18,17,35,21,14,13,6,7,7,12,12,0,13,11,2,10,8,3,5,20,15,3,3,4,4,0,,,
"Jul 30, 2021 2:00 PM",39,25,14,39,18,21,40,21,19,35,16,19,18,12,6,8,8,8,0,14,11,3,9,13,8,5,18,32,4,5,4,3,1,,,
"Jul 30, 2021 3:00 PM",41,23,18,49,23,26,39,25,14,41,24,17,12,11,1,3,17,17,0,20,19,1,18,16,5,11,24,15,4,3,4,2,2,,,
"Jul 30, 2021 4:00 PM",46,14,32,38,22,16,59,31,28,49,26,23,20,6,14,11,17,17,0,19,18,1,18,20,10,10,38,23,2,0,5,3,2,,,
"Jul 30, 2021 5:00 PM",63,18,45,48,31,17,55,25,30,37,21,16,13,6,7,13,17,16,1,25,24,1,14,13,8,5,22,29,5,0,3,3,0,,,
"Jul 30, 2021 6:00 PM",57,24,33,22,15,7,39,27,12,27,17,10,8,3,5,4,10,8,2,18,17,1,7,17,9,8,30,13,4,2,1,0,1,,,
"Jul 30, 2021 7:00 PM",31,10,21,14,2,12,23,10,13,12,5,7,2,1,1,3,9,9,0,13,10,3,9,3,2,1,19,16,1,0,3,2,1,,,
"Jul 30, 2021 8:00 PM",19,6,13,14,11,3,21,9,12,16,7,9,11,5,6,11,4,3,1,4,4,0,5,8,6,2,6,8,4,2,5,3,2,,,
"Jul 30, 2021 9:00 PM",13,5,8,7,6,1,13,6,7,13,8,5,4,0,4,4,10,10,0,6,6,0,10,5,1,4,8,10,0,1,2,1,1,,,
"Jul 30, 2021 10:00 PM",11,6,5,11,10,1,8,5,3,7,6,1,2,2,0,1,2,2,0,6,6,0,2,2,0,2,8,5,2,2,3,1,2,,,
"Jul 30, 2021 11:00 PM",8,4,4,9,4,5,9,3,6,13,3,10,4,3,1,3,2,2,0,4,4,0,2,2,1,1,3,7,0,0,0,0,0,,,
"Jul 31, 2021 12:00 AM",16,4,12,0,0,0,5,2,3,7,3,4,3,3,0,2,5,5,0,4,4,0,5,3,0,3,6,3,2,0,2,0,2,,,
"Jul 31, 2021 1:00 AM",6,3,3,1,0,1,1,0,1,1,0,1,0,0,0,0,2,2,0,1,0,1,2,0,0,0,4,1,0,0,0,0,0,,,
"Jul 31, 2021 2:00 AM",2,2,0,4,2,2,4,2,2,5,2,3,0,0,0,1,0,0,0,2,1,1,0,0,0,0,3,1,0,0,1,0,1,,,
"Jul 31, 2021 3:00 AM",1,0,1,0,0,0,0,0,0,4,4,0,0,0,0,0,0,0,0,0,0,0,0,0,0,0,1,1,0,0,0,0,0,,,
"Jul 31, 2021 4:00 AM",1,0,1,4,3,1,0,0,0,0,0,0,0,0,0,0,0,0,0,0,0,0,0,0,0,0,0,0,0,0,0,0,0,,,
"Jul 31, 2021 5:00 AM",3,1,2,0,0,0,2,1,1,2,2,0,0,0,0,1,2,2,0,0,0,0,2,0,0,0,1,3,0,0,0,0,0,,,
"Jul 31, 2021 6:00 AM",8,3,5,9,6,3,15,9,6,14,7,7,0,0,0,2,6,5,1,0,0,0,5,3,2,1,7,12,1,0,0,0,0,,,
"Jul 31, 2021 7:00 AM",20,10,10,26,15,11,32,24,8,29,20,9,8,4,4,2,9,9,0,4,2,2,9,12,10,2,24,15,1,2,1,1,0,,,
"Jul 31, 2021 8:00 AM",29,12,17,53,37,16,77,48,29,49,29,20,7,5,2,6,13,13,0,11,8,3,15,17,9,8,15,17,0,2,1,0,1,,,
"Jul 31, 2021 9:00 AM",36,19,17,91,53,38,84,54,30,97,63,34,7,7,0,6,21,20,1,9,7,2,19,24,13,11,33,22,3,6,6,5,1,,,
"Jul 31, 2021 10:00 AM",51,25,26,107,54,53,102,51,51,86,50,36,29,18,11,7,22,22,0,10,8,2,22,28,18,10,44,32,4,10,5,2,3,,,
"Jul 31, 2021 11:00 AM",51,32,19,122,74,48,125,74,51,117,79,38,29,13,16,16,15,15,0,14,13,1,15,52,29,23,55,37,4,3,6,3,3,,,
"Jul 31, 2021 12:00 PM",44,20,24,136,58,78,109,57,52,108,62,46,32,16,16,15,15,15,0,16,16,0,15,33,20,13,40,42,5,3,5,2,3,,,
"Jul 31, 2021 1:00 PM",51,24,27,108,53,55,97,52,45,104,60,44,34,16,18,21,14,13,1,13,13,0,14,39,22,17,34,36,1,3,4,3,1,,,
"Jul 31, 2021 2:00 PM",57,29,28,104,48,56,114,51,63,112,51,61,34,13,21,15,23,21,2,14,13,1,21,29,11,18,31,25,7,4,11,9,2,,,
"Jul 31, 2021 3:00 PM",50,27,23,103,49,54,110,52,58,92,45,47,22,13,9,13,15,14,1,13,11,2,17,47,26,21,40,37,2,3,2,0,2,,,
"Jul 31, 2021 4:00 PM",43,29,14,88,47,41,103,56,47,86,37,49,31,12,19,10,17,17,0,20,18,2,16,38,17,21,25,29,10,9,3,2,1,,,
"Jul 31, 2021 5:00 PM",43,20,23,68,37,31,91,39,52,76,32,44,21,13,8,9,9,9,0,11,11,0,11,32,11,21,26,31,3,0,5,4,1,,,
"Jul 31, 2021 6:00 PM",32,17,15,39,22,17,53,22,31,31,13,18,9,4,5,12,7,7,0,11,11,0,7,16,5,11,18,26,6,7,8,3,5,,,
"Jul 31, 2021 7:00 PM",41,24,17,39,17,22,51,18,33,28,9,19,9,4,5,9,10,10,0,14,9,5,10,18,3,15,15,17,1,2,4,2,2,,,
"Jul 31, 2021 8:00 PM",34,17,17,18,8,10,25,7,18,21,7,14,5,1,4,7,6,6,0,8,7,1,7,9,2,7,10,19,3,1,7,5,2,,,
"Jul 31, 2021 9:00 PM",18,7,11,9,3,6,18,7,11,22,10,12,7,6,1,5,6,6,0,6,6,0,5,5,2,3,7,8,2,2,5,1,4,,,
"Jul 31, 2021 10:00 PM",15,5,10,19,13,6,9,6,3,25,16,9,3,1,2,2,3,3,0,1,1,0,2,1,1,0,5,7,2,0,1,0,1,,,
"Jul 31, 2021 11:00 PM",13,5,8,5,3,2,5,2,3,5,2,3,1,0,1,0,2,2,0,3,3,0,4,1,0,1,5,7,0,0,0,0,0,,,
"Aug 1, 2021 12:00 AM",13,3,10,0,0,0,0,0,0,2,1,1,1,0,1,1,6,6,0,3,3,0,6,2,2,0,3,4,2,0,0,0,0,,,
"Aug 1, 2021 1:00 AM",8,2,6,1,0,1,3,1,2,1,0,1,2,1,1,1,3,3,0,2,2,0,2,0,0,0,1,5,0,0,0,0,0,,,
"Aug 1, 2021 2:00 AM",4,3,1,4,1,3,1,1,0,4,1,3,0,0,0,3,0,0,0,1,1,0,0,0,0,0,3,1,0,0,0,0,0,,,
"Aug 1, 2021 3:00 AM",0,0,0,1,1,0,1,1,0,1,1,0,0,0,0,2,0,0,0,0,0,0,0,0,0,0,1,0,0,0,0,0,0,,,
"Aug 1, 2021 4:00 AM",3,1,2,0,0,0,1,0,1,0,0,0,0,0,0,0,1,1,0,0,0,0,1,1,1,0,1,0,0,0,0,0,0,,,
"Aug 1, 2021 5:00 AM",3,0,3,2,2,0,3,3,0,2,2,0,0,0,0,1,1,1,0,0,0,0,1,0,0,0,4,2,0,0,0,0,0,,,
"Aug 1, 2021 6:00 AM",12,8,4,4,1,3,10,6,4,7,3,4,0,0,0,1,2,2,0,4,4,0,2,3,2,1,6,10,0,0,1,1,0,,,
"Aug 1, 2021 7:00 AM",16,9,7,39,23,16,42,28,14,41,27,14,4,2,2,4,12,12,0,7,6,1,12,8,5,3,20,15,1,3,0,0,0,,,
"Aug 1, 2021 8:00 AM",25,8,17,63,40,23,73,49,24,74,50,24,5,5,0,19,7,6,1,6,6,0,5,17,10,7,16,17,1,9,2,0,2,,,
"Aug 1, 2021 9:00 AM",30,11,19,112,67,45,98,57,41,96,63,33,12,2,10,10,9,9,0,10,9,1,10,33,20,13,27,22,3,7,3,1,2,,,
"Aug 1, 2021 10:00 AM",44,24,20,117,58,59,110,59,51,91,48,43,26,17,9,10,17,17,0,9,7,2,18,39,24,15,40,41,7,3,9,4,5,,,
"Aug 1, 2021 11:00 AM",46,27,19,141,72,69,160,107,53,163,94,69,23,12,11,13,25,25,0,11,11,0,26,53,36,17,50,53,10,6,4,3,1,,,
"Aug 1, 2021 12:00 PM",57,30,27,155,65,90,162,82,80,141,84,57,28,13,15,17,26,26,0,21,16,5,29,52,25,27,54,33,4,11,10,5,5,,,
"Aug 1, 2021 1:00 PM",68,39,29,168,99,69,182,100,82,150,94,56,19,13,6,25,17,17,0,28,26,2,20,84,47,37,62,48,9,4,5,3,2,,,
"Aug 1, 2021 2:00 PM",56,27,29,158,95,63,178,105,73,163,101,62,22,8,14,32,25,25,0,15,13,2,24,76,47,29,52,52,9,5,4,3,1,,,
"Aug 1, 2021 3:00 PM",61,27,34,214,113,101,159,85,74,160,89,71,34,21,13,14,28,25,3,25,24,1,26,60,31,29,54,42,5,7,6,3,3,,,
"Aug 1, 2021 4:00 PM",45,18,27,172,85,87,169,73,96,178,83,95,28,16,12,18,27,27,0,17,17,0,29,60,29,31,37,38,3,4,7,5,2,,,
"Aug 1, 2021 5:00 PM",35,14,21,167,82,85,149,69,80,130,57,73,24,10,14,14,25,25,0,21,18,3,22,85,31,54,31,51,8,3,1,0,1,,,
"Aug 1, 2021 6:00 PM",59,29,30,124,53,71,154,62,92,123,42,81,24,11,13,14,14,11,3,21,20,1,11,50,23,27,36,46,3,2,8,7,1,,,
"Aug 1, 2021 7:00 PM",53,28,25,92,39,53,120,49,71,72,32,40,24,13,11,9,21,19,2,12,10,2,15,52,24,28,28,33,5,2,9,5,4,,,
"Aug 1, 2021 8:00 PM",39,14,25,54,27,27,68,26,42,51,20,31,10,8,2,7,7,7,0,15,12,3,7,29,9,20,16,33,5,3,5,3,2,,,
"Aug 1, 2021 9:00 PM",32,15,17,51,25,26,44,15,29,40,19,21,12,8,4,3,8,8,0,6,6,0,7,18,7,11,8,23,1,2,1,1,0,,,
"Aug 1, 2021 10:00 PM",10,6,4,18,7,11,15,4,11,18,10,8,2,1,1,6,3,3,0,9,9,0,4,12,4,8,11,14,0,4,2,0,2,,,
"Aug 1, 2021 11:00 PM",17,8,9,8,4,4,14,2,12,14,2,12,2,0,2,4,7,6,1,0,0,0,6,2,2,0,3,11,0,0,1,1,0,,,
"Aug 2, 2021 12:00 AM",8,2,6,0,0,0,2,1,1,3,0,3,0,0,0,1,7,7,0,2,2,0,4,3,2,1,3,0,1,0,0,0,0,,,
"Aug 2, 2021 1:00 AM",4,2,2,2,0,2,2,0,2,2,0,2,1,1,0,0,1,1,0,3,3,0,1,2,1,1,1,4,0,1,0,0,0,,,
"Aug 2, 2021 2:00 AM",3,2,1,0,0,0,0,0,0,1,1,0,0,0,0,1,1,1,0,1,1,0,1,0,0,0,0,1,0,0,0,0,0,,,
"Aug 2, 2021 3:00 AM",0,0,0,0,0,0,1,1,0,0,0,0,0,0,0,2,0,0,0,2,2,0,0,1,1,0,1,1,0,0,1,1,0,,,
"Aug 2, 2021 4:00 AM",1,0,1,0,0,0,2,0,2,0,0,0,0,0,0,1,0,0,0,0,0,0,0,2,0,2,0,1,0,0,0,0,0,,,
"Aug 2, 2021 5:00 AM",4,2,2,0,0,0,5,5,0,4,4,0,0,0,0,0,1,1,0,0,0,0,1,0,0,0,5,6,0,0,0,0,0,,,
"Aug 2, 2021 6:00 AM",12,7,5,11,7,4,10,7,3,7,3,4,0,0,0,3,5,4,1,3,3,0,4,3,3,0,3,9,0,2,0,0,0,,,
"Aug 2, 2021 7:00 AM",19,12,7,44,23,21,35,25,10,32,21,11,4,4,0,4,13,13,0,6,6,0,16,11,6,5,18,19,2,0,2,1,1,,,
"Aug 2, 2021 8:00 AM",32,14,18,72,36,36,78,40,38,68,35,33,4,3,1,14,9,9,0,9,6,3,10,20,12,8,10,27,2,0,0,0,0,,,
"Aug 2, 2021 9:00 AM",43,19,24,100,58,42,109,66,43,91,58,33,9,7,2,17,22,22,0,14,11,3,20,34,21,13,38,21,0,7,5,5,0,,,
"Aug 2, 2021 10:00 AM",50,27,23,100,57,43,131,74,57,111,67,44,24,17,7,15,23,23,0,26,21,5,27,28,15,13,34,51,2,9,5,4,1,,,
"Aug 2, 2021 11:00 AM",53,32,21,167,77,90,150,75,75,160,95,65,23,16,7,22,22,22,0,21,20,1,24,48,28,20,43,46,4,6,7,6,1,,,
"Aug 2, 2021 12:00 PM",63,35,28,177,79,98,172,76,96,151,76,75,31,14,17,28,21,21,0,17,15,2,20,53,25,28,51,47,12,9,10,4,6,,,
"Aug 2, 2021 1:00 PM",62,28,34,105,57,48,123,58,65,128,64,64,34,19,15,11,19,18,1,14,9,5,23,56,27,29,46,38,7,4,13,7,6,,,
"Aug 2, 2021 2:00 PM",51,27,24,112,52,60,111,52,59,100,50,50,19,6,13,28,25,25,0,16,10,6,24,52,30,22,35,47,7,7,3,3,0,,,
"Aug 2, 2021 3:00 PM",50,28,22,106,71,35,114,67,47,106,68,38,22,13,9,20,25,25,0,19,18,1,27,39,27,12,34,35,3,0,4,3,1,,,
"Aug 2, 2021 4:00 PM",42,16,26,103,51,52,94,43,51,98,52,46,30,16,14,23,26,26,0,20,17,3,24,31,18,13,29,39,5,2,6,3,3,,,
"Aug 2, 2021 5:00 PM",69,30,39,123,64,59,135,62,73,96,38,58,20,10,10,35,24,24,0,15,15,0,23,41,18,23,35,37,4,2,9,4,5,,,
"Aug 2, 2021 6:00 PM",62,29,33,91,50,41,105,53,52,87,41,46,21,8,13,13,17,17,0,11,11,0,15,35,22,13,36,35,3,1,4,2,2,,,
"Aug 2, 2021 7:00 PM",45,24,21,60,30,30,80,43,37,64,35,29,15,7,8,16,8,8,0,15,11,4,8,25,9,16,19,23,4,0,4,4,0,,,
"Aug 2, 2021 8:00 PM",37,11,26,85,43,42,82,35,47,68,30,38,12,5,7,11,13,11,2,10,10,0,10,24,13,11,22,23,2,2,2,1,1,,,
"Aug 2, 2021 9:00 PM",23,9,14,28,14,14,34,8,26,30,12,18,9,5,4,8,7,7,0,6,6,0,7,7,3,4,7,21,1,0,0,0,0,,,
"Aug 2, 2021 10:00 PM",10,3,7,21,11,10,13,4,9,14,5,9,1,0,1,3,1,1,0,6,6,0,2,8,3,5,11,2,1,0,1,0,1,,,
"Aug 2, 2021 11:00 PM",18,5,13,7,4,3,6,3,3,4,3,1,7,3,4,5,3,3,0,4,4,0,3,2,1,1,5,12,0,0,2,2,0,,,
"Aug 3, 2021 12:00 AM",6,1,5,0,0,0,1,0,1,4,1,3,5,3,2,1,1,1,0,4,4,0,1,0,0,0,3,3,1,0,0,0,0,,,
"Aug 3, 2021 1:00 AM",2,1,1,1,0,1,2,0,2,0,0,0,1,1,0,1,0,0,0,3,2,1,1,1,0,1,1,2,0,0,0,0,0,,,
"Aug 3, 2021 2:00 AM",4,3,1,0,0,0,1,0,1,1,0,1,0,0,0,0,0,0,0,0,0,0,0,0,0,0,0,0,0,0,0,0,0,,,
"Aug 3, 2021 3:00 AM",0,0,0,1,0,1,2,1,1,1,0,1,0,0,0,1,0,0,0,0,0,0,1,0,0,0,2,0,0,0,0,0,0,,,
"Aug 3, 2021 4:00 AM",1,1,0,0,0,0,0,0,0,0,0,0,0,0,0,0,0,0,0,0,0,0,0,0,0,0,2,0,0,0,0,0,0,,,
"Aug 3, 2021 5:00 AM",3,3,0,1,1,0,5,4,1,3,3,0,1,1,0,0,5,5,0,0,0,0,4,4,4,0,3,9,0,0,0,0,0,,,
"Aug 3, 2021 6:00 AM",36,30,6,26,14,12,32,17,15,22,11,11,5,4,1,3,23,23,0,8,8,0,22,8,4,4,15,40,0,1,2,2,0,,,
"Aug 3, 2021 7:00 AM",76,41,35,68,31,37,79,34,45,58,30,28,11,10,1,6,52,52,0,8,7,1,54,43,14,29,31,60,6,5,3,2,1,,,
"Aug 3, 2021 8:00 AM",92,71,21,75,25,50,99,52,47,88,54,34,14,11,3,11,71,71,0,17,14,3,82,30,12,18,42,75,4,7,5,3,2,,,
"Aug 3, 2021 9:00 AM",82,62,20,57,34,23,88,48,40,68,45,23,21,19,2,7,43,42,1,33,25,8,48,28,13,15,31,48,5,6,6,3,3,,,
"Aug 3, 2021 10:00 AM",61,41,20,75,39,36,76,45,31,63,37,26,14,7,7,13,26,26,0,16,11,5,26,18,7,11,28,24,0,6,2,2,0,,,
"Aug 3, 2021 11:00 AM",40,22,18,79,38,41,75,42,33,75,40,35,19,11,8,16,20,20,0,14,13,1,19,20,13,7,23,30,7,3,7,4,3,,,
"Aug 3, 2021 12:00 PM",58,34,24,71,32,39,75,37,38,82,48,34,19,11,8,7,16,16,0,15,13,2,18,24,15,9,37,21,3,2,3,3,0,,,
"Aug 3, 2021 1:00 PM",61,33,28,41,19,22,58,26,32,46,19,27,21,13,8,11,22,20,2,12,11,1,22,25,13,12,20,16,3,4,5,4,1,,,
"Aug 3, 2021 2:00 PM",49,27,22,42,28,14,44,25,19,36,19,17,21,7,14,16,15,13,2,19,17,2,15,22,11,11,14,25,3,3,5,3,2,,,
"Aug 3, 2021 3:00 PM",44,12,32,40,25,15,40,25,15,33,22,11,16,5,11,11,8,8,0,22,21,1,7,15,9,6,24,21,2,1,3,2,1,,,
"Aug 3, 2021 4:00 PM",98,36,62,43,21,22,69,39,30,54,28,26,17,13,4,11,24,21,3,35,35,0,21,26,20,6,31,31,4,0,8,4,4,,,
"Aug 3, 2021 5:00 PM",143,52,91,102,52,50,126,83,43,112,72,40,22,6,16,18,27,27,0,54,51,3,30,40,29,11,75,50,7,6,3,2,1,,,
"Aug 3, 2021 6:00 PM",120,37,83,107,65,42,119,66,53,97,56,41,11,4,7,18,30,30,0,48,46,2,31,34,24,10,71,53,6,1,7,7,0,,,
"Aug 3, 2021 7:00 PM",76,33,43,63,37,26,99,57,42,67,40,27,9,1,8,17,24,23,1,42,40,2,25,44,22,22,50,26,6,3,5,2,3,,,
"Aug 3, 2021 8:00 PM",62,26,36,47,24,23,69,34,35,60,27,33,17,5,12,15,19,19,0,30,23,7,17,28,15,13,21,27,4,1,6,3,3,,,
"Aug 3, 2021 9:00 PM",45,15,30,47,27,20,55,20,35,38,16,22,12,4,8,4,10,10,0,17,16,1,10,23,11,12,19,23,4,0,2,0,2,,,
"Aug 3, 2021 10:00 PM",37,13,24,26,21,5,17,8,9,15,7,8,8,0,8,3,6,6,0,11,10,1,7,2,1,1,20,9,5,2,1,1,0,,,
"Aug 3, 2021 11:00 PM",15,7,8,9,5,4,17,4,13,15,4,11,3,3,0,2,4,3,1,5,5,0,3,5,1,4,5,8,0,0,0,0,0,,,
"Aug 4, 2021 12:00 AM",10,0,10,0,0,0,0,0,0,1,0,1,0,0,0,1,2,2,0,2,2,0,2,0,0,0,4,1,0,2,0,0,0,,,
"Aug 4, 2021 1:00 AM",6,1,5,0,0,0,2,1,1,0,0,0,0,0,0,0,0,0,0,1,1,0,0,0,0,0,3,1,0,0,0,0,0,,,
"Aug 4, 2021 2:00 AM",1,1,0,1,1,0,3,3,0,2,2,0,0,0,0,0,1,1,0,4,4,0,1,0,0,0,1,0,0,0,0,0,0,,,
"Aug 4, 2021 3:00 AM",1,1,0,0,0,0,1,1,0,0,0,0,0,0,0,1,0,0,0,0,0,0,0,0,0,0,1,3,0,0,0,0,0,,,
"Aug 4, 2021 4:00 AM",0,0,0,0,0,0,1,1,0,0,0,0,0,0,0,0,0,0,0,1,1,0,0,0,0,0,1,0,0,1,0,0,0,,,
"Aug 4, 2021 5:00 AM",5,5,0,4,1,3,8,5,3,10,6,4,2,0,2,1,3,3,0,2,2,0,3,1,1,0,6,11,0,0,1,1,0,,,
"Aug 4, 2021 6:00 AM",34,23,11,22,16,6,34,19,15,27,17,10,1,1,0,4,18,17,1,9,9,0,16,6,3,3,22,36,1,3,3,2,1,,,
"Aug 4, 2021 7:00 AM",82,48,34,92,37,55,96,45,51,80,36,44,6,6,0,11,49,49,0,16,13,3,48,31,15,16,35,74,4,4,3,3,0,,,
"Aug 4, 2021 8:00 AM",106,70,36,80,34,46,107,53,54,86,49,37,8,6,2,9,71,71,0,18,15,3,80,44,13,31,37,76,3,8,0,0,0,,,
"Aug 4, 2021 9:00 AM",84,63,21,98,46,52,96,53,43,86,52,34,24,13,11,8,56,56,0,18,14,4,56,26,13,13,37,53,5,11,8,3,5,,,
"Aug 4, 2021 10:00 AM",59,41,18,78,40,38,101,68,33,80,51,29,10,6,4,13,24,23,1,20,16,4,23,34,24,10,40,27,7,2,10,7,3,,,
"Aug 4, 2021 11:00 AM",46,24,22,86,37,49,111,53,58,84,40,44,21,14,7,14,27,25,2,18,16,2,23,36,20,16,16,40,6,5,9,5,4,,,
"Aug 4, 2021 12:00 PM",59,34,25,101,46,55,125,61,64,100,47,53,25,18,7,23,19,18,1,11,9,2,22,41,26,15,25,55,7,8,6,5,1,,,
"Aug 4, 2021 1:00 PM",57,33,24,82,40,42,115,57,58,92,46,46,27,10,17,8,34,32,2,23,23,0,29,34,16,18,38,41,6,7,7,5,2,,,
"Aug 4, 2021 2:00 PM",47,17,30,71,33,38,66,28,38,63,37,26,20,10,10,17,14,14,0,12,10,2,10,28,14,14,30,30,7,4,6,4,2,,,
"Aug 4, 2021 3:00 PM",35,15,20,65,32,33,67,31,36,59,23,36,14,6,8,16,23,22,1,24,21,3,21,26,15,11,33,20,0,2,2,1,1,,,
"Aug 4, 2021 4:00 PM",104,30,74,56,34,22,91,44,47,69,33,36,14,2,12,8,24,23,1,37,35,2,24,31,21,10,47,37,3,2,4,3,1,,,
"Aug 4, 2021 5:00 PM",130,38,92,107,68,39,119,67,52,109,68,41,32,14,18,29,21,21,0,68,61,7,21,49,35,14,65,60,8,7,6,2,4,,,
"Aug 4, 2021 6:00 PM",121,40,81,145,93,52,160,101,59,129,70,59,22,7,15,26,31,31,0,56,50,6,29,57,41,16,75,66,7,11,12,9,3,,,
"Aug 4, 2021 7:00 PM",83,36,47,124,64,60,154,84,70,100,58,42,17,6,11,7,17,17,0,30,29,1,19,58,36,22,63,57,3,10,6,4,2,,,
"Aug 4, 2021 8:00 PM",63,24,39,135,69,66,116,57,59,116,57,59,15,5,10,13,24,24,0,23,23,0,23,53,29,24,38,47,7,6,11,6,5,,,
"Aug 4, 2021 9:00 PM",41,11,30,35,15,20,64,19,45,28,6,22,4,3,1,13,15,15,0,15,14,1,15,31,7,24,20,29,5,1,0,0,0,,,
"Aug 4, 2021 10:00 PM",24,6,18,17,9,8,14,6,8,16,7,9,0,0,0,2,7,7,0,12,11,1,9,3,1,2,11,10,5,1,7,4,3,,,
"Aug 4, 2021 11:00 PM",18,6,12,3,2,1,10,1,9,7,1,6,4,1,3,0,4,4,0,1,1,0,4,1,1,0,5,6,1,1,4,4,0,,,
"Aug 5, 2021 12:00 AM",10,3,7,0,0,0,1,1,0,5,4,1,0,0,0,0,2,1,1,9,8,1,1,2,2,0,10,2,0,2,0,0,0,,,
"Aug 5, 2021 1:00 AM",1,0,1,4,1,3,3,1,2,1,0,1,0,0,0,0,0,0,0,3,3,0,0,2,2,0,1,1,2,0,0,0,0,,,
"Aug 5, 2021 2:00 AM",3,2,1,0,0,0,1,0,1,0,0,0,0,0,0,0,0,0,0,0,0,0,0,0,0,0,1,1,1,0,0,0,0,,,
"Aug 5, 2021 3:00 AM",0,0,0,1,0,1,1,0,1,1,0,1,0,0,0,0,0,0,0,0,0,0,2,0,0,0,0,1,0,0,0,0,0,,,
"Aug 5, 2021 4:00 AM",1,1,0,0,0,0,2,1,1,1,0,1,0,0,0,0,0,0,0,1,1,0,0,0,0,0,1,2,0,0,0,0,0,,,
"Aug 5, 2021 5:00 AM",4,4,0,0,0,0,6,6,0,4,4,0,1,1,0,0,2,2,0,1,1,0,3,2,2,0,4,8,0,1,0,0,0,,,
"Aug 5, 2021 6:00 AM",26,18,8,10,5,5,15,7,8,7,2,5,2,2,0,3,12,11,1,6,6,0,11,2,1,1,8,23,0,2,3,3,0,,,
"Aug 5, 2021 7:00 AM",55,33,22,32,12,20,39,16,23,32,16,16,7,6,1,6,38,38,0,10,6,4,38,12,4,8,22,50,1,2,3,2,1,,,
"Aug 5, 2021 8:00 AM",74,49,25,32,12,20,56,25,31,41,20,21,8,5,3,6,39,37,2,15,10,5,38,24,9,15,30,52,0,0,1,0,1,,,
"Aug 5, 2021 9:00 AM",50,29,21,19,9,10,22,17,5,17,13,4,8,6,2,2,16,15,1,15,11,4,15,10,5,5,23,22,2,4,3,1,2,,,
"Aug 5, 2021 10:00 AM",26,15,11,6,4,2,15,4,11,7,3,4,2,2,0,3,11,11,0,3,2,1,11,6,4,2,7,8,0,0,0,0,0,,,
"Aug 5, 2021 11:00 AM",14,13,1,5,2,3,7,6,1,5,3,2,2,1,1,4,6,6,0,8,6,2,5,6,2,4,8,12,0,0,0,0,0,,,
"Aug 5, 2021 12:00 PM",29,15,14,14,7,7,20,13,7,13,6,7,2,1,1,15,9,9,0,5,2,3,11,4,4,0,12,9,3,0,3,3,0,,,
"Aug 5, 2021 1:00 PM",44,25,19,24,15,9,33,16,17,29,15,14,9,4,5,12,13,13,0,9,8,1,14,15,7,8,10,16,5,3,4,4,0,,,
"Aug 5, 2021 2:00 PM",31,13,18,16,7,9,41,23,18,22,15,7,4,2,2,13,9,9,0,17,15,2,11,9,8,1,18,21,2,0,8,2,6,,,
"Aug 5, 2021 3:00 PM",47,21,26,31,22,9,37,22,15,28,17,11,11,7,4,19,11,10,1,10,9,1,12,10,8,2,14,25,0,1,2,1,1,,,
"Aug 5, 2021 4:00 PM",76,31,45,61,34,27,57,31,26,48,31,17,21,12,9,8,8,8,0,17,16,1,9,10,7,3,34,28,2,0,2,1,1,,,
"Aug 5, 2021 5:00 PM",68,15,53,75,25,50,90,56,34,77,51,26,26,9,17,7,25,25,0,34,31,3,21,28,21,7,46,35,2,5,10,8,2,,,
"Aug 5, 2021 6:00 PM",71,30,41,31,19,12,28,17,11,27,14,13,7,4,3,9,13,11,2,31,28,3,13,8,5,3,45,33,1,2,0,0,0,,,
"Aug 5, 2021 7:00 PM",58,21,37,15,9,6,32,17,15,22,8,14,9,3,6,12,10,9,1,19,19,0,9,14,12,2,24,14,0,0,0,0,0,,,
"Aug 5, 2021 8:00 PM",28,9,19,25,19,6,29,19,10,30,17,13,10,4,6,8,10,10,0,17,14,3,9,10,3,7,14,14,2,2,4,1,3,,,
"Aug 5, 2021 9:00 PM",22,7,15,22,14,8,28,11,17,23,12,11,9,6,3,7,5,5,0,7,6,1,6,1,1,0,6,17,4,1,8,5,3,,,
"Aug 5, 2021 10:00 PM",9,6,3,20,14,6,12,3,9,20,5,15,3,0,3,2,1,1,0,10,10,0,2,4,2,2,8,8,1,3,4,1,3,,,
"Aug 5, 2021 11:00 PM",11,5,6,1,1,0,7,0,7,4,1,3,2,2,0,1,6,6,0,3,2,1,6,0,0,0,4,3,1,2,2,2,0,,,
"Aug 6, 2021 12:00 AM",11,3,8,0,0,0,2,0,2,3,1,2,1,1,0,4,3,3,0,2,2,0,3,0,0,0,3,4,0,0,0,0,0,,,
"Aug 6, 2021 1:00 AM",1,1,0,0,0,0,2,2,0,0,0,0,0,0,0,0,0,0,0,3,3,0,0,0,0,0,4,3,0,0,0,0,0,,,
"Aug 6, 2021 2:00 AM",4,3,1,0,0,0,1,0,1,0,0,0,0,0,0,0,0,0,0,2,2,0,0,0,0,0,1,1,0,0,0,0,0,,,
"Aug 6, 2021 3:00 AM",1,0,1,0,0,0,0,0,0,0,0,0,0,0,0,0,0,0,0,0,0,0,1,0,0,0,0,1,0,0,0,0,0,,,
"Aug 6, 2021 4:00 AM",1,1,0,0,0,0,2,2,0,0,0,0,0,0,0,0,0,0,0,0,0,0,0,0,0,0,3,0,0,0,0,0,0,,,
"Aug 6, 2021 5:00 AM",3,3,0,2,1,1,7,5,2,4,2,2,2,0,2,0,4,3,1,0,0,0,3,1,1,0,6,8,1,0,0,0,0,,,
"Aug 6, 2021 6:00 AM",19,13,6,10,6,4,25,9,16,16,8,8,4,4,0,4,9,8,1,4,4,0,9,0,0,0,12,28,0,1,0,0,0,,,
"Aug 6, 2021 7:00 AM",55,29,26,44,20,24,46,20,26,41,22,19,10,9,1,6,30,30,0,11,7,4,30,10,3,7,23,40,3,5,1,1,0,,,
"Aug 6, 2021 8:00 AM",69,51,18,66,31,35,81,43,38,59,36,23,7,3,4,6,36,35,1,12,9,3,43,27,13,14,22,52,4,6,2,2,0,,,
"Aug 6, 2021 9:00 AM",61,40,21,58,21,37,65,37,28,56,30,26,20,12,8,7,26,26,0,18,14,4,29,20,12,8,25,29,6,4,7,2,5,,,
"Aug 6, 2021 10:00 AM",39,23,16,46,15,31,54,26,28,36,16,20,16,9,7,12,18,18,0,10,9,1,22,25,19,6,15,25,2,5,2,1,1,,,
"Aug 6, 2021 11:00 AM",47,30,17,54,28,26,46,23,23,37,19,18,26,15,11,13,18,18,0,9,7,2,18,20,11,9,22,28,4,11,9,5,4,,,
"Aug 6, 2021 12:00 PM",38,18,20,41,21,20,65,30,35,40,22,18,12,3,9,13,12,12,0,10,9,1,10,30,15,15,26,19,2,1,3,3,0,,,
"Aug 6, 2021 1:00 PM",53,24,29,53,28,25,65,41,24,59,40,19,20,9,11,7,11,11,0,11,9,2,14,16,7,9,27,25,3,4,3,2,1,,,
"Aug 6, 2021 2:00 PM",48,23,25,52,19,33,57,23,34,51,23,28,14,12,2,18,19,17,2,15,14,1,16,19,13,6,18,23,5,4,8,3,5,,,
"Aug 6, 2021 3:00 PM",60,30,30,53,30,23,54,32,22,40,25,15,15,5,10,11,16,16,0,7,7,0,16,14,8,6,33,32,6,3,8,5,3,,,
"Aug 6, 2021 4:00 PM",69,31,38,75,36,39,61,34,27,52,31,21,28,13,15,21,15,14,1,29,26,3,16,29,18,11,32,27,6,1,6,5,1,,,
"Aug 6, 2021 5:00 PM",113,54,59,64,47,17,84,49,35,65,37,28,26,6,20,11,14,13,1,30,29,1,11,38,21,17,43,37,4,2,6,4,2,,,
"Aug 6, 2021 6:00 PM",73,31,42,72,45,27,100,66,34,93,67,26,10,5,5,8,17,17,0,33,31,2,20,27,17,10,67,33,6,4,3,1,2,,,
"Aug 6, 2021 7:00 PM",58,25,33,99,63,36,69,42,27,65,43,22,7,1,6,12,25,24,1,24,23,1,23,26,16,10,27,26,4,2,6,4,2,,,
"Aug 6, 2021 8:00 PM",56,32,24,50,27,23,64,37,27,49,24,25,8,3,5,17,12,10,2,14,10,4,10,25,12,13,19,23,3,1,3,2,1,,,
"Aug 6, 2021 9:00 PM",23,9,14,27,15,12,37,15,22,31,16,15,5,4,1,6,5,5,0,11,10,1,5,15,3,12,12,19,1,0,3,1,2,,,
"Aug 6, 2021 10:00 PM",24,6,18,19,6,13,27,7,20,24,7,17,4,3,1,2,7,7,0,8,7,1,7,8,5,3,9,3,3,4,4,2,2,,,
"Aug 6, 2021 11:00 PM",21,11,10,8,5,3,16,9,7,10,3,7,0,0,0,1,9,9,0,2,2,0,9,2,0,2,1,17,0,1,2,2,0,,,
"Aug 7, 2021 12:00 AM",21,4,17,1,0,1,3,2,1,6,5,1,3,0,3,1,3,3,0,4,4,0,3,1,1,0,3,3,0,0,0,0,0,,,
"Aug 7, 2021 1:00 AM",7,2,5,6,2,4,7,4,3,7,1,6,4,2,2,0,1,1,0,4,4,0,1,1,1,0,6,3,1,0,0,0,0,,,
"Aug 7, 2021 2:00 AM",8,4,4,0,0,0,4,3,1,3,2,1,0,0,0,2,0,0,0,5,5,0,0,0,0,0,3,2,0,0,0,0,0,,,
"Aug 7, 2021 3:00 AM",1,0,1,0,0,0,0,0,0,0,0,0,0,0,0,1,0,0,0,1,1,0,2,1,1,0,0,1,0,1,0,0,0,,,
"Aug 7, 2021 4:00 AM",2,2,0,0,0,0,0,0,0,0,0,0,0,0,0,0,0,0,0,0,0,0,0,0,0,0,1,1,0,1,0,0,0,,,
"Aug 7, 2021 5:00 AM",6,3,3,1,1,0,3,2,1,3,2,1,1,0,1,1,0,0,0,2,2,0,0,2,0,2,3,5,1,0,0,0,0,,,
"Aug 7, 2021 6:00 AM",10,8,2,4,2,2,8,3,5,4,2,2,0,0,0,1,5,4,1,2,2,0,3,2,2,0,2,10,0,2,0,0,0,,,
"Aug 7, 2021 7:00 AM",16,9,7,5,3,2,14,12,2,10,6,4,1,1,0,1,8,8,0,3,1,2,9,5,3,2,5,8,1,3,1,0,1,,,
"Aug 7, 2021 8:00 AM",21,11,10,20,8,12,29,17,12,29,19,10,8,6,2,7,16,15,1,13,9,4,16,3,3,0,14,9,2,2,3,1,2,,,
"Aug 7, 2021 9:00 AM",24,10,14,59,37,22,66,47,19,57,44,13,12,11,1,11,10,9,1,8,8,0,10,15,12,3,25,16,2,5,2,2,0,,,
"Aug 7, 2021 10:00 AM",38,19,19,83,43,40,95,58,37,76,40,36,24,16,8,8,20,20,0,14,12,2,21,25,18,7,24,27,2,5,3,1,2,,,
"Aug 7, 2021 11:00 AM",27,18,9,71,34,37,83,39,44,57,35,22,14,8,6,4,6,6,0,6,5,1,6,39,20,19,28,23,6,4,12,8,4,,,
"Aug 7, 2021 12:00 PM",24,12,12,57,16,41,31,15,16,34,13,21,9,5,4,3,9,9,0,12,12,0,9,14,6,8,14,10,3,3,2,2,0,,,
"Aug 7, 2021 1:00 PM",25,16,9,30,15,15,20,9,11,22,7,15,10,7,3,6,8,7,1,9,7,2,5,8,3,5,13,11,0,2,1,1,0,,,
"Aug 7, 2021 2:00 PM",29,16,13,39,29,10,40,27,13,32,21,11,15,8,7,6,10,9,1,12,11,1,10,10,2,8,24,13,4,1,5,4,1,,,
"Aug 7, 2021 3:00 PM",29,15,14,44,22,22,36,18,18,30,14,16,9,5,4,9,14,14,0,4,4,0,12,22,17,5,13,13,2,0,4,3,1,,,
"Aug 7, 2021 4:00 PM",38,20,18,53,34,19,52,25,27,47,26,21,20,5,15,12,10,10,0,11,10,1,10,32,13,19,19,15,3,1,2,2,0,,,
"Aug 7, 2021 5:00 PM",47,19,28,49,26,23,44,20,24,40,23,17,11,3,8,6,11,11,0,13,12,1,11,9,3,6,13,20,1,0,6,1,5,,,
"Aug 7, 2021 6:00 PM",47,23,24,29,14,15,37,20,17,23,12,11,8,5,3,9,11,11,0,8,7,1,11,9,6,3,15,16,4,2,5,3,2,,,
"Aug 7, 2021 7:00 PM",18,10,8,27,12,15,22,8,14,21,8,13,12,7,5,6,8,8,0,7,6,1,8,10,3,7,8,15,3,2,1,0,1,,,
"Aug 7, 2021 8:00 PM",23,10,13,5,1,4,10,7,3,7,3,4,1,0,1,12,6,6,0,9,8,1,6,4,2,2,10,12,0,0,1,1,0,,,
"Aug 7, 2021 9:00 PM",13,3,10,5,2,3,12,3,9,7,2,5,6,3,3,2,9,8,1,9,9,0,9,6,2,4,3,5,0,0,1,0,1,,,
"Aug 7, 2021 10:00 PM",12,4,8,9,4,5,11,2,9,12,5,7,6,1,5,2,4,4,0,4,4,0,4,2,1,1,3,4,1,1,4,3,1,,,
"Aug 7, 2021 11:00 PM",12,7,5,2,2,0,6,3,3,4,3,1,11,6,5,0,2,2,0,5,5,0,1,2,2,0,6,9,0,1,0,0,0,,,
"Aug 8, 2021 12:00 AM",7,2,5,0,0,0,5,5,0,4,3,1,1,1,0,1,7,7,0,3,2,1,8,3,3,0,7,6,0,0,0,0,0,,,
"Aug 8, 2021 1:00 AM",7,4,3,5,2,3,9,1,8,7,2,5,2,2,0,0,1,1,0,3,1,2,1,0,0,0,3,5,1,0,1,1,0,,,
"Aug 8, 2021 2:00 AM",4,0,4,1,0,1,1,0,1,1,0,1,0,0,0,0,0,0,0,1,1,0,0,0,0,0,0,0,0,0,2,0,2,,,
"Aug 8, 2021 3:00 AM",0,0,0,0,0,0,1,1,0,1,0,1,0,0,0,0,0,0,0,0,0,0,1,0,0,0,0,1,0,1,0,0,0,,,
"Aug 8, 2021 4:00 AM",0,0,0,0,0,0,2,1,1,0,0,0,0,0,0,1,0,0,0,0,0,0,0,1,0,1,1,0,0,0,1,1,0,,,
"Aug 8, 2021 5:00 AM",3,1,2,1,1,0,0,0,0,0,0,0,1,0,1,0,1,1,0,0,0,0,1,0,0,0,1,6,0,0,1,0,1,,,
"Aug 8, 2021 6:00 AM",12,6,6,3,2,1,6,4,2,5,2,3,0,0,0,1,3,3,0,1,1,0,3,1,0,1,5,4,0,0,0,0,0,,,
"Aug 8, 2021 7:00 AM",14,6,8,10,5,5,10,7,3,12,9,3,0,0,0,0,9,9,0,6,5,1,10,3,2,1,5,15,0,0,0,0,0,,,
"Aug 8, 2021 8:00 AM",14,3,11,56,33,23,46,26,20,52,32,20,3,1,2,5,5,5,0,8,8,0,5,7,2,5,13,12,9,9,1,0,1,,,
"Aug 8, 2021 9:00 AM",23,17,6,79,49,30,85,60,25,70,52,18,6,4,2,3,14,14,0,9,8,1,15,26,15,11,29,34,5,3,2,1,1,,,
"Aug 8, 2021 10:00 AM",32,15,17,99,48,51,93,45,48,78,41,37,12,12,0,18,21,21,0,8,7,1,20,29,13,16,15,35,0,2,4,1,3,,,
"Aug 8, 2021 11:00 AM",44,15,29,100,62,38,98,52,46,91,51,40,26,11,15,9,15,15,0,10,9,1,17,44,29,15,36,23,4,10,2,1,1,,,
"Aug 8, 2021 12:00 PM",58,28,30,154,70,84,124,61,63,111,59,52,31,21,10,18,13,13,0,18,17,1,13,45,36,9,40,37,3,5,2,2,0,,,
"Aug 8, 2021 1:00 PM",57,25,32,119,73,46,135,83,52,110,62,48,24,12,12,33,19,19,0,13,11,2,19,46,25,21,49,40,7,7,8,5,3,,,
"Aug 8, 2021 2:00 PM",54,34,20,157,75,82,132,77,55,112,72,40,40,25,15,18,20,20,0,16,14,2,21,37,17,20,25,49,9,1,7,6,1,,,
"Aug 8, 2021 3:00 PM",42,21,21,133,71,62,163,89,74,136,78,58,36,17,19,17,21,20,1,21,19,2,18,67,39,28,55,45,10,3,8,6,2,,,
"Aug 8, 2021 4:00 PM",51,27,24,153,79,74,152,73,79,130,64,66,26,5,21,20,22,22,0,11,10,1,23,55,26,29,38,33,4,7,11,3,8,,,
"Aug 8, 2021 5:00 PM",54,23,31,117,54,63,136,63,73,129,65,64,27,15,12,21,19,19,0,10,9,1,19,49,21,28,42,49,5,6,4,3,1,,,
"Aug 8, 2021 6:00 PM",42,14,28,118,62,56,111,57,54,112,61,51,17,6,11,21,14,14,0,23,18,5,16,39,28,11,26,44,2,1,9,6,3,,,
"Aug 8, 2021 7:00 PM",46,25,21,100,48,52,87,39,48,80,32,48,18,6,12,3,14,14,0,8,8,0,15,30,10,20,30,31,4,2,4,2,2,,,
"Aug 8, 2021 8:00 PM",36,16,20,50,20,30,65,20,45,42,16,26,16,10,6,13,16,16,0,10,10,0,16,27,7,20,21,25,1,1,1,1,0,,,
"Aug 8, 2021 9:00 PM",22,9,13,28,12,16,41,16,25,35,13,22,5,4,1,5,8,8,0,11,8,3,7,20,11,9,15,18,3,2,1,1,0,,,
"Aug 8, 2021 10:00 PM",20,6,14,8,4,4,11,1,10,12,2,10,2,1,1,3,7,7,0,3,3,0,8,8,5,3,5,10,1,6,1,1,0,,,
"Aug 8, 2021 11:00 PM",13,5,8,1,1,0,7,4,3,6,2,4,1,1,0,5,2,2,0,1,1,0,3,4,2,2,2,2,1,0,0,0,0,,,
"Aug 9, 2021 12:00 AM",9,5,4,0,0,0,3,1,2,2,0,2,1,1,0,2,2,2,0,4,4,0,4,2,2,0,2,1,2,1,2,0,2,,,
"Aug 9, 2021 1:00 AM",3,1,2,1,0,1,6,0,6,1,0,1,1,1,0,1,0,0,0,1,0,1,0,0,0,0,4,2,1,0,0,0,0,,,
"Aug 9, 2021 2:00 AM",2,0,2,4,1,3,0,0,0,0,0,0,0,0,0,1,0,0,0,2,2,0,0,3,1,2,0,0,0,0,0,0,0,,,
"Aug 9, 2021 3:00 AM",2,1,1,0,0,0,1,1,0,0,0,0,1,1,0,0,0,0,0,0,0,0,0,0,0,0,2,0,0,0,0,0,0,,,
"Aug 9, 2021 4:00 AM",1,0,1,0,0,0,0,0,0,0,0,0,0,0,0,0,0,0,0,0,0,0,0,0,0,0,0,1,0,0,1,0,1,,,
"Aug 9, 2021 5:00 AM",9,7,2,3,2,1,9,6,3,8,5,3,0,0,0,4,3,3,0,2,2,0,4,2,2,0,4,11,0,1,0,0,0,,,
"Aug 9, 2021 6:00 AM",36,27,9,17,11,6,27,12,15,20,9,11,4,4,0,5,17,17,0,5,5,0,17,8,3,5,16,36,1,1,4,4,0,,,
"Aug 9, 2021 7:00 AM",59,37,22,59,22,37,64,27,37,46,22,24,13,8,5,5,49,49,0,12,8,4,52,13,5,8,31,66,6,6,2,2,0,,,
"Aug 9, 2021 8:00 AM",101,65,36,65,24,41,64,38,26,60,38,22,13,9,4,5,62,61,1,20,11,9,67,24,15,9,38,60,3,3,9,6,3,,,
"Aug 9, 2021 9:00 AM",54,41,13,58,21,37,62,38,24,39,24,15,22,13,9,10,31,30,1,18,14,4,28,17,9,8,21,28,1,2,2,2,0,,,
"Aug 9, 2021 10:00 AM",46,27,19,41,22,19,50,30,20,34,19,15,13,7,6,15,12,12,0,8,4,4,15,9,5,4,17,27,3,0,2,2,0,,,
"Aug 9, 2021 11:00 AM",33,22,11,44,23,21,43,21,22,37,20,17,6,4,2,10,19,19,0,8,8,0,18,18,12,6,14,20,2,1,1,1,0,,,
"Aug 9, 2021 12:00 PM",57,29,28,52,24,28,75,39,36,47,23,24,15,10,5,15,14,14,0,13,11,2,16,21,10,11,24,22,4,5,7,4,3,,,
"Aug 9, 2021 1:00 PM",52,24,28,75,40,35,84,42,42,46,30,16,26,13,13,28,19,18,1,16,14,2,18,29,16,13,17,20,4,6,5,4,1,,,
"Aug 9, 2021 2:00 PM",46,25,21,45,24,21,48,22,26,37,20,17,13,9,4,18,23,22,1,17,14,3,21,29,16,13,25,25,4,0,2,2,0,,,
"Aug 9, 2021 3:00 PM",67,31,36,44,31,13,49,23,26,40,23,17,22,10,12,34,13,13,0,17,16,1,14,21,9,12,27,31,2,3,8,3,5,,,
"Aug 9, 2021 4:00 PM",89,32,57,61,39,22,80,47,33,58,32,26,23,8,15,26,13,13,0,35,32,3,14,28,20,8,38,36,2,4,3,0,3,,,
"Aug 9, 2021 5:00 PM",129,41,88,79,53,26,114,59,55,86,39,47,24,8,16,19,37,37,0,46,45,1,34,38,20,18,67,63,7,8,6,5,1,,,
"Aug 9, 2021 6:00 PM",105,36,69,117,76,41,131,75,56,113,69,44,18,7,11,20,24,23,1,48,47,1,25,30,18,12,84,52,6,0,8,5,3,,,
"Aug 9, 2021 7:00 PM",71,35,36,109,53,56,109,67,42,101,65,36,14,5,9,20,17,16,1,37,33,4,16,21,14,7,51,39,5,1,9,6,3,,,
"Aug 9, 2021 8:00 PM",59,27,32,71,39,32,93,36,57,71,29,42,18,10,8,8,16,15,1,25,19,6,15,40,15,25,34,43,4,0,5,1,4,,,
"Aug 9, 2021 9:00 PM",32,6,26,34,15,19,51,17,34,28,8,20,8,4,4,6,8,7,1,12,12,0,6,15,7,8,17,19,3,2,6,4,2,,,
"Aug 9, 2021 10:00 PM",29,11,18,17,9,8,20,11,9,15,8,7,1,1,0,2,9,8,1,4,3,1,9,6,4,2,10,15,0,0,1,1,0,,,
"Aug 9, 2021 11:00 PM",5,2,3,1,0,1,10,4,6,3,0,3,3,1,2,5,1,1,0,4,4,0,1,1,0,1,9,7,1,0,5,4,1,,,
"Aug 10, 2021 12:00 AM",6,2,4,0,0,0,0,0,0,2,1,1,6,2,4,0,1,1,0,1,0,1,1,0,0,0,5,2,0,0,1,0,1,,,
"Aug 10, 2021 1:00 AM",1,0,1,0,0,0,3,0,3,0,0,0,3,2,1,0,0,0,0,0,0,0,0,0,0,0,1,1,0,0,0,0,0,,,
"Aug 10, 2021 2:00 AM",2,1,1,3,0,3,0,0,0,0,0,0,0,0,0,1,0,0,0,1,1,0,0,0,0,0,0,1,0,1,1,1,0,,,
"Aug 10, 2021 3:00 AM",4,2,2,2,1,1,1,0,1,2,1,1,0,0,0,1,0,0,0,0,0,0,0,0,0,0,0,0,0,0,0,0,0,,,
"Aug 10, 2021 4:00 AM",2,1,1,0,0,0,2,1,1,1,1,0,0,0,0,0,0,0,0,0,0,0,0,0,0,0,1,0,0,0,0,0,0,,,
"Aug 10, 2021 5:00 AM",10,10,0,4,2,2,8,4,4,7,3,4,1,0,1,0,3,3,0,1,1,0,3,4,3,1,3,14,0,0,0,0,0,,,
"Aug 10, 2021 6:00 AM",38,25,13,33,19,14,38,23,15,30,20,10,3,2,1,3,19,18,1,6,6,0,16,9,5,4,21,36,2,2,3,3,0,,,
"Aug 10, 2021 7:00 AM",73,43,30,82,33,49,84,33,51,79,34,45,7,7,0,10,66,65,1,19,15,4,65,20,5,15,37,82,1,8,4,3,1,,,
"Aug 10, 2021 8:00 AM",129,96,33,82,33,49,99,48,51,84,45,39,16,9,7,12,86,85,1,18,16,2,92,40,16,24,40,90,4,6,5,3,2,,,
"Aug 10, 2021 9:00 AM",85,60,25,80,27,53,71,37,34,69,43,26,25,14,11,7,41,40,1,22,18,4,43,29,15,14,33,65,2,9,6,5,1,,,
"Aug 10, 2021 10:00 AM",66,38,28,95,60,35,90,51,39,79,50,29,15,13,2,9,31,30,1,17,14,3,31,32,20,12,27,36,6,3,13,8,5,,,
"Aug 10, 2021 11:00 AM",35,21,14,83,47,36,109,65,44,89,53,36,18,11,7,12,19,19,0,20,17,3,19,58,35,23,46,23,9,3,7,4,3,,,
"Aug 10, 2021 12:00 PM",51,27,24,92,43,49,126,69,57,89,50,39,28,15,13,20,23,23,0,11,9,2,24,39,26,13,36,52,5,6,8,6,2,,,
"Aug 10, 2021 1:00 PM",70,45,25,102,52,50,151,79,72,108,60,48,26,13,13,17,26,25,1,16,12,4,24,54,38,16,35,41,7,9,12,6,6,,,
"Aug 10, 2021 2:00 PM",75,36,39,62,36,26,105,52,53,62,39,23,15,6,9,17,28,28,0,24,24,0,30,55,22,33,33,37,3,3,12,5,7,,,
"Aug 10, 2021 3:00 PM",73,30,43,74,31,43,98,46,52,72,33,39,30,13,17,16,22,22,0,23,20,3,24,43,16,27,34,30,4,3,9,8,1,,,
"Aug 10, 2021 4:00 PM",103,39,64,76,39,37,111,50,61,78,38,40,30,17,13,30,28,28,0,32,30,2,29,58,30,28,53,53,2,2,10,5,5,,,
"Aug 10, 2021 5:00 PM",164,48,116,127,74,53,175,98,77,147,81,66,36,10,26,21,29,26,3,59,57,2,29,50,28,22,101,59,12,12,9,6,3,,,
"Aug 10, 2021 6:00 PM",148,58,90,134,77,57,162,97,65,125,69,56,30,9,21,16,32,32,0,58,54,4,33,51,27,24,80,60,5,2,11,9,2,,,
"Aug 10, 2021 7:00 PM",107,39,68,122,72,50,148,82,66,117,65,52,18,10,8,43,35,34,1,36,32,4,35,32,21,11,70,49,8,3,16,10,6,,,
"Aug 10, 2021 8:00 PM",85,41,44,94,50,44,117,51,66,88,42,46,19,10,9,22,21,21,0,41,36,5,20,38,22,16,45,28,5,4,12,9,3,,,
"Aug 10, 2021 9:00 PM",58,19,39,35,13,22,73,30,43,41,12,29,5,4,1,2,16,15,1,26,23,3,17,17,5,12,27,34,0,3,2,1,1,,,
"Aug 10, 2021 10:00 PM",27,6,21,21,18,3,27,6,21,26,11,15,7,0,7,4,13,13,0,18,16,2,14,3,3,0,12,15,5,0,1,1,0,,,
"Aug 10, 2021 11:00 PM",17,6,11,15,13,2,20,7,13,18,6,12,4,0,4,0,0,0,0,6,6,0,0,6,1,5,5,10,2,1,3,1,2,,,
"Aug 11, 2021 12:00 AM",8,0,8,2,2,0,4,1,3,1,1,0,2,0,2,1,4,4,0,1,1,0,5,0,0,0,3,3,1,0,1,1,0,,,
"Aug 11, 2021 1:00 AM",2,0,2,5,3,2,2,0,2,2,0,2,1,0,1,0,2,2,0,3,3,0,2,0,0,0,1,2,0,0,0,0,0,,,
"Aug 11, 2021 2:00 AM",3,3,0,1,0,1,1,1,0,0,0,0,0,0,0,0,1,1,0,1,1,0,1,0,0,0,0,1,0,0,0,0,0,,,
"Aug 11, 2021 3:00 AM",0,0,0,0,0,0,2,1,1,1,0,1,0,0,0,1,0,0,0,2,2,0,1,0,0,0,3,1,0,0,0,0,0,,,
"Aug 11, 2021 4:00 AM",2,1,1,0,0,0,1,1,0,0,0,0,1,0,1,0,0,0,0,0,0,0,0,0,0,0,1,0,1,0,1,1,0,,,
"Aug 11, 2021 5:00 AM",9,9,0,3,1,2,8,5,3,4,2,2,0,0,0,1,4,4,0,1,1,0,3,3,2,1,5,11,0,1,0,0,0,,,
"Aug 11, 2021 6:00 AM",35,22,13,26,17,9,31,21,10,23,15,8,3,3,0,8,25,24,1,6,6,0,23,5,4,1,18,33,0,3,2,2,0,,,
"Aug 11, 2021 7:00 AM",62,39,23,83,43,40,83,39,44,71,36,35,8,7,1,10,61,61,0,16,13,3,60,26,13,13,33,73,5,5,0,0,0,,,
"Aug 11, 2021 8:00 AM",109,81,28,64,20,44,71,38,33,84,42,42,16,11,5,13,62,62,0,21,12,9,69,27,11,16,44,86,2,4,6,3,3,,,
"Aug 11, 2021 9:00 AM",74,55,19,58,22,36,58,36,22,46,30,16,19,16,3,9,40,40,0,12,10,2,40,28,18,10,25,26,6,3,7,4,3,,,
"Aug 11, 2021 10:00 AM",61,35,26,59,22,37,51,30,21,48,26,22,11,8,3,10,23,22,1,21,18,3,23,28,17,11,13,26,0,1,5,5,0,,,
"Aug 11, 2021 11:00 AM",42,26,16,43,25,18,52,30,22,39,25,14,18,9,9,12,14,14,0,7,5,2,12,13,8,5,22,24,0,4,3,2,1,,,
"Aug 11, 2021 12:00 PM",17,15,2,47,26,21,43,15,28,30,16,14,17,6,11,5,15,15,0,9,9,0,19,16,6,10,14,21,7,0,6,4,2,,,
"Aug 11, 2021 1:00 PM",22,16,6,17,8,9,37,17,20,31,18,13,15,6,9,11,10,10,0,20,16,4,9,9,8,1,15,21,1,2,5,3,2,,,
"Aug 11, 2021 2:00 PM",41,14,27,25,14,11,36,19,17,25,13,12,8,6,2,12,13,13,0,16,16,0,12,9,7,2,17,19,1,4,2,1,1,,,
"Aug 11, 2021 3:00 PM",38,15,23,56,28,28,64,39,25,60,36,24,23,15,8,12,15,15,0,26,24,2,15,25,14,11,25,41,4,3,5,2,3,,,
"Aug 11, 2021 4:00 PM",77,21,56,74,46,28,107,62,45,79,44,35,19,5,14,17,15,15,0,28,28,0,15,46,31,15,43,43,3,4,2,1,1,,,
"Aug 11, 2021 5:00 PM",150,50,100,131,88,43,158,97,61,114,67,47,41,22,19,18,32,31,1,68,65,3,31,48,36,12,71,64,9,9,7,5,2,,,
"Aug 11, 2021 6:00 PM",123,45,78,163,99,64,185,106,79,155,87,68,13,7,6,27,31,31,0,52,49,3,32,67,38,29,90,51,7,9,8,7,1,,,
"Aug 11, 2021 7:00 PM",88,39,49,144,82,62,165,76,89,135,77,58,26,17,9,29,12,12,0,37,33,4,13,47,30,17,54,49,8,5,9,5,4,,,
"Aug 11, 2021 8:00 PM",73,34,39,124,61,63,120,50,70,112,52,60,20,14,6,5,26,25,1,24,23,1,26,52,14,38,47,42,7,3,3,2,1,,,
"Aug 11, 2021 9:00 PM",36,18,18,75,28,47,76,27,49,62,20,42,5,2,3,7,8,8,0,28,24,4,9,21,4,17,20,24,5,0,5,2,3,,,
"Aug 11, 2021 10:00 PM",20,3,17,11,5,6,28,10,18,25,10,15,6,2,4,1,8,8,0,11,11,0,9,5,3,2,13,15,3,1,2,1,1,,,
"Aug 11, 2021 11:00 PM",15,8,7,9,5,4,15,2,13,13,3,10,1,1,0,2,8,8,0,2,2,0,8,2,0,2,8,8,2,1,2,2,0,,,
"Aug 12, 2021 12:00 AM",9,2,7,0,0,0,0,0,0,2,2,0,1,1,0,3,1,1,0,5,5,0,0,1,1,0,5,1,1,0,0,0,0,,,
"Aug 12, 2021 1:00 AM",5,0,5,6,3,3,2,1,1,10,7,3,2,1,1,1,0,0,0,2,2,0,1,0,0,0,7,3,0,0,0,0,0,,,
"Aug 12, 2021 2:00 AM",5,3,2,0,0,0,4,1,3,1,1,0,0,0,0,1,0,0,0,0,0,0,0,0,0,0,3,6,0,0,2,0,2,,,
"Aug 12, 2021 3:00 AM",1,0,1,0,0,0,0,0,0,0,0,0,0,0,0,0,0,0,0,0,0,0,2,0,0,0,0,0,0,0,0,0,0,,,
"Aug 12, 2021 4:00 AM",1,1,0,0,0,0,1,1,0,0,0,0,0,0,0,0,2,2,0,0,0,0,2,0,0,0,1,1,0,0,0,0,0,,,
"Aug 12, 2021 5:00 AM",9,9,0,3,1,2,7,4,3,7,5,2,2,2,0,0,3,3,0,1,1,0,2,0,0,0,2,13,0,0,0,0,0,,,
"Aug 12, 2021 6:00 AM",36,25,11,26,15,11,39,19,20,27,16,11,2,1,1,4,19,18,1,4,4,0,18,10,5,5,17,31,1,4,3,3,0,,,
"Aug 12, 2021 7:00 AM",76,47,29,94,42,52,99,47,52,96,45,51,11,10,1,8,54,54,0,20,15,5,57,21,9,12,41,60,0,9,2,2,0,,,
"Aug 12, 2021 8:00 AM",111,75,36,66,27,39,91,47,44,84,48,36,18,12,6,11,74,74,0,12,9,3,76,34,20,14,42,97,3,3,4,3,1,,,
"Aug 12, 2021 9:00 AM",81,55,26,69,28,41,73,42,31,67,35,32,26,21,5,14,39,38,1,21,17,4,38,35,26,9,25,43,3,5,5,1,4,,,
"Aug 12, 2021 10:00 AM",66,39,27,75,31,44,79,40,39,59,35,24,22,10,12,9,36,35,1,11,6,5,36,24,13,11,20,31,3,4,6,3,3,,,
"Aug 12, 2021 11:00 AM",55,29,26,71,35,36,96,47,49,73,33,40,21,11,10,9,16,16,0,10,9,1,16,37,18,19,16,30,3,4,5,5,0,,,
"Aug 12, 2021 12:00 PM",53,28,25,85,46,39,91,52,39,74,39,35,21,7,14,14,15,14,1,15,14,1,13,32,25,7,20,23,5,6,2,2,0,,,
"Aug 12, 2021 1:00 PM",55,31,24,62,32,30,79,44,35,47,24,23,22,8,14,12,17,16,1,19,17,2,16,26,13,13,10,22,2,1,6,4,2,,,
"Aug 12, 2021 2:00 PM",52,23,29,84,45,39,79,48,31,63,42,21,30,14,16,16,19,19,0,19,18,1,17,28,20,8,27,30,1,2,5,2,3,,,
"Aug 12, 2021 3:00 PM",62,32,30,49,22,27,50,22,28,41,20,21,25,11,14,10,22,22,0,20,19,1,21,26,20,6,28,33,3,3,5,3,2,,,
"Aug 12, 2021 4:00 PM",91,28,63,51,20,31,83,54,29,59,37,22,11,7,4,9,16,14,2,36,34,2,14,48,30,18,59,29,9,2,10,5,5,,,
"Aug 12, 2021 5:00 PM",146,41,105,124,56,68,154,95,59,127,77,50,44,24,20,21,44,42,2,53,50,3,38,57,39,18,69,47,9,6,8,5,3,,,
"Aug 12, 2021 6:00 PM",132,57,75,127,81,46,158,95,63,122,81,41,19,9,10,27,25,25,0,59,58,1,23,60,48,12,80,65,6,6,8,4,4,,,
"Aug 12, 2021 7:00 PM",105,48,57,120,71,49,126,66,60,91,49,42,28,9,19,17,16,15,1,23,19,4,15,40,16,24,51,48,5,3,8,6,2,,,
"Aug 12, 2021 8:00 PM",67,24,43,121,60,61,119,57,62,97,51,46,16,9,7,19,17,17,0,26,25,1,18,39,19,20,34,32,5,1,7,3,4,,,
"Aug 12, 2021 9:00 PM",36,13,23,49,25,24,72,19,53,63,16,47,11,7,4,6,13,13,0,21,16,5,14,16,4,12,15,30,7,1,4,2,2,,,
"Aug 12, 2021 10:00 PM",23,9,14,33,28,5,39,9,30,36,13,23,7,3,4,1,10,10,0,15,15,0,13,12,4,8,12,19,3,3,3,1,2,,,
"Aug 12, 2021 11:00 PM",25,9,16,22,19,3,23,4,19,16,4,12,5,2,3,4,5,5,0,9,9,0,4,9,5,4,6,13,0,0,3,3,0,,,
"Aug 13, 2021 12:00 AM",17,5,12,0,0,0,1,0,1,1,0,1,2,0,2,4,2,2,0,6,6,0,2,6,4,2,11,1,2,0,1,1,0,,,
"Aug 13, 2021 1:00 AM",2,0,2,0,0,0,0,0,0,2,2,0,2,0,2,0,0,0,0,4,4,0,0,0,0,0,1,0,0,0,0,0,0,,,
"Aug 13, 2021 2:00 AM",6,6,0,2,0,2,2,0,2,2,0,2,0,0,0,0,1,1,0,0,0,0,0,0,0,0,2,0,0,0,0,0,0,,,
"Aug 13, 2021 3:00 AM",0,0,0,0,0,0,0,0,0,0,0,0,0,0,0,0,0,0,0,0,0,0,3,0,0,0,1,0,0,0,0,0,0,,,
"Aug 13, 2021 4:00 AM",2,1,1,0,0,0,1,1,0,0,0,0,0,0,0,0,0,0,0,1,1,0,0,0,0,0,1,0,0,0,0,0,0,,,
"Aug 13, 2021 5:00 AM",13,13,0,4,4,0,9,7,2,6,5,1,0,0,0,1,5,5,0,3,3,0,4,1,1,0,2,8,0,0,1,1,0,,,
"Aug 13, 2021 6:00 AM",26,14,12,30,17,13,33,16,17,29,16,13,6,2,4,3,14,13,1,8,7,1,14,6,4,2,10,29,0,3,2,2,0,,,
"Aug 13, 2021 7:00 AM",59,34,25,74,32,42,70,34,36,61,30,31,4,4,0,6,47,47,0,12,8,4,50,28,10,18,37,58,2,8,3,1,2,,,
"Aug 13, 2021 8:00 AM",107,79,28,105,44,61,83,39,44,86,46,40,15,13,2,18,68,68,0,22,12,10,69,23,12,11,33,78,3,6,1,1,0,,,
"Aug 13, 2021 9:00 AM",59,39,20,88,43,45,90,53,37,81,51,30,15,10,5,8,31,30,1,17,13,4,35,35,20,15,34,40,5,3,8,4,4,,,
"Aug 13, 2021 10:00 AM",45,26,19,79,29,50,69,38,31,75,42,33,20,16,4,8,26,26,0,10,8,2,26,34,20,14,23,35,5,8,4,4,0,,,
"Aug 13, 2021 11:00 AM",32,19,13,73,32,41,65,29,36,54,26,28,23,15,8,15,16,16,0,14,12,2,17,31,14,17,28,27,3,6,3,2,1,,,
"Aug 13, 2021 12:00 PM",59,26,33,79,39,40,102,58,44,82,48,34,18,10,8,14,16,16,0,19,19,0,16,35,23,12,32,24,3,3,6,5,1,,,
"Aug 13, 2021 1:00 PM",72,41,31,85,47,38,77,43,34,69,40,29,24,8,16,26,20,20,0,23,22,1,19,17,10,7,34,37,6,4,7,4,3,,,
"Aug 13, 2021 2:00 PM",88,39,49,57,32,25,97,53,44,74,42,32,22,9,13,23,25,25,0,25,23,2,27,31,25,6,29,24,3,4,6,4,2,,,
"Aug 13, 2021 3:00 PM",80,40,40,98,59,39,127,68,59,87,45,42,13,8,5,16,26,25,1,29,26,3,25,46,21,25,45,34,2,1,2,0,2,,,
"Aug 13, 2021 4:00 PM",87,38,49,102,56,46,129,64,65,94,48,46,31,17,14,16,23,22,1,42,41,1,24,64,35,29,52,43,4,2,5,4,1,,,
"Aug 13, 2021 5:00 PM",131,46,85,106,58,48,152,88,64,108,56,52,19,11,8,27,30,28,2,48,46,2,30,65,38,27,67,49,3,2,5,3,2,,,
"Aug 13, 2021 6:00 PM",103,41,62,106,63,43,134,74,60,74,49,25,32,18,14,22,24,23,1,49,49,0,23,55,35,20,73,49,6,2,7,2,5,,,
"Aug 13, 2021 7:00 PM",79,31,48,72,36,36,110,53,57,76,36,40,17,8,9,9,15,15,0,16,16,0,15,32,16,16,32,65,4,5,9,6,3,,,
"Aug 13, 2021 8:00 PM",45,24,21,52,23,29,68,30,38,57,24,33,12,6,6,6,23,23,0,16,12,4,21,24,8,16,35,26,4,3,6,5,1,,,
"Aug 13, 2021 9:00 PM",28,14,14,29,16,13,46,17,29,33,12,21,5,4,1,13,12,12,0,14,14,0,14,13,5,8,17,16,2,2,6,5,1,,,
"Aug 13, 2021 10:00 PM",18,5,13,17,11,6,34,11,23,20,8,12,1,0,1,5,3,3,0,12,11,1,4,6,3,3,13,11,2,2,3,2,1,,,
"Aug 13, 2021 11:00 PM",19,3,16,5,5,0,15,3,12,15,7,8,1,0,1,0,9,9,0,13,13,0,10,1,1,0,4,5,2,1,2,1,1,,,
"Aug 14, 2021 12:00 AM",26,9,17,0,0,0,5,5,0,6,4,2,1,0,1,5,5,5,0,5,4,1,5,2,1,1,8,8,0,0,0,0,0,,,
"Aug 14, 2021 1:00 AM",9,1,8,0,0,0,2,2,0,2,2,0,0,0,0,0,1,1,0,5,5,0,1,2,1,1,5,1,0,2,0,0,0,,,
"Aug 14, 2021 2:00 AM",8,7,1,3,2,1,4,2,2,5,2,3,0,0,0,0,1,1,0,4,4,0,1,2,2,0,2,2,0,0,0,0,0,,,
"Aug 14, 2021 3:00 AM",2,0,2,0,0,0,4,0,4,3,0,3,1,1,0,0,0,0,0,1,1,0,1,0,0,0,2,4,0,0,0,0,0,,,
"Aug 14, 2021 4:00 AM",1,1,0,0,0,0,0,0,0,0,0,0,0,0,0,0,0,0,0,0,0,0,0,0,0,0,0,0,0,0,0,0,0,,,
"Aug 14, 2021 5:00 AM",6,2,4,0,0,0,7,5,2,6,5,1,0,0,0,1,1,1,0,0,0,0,1,2,2,0,4,4,0,0,1,1,0,,,
"Aug 14, 2021 6:00 AM",13,5,8,2,2,0,11,8,3,7,5,2,0,0,0,2,4,3,1,2,2,0,3,5,5,0,11,7,1,3,1,0,1,,,
"Aug 14, 2021 7:00 AM",15,5,10,34,16,18,36,19,17,26,13,13,1,0,1,3,12,12,0,2,1,1,11,9,6,3,15,20,0,1,2,2,0,,,
"Aug 14, 2021 8:00 AM",19,9,10,49,31,18,51,39,12,54,41,13,2,2,0,10,9,9,0,9,8,1,12,16,7,9,23,14,0,2,2,1,1,,,
"Aug 14, 2021 9:00 AM",22,11,11,48,22,26,47,23,24,35,21,14,6,5,1,4,12,12,0,10,7,3,11,17,9,8,25,18,1,1,2,2,0,,,
"Aug 14, 2021 10:00 AM",29,18,11,48,21,27,42,18,24,41,17,24,5,2,3,7,13,13,0,4,3,1,12,13,4,9,17,19,2,1,1,1,0,,,
"Aug 14, 2021 11:00 AM",19,12,7,32,12,20,33,13,20,33,16,17,12,7,5,9,9,9,0,11,9,2,9,13,6,7,17,13,1,4,4,3,1,,,
"Aug 14, 2021 12:00 PM",30,15,15,72,31,41,53,40,13,56,40,16,16,6,10,13,12,10,2,17,14,3,13,13,10,3,39,19,4,2,1,0,1,,,
"Aug 14, 2021 1:00 PM",31,19,12,45,20,25,57,31,26,51,31,20,11,9,2,6,23,20,3,14,12,2,19,26,9,17,22,19,6,3,5,4,1,,,
"Aug 14, 2021 2:00 PM",39,24,15,27,11,16,32,18,14,20,14,6,10,4,6,8,8,8,0,13,11,2,10,18,7,11,19,15,1,4,3,1,2,,,
"Aug 14, 2021 3:00 PM",31,14,17,23,12,11,37,17,20,36,19,17,3,2,1,6,15,15,0,9,7,2,15,21,12,9,25,20,5,2,2,2,0,,,
"Aug 14, 2021 4:00 PM",26,17,9,38,21,17,58,39,19,51,29,22,18,9,9,12,15,15,0,14,14,0,15,30,19,11,19,16,2,3,6,5,1,,,
"Aug 14, 2021 5:00 PM",42,21,21,65,36,29,60,19,41,44,16,28,11,1,10,10,12,12,0,13,12,1,11,37,16,21,11,19,2,1,2,2,0,,,
"Aug 14, 2021 6:00 PM",34,17,17,37,27,10,43,24,19,40,19,21,6,3,3,5,4,4,0,11,8,3,4,21,12,9,11,11,3,0,0,0,0,,,
"Aug 14, 2021 7:00 PM",42,18,24,15,6,9,17,8,9,19,6,13,2,1,1,2,7,7,0,6,5,1,6,6,3,3,10,11,1,1,4,2,2,,,
"Aug 14, 2021 8:00 PM",26,11,15,17,13,4,19,3,16,14,6,8,5,3,2,6,7,7,0,5,5,0,8,6,1,5,9,13,1,1,5,2,3,,,
"Aug 14, 2021 9:00 PM",19,8,11,7,4,3,8,6,2,7,4,3,3,1,2,2,14,14,0,6,5,1,14,6,6,0,4,6,0,1,0,0,0,,,
"Aug 14, 2021 10:00 PM",7,3,4,3,3,0,8,1,7,8,4,4,0,0,0,2,1,1,0,7,7,0,2,2,2,0,4,10,1,0,0,0,0,,,
"Aug 14, 2021 11:00 PM",10,5,5,6,2,4,6,1,5,5,1,4,1,0,1,1,6,6,0,0,0,0,7,0,0,0,1,8,0,0,0,0,0,,,
"Aug 15, 2021 12:00 AM",8,2,6,1,0,1,0,0,0,3,0,3,2,1,1,0,5,5,0,2,2,0,5,0,0,0,5,5,1,0,2,1,1,,,
"Aug 15, 2021 1:00 AM",1,0,1,0,0,0,3,2,1,0,0,0,1,0,1,0,0,0,0,2,2,0,0,0,0,0,3,6,0,1,0,0,0,,,
"Aug 15, 2021 2:00 AM",5,2,3,4,1,3,4,1,3,7,1,6,0,0,0,1,2,2,0,5,5,0,2,0,0,0,1,3,0,0,0,0,0,,,
"Aug 15, 2021 3:00 AM",6,1,5,6,1,5,1,0,1,4,0,4,0,0,0,1,0,0,0,1,1,0,0,0,0,0,0,1,0,1,0,0,0,,,
"Aug 15, 2021 4:00 AM",5,4,1,0,0,0,0,0,0,0,0,0,0,0,0,0,1,0,1,2,2,0,0,0,0,0,2,1,0,0,0,0,0,,,
"Aug 15, 2021 5:00 AM",2,0,2,6,4,2,7,5,2,3,2,1,1,1,0,0,1,1,0,4,4,0,1,0,0,0,2,4,0,0,0,0,0,,,
"Aug 15, 2021 6:00 AM",9,5,4,7,4,3,15,6,9,14,6,8,0,0,0,0,2,2,0,1,0,1,2,4,2,2,7,8,0,0,0,0,0,,,
"Aug 15, 2021 7:00 AM",15,7,8,36,14,22,39,20,19,37,18,19,1,1,0,1,6,6,0,7,7,0,6,6,1,5,12,23,0,0,2,2,0,,,
"Aug 15, 2021 8:00 AM",21,6,15,37,21,16,46,31,15,40,23,17,5,2,3,12,11,11,0,6,5,1,12,10,9,1,19,23,1,10,4,2,2,,,
"Aug 15, 2021 9:00 AM",29,17,12,122,81,41,132,83,49,110,78,32,19,10,9,23,14,13,1,14,13,1,12,35,23,12,29,32,4,11,3,2,1,,,
"Aug 15, 2021 10:00 AM",46,27,19,128,61,67,125,60,65,116,59,57,19,7,12,7,21,20,1,16,15,1,20,45,20,25,49,31,7,3,5,4,1,,,
"Aug 15, 2021 11:00 AM",65,33,32,182,103,79,170,104,66,166,107,59,17,14,3,22,26,26,0,39,33,6,31,70,44,26,48,36,5,5,4,2,2,,,
"Aug 15, 2021 12:00 PM",60,39,21,178,94,84,168,82,86,157,76,81,26,15,11,24,44,43,1,24,22,2,46,51,27,24,42,45,13,7,5,4,1,,,
"Aug 15, 2021 1:00 PM",47,21,26,145,64,81,151,80,71,139,76,63,32,17,15,23,30,29,1,19,17,2,28,51,37,14,50,44,8,2,9,4,5,,,
"Aug 15, 2021 2:00 PM",60,30,30,180,90,90,168,101,67,137,80,57,23,9,14,32,15,14,1,15,13,2,14,84,51,33,41,43,4,3,12,7,5,,,
"Aug 15, 2021 3:00 PM",47,29,18,162,89,73,170,84,86,156,98,58,32,18,14,9,22,21,1,14,13,1,28,68,33,35,41,48,5,5,5,4,1,,,
"Aug 15, 2021 4:00 PM",75,38,37,113,49,64,164,70,94,124,47,77,37,14,23,19,20,18,2,14,12,2,19,51,15,36,54,46,4,2,6,3,3,,,
"Aug 15, 2021 5:00 PM",53,25,28,85,50,35,114,60,54,77,44,33,10,0,10,19,11,11,0,10,10,0,13,52,24,28,37,36,1,1,9,6,3,,,
"Aug 15, 2021 6:00 PM",46,24,22,59,30,29,89,36,53,59,27,32,13,8,5,21,9,8,1,15,14,1,11,41,21,20,24,42,2,4,3,2,1,,,
"Aug 15, 2021 7:00 PM",55,21,34,53,31,22,60,25,35,45,23,22,13,5,8,9,12,12,0,3,1,2,11,34,16,18,21,31,3,2,5,4,1,,,
"Aug 15, 2021 8:00 PM",24,9,15,27,13,14,36,16,20,24,11,13,8,2,6,8,5,5,0,12,10,2,5,9,3,6,11,24,1,0,3,1,2,,,
"Aug 15, 2021 9:00 PM",22,13,9,17,9,8,28,12,16,23,6,17,0,0,0,6,8,8,0,5,5,0,11,17,9,8,12,12,3,0,3,2,1,,,
"Aug 15, 2021 10:00 PM",12,0,12,13,3,10,20,7,13,11,2,9,5,1,4,2,5,5,0,2,2,0,5,6,3,3,7,10,1,4,0,0,0,,,
"Aug 15, 2021 11:00 PM",9,4,5,2,1,1,11,7,4,2,0,2,1,0,1,3,8,7,1,3,3,0,10,0,0,0,3,6,1,0,0,0,0,,,
"Aug 16, 2021 12:00 AM",4,2,2,0,0,0,1,0,1,1,0,1,0,0,0,0,3,3,0,4,4,0,2,3,1,2,1,6,0,2,1,0,1,,,
"Aug 16, 2021 1:00 AM",4,0,4,0,0,0,1,1,0,0,0,0,2,2,0,0,0,0,0,3,2,1,0,0,0,0,1,2,0,0,0,0,0,,,
"Aug 16, 2021 2:00 AM",1,1,0,1,0,1,2,0,2,2,0,2,0,0,0,2,1,1,0,3,3,0,1,0,0,0,0,0,0,0,0,0,0,,,
"Aug 16, 2021 3:00 AM",0,0,0,0,0,0,2,1,1,1,0,1,0,0,0,0,0,0,0,0,0,0,0,0,0,0,2,0,0,0,0,0,0,,,
"Aug 16, 2021 4:00 AM",1,1,0,0,0,0,1,1,0,0,0,0,0,0,0,0,1,1,0,0,0,0,1,0,0,0,1,1,1,0,0,0,0,,,
"Aug 16, 2021 5:00 AM",5,5,0,2,0,2,8,4,4,7,4,3,2,2,0,1,3,3,0,1,1,0,3,2,1,1,3,13,0,0,0,0,0,,,
"Aug 16, 2021 6:00 AM",30,23,7,11,7,4,21,12,9,11,8,3,2,1,1,2,19,19,0,4,3,1,22,6,5,1,15,31,0,1,2,2,0,,,
"Aug 16, 2021 7:00 AM",69,40,29,64,29,35,90,43,47,62,29,33,10,7,3,6,42,42,0,22,16,6,46,25,11,14,36,65,1,5,0,0,0,,,
"Aug 16, 2021 8:00 AM",111,79,32,54,17,37,82,37,45,59,33,26,9,5,4,12,76,76,0,15,11,4,76,34,15,19,37,71,2,3,6,4,2,,,
"Aug 16, 2021 9:00 AM",68,46,22,44,24,20,49,31,18,52,35,17,21,15,6,16,38,38,0,18,13,5,37,19,12,7,19,38,1,3,2,2,0,,,
"Aug 16, 2021 10:00 AM",41,25,16,57,31,26,44,24,20,50,28,22,18,11,7,10,24,24,0,11,7,4,25,16,12,4,20,17,1,2,2,1,1,,,
"Aug 16, 2021 11:00 AM",45,28,17,68,30,38,70,40,30,60,35,25,26,17,9,17,14,13,1,10,9,1,13,24,17,7,20,21,6,1,7,6,1,,,
"Aug 16, 2021 12:00 PM",51,25,26,60,34,26,78,37,41,66,37,29,26,18,8,15,19,18,1,8,8,0,17,12,7,5,19,29,3,1,6,4,2,,,
"Aug 16, 2021 1:00 PM",48,27,21,65,31,34,61,30,31,53,29,24,22,11,11,9,21,21,0,14,13,1,24,16,8,8,22,35,3,2,5,4,1,,,
"Aug 16, 2021 2:00 PM",57,32,25,46,24,22,65,26,39,51,22,29,21,13,8,20,11,10,1,15,15,0,12,24,20,4,11,27,2,3,6,5,1,,,
"Aug 16, 2021 3:00 PM",70,29,41,48,34,14,72,43,29,50,29,21,27,10,17,28,27,26,1,21,18,3,23,37,26,11,27,36,4,5,3,0,3,,,
"Aug 16, 2021 4:00 PM",78,27,51,65,39,26,80,46,34,63,37,26,27,4,23,29,23,21,2,33,32,1,21,38,24,14,36,40,6,6,10,8,2,,,
"Aug 16, 2021 5:00 PM",117,9,108,95,61,34,140,83,57,110,58,52,29,8,21,23,37,37,0,60,59,1,41,40,28,12,73,52,7,8,12,9,3,,,
"Aug 16, 2021 6:00 PM",94,19,75,93,58,35,126,73,53,86,51,35,24,7,17,29,23,23,0,64,62,2,23,44,25,19,88,42,9,5,3,3,0,,,
"Aug 16, 2021 7:00 PM",94,33,61,48,27,21,87,48,39,58,34,24,8,5,3,24,15,15,0,22,20,2,15,42,26,16,33,37,2,3,3,1,2,,,
"Aug 16, 2021 8:00 PM",57,20,37,38,15,23,70,34,36,40,17,23,5,3,2,11,13,13,0,19,19,0,13,18,9,9,22,29,5,3,4,3,1,,,
"Aug 16, 2021 9:00 PM",35,9,26,26,12,14,18,5,13,17,6,11,4,4,0,9,11,10,1,9,9,0,9,3,0,3,9,6,2,1,8,3,5,,,
"Aug 16, 2021 10:00 PM",19,6,13,6,5,1,10,3,7,8,3,5,2,1,1,1,7,7,0,8,7,1,8,2,2,0,9,5,2,2,4,4,0,,,
"Aug 16, 2021 11:00 PM",8,4,4,2,1,1,7,3,4,7,2,5,3,3,0,2,1,1,0,8,8,0,1,3,2,1,6,3,1,0,4,3,1,,,
"Aug 17, 2021 12:00 AM",7,2,5,0,0,0,0,0,0,3,2,1,1,0,1,0,1,1,0,0,0,0,1,1,1,0,3,2,2,0,1,1,0,,,
"Aug 17, 2021 1:00 AM",1,1,0,0,0,0,0,0,0,1,1,0,0,0,0,0,0,0,0,1,1,0,0,0,0,0,0,0,0,0,0,0,0,,,
"Aug 17, 2021 2:00 AM",4,2,2,1,1,0,4,0,4,2,0,2,0,0,0,0,0,0,0,2,2,0,0,0,0,0,1,2,0,0,0,0,0,,,
"Aug 17, 2021 3:00 AM",1,0,1,0,0,0,2,0,2,1,0,1,0,0,0,1,0,0,0,0,0,0,1,0,0,0,0,1,0,0,0,0,0,,,
"Aug 17, 2021 4:00 AM",0,0,0,0,0,0,1,1,0,0,0,0,0,0,0,1,0,0,0,0,0,0,0,0,0,0,1,0,0,0,0,0,0,,,
"Aug 17, 2021 5:00 AM",5,5,0,1,1,0,9,7,2,8,6,2,1,0,1,0,2,2,0,1,1,0,2,2,1,1,6,7,0,0,0,0,0,,,
"Aug 17, 2021 6:00 AM",33,23,10,20,12,8,31,17,14,19,15,4,4,3,1,3,14,14,0,9,7,2,14,5,3,2,14,34,2,5,2,2,0,,,
"Aug 17, 2021 7:00 AM",79,45,34,83,34,49,88,38,50,67,34,33,10,9,1,14,56,56,0,17,14,3,55,31,19,12,39,68,0,7,4,4,0,,,
"Aug 17, 2021 8:00 AM",121,89,32,63,26,37,123,58,65,80,45,35,8,7,1,13,60,60,0,22,15,7,64,43,19,24,48,97,4,9,6,5,1,,,
"Aug 17, 2021 9:00 AM",72,48,24,39,17,22,55,31,24,42,27,15,16,12,4,10,32,32,0,11,8,3,35,22,11,11,25,49,2,10,6,4,2,,,
"Aug 17, 2021 10:00 AM",51,33,18,34,23,11,48,28,20,39,30,9,9,1,8,4,24,24,0,13,7,6,22,19,6,13,19,18,1,2,6,4,2,,,
"Aug 17, 2021 11:00 AM",48,33,15,35,14,21,51,22,29,41,17,24,13,10,3,11,17,17,0,5,5,0,18,16,5,11,19,31,5,1,9,8,1,,,
"Aug 17, 2021 12:00 PM",63,33,30,55,27,28,45,31,14,47,31,16,15,8,7,10,18,18,0,14,12,2,17,16,12,4,30,24,5,1,7,4,3,,,
"Aug 17, 2021 1:00 PM",70,36,34,60,33,27,58,29,29,60,32,28,25,10,15,21,18,17,1,10,9,1,18,21,12,9,29,28,4,4,3,2,1,,,
"Aug 17, 2021 2:00 PM",59,31,28,44,20,24,49,23,26,39,20,19,18,14,4,28,19,19,0,16,15,1,21,15,9,6,13,20,6,4,3,2,1,,,
"Aug 17, 2021 3:00 PM",72,37,35,55,26,29,66,35,31,53,23,30,23,10,13,18,16,16,0,21,19,2,16,17,8,9,28,36,5,4,5,4,1,,,
"Aug 17, 2021 4:00 PM",97,37,60,60,40,20,72,33,39,53,29,24,33,14,19,22,25,21,4,34,32,2,24,43,21,22,46,41,4,3,3,2,1,,,
"Aug 17, 2021 5:00 PM",168,54,114,106,56,50,135,82,53,88,49,39,22,4,18,22,32,32,0,56,54,2,33,42,31,11,83,57,8,4,7,5,2,,,
"Aug 17, 2021 6:00 PM",132,55,77,140,90,50,204,121,83,128,83,45,25,11,14,30,26,26,0,43,42,1,24,60,40,20,94,61,8,7,6,3,3,,,
"Aug 17, 2021 7:00 PM",95,35,60,113,66,47,134,81,53,98,57,41,27,8,19,17,25,25,0,30,28,2,26,51,33,18,63,51,3,5,7,7,0,,,
"Aug 17, 2021 8:00 PM",62,26,36,90,41,49,132,54,78,63,23,40,20,10,10,15,20,20,0,30,29,1,20,47,16,31,31,35,2,5,9,4,5,,,
"Aug 17, 2021 9:00 PM",38,8,30,33,21,12,40,9,31,19,7,12,11,8,3,8,10,10,0,20,20,0,9,10,7,3,18,17,2,3,2,2,0,,,
"Aug 17, 2021 10:00 PM",19,6,13,10,7,3,14,5,9,11,4,7,6,0,6,3,4,4,0,9,8,1,5,3,3,0,12,10,3,2,1,0,1,,,
"Aug 17, 2021 11:00 PM",8,2,6,4,4,0,7,2,5,7,3,4,2,0,2,0,3,3,0,4,3,1,3,1,1,0,7,7,1,0,1,0,1,,,
"Aug 18, 2021 12:00 AM",9,1,8,0,0,0,0,0,0,1,1,0,1,1,0,1,1,1,0,2,2,0,1,1,1,0,5,2,0,0,2,1,1,,,
"Aug 18, 2021 1:00 AM",3,0,3,1,1,0,8,0,8,4,0,4,0,0,0,0,1,1,0,0,0,0,1,0,0,0,2,2,0,0,0,0,0,,,
"Aug 18, 2021 2:00 AM",2,2,0,0,0,0,0,0,0,2,2,0,0,0,0,0,0,0,0,0,0,0,0,0,0,0,1,0,1,0,0,0,0,,,
"Aug 18, 2021 3:00 AM",1,0,1,0,0,0,1,1,0,0,0,0,0,0,0,0,1,1,0,0,0,0,2,0,0,0,1,0,0,0,0,0,0,,,
"Aug 18, 2021 4:00 AM",2,1,1,0,0,0,0,0,0,0,0,0,1,1,0,2,0,0,0,0,0,0,0,0,0,0,0,0,0,0,0,0,0,,,
"Aug 18, 2021 5:00 AM",8,8,0,6,4,2,8,6,2,8,6,2,1,0,1,0,3,3,0,4,3,1,3,2,0,2,5,12,0,0,0,0,0,,,
"Aug 18, 2021 6:00 AM",31,22,9,20,10,10,22,12,10,22,13,9,9,7,2,3,18,17,1,6,5,1,17,8,3,5,15,29,2,3,1,1,0,,,
"Aug 18, 2021 7:00 AM",75,47,28,90,46,44,100,49,51,82,43,39,11,9,2,8,57,57,0,16,14,2,63,33,20,13,42,74,3,9,3,3,0,,,
"Aug 18, 2021 8:00 AM",130,105,25,69,22,47,114,54,60,79,38,41,18,16,2,17,80,79,1,22,16,6,81,36,14,22,49,89,4,5,3,2,1,,,
"Aug 18, 2021 9:00 AM",79,58,21,69,29,40,91,45,46,70,38,32,14,8,6,11,31,31,0,20,13,7,32,39,20,19,33,61,4,4,8,6,2,,,
"Aug 18, 2021 10:00 AM",62,35,27,71,39,32,73,41,32,55,33,22,28,18,10,12,26,26,0,15,10,5,25,25,12,13,21,24,1,1,0,0,0,,,
"Aug 18, 2021 11:00 AM",63,34,29,72,38,34,73,43,30,60,39,21,17,14,3,19,16,16,0,15,14,1,17,16,11,5,26,29,2,3,5,4,1,,,
"Aug 18, 2021 12:00 PM",66,32,34,76,37,39,76,39,37,66,32,34,32,12,20,21,21,19,2,20,16,4,20,23,8,15,31,38,8,4,12,10,2,,,
"Aug 18, 2021 1:00 PM",75,43,32,87,41,46,99,48,51,93,45,48,23,13,10,20,19,19,0,23,21,2,17,26,14,12,26,39,3,2,5,1,4,,,
"Aug 18, 2021 2:00 PM",56,33,23,82,48,34,72,46,26,59,33,26,32,16,16,12,24,24,0,20,19,1,26,16,9,7,26,27,8,7,10,5,5,,,
"Aug 18, 2021 3:00 PM",62,28,34,62,37,25,87,52,35,59,37,22,20,10,10,29,22,21,1,23,16,7,22,26,20,6,29,25,3,8,8,4,4,,,
"Aug 18, 2021 4:00 PM",99,41,58,70,41,29,80,30,50,57,35,22,34,21,13,25,24,15,9,33,30,3,20,27,18,9,43,51,5,1,6,2,4,,,
"Aug 18, 2021 5:00 PM",154,48,106,89,50,39,114,65,49,94,54,40,18,6,12,24,21,21,0,52,50,2,21,36,25,11,84,59,5,3,5,4,1,,,
"Aug 18, 2021 6:00 PM",115,37,78,103,67,36,154,85,69,116,63,53,15,5,10,17,40,39,1,65,60,5,38,54,34,20,80,54,9,9,8,6,2,,,
"Aug 18, 2021 7:00 PM",83,37,46,115,63,52,131,77,54,95,56,39,21,8,13,15,35,33,2,41,40,1,31,60,37,23,57,40,3,4,6,4,2,,,
"Aug 18, 2021 8:00 PM",72,24,48,84,49,35,98,39,59,75,33,42,15,9,6,13,18,18,0,25,23,2,20,23,9,14,34,32,8,0,4,2,2,,,
"Aug 18, 2021 9:00 PM",44,17,27,47,16,31,55,16,39,42,12,30,4,1,3,12,14,14,0,17,16,1,14,23,9,14,21,22,4,1,7,3,4,,,
"Aug 18, 2021 10:00 PM",26,7,19,15,8,7,9,2,7,15,4,11,9,4,5,5,11,10,1,17,17,0,10,2,2,0,15,12,2,2,1,1,0,,,
"Aug 18, 2021 11:00 PM",15,3,12,3,0,3,10,5,5,7,1,6,1,0,1,1,3,3,0,7,5,2,3,3,1,2,12,6,1,0,3,3,0,,,
"Aug 19, 2021 12:00 AM",5,2,3,0,0,0,2,2,0,3,2,1,2,0,2,4,0,0,0,7,6,1,0,2,2,0,7,2,0,0,1,1,0,,,
"Aug 19, 2021 1:00 AM",6,2,4,4,3,1,3,2,1,3,2,1,2,0,2,0,1,1,0,1,1,0,1,0,0,0,1,3,0,0,1,1,0,,,
"Aug 19, 2021 2:00 AM",5,2,3,1,1,0,1,0,1,1,0,1,0,0,0,1,2,0,2,2,1,1,2,0,0,0,1,1,0,0,2,1,1,,,
"Aug 19, 2021 3:00 AM",1,1,0,0,0,0,0,0,0,0,0,0,0,0,0,0,0,0,0,0,0,0,1,0,0,0,1,0,0,0,0,0,0,,,
"Aug 19, 2021 4:00 AM",0,0,0,0,0,0,1,1,0,0,0,0,0,0,0,0,2,2,0,0,0,0,2,0,0,0,1,0,0,0,1,0,1,,,
"Aug 19, 2021 5:00 AM",8,8,0,1,1,0,10,6,4,8,6,2,1,1,0,0,3,3,0,0,0,0,2,1,0,1,8,7,0,0,0,0,0,,,
"Aug 19, 2021 6:00 AM",40,27,13,19,8,11,28,16,12,16,9,7,5,4,1,2,16,15,1,6,5,1,16,8,5,3,14,25,3,1,3,3,0,,,
"Aug 19, 2021 7:00 AM",73,46,27,79,37,42,83,37,46,59,31,28,10,9,1,14,50,50,0,18,16,2,54,34,16,18,31,53,1,8,2,2,0,,,
"Aug 19, 2021 8:00 AM",111,74,37,54,24,30,101,51,50,86,45,41,14,12,2,14,60,59,1,19,14,5,58,40,19,21,47,88,3,6,4,3,1,,,
"Aug 19, 2021 9:00 AM",56,43,13,58,29,29,94,50,44,72,44,28,11,8,3,7,45,45,0,15,8,7,46,29,20,9,41,54,4,2,3,3,0,,,
"Aug 19, 2021 10:00 AM",39,26,13,57,30,27,88,44,44,57,38,19,13,5,8,8,18,17,1,19,16,3,16,35,18,17,29,19,0,2,6,3,3,,,
"Aug 19, 2021 11:00 AM",29,20,9,58,27,31,57,28,29,58,27,31,12,8,4,10,13,13,0,8,7,1,13,12,2,10,16,22,3,5,4,3,1,,,
"Aug 19, 2021 12:00 PM",45,21,24,45,19,26,56,21,35,41,17,24,15,10,5,17,17,16,1,13,11,2,14,23,15,8,16,30,3,2,1,1,0,,,
"Aug 19, 2021 1:00 PM",59,28,31,41,23,18,75,42,33,43,28,15,19,8,11,11,17,16,1,10,8,2,18,20,7,13,27,27,3,0,5,3,2,,,
"Aug 19, 2021 2:00 PM",47,26,21,57,34,23,53,32,21,47,32,15,17,6,11,14,21,21,0,18,17,1,21,29,20,9,25,17,6,1,7,5,2,,,
"Aug 19, 2021 3:00 PM",52,19,33,72,39,33,64,38,26,52,31,21,24,5,19,14,12,12,0,17,15,2,13,24,12,12,25,38,3,2,8,5,3,,,
"Aug 19, 2021 4:00 PM",88,42,46,87,45,42,91,48,43,89,45,44,27,13,14,22,22,21,1,31,29,2,25,21,17,4,42,44,2,1,5,4,1,,,
"Aug 19, 2021 5:00 PM",137,40,97,119,53,66,160,111,49,157,108,49,32,18,14,26,30,29,1,47,45,2,34,68,45,23,74,63,8,6,17,12,5,,,
"Aug 19, 2021 6:00 PM",100,34,66,130,82,48,143,91,52,118,78,40,20,9,11,21,28,28,0,53,51,2,30,47,39,8,94,55,3,12,12,8,4,,,
"Aug 19, 2021 7:00 PM",76,31,45,90,38,52,135,79,56,83,44,39,14,9,5,17,26,24,2,40,38,2,25,38,26,12,56,47,5,1,6,4,2,,,
"Aug 19, 2021 8:00 PM",63,31,32,70,40,30,83,35,48,67,32,35,13,4,9,18,18,18,0,22,19,3,17,27,16,11,31,22,2,4,2,2,0,,,
"Aug 19, 2021 9:00 PM",42,13,29,44,28,16,54,15,39,49,22,27,4,1,3,6,16,15,1,20,20,0,13,15,11,4,19,27,2,4,2,0,2,,,
"Aug 19, 2021 10:00 PM",29,11,18,39,32,7,41,9,32,41,10,31,6,1,5,5,5,5,0,16,15,1,5,21,13,8,15,18,1,1,2,2,0,,,
"Aug 19, 2021 11:00 PM",29,10,19,22,16,6,27,5,22,26,2,24,3,3,0,4,7,7,0,9,7,2,6,4,1,3,4,14,0,1,1,1,0,,,
"Aug 20, 2021 12:00 AM",11,4,7,1,0,1,2,1,1,2,0,2,0,0,0,3,1,1,0,3,3,0,1,5,2,3,6,4,1,0,1,1,0,,,
"Aug 20, 2021 1:00 AM",9,3,6,4,3,1,3,2,1,4,2,2,2,0,2,0,0,0,0,4,3,1,0,0,0,0,5,1,1,1,0,0,0,,,
"Aug 20, 2021 2:00 AM",4,2,2,0,0,0,0,0,0,1,0,1,0,0,0,0,0,0,0,0,0,0,0,0,0,0,2,2,1,0,0,0,0,,,
"Aug 20, 2021 3:00 AM",0,0,0,0,0,0,2,0,2,1,0,1,0,0,0,0,0,0,0,1,0,1,1,0,0,0,0,0,0,0,0,0,0,,,
"Aug 20, 2021 4:00 AM",0,0,0,0,0,0,2,2,0,0,0,0,0,0,0,0,1,1,0,0,0,0,1,0,0,0,4,0,0,0,0,0,0,,,
"Aug 20, 2021 5:00 AM",9,9,0,5,2,3,11,7,4,8,6,2,0,0,0,1,5,5,0,2,2,0,4,2,2,0,2,7,0,0,0,0,0,,,
"Aug 20, 2021 6:00 AM",33,20,13,18,8,10,27,11,16,17,8,9,8,5,3,3,8,7,1,5,4,1,7,3,1,2,15,26,3,2,2,2,0,,,
"Aug 20, 2021 7:00 AM",52,28,24,62,33,29,70,38,32,43,28,15,8,7,1,6,40,40,0,12,9,3,42,26,18,8,33,55,2,5,5,4,1,,,
"Aug 20, 2021 8:00 AM",92,60,32,64,26,38,82,39,43,65,36,29,7,7,0,7,42,41,1,17,12,5,44,24,7,17,33,68,2,2,4,3,1,,,
"Aug 20, 2021 9:00 AM",65,41,24,45,19,26,65,34,31,51,28,23,9,7,2,8,29,29,0,20,13,7,31,28,19,9,24,37,0,8,9,5,4,,,
"Aug 20, 2021 10:00 AM",39,25,14,65,40,25,81,56,25,67,44,23,8,5,3,4,16,15,1,12,9,3,18,33,25,8,32,26,4,3,6,5,1,,,
"Aug 20, 2021 11:00 AM",40,26,14,71,31,40,59,32,27,64,33,31,8,5,3,9,21,21,0,9,6,3,22,33,16,17,18,23,3,2,6,3,3,,,
"Aug 20, 2021 12:00 PM",76,34,42,63,36,27,69,31,38,53,25,28,17,10,7,15,21,20,1,9,8,1,25,36,20,16,21,27,5,4,7,3,4,,,
"Aug 20, 2021 1:00 PM",60,31,29,49,19,30,65,26,39,52,18,34,16,7,9,15,19,18,1,22,20,2,19,21,11,10,20,26,4,0,10,5,5,,,
"Aug 20, 2021 2:00 PM",54,23,31,42,14,28,51,22,29,26,11,15,7,4,3,11,22,22,0,20,16,4,23,23,13,10,23,26,4,3,7,5,2,,,
"Aug 20, 2021 3:00 PM",65,29,36,38,20,18,41,21,20,31,20,11,15,7,8,14,18,17,1,21,16,5,15,20,8,12,28,32,5,3,4,3,1,,,
"Aug 20, 2021 4:00 PM",70,37,33,47,28,19,57,31,26,51,27,24,15,2,13,11,13,13,0,24,21,3,13,20,11,9,40,32,5,2,2,1,1,,,
"Aug 20, 2021 5:00 PM",108,38,70,54,28,26,69,40,29,60,30,30,17,6,11,23,14,14,0,41,39,2,15,26,23,3,43,37,4,4,6,4,2,,,
"Aug 20, 2021 6:00 PM",102,35,67,48,32,16,75,45,30,58,30,28,10,3,7,19,23,23,0,40,38,2,22,31,26,5,46,35,1,1,6,4,2,,,
"Aug 20, 2021 7:00 PM",69,35,34,26,16,10,69,35,34,45,23,22,16,10,6,7,18,17,1,12,11,1,16,22,13,9,20,25,7,0,5,4,1,,,
"Aug 20, 2021 8:00 PM",57,25,32,26,10,16,46,15,31,31,10,21,11,3,8,7,9,9,0,14,9,5,9,17,13,4,14,26,0,4,6,4,2,,,
"Aug 20, 2021 9:00 PM",15,4,11,21,10,11,20,7,13,15,5,10,4,1,3,10,5,5,0,12,12,0,5,10,6,4,10,14,1,0,2,1,1,,,
"Aug 20, 2021 10:00 PM",16,7,9,10,8,2,15,5,10,10,5,5,1,1,0,4,3,3,0,8,6,2,3,1,1,0,12,13,1,3,2,2,0,,,
"Aug 20, 2021 11:00 PM",26,10,16,9,4,5,8,2,6,3,0,3,2,2,0,2,4,4,0,3,3,0,4,2,1,1,5,8,1,0,3,2,1,,,
"Aug 21, 2021 12:00 AM",7,3,4,0,0,0,3,1,2,4,2,2,4,2,2,1,1,1,0,5,5,0,2,3,2,1,6,4,0,0,3,2,1,,,
"Aug 21, 2021 1:00 AM",5,1,4,1,0,1,3,1,2,1,1,0,4,1,3,0,0,0,0,3,3,0,0,0,0,0,7,4,0,0,0,0,0,,,
"Aug 21, 2021 2:00 AM",6,2,4,2,2,0,7,6,1,3,2,1,0,0,0,0,1,1,0,3,3,0,1,1,0,1,8,1,0,0,0,0,0,,,
"Aug 21, 2021 3:00 AM",4,0,4,0,0,0,1,1,0,1,1,0,0,0,0,1,0,0,0,2,2,0,3,1,1,0,3,2,0,1,0,0,0,,,
"Aug 21, 2021 4:00 AM",2,1,1,2,2,0,1,1,0,2,1,1,0,0,0,0,0,0,0,1,1,0,0,0,0,0,2,0,0,0,0,0,0,,,
"Aug 21, 2021 5:00 AM",3,1,2,0,0,0,1,1,0,1,1,0,0,0,0,1,3,3,0,0,0,0,3,1,1,0,2,3,0,0,1,1,0,,,
"Aug 21, 2021 6:00 AM",8,3,5,2,2,0,4,4,0,3,3,0,2,2,0,0,5,4,1,0,0,0,4,1,1,0,2,2,3,0,3,2,1,,,
"Aug 21, 2021 7:00 AM",12,3,9,5,1,4,11,8,3,10,7,3,3,1,2,4,6,6,0,3,3,0,6,2,2,0,6,6,0,1,4,3,1,,,
"Aug 21, 2021 8:00 AM",21,9,12,26,15,11,24,15,9,21,12,9,1,1,0,8,12,12,0,7,7,0,10,5,4,1,10,7,0,4,7,3,4,,,
"Aug 21, 2021 9:00 AM",26,14,12,35,17,18,36,22,14,31,20,11,7,4,3,9,10,10,0,10,10,0,9,6,3,3,19,21,2,3,7,2,5,,,
"Aug 21, 2021 10:00 AM",34,18,16,37,20,17,39,22,17,35,22,13,5,4,1,7,9,9,0,8,8,0,9,11,5,6,15,10,6,1,4,1,3,,,
"Aug 21, 2021 11:00 AM",44,23,21,50,32,18,72,50,22,56,40,16,4,2,2,18,14,14,0,12,9,3,15,22,13,9,34,20,3,3,0,0,0,,,
"Aug 21, 2021 12:00 PM",44,22,22,94,28,66,111,75,36,86,57,29,20,12,8,13,16,16,0,12,10,2,16,38,21,17,36,26,6,2,9,7,2,,,
"Aug 21, 2021 1:00 PM",42,23,19,78,34,44,121,58,63,71,36,35,9,7,2,14,12,12,0,17,12,5,10,29,13,16,30,24,9,3,7,6,1,,,
"Aug 21, 2021 2:00 PM",30,11,19,92,54,38,83,36,47,64,35,29,18,12,6,7,14,14,0,8,8,0,10,17,7,10,14,22,6,4,6,4,2,,,
"Aug 21, 2021 3:00 PM",29,12,17,36,16,20,32,14,18,16,7,9,19,10,9,11,9,7,2,6,5,1,7,6,3,3,14,15,2,5,8,4,4,,,
"Aug 21, 2021 4:00 PM",31,20,11,21,11,10,29,12,17,25,10,15,15,7,8,12,7,7,0,5,5,0,6,7,1,6,11,14,1,2,0,0,0,,,
"Aug 21, 2021 5:00 PM",32,16,16,50,31,19,36,16,20,42,19,23,10,6,4,11,8,8,0,9,9,0,9,22,11,11,14,23,0,1,7,5,2,,,
"Aug 21, 2021 6:00 PM",37,18,19,47,29,18,50,21,29,50,21,29,7,4,3,13,14,12,2,12,9,3,10,19,10,9,15,20,1,2,1,1,0,,,
"Aug 21, 2021 7:00 PM",32,16,16,42,24,18,40,21,19,32,16,16,8,4,4,12,8,8,0,3,2,1,9,18,7,11,15,26,2,2,5,2,3,,,
"Aug 21, 2021 8:00 PM",35,13,22,30,14,16,26,14,12,21,10,11,9,4,5,6,6,5,1,5,4,1,5,15,11,4,7,14,1,0,2,2,0,,,
"Aug 21, 2021 9:00 PM",32,10,22,9,6,3,16,3,13,12,4,8,1,0,1,3,6,6,0,4,4,0,6,5,3,2,3,10,1,0,3,3,0,,,
"Aug 21, 2021 10:00 PM",16,7,9,11,6,5,14,8,6,14,10,4,2,1,1,0,4,4,0,7,6,1,5,2,2,0,4,9,2,3,1,0,1,,,
"Aug 21, 2021 11:00 PM",16,8,8,3,1,2,6,1,5,3,1,2,7,6,1,2,5,5,0,1,1,0,4,0,0,0,6,7,0,0,1,1,0,,,
"Aug 22, 2021 12:00 AM",9,4,5,0,0,0,0,0,0,7,2,5,6,5,1,0,3,3,0,7,7,0,2,2,2,0,8,8,0,0,1,1,0,,,
"Aug 22, 2021 1:00 AM",6,2,4,8,8,0,8,6,2,7,6,1,2,0,2,0,0,0,0,5,5,0,0,1,1,0,7,0,0,1,1,0,1,,,
"Aug 22, 2021 2:00 AM",8,4,4,4,0,4,5,1,4,4,1,3,0,0,0,0,0,0,0,3,3,0,1,1,1,0,3,3,0,0,2,2,0,,,
"Aug 22, 2021 3:00 AM",2,1,1,1,1,0,0,0,0,0,0,0,0,0,0,1,0,0,0,3,3,0,0,0,0,0,1,1,0,0,0,0,0,,,
"Aug 22, 2021 4:00 AM",1,1,0,2,2,0,2,2,0,0,0,0,0,0,0,1,1,1,0,0,0,0,1,0,0,0,2,0,1,0,1,1,0,,,
"Aug 22, 2021 5:00 AM",4,2,2,2,0,2,2,2,0,3,0,3,0,0,0,0,5,5,0,1,1,0,5,1,1,0,2,5,0,0,1,1,0,,,
"Aug 22, 2021 6:00 AM",6,2,4,12,10,2,8,6,2,7,6,1,0,0,0,0,7,7,0,1,1,0,8,5,4,1,6,10,0,4,2,2,0,,,
"Aug 22, 2021 7:00 AM",23,5,18,25,11,14,34,23,11,23,14,9,1,1,0,2,8,8,0,9,7,2,11,11,7,4,12,20,1,3,2,2,0,,,
"Aug 22, 2021 8:00 AM",29,5,24,73,50,23,68,45,23,80,56,24,7,4,3,13,12,12,0,5,5,0,11,17,10,7,27,36,1,13,1,1,0,,,
"Aug 22, 2021 9:00 AM",36,19,17,139,96,43,126,86,40,130,82,48,14,8,6,20,23,23,0,12,9,3,28,40,31,9,25,36,5,13,7,4,3,,,
"Aug 22, 2021 10:00 AM",50,24,26,160,78,82,154,84,70,136,76,60,21,9,12,11,19,19,0,12,10,2,19,46,19,27,41,35,8,14,5,4,1,,,
"Aug 22, 2021 11:00 AM",65,35,30,173,85,88,168,100,68,151,84,67,37,27,10,17,31,31,0,18,16,2,32,58,34,24,56,58,16,6,16,11,5,,,
"Aug 22, 2021 12:00 PM",89,45,44,219,127,92,214,138,76,186,117,69,25,13,12,24,17,17,0,15,14,1,21,51,37,14,49,61,12,6,7,4,3,,,
"Aug 22, 2021 1:00 PM",73,33,40,183,74,109,229,114,115,176,94,82,27,17,10,21,30,30,0,26,23,3,30,72,42,30,56,53,11,4,7,4,3,,,
"Aug 22, 2021 2:00 PM",76,42,34,171,83,88,226,95,131,145,58,87,26,13,13,34,27,27,0,20,13,7,26,71,37,34,58,62,2,5,5,2,3,,,
"Aug 22, 2021 3:00 PM",53,29,24,170,86,84,162,76,86,126,64,62,36,11,25,22,19,17,2,19,17,2,15,54,17,37,38,43,4,4,9,7,2,,,
"Aug 22, 2021 4:00 PM",45,22,23,135,55,80,136,68,68,128,67,61,21,10,11,16,20,19,1,17,17,0,16,47,22,25,28,44,7,9,11,9,2,,,
"Aug 22, 2021 5:00 PM",52,16,36,112,67,45,107,52,55,90,45,45,22,5,17,26,18,18,0,15,13,2,20,27,13,14,45,33,6,3,6,4,2,,,
"Aug 22, 2021 6:00 PM",64,25,39,68,31,37,89,46,43,69,36,33,11,4,7,12,21,20,1,17,16,1,19,42,21,21,35,32,5,4,6,3,3,,,
"Aug 22, 2021 7:00 PM",57,37,20,86,37,49,92,35,57,70,34,36,10,5,5,13,14,13,1,12,11,1,13,33,15,18,21,32,1,0,9,7,2,,,
"Aug 22, 2021 8:00 PM",35,17,18,45,20,25,47,14,33,30,11,19,10,7,3,16,12,10,2,12,8,4,12,21,6,15,19,22,3,0,10,6,4,,,
"Aug 22, 2021 9:00 PM",31,8,23,30,10,20,21,7,14,26,12,14,7,4,3,4,5,5,0,6,6,0,5,13,9,4,6,20,1,3,0,0,0,,,
"Aug 22, 2021 10:00 PM",17,8,9,12,8,4,9,2,7,6,2,4,3,2,1,3,8,8,0,6,5,1,9,3,2,1,4,13,1,2,6,5,1,,,
"Aug 22, 2021 11:00 PM",11,5,6,14,7,7,10,6,4,12,6,6,8,3,5,5,3,3,0,4,4,0,3,2,2,0,6,3,2,1,3,0,3,,,
"Aug 23, 2021 12:00 AM",8,2,6,0,0,0,3,2,1,8,4,4,2,2,0,0,1,1,0,6,6,0,1,4,1,3,3,1,0,0,0,0,0,,,
"Aug 23, 2021 1:00 AM",6,0,6,1,1,0,0,0,0,2,2,0,1,0,1,0,1,0,1,2,2,0,1,0,0,0,2,0,0,0,2,1,1,,,
"Aug 23, 2021 2:00 AM",1,0,1,3,0,3,2,0,2,2,0,2,0,0,0,0,0,0,0,0,0,0,0,0,0,0,1,1,0,0,0,0,0,,,
"Aug 23, 2021 3:00 AM",2,0,2,1,0,1,1,0,1,3,2,1,0,0,0,0,0,0,0,0,0,0,0,0,0,0,0,1,0,0,0,0,0,,,
"Aug 23, 2021 4:00 AM",3,2,1,0,0,0,2,1,1,0,0,0,0,0,0,1,0,0,0,0,0,0,0,1,1,0,0,1,0,0,0,0,0,,,
"Aug 23, 2021 5:00 AM",2,2,0,4,1,3,11,8,3,9,6,3,1,1,0,1,5,5,0,1,1,0,5,1,0,1,6,10,0,0,0,0,0,,,
"Aug 23, 2021 6:00 AM",38,25,13,15,7,8,21,11,10,15,7,8,6,6,0,3,18,18,0,5,4,1,17,10,5,5,18,32,2,1,4,4,0,,,
"Aug 23, 2021 7:00 AM",69,51,18,82,38,44,84,36,48,70,36,34,6,5,1,7,55,55,0,17,14,3,59,26,13,13,43,82,1,7,3,2,1,,,
"Aug 23, 2021 8:00 AM",117,80,37,85,33,52,90,39,51,83,45,38,13,8,5,12,74,74,0,22,16,6,78,38,17,21,36,81,2,4,4,2,2,,,
"Aug 23, 2021 9:00 AM",81,57,24,65,30,35,92,49,43,69,37,32,16,10,6,8,29,29,0,21,17,4,27,28,19,9,32,53,2,3,3,2,1,,,
"Aug 23, 2021 10:00 AM",64,35,29,106,58,48,88,63,25,88,54,34,18,13,5,12,29,29,0,11,9,2,30,23,16,7,21,32,3,2,7,5,2,,,
"Aug 23, 2021 11:00 AM",47,26,21,123,73,50,147,84,63,110,64,46,32,22,10,13,20,20,0,12,10,2,18,36,19,17,33,32,7,5,3,3,0,,,
"Aug 23, 2021 12:00 PM",80,46,34,146,76,70,158,85,73,119,72,47,22,15,7,14,19,19,0,27,24,3,20,38,19,19,52,58,9,6,6,3,3,,,
"Aug 23, 2021 1:00 PM",62,33,29,126,70,56,186,99,87,95,51,44,25,14,11,24,36,35,1,26,25,1,32,62,38,24,46,40,6,5,5,5,0,,,
"Aug 23, 2021 2:00 PM",82,53,29,133,61,72,182,76,106,112,63,49,32,24,8,14,30,28,2,26,24,2,24,64,38,26,51,37,7,4,12,9,3,,,
"Aug 23, 2021 3:00 PM",67,34,33,141,79,62,160,84,76,119,68,51,50,21,29,14,23,23,0,31,24,7,25,60,28,32,39,48,6,2,13,10,3,,,
"Aug 23, 2021 4:00 PM",102,36,66,113,63,50,164,93,71,124,71,53,31,15,16,45,28,27,1,31,27,4,26,75,32,43,59,47,6,5,14,8,6,,,
"Aug 23, 2021 5:00 PM",155,52,103,140,72,68,189,113,76,158,84,74,28,16,12,54,26,25,1,66,62,4,26,70,44,26,112,68,7,11,6,3,3,,,
"Aug 23, 2021 6:00 PM",150,54,96,235,152,83,252,144,108,211,128,83,25,10,15,40,37,37,0,64,63,1,35,94,59,35,106,68,3,6,8,5,3,,,
"Aug 23, 2021 7:00 PM",86,36,50,181,85,96,244,107,137,204,87,117,19,16,3,15,29,28,1,37,35,2,29,76,37,39,54,69,3,2,10,10,0,,,
"Aug 23, 2021 8:00 PM",62,27,35,75,33,42,96,43,53,77,36,41,12,7,5,33,17,17,0,21,17,4,14,30,13,17,31,36,7,1,8,2,6,,,
"Aug 23, 2021 9:00 PM",25,8,17,34,15,19,37,11,26,38,13,25,7,1,6,9,13,10,3,15,13,2,12,10,6,4,21,28,0,2,5,3,2,,,
"Aug 23, 2021 10:00 PM",29,12,17,4,4,0,14,3,11,7,1,6,1,0,1,6,9,8,1,12,10,2,7,3,2,1,8,7,2,2,0,0,0,,,
"Aug 23, 2021 11:00 PM",9,5,4,6,2,4,4,3,1,3,1,2,5,3,2,4,0,0,0,9,7,2,0,1,1,0,5,9,2,1,4,2,2,,,
"Aug 24, 2021 12:00 AM",6,0,6,0,0,0,6,0,6,1,0,1,2,1,1,0,1,1,0,4,4,0,1,1,1,0,2,2,1,0,2,2,0,,,
"Aug 24, 2021 1:00 AM",3,2,1,6,2,4,10,3,7,9,2,7,10,7,3,0,3,3,0,4,4,0,3,1,1,0,3,1,1,0,0,0,0,,,
"Aug 24, 2021 2:00 AM",4,3,1,0,0,0,1,0,1,2,2,0,0,0,0,0,1,1,0,2,2,0,1,0,0,0,1,1,0,0,0,0,0,,,
"Aug 24, 2021 3:00 AM",0,0,0,0,0,0,0,0,0,0,0,0,0,0,0,2,0,0,0,0,0,0,0,0,0,0,0,0,0,0,1,1,0,,,
"Aug 24, 2021 4:00 AM",3,2,1,1,0,1,3,3,0,1,1,0,1,0,1,0,2,2,0,0,0,0,2,0,0,0,2,0,0,0,0,0,0,,,
"Aug 24, 2021 5:00 AM",6,4,2,2,2,0,3,3,0,3,3,0,0,0,0,0,6,6,0,0,0,0,4,9,8,1,3,5,0,0,0,0,0,,,
"Aug 24, 2021 6:00 AM",42,24,18,28,17,11,41,25,16,27,19,8,5,3,2,3,20,19,1,6,5,1,18,13,5,8,14,36,3,2,2,2,0,,,
"Aug 24, 2021 7:00 AM",94,54,40,72,28,44,87,35,52,80,34,46,12,6,6,7,54,54,0,14,12,2,57,30,10,20,42,88,5,5,4,1,3,,,
"Aug 24, 2021 8:00 AM",127,88,39,74,30,44,94,40,54,75,36,39,14,9,5,16,81,79,2,29,23,6,83,47,18,29,37,108,4,7,6,3,3,,,
"Aug 24, 2021 9:00 AM",74,57,17,65,28,37,84,51,33,77,46,31,15,7,8,9,45,44,1,14,12,2,46,36,24,12,36,37,3,3,5,3,2,,,
"Aug 24, 2021 10:00 AM",50,30,20,62,30,32,76,47,29,55,32,23,11,8,3,13,24,24,0,14,11,3,23,25,10,15,39,32,5,1,6,5,1,,,
"Aug 24, 2021 11:00 AM",48,31,17,69,38,31,78,43,35,56,32,24,12,5,7,12,19,19,0,11,7,4,20,18,12,6,28,33,4,2,3,2,1,,,
"Aug 24, 2021 12:00 PM",53,35,18,79,44,35,123,76,47,83,43,40,21,8,13,23,21,21,0,17,14,3,21,42,32,10,34,34,7,7,8,3,5,,,
"Aug 24, 2021 1:00 PM",69,38,31,109,54,55,186,106,80,95,56,39,22,14,8,12,26,26,0,16,15,1,27,63,40,23,40,46,2,4,4,4,0,,,
"Aug 24, 2021 2:00 PM",74,37,37,85,42,43,166,100,66,72,44,28,27,16,11,24,18,17,1,16,15,1,18,68,43,25,43,48,3,3,9,6,3,,,
"Aug 24, 2021 3:00 PM",90,45,45,124,71,53,226,126,100,123,71,52,24,18,6,16,22,22,0,8,7,1,22,76,44,32,62,38,8,6,6,1,5,,,
"Aug 24, 2021 4:00 PM",103,38,65,146,75,71,206,114,92,142,83,59,28,9,19,41,20,20,0,30,29,1,22,73,41,32,64,61,7,1,9,5,4,,,
"Aug 24, 2021 5:00 PM",181,54,127,194,89,105,264,131,133,199,101,98,36,13,23,34,25,24,1,60,59,1,24,106,60,46,117,95,11,10,8,6,2,,,
"Aug 24, 2021 6:00 PM",153,66,87,273,180,93,341,207,134,261,182,79,33,13,20,28,50,50,0,72,69,3,48,125,85,40,117,77,10,8,7,3,4,,,
"Aug 24, 2021 7:00 PM",136,67,69,235,102,133,239,107,132,217,104,113,21,12,9,42,24,22,2,41,37,4,25,89,42,47,65,68,6,7,11,4,7,,,
"Aug 24, 2021 8:00 PM",92,38,54,173,64,109,210,75,135,162,55,107,11,6,5,34,17,15,2,38,35,3,14,65,31,34,49,68,8,3,8,4,4,,,
"Aug 24, 2021 9:00 PM",51,15,36,97,45,52,100,24,76,85,21,64,12,4,8,18,10,8,2,22,22,0,7,40,22,18,24,42,4,2,3,2,1,,,
"Aug 24, 2021 10:00 PM",34,8,26,27,14,13,50,13,37,26,6,20,10,4,6,5,7,7,0,16,14,2,6,18,11,7,14,15,2,3,2,2,0,,,
"Aug 24, 2021 11:00 PM",14,6,8,12,11,1,8,3,5,16,8,8,6,4,2,7,4,3,1,6,6,0,3,5,4,1,5,14,1,2,2,2,0,,,
"Aug 25, 2021 12:00 AM",13,4,9,1,0,1,2,0,2,2,0,2,1,0,1,0,1,1,0,4,4,0,1,0,0,0,1,6,0,0,0,0,0,,,
"Aug 25, 2021 1:00 AM",4,0,4,0,0,0,2,0,2,1,0,1,0,0,0,1,0,0,0,2,2,0,0,1,0,1,0,1,1,1,0,0,0,,,
"Aug 25, 2021 2:00 AM",4,4,0,3,0,3,1,0,1,0,0,0,0,0,0,0,0,0,0,0,0,0,0,0,0,0,0,3,0,0,0,0,0,,,
"Aug 25, 2021 3:00 AM",2,0,2,0,0,0,0,0,0,0,0,0,2,1,1,1,1,1,0,0,0,0,1,2,2,0,0,1,0,1,0,0,0,,,
"Aug 25, 2021 4:00 AM",1,1,0,0,0,0,2,2,0,0,0,0,0,0,0,0,0,0,0,0,0,0,0,1,1,0,1,0,0,0,0,0,0,,,
"Aug 25, 2021 5:00 AM",5,3,2,5,1,4,10,9,1,6,5,1,0,0,0,2,7,7,0,1,1,0,7,4,1,3,2,8,0,0,0,0,0,,,
"Aug 25, 2021 6:00 AM",44,29,15,23,14,9,31,20,11,19,14,5,2,2,0,5,18,17,1,5,4,1,17,6,3,3,23,34,1,1,5,5,0,,,
"Aug 25, 2021 7:00 AM",87,53,34,99,43,56,90,41,49,85,39,46,12,8,4,8,61,61,0,23,17,6,60,26,15,11,50,96,7,8,2,2,0,,,
"Aug 25, 2021 8:00 AM",115,77,38,100,45,55,106,51,55,107,59,48,17,10,7,16,96,95,1,22,18,4,101,35,17,18,55,98,2,8,6,4,2,,,
"Aug 25, 2021 9:00 AM",85,56,29,90,36,54,87,41,46,89,42,47,20,12,8,20,35,34,1,18,14,4,35,25,8,17,35,56,6,10,8,6,2,,,
"Aug 25, 2021 10:00 AM",58,30,28,75,47,28,72,41,31,58,36,22,31,18,13,11,28,28,0,22,20,2,28,31,21,10,26,30,4,3,7,5,2,,,
"Aug 25, 2021 11:00 AM",49,32,17,94,42,52,126,68,58,82,41,41,20,9,11,33,30,30,0,6,6,0,38,30,18,12,36,39,2,2,2,2,0,,,
"Aug 25, 2021 12:00 PM",73,40,33,111,62,49,137,77,60,106,66,40,19,8,11,25,29,29,0,25,19,6,27,67,38,29,49,45,8,5,12,7,5,,,
"Aug 25, 2021 1:00 PM",85,47,38,137,84,53,186,123,63,133,89,44,25,15,10,17,23,23,0,25,24,1,25,57,35,22,47,45,9,6,8,7,1,,,
"Aug 25, 2021 2:00 PM",76,40,36,91,46,45,200,109,91,95,54,41,10,3,7,21,20,20,0,25,23,2,21,59,38,21,53,33,7,4,6,2,4,,,
"Aug 25, 2021 3:00 PM",71,25,46,135,74,61,204,116,88,109,66,43,27,14,13,25,30,30,0,27,23,4,28,64,45,19,57,44,2,2,7,4,3,,,
"Aug 25, 2021 4:00 PM",121,50,71,172,98,74,249,124,125,162,81,81,35,14,21,17,27,27,0,30,27,3,29,82,46,36,85,79,7,6,10,3,7,,,
"Aug 25, 2021 5:00 PM",185,59,126,201,115,86,282,177,105,185,116,69,48,23,25,27,41,40,1,65,62,3,37,115,76,39,93,75,9,9,9,3,6,,,
"Aug 25, 2021 6:00 PM",150,65,85,276,169,107,363,214,149,265,167,98,31,6,25,33,45,45,0,82,76,6,49,129,74,55,159,80,13,11,11,6,5,,,
"Aug 25, 2021 7:00 PM",108,50,58,328,168,160,293,161,132,278,160,118,27,18,9,89,34,32,2,35,33,2,30,92,53,39,89,84,14,9,11,9,2,,,
"Aug 25, 2021 8:00 PM",100,43,57,196,68,128,197,58,139,156,50,106,26,19,7,15,27,24,3,27,25,2,27,72,23,49,39,88,11,6,8,3,5,,,
"Aug 25, 2021 9:00 PM",58,20,38,65,32,33,109,28,81,72,21,51,9,5,4,7,19,18,1,25,22,3,17,22,13,9,20,33,10,2,4,3,1,,,
"Aug 25, 2021 10:00 PM",36,8,28,45,16,29,52,7,45,58,12,46,5,2,3,10,3,3,0,19,19,0,3,31,17,14,10,27,3,1,6,3,3,,,
"Aug 25, 2021 11:00 PM",23,5,18,12,8,4,29,6,23,21,6,15,3,2,1,1,5,5,0,10,10,0,5,9,6,3,9,16,1,2,1,1,0,,,
"Aug 26, 2021 12:00 AM",13,4,9,0,0,0,3,1,2,16,8,8,11,5,6,4,3,3,0,4,2,2,3,3,2,1,8,10,1,0,1,1,0,,,
"Aug 26, 2021 1:00 AM",1,0,1,5,3,2,6,2,4,4,3,1,0,0,0,2,1,1,0,3,3,0,1,6,6,0,1,3,0,1,0,0,0,,,
"Aug 26, 2021 2:00 AM",3,2,1,0,0,0,1,0,1,0,0,0,0,0,0,2,0,0,0,1,1,0,0,1,1,0,0,1,0,0,0,0,0,,,
"Aug 26, 2021 3:00 AM",0,0,0,0,0,0,3,1,2,2,0,2,0,0,0,0,0,0,0,0,0,0,0,5,1,4,0,0,1,1,0,0,0,,,
"Aug 26, 2021 4:00 AM",2,1,1,1,1,0,2,2,0,1,1,0,0,0,0,0,0,0,0,0,0,0,0,0,0,0,1,0,0,1,0,0,0,,,
"Aug 26, 2021 5:00 AM",6,4,2,3,1,2,8,5,3,6,4,2,1,1,0,2,8,8,0,1,1,0,8,2,0,2,4,9,0,1,0,0,0,,,
"Aug 26, 2021 6:00 AM",36,24,12,27,18,9,37,23,14,27,18,9,2,1,1,4,16,15,1,6,4,2,16,15,9,6,16,29,0,3,3,3,0,,,
"Aug 26, 2021 7:00 AM",76,35,41,94,40,54,82,40,42,82,39,43,7,7,0,9,59,59,0,21,15,6,59,30,16,14,49,78,6,4,3,3,0,,,
"Aug 26, 2021 8:00 AM",135,95,40,99,46,53,128,57,71,101,56,45,26,17,9,22,82,82,0,24,20,4,85,44,23,21,53,83,6,6,8,6,2,,,
"Aug 26, 2021 9:00 AM",96,61,35,89,35,54,87,41,46,75,37,38,22,13,9,21,35,35,0,18,14,4,37,33,14,19,39,53,1,7,3,2,1,,,
"Aug 26, 2021 10:00 AM",63,40,23,91,52,39,110,76,34,89,63,26,14,8,6,25,31,29,2,19,13,6,32,55,36,19,37,30,1,7,4,2,2,,,
"Aug 26, 2021 11:00 AM",42,19,23,137,65,72,133,68,65,121,66,55,20,10,10,26,35,34,1,12,10,2,35,48,28,20,37,39,7,9,8,5,3,,,
"Aug 26, 2021 12:00 PM",52,30,22,150,65,85,158,78,80,125,57,68,26,13,13,20,22,21,1,17,13,4,21,53,36,17,39,49,4,3,8,4,4,,,
"Aug 26, 2021 1:00 PM",70,38,32,118,59,59,184,106,78,115,66,49,31,13,18,24,24,24,0,28,26,2,26,63,45,18,43,53,2,2,3,2,1,,,
"Aug 26, 2021 2:00 PM",62,38,24,108,63,45,163,85,78,85,46,39,22,11,11,14,30,28,2,31,25,6,29,75,45,30,34,46,8,8,9,1,8,,,
"Aug 26, 2021 3:00 PM",81,40,41,108,56,52,191,117,74,116,71,45,34,20,14,18,31,29,2,22,20,2,28,77,48,29,64,42,7,7,2,1,1,,,
"Aug 26, 2021 4:00 PM",107,45,62,162,100,62,247,139,108,156,90,66,43,26,17,37,33,32,1,26,23,3,31,102,59,43,89,55,8,12,6,4,2,,,
"Aug 26, 2021 5:00 PM",179,62,117,180,75,105,309,191,118,201,124,77,36,15,21,32,33,33,0,54,54,0,37,108,55,53,115,80,6,8,8,3,5,,,
"Aug 26, 2021 6:00 PM",146,63,83,198,119,79,294,166,128,189,129,60,37,23,14,23,47,45,2,66,63,3,39,109,72,37,111,93,7,10,13,8,5,,,
"Aug 26, 2021 7:00 PM",109,44,65,201,97,104,220,107,113,166,91,75,33,12,21,28,28,26,2,48,46,2,28,85,49,36,68,65,7,2,1,1,0,,,
"Aug 26, 2021 8:00 PM",81,36,45,132,57,75,162,54,108,135,51,84,11,8,3,22,22,21,1,22,19,3,21,61,22,39,29,64,4,3,4,3,1,,,
"Aug 26, 2021 9:00 PM",51,21,30,75,43,32,77,16,61,61,12,49,12,8,4,8,16,16,0,24,24,0,15,29,17,12,18,34,3,4,6,5,1,,,
"Aug 26, 2021 10:00 PM",37,11,26,30,21,9,43,9,34,35,7,28,10,4,6,2,7,7,0,18,18,0,6,10,7,3,15,24,2,2,1,1,0,,,
"Aug 26, 2021 11:00 PM",21,5,16,21,16,5,31,7,24,24,4,20,5,2,3,2,13,13,0,6,6,0,12,8,5,3,8,13,0,1,4,3,1,,,
"Aug 27, 2021 12:00 AM",18,4,14,1,0,1,0,0,0,15,1,14,1,1,0,3,2,2,0,3,3,0,2,0,0,0,6,10,2,1,4,3,1,,,
"Aug 27, 2021 1:00 AM",6,2,4,8,4,4,4,0,4,3,0,3,1,1,0,0,1,1,0,2,2,0,1,1,1,0,1,2,0,0,0,0,0,,,
"Aug 27, 2021 2:00 AM",2,1,1,2,2,0,3,2,1,7,6,1,0,0,0,0,0,0,0,1,1,0,0,1,1,0,1,3,0,0,0,0,0,,,
"Aug 27, 2021 3:00 AM",2,0,2,0,0,0,1,1,0,0,0,0,0,0,0,1,0,0,0,2,1,1,0,0,0,0,1,0,0,0,0,0,0,,,
"Aug 27, 2021 4:00 AM",2,0,2,0,0,0,2,2,0,0,0,0,0,0,0,1,1,1,0,0,0,0,1,1,1,0,1,0,0,0,0,0,0,,,
"Aug 27, 2021 5:00 AM",4,3,1,1,1,0,11,9,2,5,3,2,0,0,0,1,4,4,0,1,1,0,3,4,2,2,3,10,0,1,0,0,0,,,
"Aug 27, 2021 6:00 AM",35,24,11,18,12,6,32,25,7,20,16,4,2,1,1,3,14,13,1,4,2,2,12,11,9,2,16,24,0,1,0,0,0,,,
"Aug 27, 2021 7:00 AM",97,45,52,90,41,49,93,43,50,79,44,35,3,2,1,10,61,60,1,19,13,6,60,25,14,11,45,59,2,6,5,3,2,,,
"Aug 27, 2021 8:00 AM",124,81,43,102,41,61,105,44,61,98,42,56,14,9,5,13,63,63,0,24,18,6,63,34,14,20,35,78,4,4,7,6,1,,,
"Aug 27, 2021 9:00 AM",89,57,32,80,28,52,94,42,52,88,39,49,18,8,10,14,31,31,0,20,17,3,35,42,18,24,30,40,4,6,7,6,1,,,
"Aug 27, 2021 10:00 AM",82,42,40,89,51,38,90,58,32,91,58,33,19,11,8,13,25,25,0,15,11,4,26,16,10,6,35,27,3,7,4,2,2,,,
"Aug 27, 2021 11:00 AM",60,38,22,105,53,52,104,68,36,90,49,41,16,9,7,19,23,23,0,22,18,4,24,58,36,22,33,24,7,3,5,4,1,,,
"Aug 27, 2021 12:00 PM",75,46,29,130,79,51,118,61,57,99,55,44,18,8,10,16,25,24,1,20,18,2,22,44,25,19,35,32,7,3,6,5,1,,,
"Aug 27, 2021 1:00 PM",90,42,48,114,58,56,163,97,66,108,59,49,27,17,10,17,30,30,0,29,26,3,29,46,34,12,36,40,6,5,17,12,5,,,
"Aug 27, 2021 2:00 PM",91,46,45,121,81,40,177,103,74,121,70,51,27,11,16,22,36,35,1,19,15,4,32,82,54,28,47,51,8,4,11,5,6,,,
"Aug 27, 2021 3:00 PM",93,45,48,163,81,82,226,131,95,139,85,54,20,9,11,23,27,24,3,29,27,2,22,77,51,26,63,45,9,5,9,4,5,,,
"Aug 27, 2021 4:00 PM",103,47,56,157,77,80,247,134,113,114,63,51,15,4,11,27,24,24,0,32,30,2,24,100,52,48,85,61,11,7,5,2,3,,,
"Aug 27, 2021 5:00 PM",143,53,90,159,81,78,285,140,145,166,82,84,34,7,27,19,37,37,0,52,46,6,36,108,55,53,83,78,15,6,12,6,6,,,
"Aug 27, 2021 6:00 PM",103,40,63,162,83,79,284,142,142,162,85,77,19,8,11,25,29,26,3,53,50,3,26,100,45,55,98,81,7,9,12,7,5,,,
"Aug 27, 2021 7:00 PM",93,34,59,142,51,91,145,60,85,98,40,58,25,12,13,11,33,33,0,31,30,1,31,45,19,26,47,53,7,3,9,5,4,,,
"Aug 27, 2021 8:00 PM",71,34,37,71,31,40,92,31,61,58,26,32,16,9,7,12,19,18,1,16,14,2,19,48,16,32,33,34,3,3,3,2,1,,,
"Aug 27, 2021 9:00 PM",44,17,27,36,20,16,59,16,43,43,11,32,11,8,3,8,8,8,0,13,11,2,7,6,4,2,13,16,3,1,4,2,2,,,
"Aug 27, 2021 10:00 PM",17,6,11,26,13,13,27,11,16,21,11,10,13,8,5,3,10,10,0,15,15,0,10,15,9,6,6,18,1,2,5,3,2,,,
"Aug 27, 2021 11:00 PM",26,10,16,10,4,6,18,5,13,15,7,8,6,4,2,2,5,5,0,6,6,0,5,8,6,2,9,19,1,0,1,1,0,,,
"Aug 28, 2021 12:00 AM",18,4,14,0,0,0,2,0,2,14,5,9,7,3,4,5,4,4,0,6,6,0,5,7,3,4,11,9,1,1,2,2,0,,,
"Aug 28, 2021 1:00 AM",5,2,3,5,2,3,2,0,2,4,0,4,4,1,3,0,2,1,1,6,6,0,2,1,0,1,5,3,0,0,1,0,1,,,
"Aug 28, 2021 2:00 AM",7,1,6,0,0,0,9,2,7,3,0,3,0,0,0,0,0,0,0,6,6,0,1,2,2,0,4,3,0,0,0,0,0,,,
"Aug 28, 2021 3:00 AM",4,0,4,0,0,0,2,0,2,0,0,0,0,0,0,1,0,0,0,0,0,0,2,0,0,0,1,1,0,0,0,0,0,,,
"Aug 28, 2021 4:00 AM",2,0,2,0,0,0,0,0,0,0,0,0,0,0,0,2,2,2,0,1,1,0,2,1,0,1,0,0,0,0,0,0,0,,,
"Aug 28, 2021 5:00 AM",4,1,3,0,0,0,6,6,0,2,1,1,0,0,0,1,1,1,0,0,0,0,1,0,0,0,6,4,0,1,0,0,0,,,
"Aug 28, 2021 6:00 AM",16,6,10,4,0,4,9,5,4,7,4,3,1,1,0,5,3,2,1,1,1,0,2,2,1,1,6,11,1,0,3,3,0,,,
"Aug 28, 2021 7:00 AM",31,7,24,34,16,18,40,23,17,27,17,10,1,1,0,1,11,11,0,7,6,1,11,9,6,3,18,17,1,2,0,0,0,,,
"Aug 28, 2021 8:00 AM",28,19,9,71,46,25,78,58,20,66,53,13,12,5,7,11,25,25,0,10,9,1,26,24,19,5,22,14,0,10,4,1,3,,,
"Aug 28, 2021 9:00 AM",51,28,23,136,78,58,108,67,41,114,76,38,16,8,8,23,20,20,0,11,11,0,19,34,21,13,50,35,4,2,10,6,4,,,
"Aug 28, 2021 10:00 AM",61,35,26,209,120,89,161,102,59,174,110,64,31,17,14,14,16,16,0,16,15,1,16,53,30,23,61,41,8,0,3,2,1,,,
"Aug 28, 2021 11:00 AM",79,45,34,229,122,107,221,128,93,203,121,82,32,20,12,29,35,35,0,14,12,2,36,86,58,28,63,59,7,16,9,5,4,,,
"Aug 28, 2021 12:00 PM",75,37,38,243,103,140,252,166,86,239,153,86,44,20,24,25,29,29,0,20,18,2,31,90,61,29,83,61,9,6,14,12,2,,,
"Aug 28, 2021 1:00 PM",89,50,39,262,139,123,245,136,109,242,141,101,34,19,15,19,32,31,1,26,24,2,31,90,62,28,70,61,7,2,7,4,3,,,
"Aug 28, 2021 2:00 PM",69,36,33,203,107,96,249,144,105,198,107,91,24,10,14,25,24,24,0,22,21,1,24,105,77,28,52,51,8,11,8,5,3,,,
"Aug 28, 2021 3:00 PM",94,48,46,212,136,76,364,218,146,192,116,76,37,21,16,25,35,33,2,22,21,1,35,117,76,41,97,62,10,6,6,4,2,,,
"Aug 28, 2021 4:00 PM",75,27,48,241,94,147,338,161,177,181,83,98,48,29,19,23,20,20,0,21,19,2,21,139,82,57,55,85,7,5,9,3,6,,,
"Aug 28, 2021 5:00 PM",53,31,22,181,80,101,320,120,200,175,56,119,34,16,18,11,22,22,0,17,14,3,23,113,34,79,50,81,4,1,7,6,1,,,
"Aug 28, 2021 6:00 PM",55,23,32,136,75,61,222,63,159,127,48,79,22,11,11,10,18,18,0,16,16,0,23,80,29,51,36,63,4,3,8,8,0,,,
"Aug 28, 2021 7:00 PM",60,33,27,95,49,46,134,55,79,81,38,43,15,4,11,20,22,22,0,16,13,3,25,64,22,42,25,35,4,4,5,4,1,,,
"Aug 28, 2021 8:00 PM",26,13,13,69,35,34,79,23,56,56,25,31,11,6,5,13,16,14,2,17,17,0,16,30,10,20,18,45,3,1,5,3,2,,,
"Aug 28, 2021 9:00 PM",26,10,16,39,19,20,42,10,32,42,11,31,5,1,4,5,11,11,0,12,12,0,13,17,14,3,10,21,0,4,3,0,3,,,
"Aug 28, 2021 10:00 PM",15,8,7,8,5,3,12,1,11,12,6,6,3,2,1,5,3,3,0,7,7,0,3,1,0,1,7,18,1,1,3,2,1,,,
"Aug 28, 2021 11:00 PM",13,4,9,20,10,10,19,9,10,14,3,11,5,4,1,5,10,10,0,5,5,0,11,9,8,1,8,6,1,3,3,3,0,,,
"Aug 29, 2021 12:00 AM",10,5,5,0,0,0,2,1,1,5,1,4,5,3,2,3,3,3,0,8,8,0,3,3,3,0,9,11,0,1,1,0,1,,,
"Aug 29, 2021 1:00 AM",10,1,9,1,1,0,5,3,2,10,6,4,0,0,0,4,4,3,1,1,1,0,4,1,1,0,8,6,2,1,0,0,0,,,
"Aug 29, 2021 2:00 AM",2,0,2,7,5,2,3,2,1,2,2,0,0,0,0,2,0,0,0,0,0,0,0,4,3,1,3,4,0,1,0,0,0,,,
"Aug 29, 2021 3:00 AM",0,0,0,0,0,0,2,0,2,0,0,0,0,0,0,1,1,1,0,2,2,0,3,1,0,1,2,2,0,0,0,0,0,,,
"Aug 29, 2021 4:00 AM",1,1,0,0,0,0,3,3,0,1,1,0,0,0,0,0,0,0,0,0,0,0,0,1,1,0,1,2,0,0,0,0,0,,,
"Aug 29, 2021 5:00 AM",3,1,2,1,0,1,3,3,0,1,0,1,0,0,0,0,0,0,0,1,1,0,0,0,0,0,1,4,0,0,1,1,0,,,
"Aug 29, 2021 6:00 AM",11,8,3,5,2,3,11,8,3,7,4,3,1,1,0,2,4,4,0,3,3,0,4,7,6,1,4,7,1,0,0,0,0,,,
"Aug 29, 2021 7:00 AM",21,5,16,32,22,10,35,24,11,33,24,9,2,0,2,1,8,8,0,11,7,4,9,5,2,3,15,24,0,2,1,0,1,,,
"Aug 29, 2021 8:00 AM",33,12,21,78,52,26,77,50,27,73,51,22,5,3,2,3,12,12,0,6,4,2,10,25,21,4,23,25,0,3,2,0,2,,,
"Aug 29, 2021 9:00 AM",35,20,15,126,72,54,113,72,41,109,69,40,12,9,3,13,14,14,0,11,8,3,14,32,23,9,43,29,6,10,18,4,14,,,
"Aug 29, 2021 10:00 AM",57,31,26,142,73,69,129,67,62,134,67,67,14,9,5,15,24,23,1,9,7,2,23,57,36,21,33,33,4,10,18,15,3,,,
"Aug 29, 2021 11:00 AM",46,26,20,114,54,60,111,56,55,111,53,58,18,11,7,5,14,14,0,13,12,1,14,48,26,22,38,27,10,5,8,4,4,,,
"Aug 29, 2021 12:00 PM",49,22,27,143,51,92,109,54,55,103,47,56,22,13,9,14,27,24,3,18,15,3,22,38,14,24,36,48,6,6,2,1,1,,,
"Aug 29, 2021 1:00 PM",48,22,26,126,67,59,115,83,32,94,71,23,16,9,7,15,32,31,1,23,22,1,29,54,40,14,44,29,9,5,5,3,2,,,
"Aug 29, 2021 2:00 PM",53,33,20,112,60,52,140,72,68,118,70,48,27,10,17,25,16,16,0,23,16,7,16,34,21,13,48,34,6,2,6,3,3,,,
"Aug 29, 2021 3:00 PM",61,32,29,151,73,78,176,99,77,124,70,54,34,13,21,14,20,20,0,14,13,1,21,68,40,28,51,59,13,4,5,4,1,,,
"Aug 29, 2021 4:00 PM",60,34,26,125,70,55,205,108,97,124,61,63,26,12,14,15,23,23,0,23,19,4,23,106,63,43,56,60,9,6,6,4,2,,,
"Aug 29, 2021 5:00 PM",53,26,27,163,83,80,226,115,111,149,68,81,39,16,23,25,25,25,0,15,14,1,23,78,43,35,39,49,3,3,2,0,2,,,
"Aug 29, 2021 6:00 PM",59,33,26,92,42,50,155,42,113,72,26,46,15,10,5,12,21,19,2,30,25,5,19,77,28,49,23,58,2,5,4,2,2,,,
"Aug 29, 2021 7:00 PM",48,25,23,49,21,28,75,29,46,46,18,28,21,11,10,26,8,8,0,8,8,0,8,40,5,35,19,39,6,2,11,9,2,,,
"Aug 29, 2021 8:00 PM",38,24,14,32,16,16,48,16,32,38,17,21,8,2,6,7,9,8,1,7,7,0,8,20,14,6,14,17,1,2,7,2,5,,,
"Aug 29, 2021 9:00 PM",23,12,11,7,3,4,25,9,16,14,6,8,2,2,0,3,3,3,0,4,4,0,4,11,6,5,9,14,3,2,3,2,1,,,
"Aug 29, 2021 10:00 PM",14,2,12,6,5,1,13,6,7,5,2,3,3,1,2,1,4,3,1,2,1,1,2,6,3,3,5,10,1,3,1,1,0,,,
"Aug 29, 2021 11:00 PM",10,4,6,1,0,1,2,2,0,5,2,3,2,2,0,6,3,3,0,3,3,0,4,0,0,0,7,3,1,1,0,0,0,,,
"Aug 30, 2021 12:00 AM",5,2,3,0,0,0,2,1,1,3,1,2,0,0,0,1,4,4,0,1,1,0,4,0,0,0,3,2,2,1,4,2,2,,,
"Aug 30, 2021 1:00 AM",4,0,4,2,1,1,3,2,1,2,1,1,0,0,0,0,0,0,0,2,2,0,0,0,0,0,2,3,0,0,2,1,1,,,
"Aug 30, 2021 2:00 AM",1,0,1,1,1,0,2,1,1,1,0,1,0,0,0,1,0,0,0,0,0,0,0,2,1,1,1,1,0,0,0,0,0,,,
"Aug 30, 2021 3:00 AM",1,0,1,0,0,0,0,0,0,0,0,0,0,0,0,1,1,0,1,0,0,0,2,0,0,0,0,0,0,0,0,0,0,,,
"Aug 30, 2021 4:00 AM",0,0,0,0,0,0,5,4,1,1,1,0,0,0,0,1,0,0,0,0,0,0,0,2,1,1,1,1,0,0,0,0,0,,,
"Aug 30, 2021 5:00 AM",8,8,0,0,0,0,12,8,4,8,5,3,5,4,1,3,6,6,0,2,1,1,6,1,1,0,6,12,0,1,0,0,0,,,
"Aug 30, 2021 6:00 AM",34,26,8,11,5,6,21,12,9,14,8,6,3,2,1,4,29,29,0,3,2,1,29,11,7,4,14,27,1,2,0,0,0,,,
"Aug 30, 2021 7:00 AM",86,52,34,54,21,33,70,33,37,48,22,26,12,10,2,12,55,54,1,26,21,5,56,23,8,15,37,70,4,5,3,3,0,,,
"Aug 30, 2021 8:00 AM",125,85,40,80,28,52,130,40,90,89,37,52,34,21,13,15,97,96,1,29,21,8,97,55,8,47,49,101,6,2,6,4,2,,,
"Aug 30, 2021 9:00 AM",93,72,21,56,22,34,72,35,37,63,34,29,20,14,6,7,40,40,0,25,15,10,41,30,12,18,34,40,2,2,10,9,1,,,
"Aug 30, 2021 10:00 AM",78,46,32,47,25,22,56,30,26,38,23,15,9,6,3,14,27,27,0,17,11,6,30,20,9,11,19,30,0,4,2,1,1,,,
"Aug 30, 2021 11:00 AM",57,36,21,74,42,32,51,30,21,41,25,16,16,4,12,19,23,22,1,14,13,1,23,18,11,7,14,29,5,1,4,2,2,,,
"Aug 30, 2021 12:00 PM",70,35,35,68,39,29,61,27,34,69,41,28,25,15,10,14,18,18,0,15,13,2,19,16,10,6,18,42,3,2,12,10,2,,,
"Aug 30, 2021 1:00 PM",75,32,43,62,36,26,82,46,36,66,34,32,27,10,17,17,24,23,1,27,23,4,21,35,23,12,21,34,7,5,4,1,3,,,
"Aug 30, 2021 2:00 PM",62,36,26,78,41,37,67,37,30,67,32,35,30,14,16,24,22,19,3,17,17,0,19,28,17,11,30,23,5,5,7,4,3,,,
"Aug 30, 2021 3:00 PM",70,22,48,58,36,22,82,56,26,50,32,18,25,11,14,13,28,25,3,20,15,5,25,45,27,18,36,39,5,2,6,1,5,,,
"Aug 30, 2021 4:00 PM",95,36,59,71,44,27,105,68,37,81,49,32,33,15,18,18,26,25,1,56,48,8,28,41,21,20,56,46,13,4,14,10,4,,,
"Aug 30, 2021 5:00 PM",161,49,112,103,62,41,142,83,59,100,51,49,37,18,19,24,33,33,0,69,67,2,28,47,27,20,98,62,4,13,14,10,4,,,
"Aug 30, 2021 6:00 PM",127,41,86,87,46,41,124,73,51,109,64,45,22,6,16,31,34,32,2,79,79,0,35,46,26,20,79,41,9,7,10,9,1,,,
"Aug 30, 2021 7:00 PM",95,36,59,71,33,38,107,56,51,84,42,42,18,9,9,8,21,20,1,34,34,0,22,33,21,12,45,46,4,7,7,4,3,,,
"Aug 30, 2021 8:00 PM",80,27,53,30,19,11,60,27,33,43,23,20,11,5,6,14,9,9,0,17,17,0,9,15,8,7,28,25,5,2,10,7,3,,,
"Aug 30, 2021 9:00 PM",36,13,23,10,5,5,18,7,11,15,6,9,1,1,0,5,8,8,0,16,13,3,8,4,2,2,11,22,1,2,3,1,2,,,
"Aug 30, 2021 10:00 PM",20,9,11,6,3,3,10,7,3,7,5,2,2,2,0,2,3,3,0,10,9,1,3,3,2,1,6,6,1,1,3,2,1,,,
"Aug 30, 2021 11:00 PM",13,4,9,5,3,2,9,5,4,3,1,2,2,1,1,2,2,2,0,3,3,0,2,3,2,1,5,4,1,0,0,0,0,,,
"Aug 31, 2021 12:00 AM",3,1,2,0,0,0,5,1,4,4,0,4,2,0,2,0,2,2,0,1,1,0,2,0,0,0,3,1,0,0,0,0,0,,,
"Aug 31, 2021 1:00 AM",4,1,3,0,0,0,1,0,1,1,0,1,0,0,0,0,1,1,0,0,0,0,1,0,0,0,0,2,0,0,0,0,0,,,
"Aug 31, 2021 2:00 AM",2,2,0,0,0,0,0,0,0,0,0,0,0,0,0,0,1,1,0,1,1,0,1,0,0,0,3,2,0,0,0,0,0,,,
"Aug 31, 2021 3:00 AM",0,0,0,0,0,0,0,0,0,0,0,0,0,0,0,0,1,1,0,0,0,0,3,0,0,0,0,1,0,0,0,0,0,,,
"Aug 31, 2021 4:00 AM",3,2,1,2,2,0,2,2,0,1,1,0,1,0,1,0,1,1,0,0,0,0,1,1,1,0,1,1,0,0,0,0,0,,,
"Aug 31, 2021 5:00 AM",8,4,4,5,3,2,12,9,3,8,6,2,0,0,0,3,9,9,0,1,1,0,10,5,5,0,3,7,1,0,0,0,0,,,
"Aug 31, 2021 6:00 AM",50,39,11,26,9,17,34,15,19,23,14,9,5,4,1,8,23,22,1,8,5,3,21,9,6,3,14,49,0,3,4,3,1,,,
"Aug 31, 2021 7:00 AM",100,54,46,77,30,47,111,50,61,78,38,40,7,7,0,13,60,60,0,19,16,3,64,35,17,18,49,103,5,8,4,4,0,,,
"Aug 31, 2021 8:00 AM",190,129,61,112,35,77,187,75,112,146,66,80,42,29,13,16,100,100,0,38,34,4,97,82,32,50,63,117,7,4,14,12,2,,,
"Aug 31, 2021 9:00 AM",82,57,25,63,26,37,77,40,37,62,40,22,12,7,5,14,46,46,0,26,18,8,50,32,9,23,32,49,6,2,9,6,3,,,
"Aug 31, 2021 10:00 AM",66,41,25,42,20,22,50,28,22,48,27,21,7,4,3,10,32,30,2,12,9,3,29,28,18,10,13,27,0,4,3,3,0,,,
"Aug 31, 2021 11:00 AM",45,24,21,65,37,28,54,30,24,57,33,24,14,6,8,14,27,27,0,11,9,2,30,19,8,11,13,14,3,3,6,3,3,,,
"Aug 31, 2021 12:00 PM",80,32,48,91,46,45,81,45,36,72,38,34,23,13,10,16,34,33,1,24,20,4,30,27,17,10,29,26,7,3,8,8,0,,,
"Aug 31, 2021 1:00 PM",76,48,28,60,32,28,70,43,27,58,36,22,22,11,11,26,22,22,0,23,20,3,20,30,18,12,26,39,3,3,8,4,4,,,
"Aug 31, 2021 2:00 PM",66,38,28,56,42,14,67,36,31,64,48,16,19,11,8,12,21,21,0,22,20,2,20,31,16,15,32,24,3,6,3,1,2,,,
"Aug 31, 2021 3:00 PM",80,31,49,69,43,26,93,56,37,62,39,23,28,15,13,8,26,26,0,30,24,6,29,36,20,16,35,28,3,6,9,6,3,,,
"Aug 31, 2021 4:00 PM",116,43,73,76,38,38,94,54,40,65,31,34,24,8,16,26,25,25,0,37,34,3,27,36,16,20,59,52,6,0,9,4,5,,,
"Aug 31, 2021 5:00 PM",184,51,133,101,39,62,173,93,80,118,67,51,33,13,20,24,39,38,1,60,55,5,34,71,39,32,87,69,4,4,8,3,5,,,
"Aug 31, 2021 6:00 PM",133,44,89,123,85,38,181,114,67,116,69,47,20,10,10,43,30,29,1,68,67,1,27,67,45,22,95,52,7,9,11,9,2,,,
"Aug 31, 2021 7:00 PM",106,35,71,96,53,43,125,68,57,94,54,40,20,6,14,26,27,26,1,51,48,3,28,50,31,19,56,25,4,2,8,7,1,,,
"Aug 31, 2021 8:00 PM",88,37,51,47,20,27,75,31,44,48,20,28,13,11,2,14,8,8,0,25,23,2,9,39,14,25,32,26,5,1,3,0,3,,,
"Aug 31, 2021 9:00 PM",39,11,28,26,17,9,33,11,22,22,7,15,8,1,7,10,7,7,0,27,25,2,6,14,8,6,8,19,2,2,2,1,1,,,
"Aug 31, 2021 10:00 PM",29,12,17,21,14,7,27,8,19,28,10,18,3,1,2,1,10,9,1,9,9,0,11,13,7,6,10,8,4,1,12,6,6,,,
"Aug 31, 2021 11:00 PM",13,5,8,11,10,1,13,3,10,12,4,8,3,0,3,5,2,2,0,6,5,1,2,6,4,2,3,6,0,0,0,0,0,,,
"Sep 1, 2021 12:00 AM",6,3,3,0,0,0,0,0,0,1,1,0,0,0,0,0,2,2,0,4,4,0,3,1,1,0,6,1,0,0,0,0,0,,,
"Sep 1, 2021 1:00 AM",4,1,3,1,1,0,2,1,1,3,1,2,0,0,0,0,2,2,0,1,1,0,2,3,2,1,1,0,0,1,0,0,0,,,
"Sep 1, 2021 2:00 AM",3,1,2,1,1,0,2,0,2,1,0,1,0,0,0,0,1,1,0,0,0,0,1,0,0,0,1,2,0,0,0,0,0,,,
"Sep 1, 2021 3:00 AM",1,0,1,0,0,0,0,0,0,0,0,0,0,0,0,0,1,0,1,0,0,0,2,0,0,0,0,0,0,0,0,0,0,,,
"Sep 1, 2021 4:00 AM",1,0,1,0,0,0,0,0,0,0,0,0,0,0,0,2,0,0,0,1,0,1,0,0,0,0,0,1,0,0,0,0,0,,,
"Sep 1, 2021 5:00 AM",6,5,1,3,1,2,8,5,3,10,7,3,2,0,2,2,6,6,0,2,1,1,6,0,0,0,7,14,0,0,0,0,0,,,
"Sep 1, 2021 6:00 AM",43,30,13,19,10,9,36,23,13,22,12,10,4,3,1,5,25,24,1,8,6,2,24,14,7,7,27,35,2,0,3,3,0,,,
"Sep 1, 2021 7:00 AM",112,66,46,86,37,49,124,45,79,76,34,42,12,11,1,21,74,74,0,21,17,4,80,39,16,23,57,89,6,7,7,7,0,,,
"Sep 1, 2021 8:00 AM",190,133,57,134,42,92,217,91,126,159,65,94,40,21,19,30,109,108,1,43,31,12,115,101,19,82,58,140,5,5,11,8,3,,,
"Sep 1, 2021 9:00 AM",87,67,20,76,38,38,98,51,47,86,60,26,22,13,9,13,37,37,0,21,11,10,45,34,17,17,31,57,6,5,8,4,4,,,
"Sep 1, 2021 10:00 AM",56,31,25,95,49,46,90,52,38,63,35,28,12,9,3,11,22,21,1,13,12,1,20,23,12,11,27,39,5,7,6,5,1,,,
"Sep 1, 2021 11:00 AM",53,28,25,63,18,45,73,31,42,61,26,35,14,8,6,16,26,26,0,12,11,1,24,35,18,17,22,39,6,2,2,2,0,,,
"Sep 1, 2021 12:00 PM",54,33,21,65,33,32,95,34,61,73,25,48,25,11,14,9,21,21,0,14,13,1,18,47,14,33,32,43,5,4,6,5,1,,,
"Sep 1, 2021 1:00 PM",89,45,44,105,65,40,125,83,42,102,76,26,32,11,21,21,26,25,1,34,31,3,26,50,29,21,54,32,2,4,6,4,2,,,
"Sep 1, 2021 2:00 PM",64,35,29,68,41,27,63,31,32,73,46,27,12,5,7,19,28,27,1,29,26,3,29,28,17,11,29,27,4,9,9,7,2,,,
"Sep 1, 2021 3:00 PM",94,36,58,65,30,35,84,50,34,51,30,21,18,11,7,21,27,26,1,29,26,3,30,28,18,10,40,39,2,5,9,2,7,,,
"Sep 1, 2021 4:00 PM",139,40,99,71,37,34,76,37,39,68,32,36,32,8,24,25,27,27,0,51,47,4,30,42,24,18,57,38,10,4,9,7,2,,,
"Sep 1, 2021 5:00 PM",179,59,120,109,62,47,150,86,64,112,59,53,45,16,29,37,29,29,0,73,72,1,26,56,41,15,110,73,5,4,7,5,2,,,
"Sep 1, 2021 6:00 PM",159,54,105,126,76,50,189,122,67,141,87,54,15,7,8,34,45,45,0,81,78,3,46,60,45,15,98,70,6,5,9,7,2,,,
"Sep 1, 2021 7:00 PM",99,37,62,73,41,32,136,75,61,63,39,24,12,6,6,15,23,22,1,44,41,3,23,46,26,20,58,46,2,4,5,5,0,,,
"Sep 1, 2021 8:00 PM",80,37,43,61,33,28,89,40,49,62,32,30,13,3,10,19,27,27,0,35,34,1,22,31,16,15,28,34,2,1,7,5,2,,,
"Sep 1, 2021 9:00 PM",41,14,27,12,6,6,29,9,20,31,11,20,2,1,1,3,5,5,0,14,14,0,5,14,8,6,15,15,2,2,5,3,2,,,
"Sep 1, 2021 10:00 PM",30,9,21,9,7,2,19,10,9,22,10,12,3,0,3,4,6,6,0,15,13,2,5,6,4,2,9,7,3,0,5,2,3,,,
"Sep 1, 2021 11:00 PM",12,1,11,11,9,2,6,2,4,8,2,6,4,0,4,3,6,5,1,6,6,0,6,3,2,1,12,4,1,1,0,0,0,,,
"Sep 2, 2021 12:00 AM",9,6,3,0,0,0,0,0,0,1,1,0,0,0,0,0,0,0,0,4,3,1,0,2,2,0,2,5,0,2,0,0,0,,,
"Sep 2, 2021 1:00 AM",5,2,3,2,1,1,2,0,2,4,1,3,4,0,4,0,1,1,0,1,1,0,2,0,0,0,0,3,1,0,1,0,1,,,
"Sep 2, 2021 2:00 AM",3,3,0,0,0,0,1,0,1,0,0,0,0,0,0,0,1,0,1,2,2,0,0,0,0,0,1,2,0,0,0,0,0,,,
"Sep 2, 2021 3:00 AM",1,0,1,0,0,0,0,0,0,0,0,0,1,0,1,0,0,0,0,1,1,0,1,0,0,0,1,0,0,0,0,0,0,,,
"Sep 2, 2021 4:00 AM",2,1,1,0,0,0,1,1,0,0,0,0,0,0,0,0,0,0,0,0,0,0,0,0,0,0,1,0,0,0,0,0,0,,,
"Sep 2, 2021 5:00 AM",6,5,1,1,0,1,5,4,1,0,0,0,1,0,1,2,4,4,0,2,1,1,4,3,2,1,3,11,0,0,0,0,0,,,
"Sep 2, 2021 6:00 AM",43,31,12,27,11,16,33,16,17,23,11,12,4,4,0,9,23,22,1,9,8,1,23,8,6,2,16,26,3,3,2,2,0,,,
"Sep 2, 2021 7:00 AM",117,68,49,64,23,41,103,40,63,68,30,38,13,9,4,12,71,70,1,23,17,6,74,35,15,20,47,109,6,4,6,5,1,,,
"Sep 2, 2021 8:00 AM",221,149,72,128,41,87,224,78,146,159,61,98,50,32,18,39,116,116,0,57,45,12,118,84,17,67,65,145,7,5,14,11,3,,,
"Sep 2, 2021 9:00 AM",95,70,25,38,22,16,93,53,40,64,43,21,19,13,6,13,57,56,1,15,11,4,57,34,19,15,29,55,6,5,8,4,4,,,
"Sep 2, 2021 10:00 AM",49,26,23,58,28,30,75,36,39,45,23,22,15,10,5,12,28,28,0,14,13,1,29,22,11,11,20,31,4,7,1,1,0,,,
"Sep 2, 2021 11:00 AM",57,34,23,43,20,23,52,21,31,45,22,23,16,7,9,11,20,20,0,12,8,4,19,23,12,11,26,21,4,5,8,5,3,,,
"Sep 2, 2021 12:00 PM",53,26,27,51,20,31,69,38,31,52,31,21,25,11,14,14,27,27,0,20,18,2,28,20,6,14,26,20,5,1,6,6,0,,,
"Sep 2, 2021 1:00 PM",75,42,33,60,28,32,73,35,38,67,34,33,26,7,19,14,16,15,1,22,19,3,20,23,10,13,30,28,5,2,1,1,0,,,
"Sep 2, 2021 2:00 PM",72,39,33,43,25,18,56,25,31,54,26,28,26,15,11,20,26,25,1,30,29,1,22,33,20,13,25,29,3,6,9,7,2,,,
"Sep 2, 2021 3:00 PM",92,40,52,53,41,12,79,61,18,70,56,14,26,9,17,21,48,48,0,43,30,13,49,27,18,9,61,41,10,3,10,4,6,,,
"Sep 2, 2021 4:00 PM",140,52,88,83,49,34,106,67,39,104,64,40,24,12,12,21,23,23,0,52,49,3,24,33,25,8,53,47,4,3,9,6,3,,,
"Sep 2, 2021 5:00 PM",181,56,125,109,50,59,140,86,54,119,69,50,32,9,23,32,30,29,1,82,79,3,30,46,28,18,81,58,8,6,10,10,0,,,
"Sep 2, 2021 6:00 PM",166,59,107,81,49,32,148,88,60,103,58,45,26,12,14,21,22,22,0,77,74,3,25,61,38,23,95,66,6,6,9,7,2,,,
"Sep 2, 2021 7:00 PM",114,36,78,102,54,48,123,68,55,88,47,41,21,11,10,14,21,21,0,41,38,3,21,43,30,13,49,43,6,3,14,10,4,,,
"Sep 2, 2021 8:00 PM",84,34,50,45,26,19,85,36,49,62,28,34,9,1,8,17,23,21,2,35,31,4,20,28,12,16,24,33,4,2,4,0,4,,,
"Sep 2, 2021 9:00 PM",38,13,25,17,10,7,29,11,18,20,9,11,5,2,3,11,11,11,0,16,16,0,10,7,5,2,21,17,2,4,2,1,1,,,
"Sep 2, 2021 10:00 PM",33,10,23,9,8,1,21,11,10,12,6,6,7,2,5,3,3,3,0,9,7,2,4,4,4,0,11,8,3,2,3,3,0,,,
"Sep 2, 2021 11:00 PM",23,4,19,9,6,3,14,5,9,12,4,8,6,2,4,2,5,5,0,6,5,1,4,2,1,1,13,7,0,1,0,0,0,,,
"Sep 3, 2021 12:00 AM",13,4,9,1,1,0,2,1,1,6,1,5,1,1,0,2,1,1,0,3,3,0,1,2,1,1,5,4,2,1,1,0,1,,,
"Sep 3, 2021 1:00 AM",6,4,2,0,0,0,3,2,1,0,0,0,0,0,0,0,1,0,1,1,1,0,2,0,0,0,5,1,0,0,0,0,0,,,
"Sep 3, 2021 2:00 AM",3,1,2,2,0,2,2,0,2,2,0,2,0,0,0,0,1,1,0,0,0,0,1,0,0,0,0,2,0,0,0,0,0,,,
"Sep 3, 2021 3:00 AM",1,0,1,0,0,0,2,1,1,1,0,1,0,0,0,0,0,0,0,0,0,0,0,0,0,0,1,0,0,0,0,0,0,,,
"Sep 3, 2021 4:00 AM",1,1,0,0,0,0,1,0,1,0,0,0,0,0,0,1,1,1,0,0,0,0,1,0,0,0,0,0,0,0,0,0,0,,,
"Sep 3, 2021 5:00 AM",5,4,1,4,4,0,9,6,3,6,5,1,0,0,0,0,6,6,0,1,1,0,4,3,2,1,5,16,1,0,0,0,0,,,
"Sep 3, 2021 6:00 AM",38,29,9,32,17,15,38,24,14,29,16,13,3,2,1,6,21,20,1,6,3,3,23,13,4,9,25,25,1,1,0,0,0,,,
"Sep 3, 2021 7:00 AM",103,54,49,91,38,53,113,41,72,86,42,44,18,17,1,15,64,63,1,17,11,6,69,35,15,20,37,83,3,7,8,5,3,,,
"Sep 3, 2021 8:00 AM",193,131,62,138,42,96,208,80,128,161,61,100,46,31,15,26,89,88,1,57,47,10,92,86,23,63,57,121,9,5,13,12,1,,,
"Sep 3, 2021 9:00 AM",86,59,27,88,40,48,120,69,51,85,56,29,25,12,13,11,35,35,0,28,22,6,36,47,20,27,59,45,1,3,1,1,0,,,
"Sep 3, 2021 10:00 AM",57,33,24,80,26,54,92,48,44,71,39,32,12,10,2,5,25,25,0,11,10,1,27,23,14,9,24,41,4,1,3,1,2,,,
"Sep 3, 2021 11:00 AM",46,21,25,50,21,29,69,37,32,42,26,16,17,10,7,6,25,25,0,23,19,4,25,27,16,11,25,20,2,5,6,5,1,,,
"Sep 3, 2021 12:00 PM",81,38,43,85,46,39,102,48,54,74,35,39,19,11,8,12,19,18,1,18,14,4,19,37,18,19,35,39,2,1,6,3,3,,,
"Sep 3, 2021 1:00 PM",87,46,41,71,35,36,87,51,36,66,34,32,20,11,9,10,34,33,1,28,21,7,35,33,19,14,32,32,6,3,9,6,3,,,
"Sep 3, 2021 2:00 PM",95,49,46,77,40,37,78,41,37,77,40,37,19,12,7,18,28,27,1,23,20,3,25,29,15,14,32,37,5,5,14,8,6,,,
"Sep 3, 2021 3:00 PM",103,51,52,69,41,28,96,56,40,81,49,32,15,2,13,28,26,25,1,25,23,2,23,35,24,11,60,46,2,6,8,4,4,,,
"Sep 3, 2021 4:00 PM",119,41,78,91,48,43,113,60,53,90,48,42,19,6,13,23,19,19,0,42,35,7,20,51,31,20,60,51,5,7,11,8,3,,,
"Sep 3, 2021 5:00 PM",131,40,91,85,52,33,120,67,53,90,46,44,31,4,27,30,25,24,1,70,67,3,25,53,33,20,74,48,6,4,10,6,4,,,
"Sep 3, 2021 6:00 PM",112,37,75,78,52,26,101,68,33,91,51,40,23,15,8,14,25,24,1,51,48,3,25,49,37,12,48,36,3,2,9,5,4,,,
"Sep 3, 2021 7:00 PM",74,33,41,61,32,29,75,41,34,65,27,38,9,3,6,10,16,16,0,26,25,1,18,28,18,10,32,34,1,2,2,1,1,,,
"Sep 3, 2021 8:00 PM",60,26,34,25,17,8,45,21,24,21,11,10,13,3,10,5,9,8,1,17,15,2,11,28,16,12,20,31,2,1,6,3,3,,,
"Sep 3, 2021 9:00 PM",27,9,18,15,9,6,29,12,17,21,9,12,2,1,1,3,10,9,1,11,11,0,11,6,4,2,9,10,2,1,3,1,2,,,
"Sep 3, 2021 10:00 PM",19,4,15,15,10,5,20,10,10,17,9,8,4,0,4,3,5,5,0,13,13,0,6,13,7,6,7,11,0,1,0,0,0,,,
"Sep 3, 2021 11:00 PM",23,5,18,16,10,6,19,4,15,15,6,9,2,1,1,1,6,5,1,8,8,0,6,1,1,0,10,10,2,1,1,1,0,,,
"Sep 4, 2021 12:00 AM",18,5,13,0,0,0,3,1,2,7,1,6,3,3,0,1,6,5,1,14,11,3,4,0,0,0,4,9,0,0,3,1,2,,,
"Sep 4, 2021 1:00 AM",8,3,5,2,0,2,0,0,0,0,0,0,0,0,0,1,1,1,0,5,4,1,1,2,2,0,4,2,0,0,2,2,0,,,
"Sep 4, 2021 2:00 AM",8,5,3,4,2,2,2,1,1,2,0,2,0,0,0,0,1,1,0,2,2,0,1,1,1,0,3,1,0,0,0,0,0,,,
"Sep 4, 2021 3:00 AM",2,0,2,0,0,0,0,0,0,0,0,0,0,0,0,2,0,0,0,0,0,0,2,0,0,0,2,0,0,0,2,1,1,,,
"Sep 4, 2021 4:00 AM",3,1,2,0,0,0,1,1,0,0,0,0,0,0,0,0,0,0,0,0,0,0,0,0,0,0,2,1,0,0,0,0,0,,,
"Sep 4, 2021 5:00 AM",4,1,3,1,1,0,7,6,1,3,2,1,0,0,0,1,2,2,0,2,2,0,2,1,1,0,7,4,1,0,1,1,0,,,
"Sep 4, 2021 6:00 AM",3,0,3,13,7,6,17,10,7,10,6,4,0,0,0,2,7,6,1,4,4,0,7,2,2,0,9,9,0,2,0,0,0,,,
"Sep 4, 2021 7:00 AM",25,12,13,51,34,17,52,39,13,51,37,14,7,5,2,7,10,10,0,5,4,1,10,13,10,3,17,19,0,5,6,3,3,,,
"Sep 4, 2021 8:00 AM",38,16,22,72,33,39,77,41,36,59,38,21,13,6,7,5,18,18,0,12,10,2,21,22,14,8,26,20,4,2,0,0,0,,,
"Sep 4, 2021 9:00 AM",51,33,18,122,62,60,108,75,33,94,67,27,19,12,7,14,11,11,0,11,9,2,13,25,13,12,48,35,1,5,9,5,4,,,
"Sep 4, 2021 10:00 AM",65,40,25,163,86,77,183,118,65,141,88,53,26,11,15,18,27,26,1,9,9,0,29,37,27,10,47,45,4,7,5,3,2,,,
"Sep 4, 2021 11:00 AM",73,34,39,123,66,57,212,109,103,129,70,59,35,26,9,19,23,23,0,12,12,0,25,63,42,21,59,49,7,5,13,7,6,,,
"Sep 4, 2021 12:00 PM",56,29,27,199,71,128,208,107,101,161,78,83,42,20,22,27,23,23,0,22,20,2,20,74,44,30,39,54,18,6,17,11,6,,,
"Sep 4, 2021 1:00 PM",76,42,34,144,72,72,164,93,71,118,67,51,26,15,11,23,39,38,1,19,13,6,39,73,42,31,62,38,3,5,12,11,1,,,
"Sep 4, 2021 2:00 PM",75,50,25,160,94,66,161,73,88,137,74,63,38,18,20,14,28,28,0,14,10,4,27,53,30,23,39,56,7,14,16,11,5,,,
"Sep 4, 2021 3:00 PM",54,25,29,145,58,87,142,64,78,122,53,69,29,20,9,34,24,24,0,18,15,3,23,60,34,26,54,52,15,6,7,4,3,,,
"Sep 4, 2021 4:00 PM",63,37,26,170,89,81,151,87,64,138,81,57,49,19,30,25,18,15,3,25,18,7,16,73,38,35,36,47,4,6,7,4,3,,,
"Sep 4, 2021 5:00 PM",61,25,36,107,66,41,136,56,80,123,52,71,24,16,8,18,24,21,3,16,11,5,23,39,18,21,36,41,8,6,8,4,4,,,
"Sep 4, 2021 6:00 PM",61,24,37,71,38,33,69,25,44,59,19,40,19,10,9,9,20,19,1,12,8,4,23,26,5,21,30,47,4,1,4,2,2,,,
"Sep 4, 2021 7:00 PM",60,28,32,62,38,24,68,27,41,60,25,35,28,14,14,13,15,14,1,18,17,1,13,30,12,18,16,40,2,1,4,2,2,,,
"Sep 4, 2021 8:00 PM",35,15,20,41,21,20,44,20,24,44,19,25,11,4,7,11,17,16,1,11,10,1,19,20,5,15,12,21,0,2,5,2,3,,,
"Sep 4, 2021 9:00 PM",23,8,15,21,13,8,29,13,16,24,10,14,9,3,6,6,13,13,0,11,10,1,12,14,8,6,11,16,1,3,6,3,3,,,
"Sep 4, 2021 10:00 PM",11,6,5,9,7,2,12,5,7,12,7,5,7,2,5,4,1,1,0,8,8,0,1,4,3,1,4,13,1,0,3,1,2,,,
"Sep 4, 2021 11:00 PM",10,4,6,10,7,3,16,6,10,10,3,7,6,3,3,6,4,4,0,4,4,0,4,6,3,3,13,3,1,0,3,2,1,,,
"Sep 5, 2021 12:00 AM",14,5,9,2,2,0,3,1,2,13,10,3,2,1,1,1,3,2,1,7,6,1,2,6,5,1,9,3,1,0,0,0,0,,,
"Sep 5, 2021 1:00 AM",6,3,3,2,2,0,7,2,5,2,1,1,2,0,2,1,3,3,0,3,3,0,3,7,2,5,3,0,1,2,3,2,1,,,
"Sep 5, 2021 2:00 AM",4,3,1,3,1,2,11,3,8,3,1,2,2,0,2,0,1,1,0,4,4,0,1,3,2,1,2,3,0,0,1,1,0,,,
"Sep 5, 2021 3:00 AM",2,1,1,1,0,1,0,0,0,0,0,0,1,0,1,1,0,0,0,3,3,0,0,0,0,0,0,2,0,0,0,0,0,,,
"Sep 5, 2021 4:00 AM",2,1,1,0,0,0,0,0,0,0,0,0,0,0,0,1,1,1,0,0,0,0,1,0,0,0,1,1,0,1,1,1,0,,,
"Sep 5, 2021 5:00 AM",2,0,2,0,0,0,2,2,0,1,1,0,0,0,0,0,0,0,0,0,0,0,1,0,0,0,1,3,1,0,0,0,0,,,
"Sep 5, 2021 6:00 AM",7,2,5,8,4,4,8,5,3,5,2,3,0,0,0,4,9,9,0,3,3,0,9,2,2,0,13,6,0,2,1,0,1,,,
"Sep 5, 2021 7:00 AM",21,3,18,25,16,9,26,16,10,18,12,6,2,2,0,3,9,9,0,5,4,1,10,6,5,1,14,20,0,3,1,1,0,,,
"Sep 5, 2021 8:00 AM",30,12,18,89,43,46,83,55,28,73,49,24,16,12,4,5,14,14,0,10,9,1,15,20,12,8,27,24,2,6,3,1,2,,,
"Sep 5, 2021 9:00 AM",39,22,17,146,76,70,142,91,51,120,88,32,11,6,5,13,20,20,0,19,16,3,21,51,31,20,40,31,4,15,4,3,1,,,
"Sep 5, 2021 10:00 AM",38,24,14,151,83,68,161,89,72,125,74,51,21,9,12,19,16,16,0,13,13,0,16,55,32,23,62,33,5,8,6,3,3,,,
"Sep 5, 2021 11:00 AM",58,36,22,179,96,83,253,162,91,167,99,68,32,15,17,25,25,25,0,23,21,2,25,71,46,25,80,61,7,8,10,3,7,,,
"Sep 5, 2021 12:00 PM",77,33,44,232,116,116,310,170,140,224,114,110,44,23,21,20,28,28,0,18,16,2,27,105,64,41,64,56,7,3,14,10,4,,,
"Sep 5, 2021 1:00 PM",75,42,33,201,99,102,310,148,162,192,106,86,28,14,14,23,38,38,0,21,18,3,43,105,51,54,76,66,5,4,6,5,1,,,
"Sep 5, 2021 2:00 PM",67,32,35,165,80,85,235,118,117,158,93,65,48,35,13,26,38,38,0,20,17,3,38,64,32,32,51,73,5,8,5,3,2,,,
"Sep 5, 2021 3:00 PM",54,24,30,196,108,88,184,82,102,180,91,89,48,20,28,25,33,32,1,30,25,5,33,74,36,38,49,51,10,6,12,9,3,,,
"Sep 5, 2021 4:00 PM",64,31,33,158,81,77,189,87,102,153,70,83,44,18,26,31,27,26,1,25,21,4,30,88,40,48,30,44,5,9,12,8,4,,,
"Sep 5, 2021 5:00 PM",72,25,47,148,73,75,187,70,117,146,60,86,24,8,16,28,26,26,0,25,23,2,26,89,36,53,35,59,2,1,1,1,0,,,
"Sep 5, 2021 6:00 PM",50,19,31,125,61,64,119,59,60,119,52,67,20,13,7,27,14,14,0,24,18,6,15,49,18,31,29,47,4,4,17,11,6,,,
"Sep 5, 2021 7:00 PM",47,26,21,58,28,30,78,34,44,55,22,33,10,8,2,24,20,18,2,10,10,0,18,33,16,17,13,28,3,3,12,6,6,,,
"Sep 5, 2021 8:00 PM",27,13,14,37,12,25,66,23,43,51,22,29,9,6,3,8,13,12,1,8,8,0,14,16,6,10,15,30,1,0,8,5,3,,,
"Sep 5, 2021 9:00 PM",24,8,16,7,6,1,15,3,12,15,9,6,2,0,2,8,6,6,0,6,6,0,8,8,5,3,3,12,3,0,4,3,1,,,
"Sep 5, 2021 10:00 PM",19,7,12,8,5,3,13,4,9,8,4,4,0,0,0,6,2,2,0,5,5,0,2,2,2,0,5,11,3,1,6,3,3,,,
"Sep 5, 2021 11:00 PM",11,5,6,1,0,1,2,1,1,3,1,2,1,0,1,0,3,3,0,5,5,0,3,2,2,0,5,2,0,0,0,0,0,,,
"Sep 6, 2021 12:00 AM",7,2,5,0,0,0,0,0,0,0,0,0,1,0,1,0,1,1,0,3,3,0,1,0,0,0,2,1,0,0,0,0,0,,,
"Sep 6, 2021 1:00 AM",2,1,1,1,0,1,1,0,1,0,0,0,0,0,0,1,0,0,0,1,1,0,0,0,0,0,2,2,0,0,1,1,0,,,
"Sep 6, 2021 2:00 AM",4,0,4,0,0,0,2,2,0,0,0,0,0,0,0,2,0,0,0,1,1,0,0,2,2,0,0,0,0,0,0,0,0,,,
"Sep 6, 2021 3:00 AM",0,0,0,0,0,0,0,0,0,0,0,0,0,0,0,0,0,0,0,1,1,0,1,0,0,0,0,1,0,0,0,0,0,,,
"Sep 6, 2021 4:00 AM",1,0,1,0,0,0,0,0,0,0,0,0,0,0,0,2,0,0,0,0,0,0,0,0,0,0,1,1,0,0,1,1,0,,,
"Sep 6, 2021 5:00 AM",12,8,4,0,0,0,10,5,5,7,4,3,0,0,0,1,4,4,0,4,2,2,4,1,1,0,7,19,0,0,0,0,0,,,
"Sep 6, 2021 6:00 AM",41,33,8,22,11,11,34,16,18,24,11,13,4,4,0,6,28,28,0,10,10,0,28,10,3,7,20,38,1,1,1,1,0,,,
"Sep 6, 2021 7:00 AM",110,70,40,70,30,40,92,35,57,65,32,33,15,13,2,14,78,78,0,28,25,3,81,34,13,21,48,103,5,9,5,2,3,,,
"Sep 6, 2021 8:00 AM",206,142,64,144,43,101,191,60,131,149,54,95,53,39,14,49,123,123,0,60,45,15,133,91,22,69,60,143,7,5,20,15,5,,,
"Sep 6, 2021 9:00 AM",100,69,31,98,48,50,114,73,41,86,56,30,16,10,6,14,51,51,0,25,14,11,52,45,23,22,38,57,4,3,5,5,0,,,
"Sep 6, 2021 10:00 AM",43,26,17,80,40,40,87,51,36,60,31,29,23,16,7,12,19,19,0,21,19,2,20,23,9,14,21,33,5,4,5,2,3,,,
"Sep 6, 2021 11:00 AM",47,23,24,101,56,45,115,71,44,77,53,24,16,9,7,11,28,27,1,14,13,1,26,43,26,17,42,35,6,1,0,0,0,,,
"Sep 6, 2021 12:00 PM",61,26,35,100,58,42,225,123,102,104,53,51,27,10,17,16,28,27,1,22,19,3,26,70,46,24,72,48,7,4,6,4,2,,,
"Sep 6, 2021 1:00 PM",72,26,46,142,73,69,241,123,118,113,55,58,13,8,5,15,28,28,0,25,20,5,30,63,28,35,47,46,9,5,2,2,0,,,
"Sep 6, 2021 2:00 PM",73,38,35,103,59,44,153,80,73,93,59,34,39,20,19,22,22,22,0,26,25,1,20,64,27,37,45,39,5,12,7,4,3,,,
"Sep 6, 2021 3:00 PM",96,39,57,133,65,68,158,85,73,106,60,46,28,10,18,27,41,41,0,43,38,5,35,59,38,21,56,58,8,3,7,3,4,,,
"Sep 6, 2021 4:00 PM",142,58,84,170,96,74,199,114,85,150,82,68,46,11,35,19,29,29,0,62,57,5,34,86,64,22,81,49,10,6,19,10,9,,,
"Sep 6, 2021 5:00 PM",197,72,125,179,106,73,243,134,109,185,102,83,30,16,14,38,37,37,0,110,103,7,35,101,54,47,134,90,8,11,10,5,5,,,
"Sep 6, 2021 6:00 PM",178,72,106,259,162,97,286,178,108,220,138,82,36,20,16,41,39,38,1,73,71,2,38,83,57,26,133,62,7,6,16,8,8,,,
"Sep 6, 2021 7:00 PM",123,45,78,240,111,129,255,134,121,184,97,87,27,10,17,28,38,36,2,41,36,5,42,85,45,40,72,68,7,6,16,10,6,,,
"Sep 6, 2021 8:00 PM",87,34,53,135,48,87,145,45,100,113,38,75,12,7,5,14,26,25,1,23,22,1,24,55,14,41,29,45,8,1,9,6,3,,,
"Sep 6, 2021 9:00 PM",44,11,33,24,8,16,40,6,34,22,4,18,3,3,0,4,12,12,0,8,8,0,14,12,6,6,13,28,1,0,7,3,4,,,
"Sep 6, 2021 10:00 PM",15,2,13,12,6,6,13,1,12,10,3,7,0,0,0,3,6,6,0,6,5,1,6,11,11,0,7,13,0,0,2,2,0,,,
"Sep 6, 2021 11:00 PM",13,4,9,7,3,4,6,3,3,4,0,4,0,0,0,0,2,2,0,6,6,0,3,3,3,0,3,3,2,2,1,0,1,,,
"Sep 7, 2021 12:00 AM",8,2,6,0,0,0,2,2,0,4,1,3,0,0,0,0,1,1,0,1,1,0,2,1,0,1,3,2,1,0,1,1,0,,,
"Sep 7, 2021 1:00 AM",1,0,1,1,1,0,3,2,1,1,1,0,0,0,0,0,0,0,0,1,0,1,2,1,1,0,4,1,0,0,0,0,0,,,
"Sep 7, 2021 2:00 AM",1,1,0,0,0,0,1,0,1,1,0,1,0,0,0,1,1,1,0,1,0,1,1,0,0,0,0,1,0,0,0,0,0,,,
"Sep 7, 2021 3:00 AM",1,0,1,0,0,0,1,0,1,0,0,0,0,0,0,0,0,0,0,0,0,0,1,0,0,0,0,2,0,0,0,0,0,,,
"Sep 7, 2021 4:00 AM",2,1,1,0,0,0,2,1,1,1,0,1,1,0,1,1,0,0,0,0,0,0,0,1,0,1,1,0,0,0,0,0,0,,,
"Sep 7, 2021 5:00 AM",6,4,2,2,1,1,5,2,3,5,2,3,0,0,0,1,4,4,0,1,0,1,4,0,0,0,5,11,0,0,0,0,0,,,
"Sep 7, 2021 6:00 AM",47,39,8,41,27,14,47,31,16,40,29,11,8,6,2,12,30,29,1,17,14,3,27,11,8,3,31,40,1,1,5,5,0,,,
"Sep 7, 2021 7:00 AM",147,91,56,96,35,61,109,36,73,86,41,45,14,13,1,11,72,69,3,30,24,6,73,46,18,28,49,110,6,7,3,2,1,,,
"Sep 7, 2021 8:00 AM",198,133,65,157,49,108,205,61,144,167,53,114,37,21,16,44,138,137,1,76,64,12,135,83,18,65,67,162,5,5,22,21,1,,,
"Sep 7, 2021 9:00 AM",83,61,22,84,38,46,96,52,44,80,48,32,20,13,7,27,30,30,0,13,9,4,36,35,14,21,29,61,2,4,13,7,6,,,
"Sep 7, 2021 10:00 AM",60,37,23,83,35,48,89,58,31,70,38,32,15,9,6,11,26,25,1,13,9,4,26,19,15,4,35,39,4,5,5,4,1,,,
"Sep 7, 2021 11:00 AM",46,26,20,73,41,32,111,62,49,69,35,34,14,7,7,6,24,24,0,19,14,5,26,32,20,12,41,34,9,3,10,7,3,,,
"Sep 7, 2021 12:00 PM",76,42,34,133,67,66,225,141,84,110,64,46,18,4,14,14,28,25,3,27,24,3,26,77,39,38,66,33,6,6,9,6,3,,,
"Sep 7, 2021 1:00 PM",63,40,23,123,71,52,286,145,141,110,61,49,17,7,10,18,45,45,0,33,28,5,46,83,42,41,68,62,10,2,10,7,3,,,
"Sep 7, 2021 2:00 PM",70,31,39,142,89,53,221,126,95,125,90,35,31,13,18,26,25,25,0,27,24,3,24,95,49,46,56,46,4,13,6,2,4,,,
"Sep 7, 2021 3:00 PM",96,38,58,140,79,61,187,98,89,108,59,49,25,17,8,22,46,46,0,27,19,8,45,65,36,29,78,52,7,5,15,5,10,,,
"Sep 7, 2021 4:00 PM",154,68,86,172,87,85,198,108,90,134,79,55,28,9,19,23,42,40,2,63,56,7,39,67,39,28,94,82,9,3,16,8,8,,,
"Sep 7, 2021 5:00 PM",190,59,131,189,121,68,248,154,94,174,106,68,44,17,27,25,32,31,1,109,100,9,33,85,49,36,158,110,10,6,12,7,5,,,
"Sep 7, 2021 6:00 PM",174,71,103,275,177,98,320,205,115,269,176,93,32,9,23,38,37,36,1,58,54,4,38,112,67,45,156,97,8,10,12,6,6,,,
"Sep 7, 2021 7:00 PM",132,58,74,264,131,133,261,138,123,217,114,103,27,18,9,31,42,38,4,43,40,3,39,80,51,29,72,78,5,4,21,14,7,,,
"Sep 7, 2021 8:00 PM",106,34,72,132,48,84,190,56,134,141,46,95,14,9,5,12,20,20,0,36,29,7,22,58,20,38,40,73,7,1,12,4,8,,,
"Sep 7, 2021 9:00 PM",46,18,28,28,9,19,46,10,36,36,13,23,5,3,2,5,10,10,0,18,16,2,12,11,7,4,20,43,3,7,8,4,4,,,
"Sep 7, 2021 10:00 PM",46,6,40,17,7,10,16,7,9,19,7,12,1,0,1,3,9,9,0,11,11,0,9,8,5,3,19,13,2,1,5,3,2,,,
"Sep 7, 2021 11:00 PM",19,4,15,6,6,0,7,2,5,10,5,5,2,1,1,0,3,3,0,9,6,3,3,4,1,3,6,7,1,0,2,1,1,,,
"Sep 8, 2021 12:00 AM",10,2,8,0,0,0,0,0,0,1,1,0,5,2,3,0,0,0,0,5,5,0,0,1,1,0,5,2,1,0,5,4,1,,,
"Sep 8, 2021 1:00 AM",2,0,2,0,0,0,1,1,0,0,0,0,0,0,0,0,0,0,0,1,1,0,0,1,1,0,0,0,0,1,0,0,0,,,
"Sep 8, 2021 2:00 AM",2,2,0,1,0,1,6,6,0,8,6,2,0,0,0,0,0,0,0,0,0,0,0,4,4,0,3,0,0,0,0,0,0,,,
"Sep 8, 2021 3:00 AM",2,1,1,2,1,1,3,0,3,1,0,1,0,0,0,1,0,0,0,0,0,0,0,0,0,0,0,4,0,0,0,0,0,,,
"Sep 8, 2021 4:00 AM",2,1,1,0,0,0,1,1,0,0,0,0,0,0,0,2,1,0,1,2,2,0,1,0,0,0,1,1,0,0,1,1,0,,,
"Sep 8, 2021 5:00 AM",8,6,2,3,2,1,6,3,3,5,4,1,0,0,0,2,4,4,0,4,2,2,4,1,0,1,4,10,0,0,1,1,0,,,
"Sep 8, 2021 6:00 AM",49,36,13,21,9,12,28,13,15,19,10,9,5,4,1,9,21,20,1,9,9,0,25,9,4,5,27,37,0,0,1,1,0,,,
"Sep 8, 2021 7:00 AM",121,81,40,84,34,50,117,42,75,87,42,45,10,8,2,15,79,78,1,31,28,3,79,37,13,24,32,118,0,9,7,2,5,,,
"Sep 8, 2021 8:00 AM",199,139,60,165,51,114,218,68,150,169,57,112,59,45,14,32,107,106,1,56,46,10,119,80,15,65,77,162,7,3,13,11,2,,,
"Sep 8, 2021 9:00 AM",94,73,21,84,45,39,84,47,37,92,60,32,14,6,8,8,51,51,0,14,10,4,50,29,15,14,23,53,4,1,7,4,3,,,
"Sep 8, 2021 10:00 AM",52,31,21,77,39,38,73,42,31,63,38,25,14,12,2,16,29,29,0,18,13,5,32,24,14,10,31,28,6,5,4,4,0,,,
"Sep 8, 2021 11:00 AM",51,28,23,62,25,37,68,36,32,48,23,25,11,7,4,16,19,18,1,10,8,2,18,26,6,20,32,34,4,1,3,2,1,,,
"Sep 8, 2021 12:00 PM",69,39,30,73,29,44,120,62,58,70,29,41,21,8,13,17,22,22,0,18,16,2,22,25,12,13,35,37,1,2,4,2,2,,,
"Sep 8, 2021 1:00 PM",93,47,46,84,54,30,170,97,73,74,53,21,25,8,17,17,30,30,0,31,27,4,30,65,34,31,65,53,7,10,11,4,7,,,
"Sep 8, 2021 2:00 PM",65,26,39,61,35,26,98,52,46,66,48,18,15,8,7,18,25,24,1,28,21,7,25,36,15,21,35,33,3,9,11,4,7,,,
"Sep 8, 2021 3:00 PM",91,41,50,49,32,17,88,48,40,57,32,25,29,10,19,23,31,30,1,38,32,6,30,28,16,12,48,39,5,5,9,1,8,,,
"Sep 8, 2021 4:00 PM",130,52,78,76,43,33,119,74,45,81,44,37,28,12,16,22,30,28,2,57,56,1,30,43,26,17,68,57,7,5,11,8,3,,,
"Sep 8, 2021 5:00 PM",181,65,116,94,55,39,124,80,44,106,75,31,28,15,13,32,39,39,0,84,83,1,40,47,34,13,124,48,8,3,7,5,2,,,
"Sep 8, 2021 6:00 PM",164,54,110,120,72,48,166,102,64,134,88,46,23,10,13,28,42,40,2,78,75,3,43,56,36,20,91,76,4,5,8,5,3,,,
"Sep 8, 2021 7:00 PM",96,30,66,95,45,50,95,56,39,76,43,33,15,5,10,16,25,25,0,33,31,2,26,43,25,18,47,35,9,7,8,6,2,,,
"Sep 8, 2021 8:00 PM",77,24,53,61,31,30,86,37,49,55,22,33,13,8,5,14,15,15,0,28,26,2,15,19,13,6,34,29,1,3,6,4,2,,,
"Sep 8, 2021 9:00 PM",44,19,25,19,6,13,25,11,14,13,6,7,1,0,1,12,9,9,0,22,21,1,10,6,4,2,24,19,2,2,5,3,2,,,
"Sep 8, 2021 10:00 PM",33,13,20,15,9,6,19,7,12,18,8,10,2,0,2,5,8,8,0,8,8,0,8,7,4,3,10,5,3,1,1,1,0,,,
"Sep 8, 2021 11:00 PM",14,3,11,7,6,1,15,6,9,12,5,7,1,0,1,5,4,4,0,5,4,1,4,3,3,0,9,4,0,2,1,0,1,,,
"Sep 9, 2021 12:00 AM",10,1,9,0,0,0,1,1,0,1,1,0,0,0,0,2,1,1,0,2,2,0,1,1,1,0,3,3,0,0,1,0,1,,,
"Sep 9, 2021 1:00 AM",1,1,0,0,0,0,0,0,0,1,1,0,0,0,0,1,1,0,1,2,2,0,1,0,0,0,1,0,0,0,0,0,0,,,
"Sep 9, 2021 2:00 AM",0,0,0,3,1,2,2,1,1,1,0,1,0,0,0,1,0,0,0,0,0,0,0,0,0,0,1,1,0,0,0,0,0,,,
"Sep 9, 2021 3:00 AM",0,0,0,1,1,0,0,0,0,0,0,0,2,0,2,0,0,0,0,0,0,0,1,0,0,0,0,1,0,0,0,0,0,,,
"Sep 9, 2021 4:00 AM",1,1,0,0,0,0,1,1,0,0,0,0,0,0,0,0,0,0,0,3,2,1,0,0,0,0,1,0,0,0,0,0,0,,,
"Sep 9, 2021 5:00 AM",5,3,2,1,0,1,5,4,1,4,3,1,0,0,0,1,3,3,0,3,2,1,3,1,1,0,5,7,0,1,0,0,0,,,
"Sep 9, 2021 6:00 AM",48,31,17,32,17,15,35,21,14,31,21,10,4,4,0,7,20,20,0,7,7,0,19,13,4,9,25,28,0,1,2,2,0,,,
"Sep 9, 2021 7:00 AM",109,63,46,66,23,43,102,30,72,65,26,39,8,8,0,19,66,66,0,34,25,9,73,37,10,27,52,86,2,11,10,8,2,,,
"Sep 9, 2021 8:00 AM",198,129,69,119,34,85,137,44,93,136,53,83,38,29,9,40,121,120,1,59,48,11,118,62,19,43,60,145,8,5,16,13,3,,,
"Sep 9, 2021 9:00 AM",77,49,28,62,28,34,74,38,36,70,34,36,15,10,5,11,46,46,0,13,11,2,53,27,11,16,30,66,2,3,5,4,1,,,
"Sep 9, 2021 10:00 AM",56,35,21,46,19,27,60,36,24,49,33,16,13,5,8,11,26,25,1,16,14,2,28,24,14,10,24,31,2,1,2,1,1,,,
"Sep 9, 2021 11:00 AM",46,25,21,48,22,26,70,41,29,50,27,23,13,6,7,9,21,21,0,8,7,1,22,19,7,12,28,25,1,2,7,4,3,,,
"Sep 9, 2021 12:00 PM",60,38,22,68,34,34,81,36,45,54,25,29,16,8,8,29,19,19,0,22,19,3,19,22,14,8,26,29,8,1,8,5,3,,,
"Sep 9, 2021 1:00 PM",69,36,33,61,26,35,109,65,44,50,25,25,20,10,10,16,35,34,1,27,22,5,33,38,21,17,32,32,6,3,3,2,1,,,
"Sep 9, 2021 2:00 PM",71,32,39,39,21,18,108,55,53,63,39,24,21,14,7,18,32,31,1,28,28,0,31,23,17,6,35,36,10,10,1,0,1,,,
"Sep 9, 2021 3:00 PM",71,29,42,52,31,21,98,60,38,56,37,19,25,14,11,25,53,53,0,29,21,8,46,34,16,18,63,43,5,2,7,4,3,,,
"Sep 9, 2021 4:00 PM",138,65,73,83,45,38,155,85,70,90,60,30,23,9,14,24,29,29,0,65,61,4,31,24,17,7,96,52,8,2,7,4,3,,,
"Sep 9, 2021 5:00 PM",158,53,105,106,64,42,142,84,58,105,65,40,20,10,10,26,36,35,1,81,77,4,35,32,15,17,107,70,3,3,9,6,3,,,
"Sep 9, 2021 6:00 PM",158,62,96,90,54,36,158,101,57,110,68,42,27,16,11,16,43,41,2,70,66,4,40,34,22,12,98,55,9,4,13,12,1,,,
"Sep 9, 2021 7:00 PM",103,37,66,89,45,44,101,57,44,85,48,37,18,14,4,7,23,21,2,30,28,2,23,24,13,11,63,27,1,1,15,12,3,,,
"Sep 9, 2021 8:00 PM",73,26,47,56,30,26,46,25,21,47,15,32,10,5,5,11,17,17,0,26,25,1,16,4,3,1,29,23,2,2,11,4,7,,,
"Sep 9, 2021 9:00 PM",51,25,26,29,16,13,28,8,20,26,6,20,3,0,3,6,4,3,1,18,18,0,4,8,5,3,18,19,1,1,2,2,0,,,
"Sep 9, 2021 10:00 PM",32,11,21,12,9,3,19,7,12,20,3,17,8,1,7,12,10,10,0,20,19,1,10,2,2,0,17,14,3,2,3,3,0,,,
"Sep 9, 2021 11:00 PM",27,5,22,12,8,4,15,4,11,8,3,5,3,0,3,2,8,8,0,9,9,0,8,1,1,0,13,4,0,2,0,0,0,,,
"Sep 10, 2021 12:00 AM",17,3,14,0,0,0,3,2,1,5,3,2,1,0,1,4,1,1,0,10,10,0,0,0,0,0,8,4,1,0,1,1,0,,,
"Sep 10, 2021 1:00 AM",6,2,4,0,0,0,1,1,0,1,1,0,0,0,0,0,3,3,0,2,2,0,3,0,0,0,2,1,1,0,0,0,0,,,
"Sep 10, 2021 2:00 AM",5,0,5,1,1,0,1,1,0,1,1,0,0,0,0,0,1,1,0,1,1,0,1,0,0,0,1,0,0,0,0,0,0,,,
"Sep 10, 2021 3:00 AM",0,0,0,1,0,1,1,1,0,0,0,0,0,0,0,0,0,0,0,0,0,0,1,0,0,0,1,0,0,0,0,0,0,,,
"Sep 10, 2021 4:00 AM",1,1,0,0,0,0,0,0,0,0,0,0,0,0,0,2,0,0,0,0,0,0,0,0,0,0,0,0,0,0,0,0,0,,,
"Sep 10, 2021 5:00 AM",5,3,2,1,1,0,7,4,3,6,4,2,0,0,0,2,4,4,0,4,2,2,4,1,1,0,4,13,0,0,0,0,0,,,
"Sep 10, 2021 6:00 AM",44,31,13,39,24,15,41,23,18,31,20,11,3,2,1,4,9,9,0,7,6,1,10,5,1,4,31,37,1,2,0,0,0,,,
"Sep 10, 2021 7:00 AM",104,53,51,83,37,46,102,33,69,79,39,40,8,8,0,14,66,66,0,23,17,6,67,30,12,18,58,83,2,6,6,4,2,,,
"Sep 10, 2021 8:00 AM",170,118,52,123,37,86,152,45,107,136,50,86,41,27,14,38,95,95,0,57,45,12,93,34,7,27,74,148,9,7,16,14,2,,,
"Sep 10, 2021 9:00 AM",105,73,32,80,43,37,96,59,37,82,48,34,11,9,2,11,32,32,0,33,23,10,36,11,7,4,29,49,3,1,7,5,2,,,
"Sep 10, 2021 10:00 AM",57,36,21,75,36,39,71,34,37,58,30,28,13,7,6,15,30,29,1,10,8,2,30,13,11,2,29,40,3,4,2,2,0,,,
"Sep 10, 2021 11:00 AM",63,27,36,51,28,23,72,43,29,62,37,25,23,15,8,12,23,22,1,28,23,5,22,14,10,4,35,26,5,4,2,1,1,,,
"Sep 10, 2021 12:00 PM",68,32,36,80,47,33,113,67,46,82,45,37,17,9,8,18,23,23,0,18,12,6,25,21,12,9,46,33,5,4,8,7,1,,,
"Sep 10, 2021 1:00 PM",103,60,43,73,34,39,129,73,56,63,32,31,21,7,14,27,33,31,2,34,29,5,32,24,11,13,39,35,3,2,4,1,3,,,
"Sep 10, 2021 2:00 PM",105,53,52,98,57,41,129,61,68,96,57,39,16,7,9,28,29,29,0,30,25,5,30,24,12,12,51,42,4,3,5,2,3,,,
"Sep 10, 2021 3:00 PM",117,59,58,87,54,33,110,66,44,63,35,28,26,9,17,33,26,26,0,37,31,6,17,24,12,12,68,43,4,2,8,7,1,,,
"Sep 10, 2021 4:00 PM",123,50,73,92,55,37,134,83,51,103,65,38,19,6,13,17,22,22,0,51,49,2,21,20,14,6,75,53,3,4,8,5,3,,,
"Sep 10, 2021 5:00 PM",177,63,114,77,45,32,139,80,59,85,54,31,31,13,18,19,40,39,1,74,65,9,38,26,17,9,103,63,7,5,10,8,2,,,
"Sep 10, 2021 6:00 PM",110,40,70,96,60,36,133,87,46,108,71,37,41,22,19,27,38,34,4,42,40,2,40,25,17,8,80,63,2,6,9,3,6,,,
"Sep 10, 2021 7:00 PM",85,37,48,74,33,41,68,38,30,70,40,30,16,7,9,11,33,28,5,28,26,2,31,14,10,4,40,36,7,3,10,6,4,,,
"Sep 10, 2021 8:00 PM",53,22,31,43,18,25,52,23,29,48,23,25,7,4,3,11,16,16,0,20,19,1,16,18,13,5,24,23,0,2,5,3,2,,,
"Sep 10, 2021 9:00 PM",36,7,29,23,16,7,46,20,26,30,13,17,14,5,9,7,9,8,1,17,17,0,6,7,4,3,16,17,3,2,6,5,1,,,
"Sep 10, 2021 10:00 PM",24,10,14,15,13,2,18,3,15,13,7,6,6,4,2,6,4,4,0,10,10,0,4,2,2,0,12,11,1,3,0,0,0,,,
"Sep 10, 2021 11:00 PM",28,6,22,12,6,6,9,4,5,10,3,7,8,5,3,6,8,8,0,14,14,0,8,1,1,0,22,5,2,2,1,1,0,,,
"Sep 11, 2021 12:00 AM",21,5,16,1,1,0,9,4,5,16,4,12,2,0,2,3,6,5,1,8,6,2,4,3,3,0,11,10,0,0,1,1,0,,,
"Sep 11, 2021 1:00 AM",10,3,7,1,1,0,7,4,3,6,4,2,1,0,1,5,2,2,0,5,4,1,2,2,1,1,11,5,0,0,2,1,1,,,
"Sep 11, 2021 2:00 AM",3,1,2,2,2,0,4,3,1,1,1,0,0,0,0,0,1,1,0,1,1,0,2,0,0,0,4,2,0,0,0,0,0,,,
"Sep 11, 2021 3:00 AM",0,0,0,0,0,0,0,0,0,0,0,0,0,0,0,0,0,0,0,0,0,0,2,0,0,0,4,2,0,0,0,0,0,,,
"Sep 11, 2021 4:00 AM",2,2,0,0,0,0,0,0,0,0,0,0,0,0,0,1,0,0,0,0,0,0,0,0,0,0,1,2,0,0,0,0,0,,,
"Sep 11, 2021 5:00 AM",3,0,3,0,0,0,4,3,1,2,1,1,0,0,0,2,3,3,0,1,1,0,3,0,0,0,5,2,0,1,1,1,0,,,
"Sep 11, 2021 6:00 AM",8,3,5,13,8,5,14,10,4,10,6,4,0,0,0,4,2,2,0,3,3,0,2,7,7,0,12,18,0,2,2,2,0,,,
"Sep 11, 2021 7:00 AM",28,8,20,38,22,16,31,18,13,35,23,12,2,2,0,2,6,6,0,8,6,2,6,6,5,1,17,18,0,2,3,1,2,,,
"Sep 11, 2021 8:00 AM",47,27,20,90,52,38,91,59,32,91,60,31,20,3,17,9,16,16,0,12,11,1,17,12,5,7,50,26,2,5,2,0,2,,,
"Sep 11, 2021 9:00 AM",54,31,23,89,42,47,105,58,47,94,52,42,16,11,5,9,13,13,0,16,12,4,14,16,9,7,36,40,6,10,7,7,0,,,
"Sep 11, 2021 10:00 AM",75,35,40,115,67,48,107,60,47,105,68,37,26,17,9,22,15,15,0,14,13,1,15,34,31,3,52,34,3,10,9,6,3,,,
"Sep 11, 2021 11:00 AM",91,45,46,146,60,86,182,100,82,160,75,85,38,11,27,29,42,41,1,11,10,1,38,34,25,9,61,47,8,3,6,1,5,,,
"Sep 11, 2021 12:00 PM",79,36,43,207,78,129,198,125,73,187,120,67,32,24,8,24,34,30,4,17,14,3,31,38,27,11,72,43,14,12,15,9,6,,,
"Sep 11, 2021 1:00 PM",81,39,42,151,73,78,177,93,84,128,73,55,28,17,11,19,26,26,0,23,21,2,25,32,23,9,58,77,7,4,8,3,5,,,
"Sep 11, 2021 2:00 PM",72,41,31,121,65,56,172,86,86,122,69,53,24,15,9,17,34,32,2,20,18,2,35,31,14,17,50,57,11,7,8,6,2,,,
"Sep 11, 2021 3:00 PM",72,36,36,153,78,75,201,100,101,119,54,65,33,13,20,14,20,20,0,19,18,1,17,29,12,17,55,42,7,1,10,10,0,,,
"Sep 11, 2021 4:00 PM",73,36,37,103,45,58,184,69,115,122,59,63,38,13,25,22,28,27,1,27,24,3,27,33,17,16,44,55,9,4,7,5,2,,,
"Sep 11, 2021 5:00 PM",76,43,33,88,49,39,163,67,96,93,31,62,21,8,13,19,22,22,0,14,10,4,27,25,18,7,41,48,5,6,9,8,1,,,
"Sep 11, 2021 6:00 PM",52,27,25,70,44,26,94,39,55,65,27,38,25,9,16,15,20,19,1,12,11,1,20,24,9,15,31,38,4,2,7,3,4,,,
"Sep 11, 2021 7:00 PM",50,28,22,70,42,28,73,38,35,66,38,28,8,4,4,15,17,17,0,11,8,3,16,17,11,6,23,36,3,2,7,5,2,,,
"Sep 11, 2021 8:00 PM",35,17,18,29,19,10,39,14,25,24,12,12,6,2,4,31,11,11,0,6,6,0,12,16,8,8,14,10,1,2,0,0,0,,,
"Sep 11, 2021 9:00 PM",18,5,13,13,6,7,28,5,23,22,3,19,6,4,2,2,8,8,0,11,10,1,8,4,2,2,4,25,3,2,3,3,0,,,
"Sep 11, 2021 10:00 PM",13,5,8,11,3,8,11,4,7,12,3,9,0,0,0,10,6,6,0,6,6,0,8,3,2,1,10,7,2,3,1,1,0,,,
"Sep 11, 2021 11:00 PM",24,9,15,11,8,3,15,3,12,10,1,9,1,0,1,3,8,7,1,6,6,0,7,1,1,0,6,9,1,2,1,1,0,,,
"Sep 12, 2021 12:00 AM",21,6,15,1,1,0,4,1,3,7,1,6,5,1,4,3,5,5,0,8,8,0,5,2,2,0,10,11,0,1,2,1,1,,,
"Sep 12, 2021 1:00 AM",8,0,8,1,1,0,7,4,3,2,1,1,4,0,4,1,0,0,0,3,3,0,1,3,2,1,2,2,0,0,0,0,0,,,
"Sep 12, 2021 2:00 AM",3,0,3,1,1,0,1,0,1,2,1,1,0,0,0,1,2,1,1,3,3,0,2,0,0,0,5,4,0,1,0,0,0,,,
"Sep 12, 2021 3:00 AM",3,1,2,1,0,1,1,1,0,2,1,1,3,0,3,0,0,0,0,4,4,0,1,1,0,1,2,2,0,0,0,0,0,,,
"Sep 12, 2021 4:00 AM",2,2,0,0,0,0,2,1,1,0,0,0,0,0,0,0,0,0,0,0,0,0,0,1,1,0,1,0,0,0,0,0,0,,,
"Sep 12, 2021 5:00 AM",4,2,2,0,0,0,1,1,0,1,1,0,0,0,0,0,3,3,0,2,2,0,3,0,0,0,4,5,0,1,1,1,0,,,
"Sep 12, 2021 6:00 AM",5,2,3,6,3,3,14,10,4,9,5,4,0,0,0,2,2,2,0,6,6,0,3,3,2,1,13,6,0,0,1,1,0,,,
"Sep 12, 2021 7:00 AM",17,7,10,18,11,7,25,15,10,20,16,4,0,0,0,5,9,9,0,6,2,4,8,0,0,0,20,20,0,2,0,0,0,,,
"Sep 12, 2021 8:00 AM",34,16,18,50,26,24,51,32,19,53,32,21,6,5,1,4,8,7,1,4,4,0,6,8,7,1,23,26,2,5,1,0,1,,,
"Sep 12, 2021 9:00 AM",39,25,14,96,65,31,95,62,33,102,65,37,17,11,6,13,15,15,0,8,6,2,13,17,10,7,51,36,1,5,5,5,0,,,
"Sep 12, 2021 10:00 AM",47,29,18,165,98,67,152,101,51,129,89,40,30,11,19,10,23,23,0,12,11,1,22,42,32,10,57,43,3,7,8,1,7,,,
"Sep 12, 2021 11:00 AM",53,27,26,189,103,86,145,83,62,155,95,60,30,13,17,18,28,26,2,23,18,5,25,29,13,16,51,35,3,13,10,4,6,,,
"Sep 12, 2021 12:00 PM",82,46,36,173,72,101,154,89,65,147,84,63,30,22,8,19,26,24,2,19,16,3,21,18,11,7,75,45,11,9,10,6,4,,,
"Sep 12, 2021 1:00 PM",76,43,33,157,73,84,138,70,68,119,48,71,18,7,11,22,14,14,0,32,30,2,13,27,14,13,40,44,10,4,9,7,2,,,
"Sep 12, 2021 2:00 PM",53,37,16,142,69,73,141,81,60,109,64,45,29,11,18,19,22,22,0,15,11,4,22,21,13,8,53,39,8,3,12,8,4,,,
"Sep 12, 2021 3:00 PM",69,35,34,151,79,72,190,96,94,132,70,62,41,16,25,23,17,17,0,14,14,0,14,35,15,20,53,58,6,2,7,5,2,,,
"Sep 12, 2021 4:00 PM",63,30,33,174,97,77,184,81,103,141,68,73,26,5,21,22,7,6,1,20,18,2,9,47,20,27,54,42,3,0,2,2,0,,,
"Sep 12, 2021 5:00 PM",73,35,38,99,46,53,119,46,73,83,33,50,17,6,11,26,21,21,0,19,15,4,22,25,2,23,36,47,6,4,6,2,4,,,
"Sep 12, 2021 6:00 PM",55,23,32,58,26,32,59,19,40,53,18,35,21,17,4,42,20,20,0,16,16,0,22,11,6,5,22,36,4,0,8,6,2,,,
"Sep 12, 2021 7:00 PM",41,20,21,47,22,25,51,26,25,39,21,18,21,4,17,14,9,9,0,16,15,1,8,12,9,3,23,25,4,1,3,3,0,,,
"Sep 12, 2021 8:00 PM",23,9,14,34,22,12,33,13,20,23,9,14,4,2,2,4,11,11,0,9,9,0,9,6,3,3,7,16,1,3,1,0,1,,,
"Sep 12, 2021 9:00 PM",18,7,11,10,6,4,16,3,13,10,3,7,5,2,3,4,7,7,0,4,2,2,8,2,1,1,3,22,1,1,2,1,1,,,
"Sep 12, 2021 10:00 PM",14,6,8,1,1,0,6,2,4,5,2,3,0,0,0,3,7,7,0,0,0,0,7,2,2,0,7,3,1,3,0,0,0,,,
"Sep 12, 2021 11:00 PM",9,3,6,0,0,0,8,5,3,3,2,1,2,0,2,3,3,3,0,2,2,0,3,1,1,0,9,3,0,0,0,0,0,,,
"Sep 13, 2021 12:00 AM",3,1,2,0,0,0,0,0,0,0,0,0,0,0,0,1,0,0,0,5,5,0,0,0,0,0,3,0,0,0,1,0,1,,,
"Sep 13, 2021 1:00 AM",5,1,4,0,0,0,2,1,1,0,0,0,0,0,0,0,0,0,0,1,1,0,0,0,0,0,1,0,0,0,0,0,0,,,
"Sep 13, 2021 2:00 AM",5,0,5,0,0,0,1,0,1,1,0,1,0,0,0,0,0,0,0,0,0,0,0,0,0,0,0,1,0,0,0,0,0,,,
"Sep 13, 2021 3:00 AM",0,0,0,0,0,0,0,0,0,0,0,0,0,0,0,0,0,0,0,0,0,0,1,0,0,0,0,1,0,0,1,0,1,,,
"Sep 13, 2021 4:00 AM",3,1,2,0,0,0,1,1,0,0,0,0,0,0,0,2,1,1,0,0,0,0,1,0,0,0,1,1,0,0,1,1,0,,,
"Sep 13, 2021 5:00 AM",9,6,3,0,0,0,5,2,3,3,2,1,0,0,0,4,9,9,0,3,1,2,9,0,0,0,5,11,0,0,0,0,0,,,
"Sep 13, 2021 6:00 AM",34,24,10,16,8,8,30,17,13,22,14,8,4,4,0,3,22,22,0,6,6,0,22,8,5,3,20,37,0,1,5,5,0,,,
"Sep 13, 2021 7:00 AM",113,64,49,56,22,34,91,35,56,66,36,30,9,9,0,13,71,70,1,24,19,5,71,20,10,10,46,84,3,6,4,3,1,,,
"Sep 13, 2021 8:00 AM",279,218,61,128,33,95,167,54,113,148,52,96,38,20,18,39,165,163,2,53,40,13,156,51,8,43,61,141,7,4,11,9,2,,,
"Sep 13, 2021 9:00 AM",139,113,26,71,25,46,81,34,47,70,29,41,13,10,3,20,76,75,1,14,8,6,71,17,9,8,40,70,1,1,4,2,2,,,
"Sep 13, 2021 10:00 AM",87,68,19,47,23,24,62,33,29,49,27,22,7,5,2,14,56,53,3,21,15,6,54,9,8,1,30,34,1,0,1,0,1,,,
"Sep 13, 2021 11:00 AM",65,28,37,56,23,33,51,25,26,45,22,23,11,6,5,8,29,28,1,17,16,1,27,12,9,3,15,32,3,1,1,1,0,,,
"Sep 13, 2021 12:00 PM",68,32,36,59,26,33,62,34,28,54,31,23,12,6,6,13,31,31,0,27,25,2,30,12,7,5,48,20,2,4,2,1,1,,,
"Sep 13, 2021 1:00 PM",99,46,53,52,28,24,70,39,31,56,30,26,17,7,10,17,34,31,3,21,16,5,29,15,11,4,36,30,5,1,2,1,1,,,
"Sep 13, 2021 2:00 PM",72,24,48,45,31,14,65,38,27,49,29,20,19,9,10,18,25,22,3,58,52,6,20,15,10,5,35,27,1,3,6,4,2,,,
"Sep 13, 2021 3:00 PM",120,35,85,28,14,14,71,46,25,39,26,13,20,8,12,17,41,40,1,51,38,13,38,22,12,10,49,28,4,3,4,1,3,,,
"Sep 13, 2021 4:00 PM",148,56,92,58,37,21,91,58,33,71,45,26,22,9,13,29,32,31,1,58,55,3,30,23,18,5,86,48,7,2,7,2,5,,,
"Sep 13, 2021 5:00 PM",202,49,153,66,47,19,155,97,58,97,56,41,27,10,17,34,36,34,2,104,102,2,35,32,26,6,118,75,8,8,8,5,3,,,
"Sep 13, 2021 6:00 PM",200,75,125,82,50,32,137,84,53,102,61,41,19,5,14,24,36,34,2,79,75,4,33,32,21,11,101,52,5,4,10,8,2,,,
"Sep 13, 2021 7:00 PM",108,41,67,73,36,37,109,58,51,71,42,29,14,7,7,22,24,21,3,44,40,4,20,21,14,7,65,36,4,2,7,5,2,,,
"Sep 13, 2021 8:00 PM",60,13,47,39,20,19,50,25,25,35,16,19,7,3,4,10,19,18,1,32,32,0,12,11,6,5,25,25,2,2,4,3,1,,,
"Sep 13, 2021 9:00 PM",46,11,35,12,5,7,22,9,13,15,4,11,5,2,3,12,15,13,2,12,11,1,14,6,4,2,8,22,1,2,1,0,1,,,
"Sep 13, 2021 10:00 PM",17,5,12,9,5,4,5,1,4,9,2,7,2,2,0,10,3,3,0,11,11,0,3,2,2,0,9,6,1,3,1,1,0,,,
"Sep 13, 2021 11:00 PM",9,3,6,1,1,0,1,1,0,1,1,0,1,0,1,4,1,1,0,6,6,0,1,1,1,0,4,4,0,0,0,0,0,,,
"Sep 14, 2021 12:00 AM",8,2,6,0,0,0,0,0,0,1,0,1,3,2,1,1,2,1,1,2,2,0,0,0,0,0,7,1,0,0,0,0,0,,,
"Sep 14, 2021 1:00 AM",8,0,8,0,0,0,0,0,0,0,0,0,0,0,0,0,0,0,0,2,2,0,0,0,0,0,0,0,0,0,0,0,0,,,
"Sep 14, 2021 2:00 AM",2,1,1,0,0,0,0,0,0,1,1,0,0,0,0,0,0,0,0,3,3,0,0,0,0,0,3,0,0,0,0,0,0,,,
"Sep 14, 2021 3:00 AM",2,0,2,0,0,0,0,0,0,0,0,0,0,0,0,0,0,0,0,1,1,0,0,0,0,0,0,0,0,0,0,0,0,,,
"Sep 14, 2021 4:00 AM",2,0,2,1,0,1,3,1,2,2,0,2,0,0,0,2,0,0,0,2,2,0,0,0,0,0,2,3,0,0,0,0,0,,,
"Sep 14, 2021 5:00 AM",6,3,3,6,5,1,10,7,3,8,7,1,2,0,2,2,6,6,0,3,2,1,7,0,0,0,8,11,0,0,0,0,0,,,
"Sep 14, 2021 6:00 AM",52,37,15,35,16,19,40,26,14,29,19,10,3,3,0,6,30,30,0,11,9,2,30,4,2,2,26,38,0,0,5,5,0,,,
"Sep 14, 2021 7:00 AM",121,72,49,80,34,46,127,40,87,93,41,52,14,13,1,13,84,84,0,30,26,4,78,28,11,17,48,117,7,7,4,3,1,,,
"Sep 14, 2021 8:00 AM",280,204,76,141,38,103,216,71,145,157,49,108,44,29,15,43,190,187,3,59,47,12,180,62,20,42,82,166,9,8,18,16,2,,,
"Sep 14, 2021 9:00 AM",129,103,26,67,27,40,111,57,54,85,55,30,16,13,3,13,75,75,0,17,11,6,67,37,20,17,44,84,2,3,12,6,6,,,
"Sep 14, 2021 10:00 AM",87,59,28,81,44,37,84,49,35,71,44,27,11,9,2,16,59,58,1,15,12,3,48,19,13,6,23,48,4,5,6,6,0,,,
"Sep 14, 2021 11:00 AM",93,67,26,99,49,50,80,48,32,76,41,35,26,11,15,7,41,40,1,23,18,5,38,19,13,6,37,37,4,7,4,3,1,,,
"Sep 14, 2021 12:00 PM",108,53,55,107,60,47,88,50,38,89,54,35,29,12,17,9,31,31,0,27,24,3,30,19,13,6,44,42,5,7,7,5,2,,,
"Sep 14, 2021 1:00 PM",118,54,64,108,53,55,99,49,50,78,39,39,13,5,8,20,52,50,2,53,46,7,45,19,10,9,55,40,8,6,9,8,1,,,
"Sep 14, 2021 2:00 PM",104,39,65,72,26,46,109,50,59,88,39,49,21,13,8,24,32,31,1,46,42,4,32,33,18,15,50,33,7,9,5,3,2,,,
"Sep 14, 2021 3:00 PM",143,46,97,76,37,39,137,80,57,103,62,41,24,8,16,23,42,39,3,70,56,14,32,30,17,13,85,43,2,0,6,3,3,,,
"Sep 14, 2021 4:00 PM",176,55,121,117,78,39,200,129,71,129,85,44,27,9,18,13,46,39,7,73,65,8,42,37,29,8,82,60,7,8,10,7,3,,,
"Sep 14, 2021 5:00 PM",223,71,152,141,87,54,241,136,105,139,72,67,37,8,29,26,44,41,3,108,101,7,37,40,24,16,175,100,10,11,10,6,4,,,
"Sep 14, 2021 6:00 PM",212,69,143,182,106,76,307,190,117,174,109,65,23,11,12,36,41,39,2,83,81,2,37,60,40,20,191,87,12,8,15,10,5,,,
"Sep 14, 2021 7:00 PM",127,50,77,135,69,66,233,104,129,124,56,68,26,12,14,22,27,26,1,52,46,6,24,34,19,15,94,59,16,5,8,5,3,,,
"Sep 14, 2021 8:00 PM",92,32,60,57,25,32,110,39,71,64,29,35,12,7,5,14,28,24,4,40,39,1,26,33,10,23,33,42,3,4,6,2,4,,,
"Sep 14, 2021 9:00 PM",38,10,28,18,10,8,24,7,17,20,5,15,5,1,4,7,13,12,1,16,16,0,13,12,8,4,20,31,0,3,2,1,1,,,
"Sep 14, 2021 10:00 PM",35,10,25,14,8,6,10,6,4,9,4,5,2,1,1,2,4,3,1,10,9,1,5,2,1,1,13,8,3,0,1,0,1,,,
"Sep 14, 2021 11:00 PM",15,4,11,7,4,3,10,6,4,8,4,4,0,0,0,1,1,1,0,7,7,0,2,0,0,0,10,8,0,0,0,0,0,,,
"Sep 15, 2021 12:00 AM",17,4,13,0,0,0,1,1,0,4,4,0,3,2,1,2,1,1,0,0,0,0,1,1,1,0,9,5,0,0,1,0,1,,,
"Sep 15, 2021 1:00 AM",1,0,1,3,3,0,2,2,0,2,2,0,0,0,0,0,4,3,1,2,2,0,3,0,0,0,2,0,0,0,0,0,0,,,
"Sep 15, 2021 2:00 AM",2,1,1,0,0,0,0,0,0,0,0,0,0,0,0,0,1,1,0,1,1,0,1,0,0,0,0,0,1,0,0,0,0,,,
"Sep 15, 2021 3:00 AM",2,1,1,1,1,0,1,1,0,1,1,0,1,0,1,1,0,0,0,1,1,0,0,0,0,0,0,1,0,0,0,0,0,,,
"Sep 15, 2021 4:00 AM",1,1,0,0,0,0,2,1,1,2,1,1,0,0,0,3,1,1,0,0,0,0,1,0,0,0,1,1,0,0,0,0,0,,,
"Sep 15, 2021 5:00 AM",9,6,3,3,2,1,7,4,3,8,4,4,0,0,0,1,4,4,0,2,0,2,5,0,0,0,8,11,1,0,0,0,0,,,
"Sep 15, 2021 6:00 AM",40,26,14,20,7,13,39,22,17,22,11,11,4,4,0,5,17,17,0,10,10,0,18,6,4,2,33,42,0,4,1,1,0,,,
"Sep 15, 2021 7:00 AM",129,79,50,82,35,47,118,48,70,77,40,37,12,10,2,12,88,87,1,32,29,3,87,32,12,20,54,104,4,7,4,3,1,,,
"Sep 15, 2021 8:00 AM",282,208,74,134,30,104,215,77,138,168,65,103,47,34,13,39,157,153,4,63,46,17,158,67,15,52,80,173,8,4,25,24,1,,,
"Sep 15, 2021 9:00 AM",127,103,24,95,46,49,108,50,58,88,47,41,27,10,17,13,89,87,2,23,16,7,84,31,17,14,45,78,4,4,4,3,1,,,
"Sep 15, 2021 10:00 AM",102,68,34,72,28,44,81,36,45,60,32,28,11,6,5,0,47,44,3,19,12,7,37,22,10,12,40,40,3,3,7,5,2,,,
"Sep 15, 2021 11:00 AM",76,39,37,63,43,20,77,41,36,61,39,22,10,6,4,0,36,36,0,11,9,2,35,11,7,4,32,36,4,2,7,5,2,,,
"Sep 15, 2021 12:00 PM",91,50,41,70,26,44,70,31,39,60,30,30,19,11,8,8,36,32,4,32,30,2,27,25,11,14,39,36,5,5,9,6,3,,,
"Sep 15, 2021 1:00 PM",122,50,72,88,63,25,118,76,42,101,65,36,25,11,14,17,49,44,5,30,29,1,39,23,17,6,72,40,7,5,4,3,1,,,
"Sep 15, 2021 2:00 PM",108,40,68,55,26,29,58,36,22,57,36,21,21,9,12,22,32,29,3,43,37,6,27,24,16,8,38,28,3,8,9,7,2,,,
"Sep 15, 2021 3:00 PM",131,56,75,43,25,18,73,48,25,54,30,24,16,4,12,17,34,31,3,45,37,8,27,15,8,7,52,36,1,2,7,3,4,,,
"Sep 15, 2021 4:00 PM",173,48,125,45,26,19,76,48,28,58,35,23,10,3,7,24,28,27,1,66,63,3,25,17,8,9,72,48,1,2,4,3,1,,,
"Sep 15, 2021 5:00 PM",243,71,172,71,50,21,138,81,57,103,66,37,26,4,22,22,39,35,4,104,98,6,33,20,11,9,116,76,5,8,9,7,2,,,
"Sep 15, 2021 6:00 PM",206,75,131,109,74,35,187,125,62,111,73,38,20,7,13,25,51,44,7,81,76,5,46,29,20,9,116,75,6,10,10,4,6,,,
"Sep 15, 2021 7:00 PM",106,40,66,84,44,40,129,76,53,73,36,37,16,7,9,16,39,37,2,44,43,1,35,30,22,8,80,51,3,3,7,4,3,,,
"Sep 15, 2021 8:00 PM",74,27,47,44,19,25,75,28,47,40,16,24,8,3,5,13,16,16,0,34,32,2,15,21,10,11,40,40,11,5,11,4,7,,,
"Sep 15, 2021 9:00 PM",37,10,27,20,15,5,30,11,19,27,14,13,3,0,3,3,14,13,1,20,18,2,13,7,4,3,23,24,4,4,5,4,1,,,
"Sep 15, 2021 10:00 PM",27,11,16,13,9,4,36,17,19,23,9,14,1,0,1,4,9,9,0,13,13,0,10,4,3,1,13,11,2,3,1,0,1,,,
"Sep 15, 2021 11:00 PM",17,4,13,4,3,1,8,1,7,4,1,3,2,1,1,2,5,4,1,14,13,1,4,1,1,0,8,7,1,3,1,1,0,,,
"Sep 16, 2021 12:00 AM",14,3,11,0,0,0,1,0,1,4,0,4,1,0,1,3,4,4,0,6,6,0,4,0,0,0,1,1,0,0,0,0,0,,,
"Sep 16, 2021 1:00 AM",4,3,1,0,0,0,2,0,2,3,1,2,0,0,0,0,1,1,0,1,1,0,2,0,0,0,2,2,1,0,0,0,0,,,
"Sep 16, 2021 2:00 AM",4,3,1,0,0,0,1,1,0,1,1,0,0,0,0,1,0,0,0,0,0,0,0,0,0,0,0,0,0,0,0,0,0,,,
"Sep 16, 2021 3:00 AM",1,0,1,0,0,0,1,1,0,0,0,0,0,0,0,0,0,0,0,0,0,0,0,0,0,0,2,0,0,0,0,0,0,,,
"Sep 16, 2021 4:00 AM",3,1,2,1,0,1,4,2,2,3,1,2,0,0,0,2,0,0,0,2,2,0,0,0,0,0,1,3,0,0,0,0,0,,,
"Sep 16, 2021 5:00 AM",5,3,2,2,2,0,9,4,5,6,5,1,0,0,0,0,7,7,0,3,1,2,7,1,1,0,4,13,0,1,1,0,1,,,
"Sep 16, 2021 6:00 AM",46,35,11,30,14,16,36,21,15,25,12,13,4,3,1,7,19,19,0,15,15,0,17,4,3,1,25,28,0,3,2,2,0,,,
"Sep 16, 2021 7:00 AM",128,84,44,91,38,53,126,50,76,89,45,44,15,14,1,16,88,87,1,31,25,6,90,27,14,13,68,95,4,5,9,6,3,,,
"Sep 16, 2021 8:00 AM",286,214,72,173,58,115,230,90,140,182,67,115,63,39,24,39,154,150,4,61,49,12,146,40,8,32,91,166,8,9,16,15,1,,,
"Sep 16, 2021 9:00 AM",133,109,24,95,38,57,162,84,78,103,55,48,22,9,13,21,106,103,3,20,11,9,97,32,17,15,51,69,3,2,6,2,4,,,
"Sep 16, 2021 10:00 AM",98,72,26,80,37,43,116,63,53,68,35,33,22,13,9,9,53,52,1,25,22,3,47,26,13,13,32,44,3,8,3,1,2,,,
"Sep 16, 2021 11:00 AM",72,43,29,64,34,30,91,49,42,54,28,26,21,15,6,8,39,37,2,24,22,2,35,18,11,7,30,49,1,5,4,3,1,,,
"Sep 16, 2021 12:00 PM",94,46,48,94,42,52,113,52,61,86,45,41,27,15,12,20,28,25,3,27,24,3,23,21,13,8,47,33,3,5,3,3,0,,,
"Sep 16, 2021 1:00 PM",110,57,53,57,35,22,63,34,29,68,37,31,26,8,18,21,32,29,3,32,29,3,28,9,5,4,40,39,9,5,4,3,1,,,
"Sep 16, 2021 2:00 PM",99,40,59,79,39,40,88,40,48,79,36,43,32,17,15,24,30,27,3,37,35,2,24,13,7,6,41,42,8,6,9,5,4,,,
"Sep 16, 2021 3:00 PM",127,45,82,60,36,24,86,51,35,64,40,24,14,3,11,20,51,48,3,54,42,12,42,26,17,9,63,47,7,2,7,4,3,,,
"Sep 16, 2021 4:00 PM",138,44,94,95,64,31,115,73,42,103,61,42,21,9,12,36,46,37,9,69,67,2,37,26,18,8,70,60,8,3,15,8,7,,,
"Sep 16, 2021 5:00 PM",216,60,156,118,80,38,164,100,64,128,74,54,24,9,15,28,56,50,6,116,111,5,33,36,23,13,129,70,6,5,6,4,2,,,
"Sep 16, 2021 6:00 PM",186,62,124,122,71,51,218,139,79,147,82,65,22,8,14,36,49,46,3,69,67,2,45,38,20,18,156,72,7,8,17,9,8,,,
"Sep 16, 2021 7:00 PM",141,44,97,116,62,54,128,60,68,95,45,50,27,13,14,19,25,23,2,58,54,4,22,22,15,7,67,44,3,6,11,5,6,,,
"Sep 16, 2021 8:00 PM",74,26,48,39,17,22,53,25,28,43,20,23,8,0,8,18,17,15,2,31,31,0,17,16,7,9,33,30,1,0,7,4,3,,,
"Sep 16, 2021 9:00 PM",47,15,32,14,9,5,32,20,12,19,10,9,4,2,2,10,12,11,1,25,25,0,10,4,3,1,14,21,2,1,3,3,0,,,
"Sep 16, 2021 10:00 PM",25,10,15,17,14,3,19,12,7,9,5,4,0,0,0,6,11,11,0,9,9,0,13,9,5,4,19,11,0,2,2,0,2,,,
"Sep 16, 2021 11:00 PM",25,9,16,9,6,3,18,11,7,15,9,6,4,1,3,3,7,6,1,10,9,1,5,7,6,1,14,6,0,2,2,1,1,,,
"Sep 17, 2021 12:00 AM",10,2,8,0,0,0,1,0,1,1,1,0,2,0,2,3,2,2,0,13,12,1,2,0,0,0,7,3,0,0,2,1,1,,,
"Sep 17, 2021 1:00 AM",10,4,6,0,0,0,1,1,0,2,2,0,1,0,1,167,4,3,1,3,3,0,3,5,4,1,2,1,0,1,1,1,0,,,
"Sep 17, 2021 2:00 AM",3,3,0,1,0,1,0,0,0,0,0,0,0,0,0,0,1,1,0,2,2,0,1,0,0,0,3,0,0,0,0,0,0,,,
"Sep 17, 2021 3:00 AM",0,0,0,1,1,0,4,2,2,1,1,0,0,0,0,0,0,0,0,1,1,0,0,0,0,0,2,1,0,0,0,0,0,,,
"Sep 17, 2021 4:00 AM",2,1,1,1,0,1,0,0,0,1,0,1,0,0,0,2,0,0,0,1,1,0,0,0,0,0,1,1,0,1,0,0,0,,,
"Sep 17, 2021 5:00 AM",9,6,3,2,2,0,4,3,1,4,3,1,0,0,0,0,7,7,0,2,1,1,8,3,2,1,5,10,0,0,1,1,0,,,
"Sep 17, 2021 6:00 AM",27,17,10,26,12,14,25,13,12,24,12,12,6,5,1,3,20,20,0,8,7,1,17,4,3,1,17,28,0,5,3,3,0,,,
"Sep 17, 2021 7:00 AM",84,46,38,48,19,29,82,30,52,52,22,30,11,9,2,12,47,47,0,19,14,5,50,19,7,12,39,66,3,7,3,3,0,,,
"Sep 17, 2021 8:00 AM",180,131,49,71,17,54,91,25,66,70,19,51,14,9,5,17,78,78,0,50,40,10,81,38,14,24,55,92,8,3,9,9,0,,,
"Sep 17, 2021 9:00 AM",88,66,22,30,20,10,58,30,28,35,24,11,9,5,4,11,40,40,0,13,10,3,39,8,4,4,19,31,0,2,1,1,0,,,
"Sep 17, 2021 10:00 AM",61,40,21,16,8,8,29,21,8,21,11,10,2,1,1,7,19,19,0,13,10,3,16,5,3,2,20,17,0,0,6,4,2,,,
"Sep 17, 2021 11:00 AM",47,24,23,8,3,5,19,6,13,8,4,4,1,1,0,4,21,20,1,6,5,1,19,2,2,0,9,16,3,2,0,0,0,,,
"Sep 17, 2021 12:00 PM",71,40,31,12,4,8,12,4,8,12,7,5,4,1,3,6,25,24,1,26,20,6,21,1,1,0,14,21,1,2,3,2,1,,,
"Sep 17, 2021 1:00 PM",114,46,68,20,9,11,27,15,12,26,13,13,8,3,5,7,20,17,3,16,13,3,17,6,5,1,20,21,2,4,5,4,1,,,
"Sep 17, 2021 2:00 PM",78,37,41,28,14,14,29,11,18,30,17,13,11,8,3,19,19,17,2,23,21,2,15,5,2,3,20,25,3,2,7,3,4,,,
"Sep 17, 2021 3:00 PM",115,44,71,27,12,15,42,29,13,32,21,11,11,6,5,16,29,28,1,37,27,10,24,16,8,8,47,35,3,0,4,3,1,,,
"Sep 17, 2021 4:00 PM",124,50,74,65,47,18,66,45,21,71,47,24,13,2,11,29,16,13,3,33,30,3,11,19,10,9,52,38,4,3,9,9,0,,,
"Sep 17, 2021 5:00 PM",148,50,98,59,33,26,76,49,27,73,45,28,16,4,12,27,30,28,2,60,55,5,28,19,14,5,74,35,2,7,13,5,8,,,
"Sep 17, 2021 6:00 PM",112,42,70,64,40,24,109,73,36,76,46,30,8,2,6,12,27,24,3,44,41,3,23,18,14,4,59,43,6,4,10,7,3,,,
"Sep 17, 2021 7:00 PM",87,41,46,44,22,22,77,36,41,51,30,21,9,3,6,20,31,26,5,33,30,3,24,5,4,1,22,25,4,1,8,6,2,,,
"Sep 17, 2021 8:00 PM",41,19,22,30,10,20,41,20,21,29,13,16,3,0,3,2,15,15,0,10,7,3,15,12,8,4,20,16,2,0,6,2,4,,,
"Sep 17, 2021 9:00 PM",33,8,25,11,6,5,25,7,18,19,5,14,2,2,0,1,8,7,1,9,9,0,8,7,5,2,15,10,0,2,5,2,3,,,
"Sep 17, 2021 10:00 PM",23,4,19,14,9,5,22,9,13,11,5,6,0,0,0,3,11,11,0,11,9,2,10,6,3,3,10,10,1,1,0,0,0,,,
"Sep 17, 2021 11:00 PM",23,6,17,9,2,7,18,2,16,17,2,15,1,1,0,2,6,4,2,10,9,1,4,6,3,3,7,4,0,4,0,0,0,,,
"Sep 18, 2021 12:00 AM",17,5,12,0,0,0,2,2,0,6,5,1,2,0,2,1,5,5,0,11,11,0,4,3,2,1,10,17,1,0,3,2,1,,,
"Sep 18, 2021 1:00 AM",5,0,5,6,1,5,6,2,4,4,3,1,1,0,1,1,3,3,0,5,5,0,4,3,1,2,7,5,1,0,1,0,1,,,
"Sep 18, 2021 2:00 AM",6,4,2,5,3,2,5,4,1,2,1,1,0,0,0,1,0,0,0,2,2,0,0,2,2,0,7,1,0,1,1,0,1,,,
"Sep 18, 2021 3:00 AM",2,0,2,1,1,0,4,4,0,2,2,0,0,0,0,0,0,0,0,1,1,0,1,1,1,0,2,0,0,0,0,0,0,,,
"Sep 18, 2021 4:00 AM",4,3,1,2,0,2,5,1,4,5,0,5,0,0,0,3,1,1,0,0,0,0,1,1,0,1,3,4,0,0,0,0,0,,,
"Sep 18, 2021 5:00 AM",3,0,3,0,0,0,1,0,1,1,0,1,0,0,0,0,2,2,0,0,0,0,3,0,0,0,5,6,0,0,2,2,0,,,
"Sep 18, 2021 6:00 AM",9,8,1,9,6,3,16,13,3,12,8,4,3,1,2,3,13,13,0,6,6,0,12,3,3,0,7,12,0,1,0,0,0,,,
"Sep 18, 2021 7:00 AM",28,13,15,38,15,23,29,18,11,30,17,13,5,1,4,5,16,16,0,95,52,43,17,4,4,0,24,22,0,5,1,0,1,,,
"Sep 18, 2021 8:00 AM",37,15,22,64,34,30,67,39,28,59,36,23,21,4,17,12,16,16,0,13,10,3,15,6,5,1,27,27,3,4,1,0,1,,,
"Sep 18, 2021 9:00 AM",45,28,17,92,46,46,120,69,51,99,59,40,13,7,6,23,25,24,1,17,14,3,25,23,18,5,44,36,8,7,3,3,0,,,
"Sep 18, 2021 10:00 AM",66,38,28,148,87,61,168,109,59,119,80,39,36,23,13,17,32,31,1,23,22,1,30,15,11,4,46,27,6,5,3,1,2,,,
"Sep 18, 2021 11:00 AM",70,40,30,143,63,80,212,116,96,131,68,63,33,22,11,38,40,36,4,13,9,4,37,38,23,15,64,52,8,13,7,5,2,,,
"Sep 18, 2021 12:00 PM",67,34,33,195,99,96,242,140,102,182,109,73,49,23,26,22,31,29,2,16,16,0,33,35,24,11,82,44,11,4,6,4,2,,,
"Sep 18, 2021 1:00 PM",74,32,42,152,67,85,162,77,85,145,84,61,33,16,17,18,20,20,0,25,22,3,20,32,12,20,52,48,7,10,6,3,3,,,
"Sep 18, 2021 2:00 PM",64,35,29,128,58,70,151,67,84,111,51,60,50,28,22,26,31,29,2,29,27,2,27,43,20,23,64,43,13,5,15,11,4,,,
"Sep 18, 2021 3:00 PM",74,32,42,180,102,78,159,79,80,146,84,62,37,15,22,26,37,34,3,29,29,0,30,22,17,5,51,54,5,3,10,8,2,,,
"Sep 18, 2021 4:00 PM",89,45,44,162,81,81,144,69,75,159,80,79,36,18,18,19,23,21,2,19,16,3,20,38,20,18,50,47,5,5,10,6,4,,,
"Sep 18, 2021 5:00 PM",63,25,38,169,88,81,157,57,100,161,63,98,36,17,19,22,22,20,2,23,21,2,20,30,12,18,42,52,6,9,8,3,5,,,
"Sep 18, 2021 6:00 PM",52,24,28,105,56,49,112,40,72,100,37,63,30,16,14,10,30,30,0,23,19,4,35,28,14,14,50,44,5,2,5,2,3,,,
"Sep 18, 2021 7:00 PM",66,39,27,80,41,39,64,25,39,56,18,38,9,5,4,6,15,15,0,15,12,3,13,19,8,11,25,29,3,6,9,3,6,,,
"Sep 18, 2021 8:00 PM",30,15,15,24,13,11,36,16,20,30,14,16,7,5,2,5,8,8,0,9,9,0,13,7,6,1,8,12,0,3,2,0,2,,,
"Sep 18, 2021 9:00 PM",22,7,15,24,14,10,33,15,18,26,11,15,3,1,2,1,13,13,0,12,11,1,13,12,7,5,9,15,0,0,3,3,0,,,
"Sep 18, 2021 10:00 PM",12,3,9,14,10,4,14,6,8,10,6,4,11,4,7,3,5,5,0,7,7,0,7,0,0,0,3,5,3,2,2,0,2,,,
"Sep 18, 2021 11:00 PM",22,13,9,14,5,9,15,2,13,15,2,13,2,0,2,3,3,2,1,4,4,0,2,4,3,1,9,4,0,1,4,2,2,,,
"Sep 19, 2021 12:00 AM",16,6,10,1,0,1,2,0,2,11,4,7,2,0,2,0,6,6,0,2,1,1,8,2,1,1,9,6,1,1,3,2,1,,,
"Sep 19, 2021 1:00 AM",9,4,5,5,1,4,9,4,5,5,1,4,0,0,0,0,3,3,0,3,3,0,2,2,2,0,4,1,0,2,0,0,0,,,
"Sep 19, 2021 2:00 AM",7,1,6,0,0,0,2,2,0,2,1,1,0,0,0,1,0,0,0,3,3,0,0,0,0,0,0,1,0,0,1,0,1,,,
"Sep 19, 2021 3:00 AM",1,0,1,1,0,1,0,0,0,1,0,1,0,0,0,0,0,0,0,2,2,0,0,0,0,0,2,1,0,0,0,0,0,,,
"Sep 19, 2021 4:00 AM",2,2,0,0,0,0,1,1,0,0,0,0,2,0,2,0,0,0,0,1,1,0,0,0,0,0,2,0,0,0,0,0,0,,,
"Sep 19, 2021 5:00 AM",1,0,1,0,0,0,1,1,0,0,0,0,0,0,0,0,2,2,0,1,1,0,2,0,0,0,2,3,0,0,0,0,0,,,
"Sep 19, 2021 6:00 AM",8,5,3,2,0,2,11,5,6,4,1,3,2,0,2,4,5,5,0,4,4,0,5,1,0,1,5,6,0,0,0,0,0,,,
"Sep 19, 2021 7:00 AM",10,4,6,17,11,6,18,13,5,19,15,4,2,2,0,3,10,10,0,4,3,1,9,6,6,0,12,22,0,2,0,0,0,,,
"Sep 19, 2021 8:00 AM",24,10,14,69,45,24,76,57,19,53,38,15,3,2,1,4,5,5,0,7,6,1,7,14,10,4,32,17,1,7,0,0,0,,,
"Sep 19, 2021 9:00 AM",41,28,13,118,51,67,118,79,39,105,74,31,9,9,0,14,15,15,0,19,16,3,14,21,16,5,58,41,4,5,3,1,2,,,
"Sep 19, 2021 10:00 AM",61,41,20,178,109,69,207,142,65,162,103,59,16,3,13,19,28,27,1,18,13,5,22,42,34,8,56,65,9,4,6,3,3,,,
"Sep 19, 2021 11:00 AM",66,39,27,201,117,84,275,167,108,189,115,74,23,15,8,21,30,28,2,22,19,3,24,47,39,8,84,46,14,11,15,9,6,,,
"Sep 19, 2021 12:00 PM",90,44,46,296,155,141,350,210,140,232,152,80,31,13,18,30,36,33,3,25,17,8,33,46,34,12,109,60,9,9,8,6,2,,,
"Sep 19, 2021 1:00 PM",66,32,34,213,106,107,235,104,131,194,105,89,48,32,16,21,29,25,4,33,32,1,24,65,40,25,69,56,16,7,13,8,5,,,
"Sep 19, 2021 2:00 PM",74,40,34,242,139,103,231,129,102,177,110,67,34,12,22,33,33,33,0,37,35,2,27,53,29,24,64,60,6,4,18,12,6,,,
"Sep 19, 2021 3:00 PM",62,27,35,238,136,102,233,112,121,193,98,95,34,16,18,38,31,31,0,16,15,1,32,36,19,17,73,53,8,4,2,0,2,,,
"Sep 19, 2021 4:00 PM",84,38,46,256,137,119,257,110,147,236,106,130,37,22,15,29,20,19,1,22,21,1,20,44,17,27,57,69,2,7,4,2,2,,,
"Sep 19, 2021 5:00 PM",63,28,35,219,92,127,187,62,125,182,59,123,39,20,19,21,29,29,0,18,16,2,27,50,19,31,35,61,10,6,7,6,1,,,
"Sep 19, 2021 6:00 PM",67,37,30,113,43,70,124,29,95,101,35,66,22,9,13,24,25,23,2,19,17,2,23,22,6,16,32,54,4,5,6,4,2,,,
"Sep 19, 2021 7:00 PM",60,26,34,64,34,30,67,26,41,65,30,35,10,4,6,9,17,17,0,12,11,1,16,13,7,6,18,33,7,1,12,6,6,,,
"Sep 19, 2021 8:00 PM",31,9,22,38,20,18,34,10,24,30,16,14,8,4,4,5,16,15,1,5,5,0,16,10,4,6,13,15,2,3,1,0,1,,,
"Sep 19, 2021 9:00 PM",21,7,14,19,6,13,19,10,9,17,6,11,1,0,1,1,8,7,1,7,7,0,7,5,4,1,8,14,1,0,0,0,0,,,
"Sep 19, 2021 10:00 PM",24,9,15,6,2,4,7,3,4,6,2,4,2,2,0,9,6,6,0,4,3,1,6,0,0,0,6,9,0,4,3,1,2,,,
"Sep 19, 2021 11:00 PM",8,3,5,8,5,3,8,0,8,10,1,9,3,2,1,2,6,3,3,2,2,0,4,0,0,0,3,3,0,2,2,2,0,,,
"Sep 20, 2021 12:00 AM",6,2,4,0,0,0,4,0,4,10,1,9,3,2,1,1,1,1,0,1,1,0,1,0,0,0,4,4,0,0,1,0,1,,,
"Sep 20, 2021 1:00 AM",5,1,4,0,0,0,2,1,1,0,0,0,1,0,1,0,0,0,0,3,3,0,0,0,0,0,3,1,0,0,0,0,0,,,
"Sep 20, 2021 2:00 AM",0,0,0,0,0,0,0,0,0,0,0,0,0,0,0,1,1,1,0,1,1,0,1,0,0,0,1,0,0,0,0,0,0,,,
"Sep 20, 2021 3:00 AM",1,0,1,0,0,0,0,0,0,0,0,0,0,0,0,0,0,0,0,0,0,0,0,0,0,0,1,0,1,0,0,0,0,,,
"Sep 20, 2021 4:00 AM",3,0,3,0,0,0,2,2,0,0,0,0,0,0,0,2,0,0,0,0,0,0,0,0,0,0,1,3,0,0,0,0,0,,,
"Sep 20, 2021 5:00 AM",6,5,1,1,1,0,4,3,1,2,1,1,0,0,0,1,6,6,0,2,1,1,6,0,0,0,6,13,0,0,0,0,0,,,
"Sep 20, 2021 6:00 AM",48,34,14,22,11,11,25,11,14,20,11,9,12,6,6,4,25,25,0,6,6,0,25,7,5,2,19,29,2,3,2,2,0,,,
"Sep 20, 2021 7:00 AM",124,85,39,86,33,53,98,28,70,85,35,50,14,13,1,14,99,99,0,32,24,8,98,20,9,11,49,104,1,5,8,5,3,,,
"Sep 20, 2021 8:00 AM",283,211,72,133,35,98,186,51,135,140,36,104,36,22,14,40,176,173,3,63,47,16,170,57,7,50,66,181,11,2,16,12,4,,,
"Sep 20, 2021 9:00 AM",154,120,34,76,28,48,98,55,43,80,43,37,17,11,6,14,84,83,1,20,14,6,79,15,8,7,43,61,1,0,4,3,1,,,
"Sep 20, 2021 10:00 AM",95,71,24,83,39,44,107,65,42,73,41,32,16,10,6,17,54,54,0,22,16,6,45,12,6,6,31,37,0,3,0,0,0,,,
"Sep 20, 2021 11:00 AM",66,41,25,84,46,38,110,57,53,88,49,39,8,5,3,7,38,36,2,15,13,2,32,22,12,10,37,43,5,3,2,1,1,,,
"Sep 20, 2021 12:00 PM",79,45,34,95,55,40,134,73,61,82,51,31,32,18,14,14,43,40,3,34,32,2,34,21,16,5,49,35,3,2,5,4,1,,,
"Sep 20, 2021 1:00 PM",117,55,62,91,44,47,135,72,63,67,29,38,21,8,13,12,36,31,5,34,29,5,31,30,19,11,43,39,8,4,5,3,2,,,
"Sep 20, 2021 2:00 PM",94,41,53,101,66,35,155,86,69,95,65,30,19,8,11,18,33,31,2,38,35,3,27,41,24,17,50,31,3,2,13,9,4,,,
"Sep 20, 2021 3:00 PM",141,39,102,84,46,38,145,64,81,104,57,47,24,13,11,16,31,27,4,69,61,8,22,37,25,12,57,55,4,8,4,4,0,,,
"Sep 20, 2021 4:00 PM",171,56,115,80,49,31,124,78,46,92,54,38,19,5,14,12,37,35,2,82,73,9,29,36,30,6,78,57,1,4,9,5,4,,,
"Sep 20, 2021 5:00 PM",215,53,162,84,60,24,152,93,59,114,69,45,31,12,19,24,42,39,3,122,117,5,42,31,21,10,147,79,3,9,6,4,2,,,
"Sep 20, 2021 6:00 PM",200,68,132,114,68,46,155,102,53,118,75,43,20,7,13,25,41,38,3,99,92,7,38,39,23,16,118,51,5,6,6,3,3,,,
"Sep 20, 2021 7:00 PM",132,49,83,74,44,30,78,50,28,77,49,28,16,6,10,26,23,22,1,53,51,2,23,16,9,7,49,38,9,2,11,6,5,,,
"Sep 20, 2021 8:00 PM",86,24,62,43,15,28,69,28,41,47,17,30,5,3,2,12,20,18,2,43,40,3,18,13,7,6,29,32,4,3,14,9,5,,,
"Sep 20, 2021 9:00 PM",40,10,30,12,8,4,27,12,15,15,5,10,6,4,2,6,16,16,0,15,13,2,13,8,5,3,8,22,3,0,11,7,4,,,
"Sep 20, 2021 10:00 PM",25,6,19,8,3,5,14,9,5,14,6,8,2,2,0,4,6,5,1,11,11,0,6,1,1,0,14,4,0,0,9,5,4,,,
"Sep 20, 2021 11:00 PM",11,1,10,8,8,0,15,6,9,8,4,4,2,2,0,1,3,2,1,5,5,0,3,5,3,2,8,3,0,0,0,0,0,,,
"Sep 21, 2021 12:00 AM",9,3,6,0,0,0,0,0,0,3,1,2,1,0,1,0,1,0,1,5,5,0,0,0,0,0,4,0,1,0,1,1,0,,,
"Sep 21, 2021 1:00 AM",2,1,1,1,0,1,0,0,0,0,0,0,0,0,0,0,1,1,0,4,4,0,1,1,1,0,0,0,0,0,0,0,0,,,
"Sep 21, 2021 2:00 AM",5,3,2,0,0,0,0,0,0,0,0,0,0,0,0,1,0,0,0,1,1,0,0,0,0,0,1,1,0,0,0,0,0,,,
"Sep 21, 2021 3:00 AM",0,0,0,0,0,0,0,0,0,0,0,0,0,0,0,1,0,0,0,0,0,0,0,0,0,0,0,0,0,0,0,0,0,,,
"Sep 21, 2021 4:00 AM",1,1,0,0,0,0,1,1,0,0,0,0,0,0,0,4,0,0,0,1,1,0,0,0,0,0,1,3,0,0,0,0,0,,,
"Sep 21, 2021 5:00 AM",10,6,4,2,2,0,8,5,3,5,4,1,1,0,1,2,6,6,0,2,1,1,7,1,0,1,4,10,0,0,0,0,0,,,
"Sep 21, 2021 6:00 AM",41,31,10,32,20,12,32,17,15,32,19,13,4,3,1,4,28,28,0,7,7,0,28,4,4,0,20,32,0,4,2,2,0,,,
"Sep 21, 2021 7:00 AM",115,78,37,107,39,68,128,44,84,108,46,62,14,12,2,17,87,86,1,28,22,6,85,24,14,10,46,135,4,6,4,3,1,,,
"Sep 21, 2021 8:00 AM",275,211,64,143,46,97,215,71,144,171,64,107,52,34,18,41,188,184,4,66,51,15,173,66,12,54,83,186,12,7,20,18,2,,,
"Sep 21, 2021 9:00 AM",136,107,29,74,32,42,124,70,54,92,61,31,21,7,14,18,107,106,1,17,12,5,94,23,11,12,45,72,2,6,8,7,1,,,
"Sep 21, 2021 10:00 AM",104,69,35,71,30,41,77,44,33,62,30,32,15,8,7,9,68,68,0,11,10,1,61,10,10,0,27,49,2,6,6,5,1,,,
"Sep 21, 2021 11:00 AM",89,60,29,57,30,27,93,42,51,58,24,34,8,3,5,13,51,46,5,25,19,6,40,12,6,6,1,39,8,1,2,2,0,,,
"Sep 21, 2021 12:00 PM",78,39,39,92,55,37,119,69,50,82,50,32,30,7,23,12,48,47,1,21,19,2,42,32,26,6,8,34,11,4,7,4,3,,,
"Sep 21, 2021 1:00 PM",118,60,58,98,45,53,121,62,59,87,42,45,19,8,11,19,47,39,8,43,35,8,29,30,16,14,5,50,4,5,6,2,4,,,
"Sep 21, 2021 2:00 PM",120,39,81,94,48,46,125,65,60,79,45,34,29,17,12,33,36,31,5,62,60,2,30,24,11,13,14,36,7,4,11,4,7,,,
"Sep 21, 2021 3:00 PM",129,48,81,93,55,38,122,64,58,81,42,39,19,11,8,20,44,39,5,61,50,11,36,32,13,19,20,44,3,4,10,7,3,,,
"Sep 21, 2021 4:00 PM",161,51,110,129,80,49,129,79,50,129,81,48,26,12,14,33,36,34,2,67,64,3,31,37,24,13,13,62,8,4,12,4,8,,,
"Sep 21, 2021 5:00 PM",247,65,182,144,82,62,170,102,68,140,85,55,36,13,23,30,42,38,4,118,114,4,34,29,18,11,13,86,11,6,13,8,5,,,
"Sep 21, 2021 6:00 PM",201,59,142,158,97,61,188,118,70,157,92,65,21,10,11,32,49,45,4,109,106,3,37,43,30,13,16,78,10,4,11,8,3,,,
"Sep 21, 2021 7:00 PM",135,42,93,103,58,45,117,66,51,107,61,46,16,7,9,24,28,25,3,47,44,3,24,29,20,9,13,36,5,1,14,7,7,,,
"Sep 21, 2021 8:00 PM",78,28,50,55,20,35,70,22,48,55,17,38,11,5,6,6,25,23,2,38,36,2,25,15,11,4,1,33,2,2,4,1,3,,,
"Sep 21, 2021 9:00 PM",45,14,31,16,12,4,16,9,7,17,9,8,2,1,1,2,9,9,0,16,15,1,9,9,5,4,2,21,5,0,3,1,2,,,
"Sep 21, 2021 10:00 PM",22,2,20,9,6,3,18,12,6,12,6,6,2,0,2,2,7,7,0,13,12,1,7,3,2,1,1,7,2,2,1,1,0,,,
"Sep 21, 2021 11:00 PM",21,7,14,1,1,0,5,1,4,6,2,4,0,0,0,0,2,2,0,9,9,0,3,1,1,0,0,5,0,3,0,0,0,,,
"Sep 22, 2021 12:00 AM",9,2,7,0,0,0,1,1,0,1,1,0,0,0,0,0,1,1,0,4,4,0,1,1,1,0,1,3,0,1,2,1,1,,,
"Sep 22, 2021 1:00 AM",7,1,6,0,0,0,3,1,2,1,1,0,0,0,0,0,0,0,0,3,3,0,0,1,1,0,0,2,0,0,0,0,0,,,
"Sep 22, 2021 2:00 AM",4,3,1,1,1,0,2,1,1,1,1,0,0,0,0,1,1,1,0,2,2,0,0,0,0,0,0,2,0,0,0,0,0,,,
"Sep 22, 2021 3:00 AM",1,0,1,0,0,0,0,0,0,0,0,0,0,0,0,0,0,0,0,0,0,0,0,0,0,0,0,0,0,0,0,0,0,,,
"Sep 22, 2021 4:00 AM",1,1,0,0,0,0,1,1,0,0,0,0,0,0,0,2,0,0,0,1,1,0,0,0,0,0,0,2,0,0,0,0,0,,,
"Sep 22, 2021 5:00 AM",9,6,3,4,3,1,6,4,2,4,4,0,1,1,0,4,9,9,0,2,1,1,9,1,1,0,1,11,0,0,0,0,0,,,
"Sep 22, 2021 6:00 AM",42,26,16,33,14,19,38,20,18,30,18,12,6,6,0,4,26,26,0,11,10,1,26,6,4,2,0,28,1,2,3,1,2,,,
"Sep 22, 2021 7:00 AM",121,77,44,80,36,44,99,33,66,72,32,40,20,16,4,13,98,94,4,40,33,7,96,16,5,11,5,122,4,8,7,7,0,,,
"Sep 22, 2021 8:00 AM",279,207,72,139,37,102,211,54,157,160,44,116,54,32,22,36,174,170,4,63,46,17,165,67,12,55,16,194,6,5,13,11,2,,,
"Sep 22, 2021 9:00 AM",157,126,31,75,34,41,106,52,54,90,49,41,17,14,3,15,116,116,0,18,14,4,103,17,9,8,5,79,3,4,5,2,3,,,
"Sep 22, 2021 10:00 AM",84,55,29,60,33,27,77,47,30,64,42,22,14,7,7,10,47,44,3,20,13,7,36,22,15,7,3,40,2,4,0,0,0,,,
"Sep 22, 2021 11:00 AM",89,57,32,49,21,28,89,50,39,56,33,23,17,9,8,16,40,39,1,26,20,6,34,14,6,8,5,35,1,5,3,3,0,,,
"Sep 22, 2021 12:00 PM",96,52,44,95,56,39,114,59,55,77,46,31,19,13,6,21,50,47,3,28,25,3,45,34,18,16,11,32,4,8,5,4,1,,,
"Sep 22, 2021 1:00 PM",127,62,65,123,77,46,218,123,95,137,81,56,37,19,18,25,59,47,12,41,36,5,42,49,34,15,13,51,8,4,9,5,4,,,
"Sep 22, 2021 2:00 PM",92,33,59,61,28,33,106,52,54,81,49,32,22,10,12,24,41,40,1,43,38,5,32,19,8,11,14,41,5,7,8,2,6,,,
"Sep 22, 2021 3:00 PM",131,46,85,68,40,28,128,72,56,71,39,32,16,6,10,15,49,46,3,50,43,7,44,27,14,13,13,49,4,4,10,4,6,,,
"Sep 22, 2021 4:00 PM",163,49,114,98,61,37,126,77,49,99,67,32,33,14,19,38,29,26,3,96,89,7,26,26,13,13,22,62,3,3,5,3,2,,,
"Sep 22, 2021 5:00 PM",264,84,180,147,86,61,173,91,82,146,87,59,27,9,18,40,45,41,4,117,106,11,39,39,30,9,23,79,8,4,12,8,4,,,
"Sep 22, 2021 6:00 PM",198,66,132,176,98,78,206,136,70,172,98,74,20,10,10,29,70,64,6,103,100,3,65,38,24,14,12,67,7,12,11,8,3,,,
"Sep 22, 2021 7:00 PM",128,43,85,125,67,58,141,75,66,119,64,55,8,3,5,16,33,33,0,50,44,6,26,37,25,12,12,46,2,6,12,8,4,,,
"Sep 22, 2021 8:00 PM",73,20,53,69,31,38,81,39,42,57,19,38,6,5,1,6,25,24,1,40,38,2,27,14,8,6,3,37,5,4,7,6,1,,,
"Sep 22, 2021 9:00 PM",47,11,36,10,6,4,26,9,17,18,6,12,8,2,6,8,13,12,1,14,14,0,11,6,4,2,1,18,4,1,5,3,2,,,
"Sep 22, 2021 10:00 PM",34,9,25,22,10,12,21,7,14,20,5,15,1,0,1,6,7,6,1,22,22,0,4,1,1,0,0,6,7,0,3,1,2,,,
"Sep 22, 2021 11:00 PM",20,3,17,11,7,4,15,8,7,7,4,3,1,1,0,1,0,0,0,13,12,1,0,4,2,2,1,9,1,1,1,1,0,,,
"Sep 23, 2021 12:00 AM",16,4,12,0,0,0,0,0,0,1,1,0,2,1,1,3,2,2,0,4,3,1,2,0,0,0,1,1,0,1,0,0,0,,,
"Sep 23, 2021 1:00 AM",2,0,2,2,0,2,1,0,1,1,0,1,0,0,0,0,1,1,0,2,2,0,1,0,0,0,0,1,0,1,0,0,0,,,
"Sep 23, 2021 2:00 AM",6,4,2,0,0,0,0,0,0,0,0,0,0,0,0,0,1,0,1,2,2,0,0,0,0,0,0,0,0,0,0,0,0,,,
"Sep 23, 2021 3:00 AM",2,2,0,0,0,0,0,0,0,0,0,0,0,0,0,0,0,0,0,0,0,0,0,0,0,0,0,0,0,0,0,0,0,,,
"Sep 23, 2021 4:00 AM",3,1,2,0,0,0,1,1,0,0,0,0,2,0,2,1,1,1,0,0,0,0,1,0,0,0,0,1,0,0,0,0,0,,,
"Sep 23, 2021 5:00 AM",9,6,3,1,1,0,4,2,2,3,2,1,0,0,0,3,9,9,0,3,3,0,9,0,0,0,2,11,0,0,1,1,0,,,
"Sep 23, 2021 6:00 AM",41,31,10,34,11,23,38,13,25,34,14,20,5,5,0,6,15,15,0,9,8,1,13,5,1,4,1,31,1,3,2,2,0,,,
"Sep 23, 2021 7:00 AM",102,65,37,60,20,40,79,21,58,58,20,38,13,11,2,18,73,70,3,24,19,5,68,19,6,13,4,91,7,9,7,7,0,,,
"Sep 23, 2021 8:00 AM",248,189,59,135,37,98,185,56,129,154,52,102,55,39,16,32,186,183,3,64,46,18,165,49,12,37,13,183,8,4,20,17,3,,,
"Sep 23, 2021 9:00 AM",158,116,42,69,26,43,88,46,42,83,43,40,18,13,5,15,98,98,0,20,12,8,86,13,5,8,2,87,2,7,7,7,0,,,
"Sep 23, 2021 10:00 AM",83,58,25,47,19,28,51,26,25,52,29,23,26,14,12,7,46,46,0,15,13,2,43,11,7,4,3,40,2,5,1,1,0,,,
"Sep 23, 2021 11:00 AM",86,59,27,55,30,25,54,35,19,41,24,17,7,4,3,12,48,46,2,15,13,2,42,7,6,1,5,35,5,2,8,3,5,,,
"Sep 23, 2021 12:00 PM",73,39,34,55,25,30,82,47,35,44,22,22,20,5,15,8,34,31,3,33,27,6,27,14,11,3,6,24,4,3,5,3,2,,,
"Sep 23, 2021 1:00 PM",111,48,63,77,38,39,128,60,68,72,32,40,24,12,12,18,51,46,5,31,24,7,47,28,20,8,7,49,8,2,5,5,0,,,
"Sep 23, 2021 2:00 PM",105,46,59,56,30,26,86,40,46,56,32,24,27,12,15,24,37,33,4,35,32,3,29,27,13,14,12,34,4,6,5,1,4,,,
"Sep 23, 2021 3:00 PM",117,36,81,67,43,24,117,70,47,80,57,23,18,5,13,22,34,29,5,52,45,7,24,22,12,10,9,52,3,4,7,4,3,,,
"Sep 23, 2021 4:00 PM",163,54,109,88,54,34,127,75,52,94,57,37,18,7,11,31,45,39,6,77,68,9,35,34,30,4,17,46,4,7,8,3,5,,,
"Sep 23, 2021 5:00 PM",232,59,173,119,70,49,171,106,65,140,89,51,23,9,14,21,54,49,5,110,104,6,49,39,27,12,10,74,7,6,12,8,4,,,
"Sep 23, 2021 6:00 PM",209,70,139,134,82,52,173,109,64,136,92,44,17,7,10,35,70,65,5,75,72,3,56,46,24,22,17,64,8,5,21,12,9,,,
"Sep 23, 2021 7:00 PM",135,51,84,80,42,38,95,51,44,83,46,37,9,4,5,9,23,20,3,58,53,5,20,22,9,13,10,44,2,3,5,4,1,,,
"Sep 23, 2021 8:00 PM",104,37,67,43,21,22,61,23,38,54,21,33,4,2,2,8,18,16,2,39,35,4,15,10,10,0,3,30,2,2,6,5,1,,,
"Sep 23, 2021 9:00 PM",44,17,27,18,8,10,21,9,12,30,12,18,6,2,4,6,21,21,0,22,21,1,21,5,4,1,3,25,1,1,5,2,3,,,
"Sep 23, 2021 10:00 PM",31,10,21,13,6,7,10,6,4,15,4,11,4,1,3,5,7,7,0,17,16,1,6,6,4,2,2,12,2,2,1,1,0,,,
"Sep 23, 2021 11:00 PM",20,5,15,14,6,8,10,0,10,14,1,13,3,2,1,2,4,3,1,19,17,2,2,2,2,0,1,10,2,0,1,1,0,,,
"Sep 24, 2021 12:00 AM",26,3,23,0,0,0,5,4,1,7,6,1,3,0,3,2,1,1,0,4,4,0,1,1,1,0,1,7,0,1,1,0,1,,,
"Sep 24, 2021 1:00 AM",10,2,8,0,0,0,4,3,1,0,0,0,0,0,0,1,2,2,0,5,5,0,2,2,2,0,0,1,0,0,0,0,0,,,
"Sep 24, 2021 2:00 AM",5,4,1,1,1,0,1,0,1,0,0,0,0,0,0,0,0,0,0,0,0,0,0,0,0,0,0,1,0,0,0,0,0,,,
"Sep 24, 2021 3:00 AM",2,1,1,0,0,0,2,1,1,1,1,0,0,0,0,0,0,0,0,0,0,0,0,0,0,0,0,0,0,0,0,0,0,,,
"Sep 24, 2021 4:00 AM",2,1,1,0,0,0,1,1,0,0,0,0,0,0,0,3,0,0,0,1,1,0,0,0,0,0,0,1,0,0,0,0,0,,,
"Sep 24, 2021 5:00 AM",9,5,4,3,2,1,6,3,3,7,5,2,0,0,0,0,8,8,0,4,3,1,7,2,2,0,0,13,0,0,2,2,0,,,
"Sep 24, 2021 6:00 AM",37,23,14,25,17,8,31,18,13,24,14,10,3,3,0,3,18,18,0,19,17,2,17,4,4,0,1,23,4,3,2,2,0,,,
"Sep 24, 2021 7:00 AM",99,64,35,93,38,55,85,36,49,68,32,36,8,8,0,12,63,61,2,25,21,4,67,17,9,8,4,92,6,5,4,2,2,,,
"Sep 24, 2021 8:00 AM",212,154,58,151,53,98,181,65,116,161,54,107,43,23,20,20,147,142,5,58,44,14,136,54,13,41,10,127,6,3,11,9,2,,,
"Sep 24, 2021 9:00 AM",114,88,26,81,40,41,109,57,52,89,55,34,21,15,6,9,82,81,1,27,19,8,74,11,4,7,1,63,1,8,4,1,3,,,
"Sep 24, 2021 10:00 AM",90,61,29,80,42,38,73,46,27,61,38,23,12,10,2,7,44,42,2,19,14,5,45,13,8,5,2,34,4,2,3,3,0,,,
"Sep 24, 2021 11:00 AM",89,51,38,87,40,47,98,53,45,77,47,30,17,14,3,10,31,29,2,23,18,5,26,14,8,6,5,32,3,8,3,1,2,,,
"Sep 24, 2021 12:00 PM",111,55,56,73,33,40,102,50,52,80,38,42,24,11,13,18,33,31,2,33,22,11,31,18,12,6,4,34,7,3,7,5,2,,,
"Sep 24, 2021 1:00 PM",111,53,58,52,24,28,122,64,58,61,28,33,20,8,12,8,40,37,3,39,35,4,31,32,21,11,15,31,6,2,5,3,2,,,
"Sep 24, 2021 2:00 PM",119,53,66,63,48,15,117,69,48,91,66,25,21,5,16,16,39,34,5,36,35,1,33,34,17,17,7,30,4,4,9,6,3,,,
"Sep 24, 2021 3:00 PM",114,39,75,60,35,25,100,51,49,71,39,32,21,10,11,20,35,33,2,46,40,6,29,31,22,9,13,47,4,7,7,5,2,,,
"Sep 24, 2021 4:00 PM",169,49,120,71,48,23,123,82,41,92,56,36,27,11,16,17,39,35,4,69,63,6,33,31,21,10,6,48,3,7,5,2,3,,,
"Sep 24, 2021 5:00 PM",165,53,112,97,50,47,133,65,68,92,48,44,24,4,20,9,41,32,9,85,82,3,37,24,14,10,12,57,6,8,9,5,4,,,
"Sep 24, 2021 6:00 PM",136,45,91,80,47,33,105,69,36,76,43,33,20,7,13,16,36,32,4,58,56,2,29,19,14,5,10,41,1,4,6,4,2,,,
"Sep 24, 2021 7:00 PM",85,35,50,56,39,17,52,31,21,55,29,26,15,10,5,16,17,17,0,45,42,3,18,7,3,4,8,36,4,0,11,7,4,,,
"Sep 24, 2021 8:00 PM",69,30,39,40,12,28,25,13,12,34,16,18,4,1,3,8,13,13,0,14,14,0,13,4,3,1,2,20,2,1,3,1,2,,,
"Sep 24, 2021 9:00 PM",40,11,29,11,8,3,17,8,9,12,6,6,5,2,3,10,11,11,0,14,12,2,11,3,2,1,0,9,2,3,4,1,3,,,
"Sep 24, 2021 10:00 PM",26,6,20,9,8,1,15,8,7,12,8,4,3,1,2,1,9,9,0,7,6,1,10,1,1,0,1,16,2,2,2,0,2,,,
"Sep 24, 2021 11:00 PM",20,10,10,5,4,1,11,3,8,13,4,9,1,1,0,1,2,2,0,11,11,0,2,1,1,0,1,9,2,1,0,0,0,,,
"Sep 25, 2021 12:00 AM",19,4,15,0,0,0,2,1,1,9,3,6,2,0,2,2,4,3,1,9,9,0,2,0,0,0,2,7,2,0,3,1,2,,,
"Sep 25, 2021 1:00 AM",7,1,6,1,1,0,5,4,1,3,3,0,0,0,0,4,7,4,3,6,6,0,4,1,1,0,0,1,0,0,0,0,0,,,
"Sep 25, 2021 2:00 AM",9,3,6,0,0,0,2,1,1,1,0,1,0,0,0,0,2,2,0,3,3,0,3,1,1,0,0,2,0,1,0,0,0,,,
"Sep 25, 2021 3:00 AM",1,0,1,0,0,0,0,0,0,0,0,0,2,2,0,0,0,0,0,0,0,0,1,0,0,0,0,1,0,1,0,0,0,,,
"Sep 25, 2021 4:00 AM",3,1,2,0,0,0,0,0,0,0,0,0,0,0,0,4,2,1,1,2,2,0,1,0,0,0,1,2,0,0,0,0,0,,,
"Sep 25, 2021 5:00 AM",3,1,2,0,0,0,2,0,2,2,0,2,0,0,0,0,2,2,0,1,1,0,1,0,0,0,0,2,0,0,2,2,0,,,
"Sep 25, 2021 6:00 AM",9,4,5,4,3,1,9,5,4,4,2,2,0,0,0,2,5,5,0,4,4,0,5,1,1,0,1,11,0,0,0,0,0,,,
"Sep 25, 2021 7:00 AM",16,5,11,33,22,11,35,22,13,36,23,13,4,1,3,2,9,9,0,6,4,2,9,7,5,2,2,19,1,7,1,0,1,,,
"Sep 25, 2021 8:00 AM",44,26,18,81,40,41,83,43,40,63,38,25,20,5,15,8,19,19,0,16,16,0,24,16,9,7,6,36,1,6,2,2,0,,,
"Sep 25, 2021 9:00 AM",56,27,29,123,70,53,135,92,43,116,73,43,24,18,6,8,26,26,0,18,15,3,27,27,21,6,11,37,10,11,9,5,4,,,
"Sep 25, 2021 10:00 AM",67,38,29,166,81,85,149,86,63,141,80,61,48,27,21,17,21,21,0,15,11,4,22,28,21,7,12,42,5,6,4,3,1,,,
"Sep 25, 2021 11:00 AM",83,35,48,169,74,95,168,96,72,125,61,64,25,14,11,36,34,34,0,23,16,7,32,45,26,19,17,48,8,5,5,2,3,,,
"Sep 25, 2021 12:00 PM",73,34,39,204,85,119,187,101,86,138,88,50,55,32,23,24,38,34,4,28,23,5,33,56,32,24,18,45,11,5,6,2,4,,,
"Sep 25, 2021 1:00 PM",77,33,44,153,83,70,188,109,79,144,86,58,26,13,13,18,33,31,2,18,13,5,30,38,21,17,16,49,11,4,12,8,4,,,
"Sep 25, 2021 2:00 PM",61,35,26,153,80,73,260,161,99,152,83,69,42,19,23,22,39,39,0,30,24,6,36,62,52,10,21,43,7,6,11,10,1,,,
"Sep 25, 2021 3:00 PM",65,36,29,210,129,81,256,153,103,199,134,65,38,24,14,32,38,38,0,19,18,1,34,51,31,20,23,65,7,7,11,4,7,,,
"Sep 25, 2021 4:00 PM",72,41,31,203,90,113,276,111,165,180,77,103,28,12,16,30,32,31,1,23,20,3,28,50,27,23,14,95,6,3,5,3,2,,,
"Sep 25, 2021 5:00 PM",76,29,47,154,81,73,193,65,128,122,42,80,40,19,21,32,28,28,0,18,15,3,28,32,12,20,6,66,7,7,1,1,0,,,
"Sep 25, 2021 6:00 PM",74,40,34,106,43,63,153,44,109,108,30,78,26,8,18,20,19,18,1,15,14,1,19,37,12,25,8,58,7,4,7,5,2,,,
"Sep 25, 2021 7:00 PM",45,19,26,58,36,22,82,34,48,55,26,29,19,5,14,10,27,25,2,12,12,0,25,32,21,11,2,44,4,3,9,6,3,,,
"Sep 25, 2021 8:00 PM",43,16,27,26,16,10,38,15,23,19,7,12,14,5,9,9,14,12,2,8,7,1,11,10,7,3,1,25,0,0,0,0,0,,,
"Sep 25, 2021 9:00 PM",21,10,11,23,13,10,25,11,14,22,10,12,4,3,1,4,14,14,0,8,7,1,14,5,3,2,3,22,2,1,2,2,0,,,
"Sep 25, 2021 10:00 PM",14,5,9,7,5,2,14,7,7,8,4,4,4,4,0,6,7,6,1,4,3,1,7,4,3,1,1,9,1,6,1,0,1,,,
"Sep 25, 2021 11:00 PM",11,5,6,12,10,2,12,8,4,10,6,4,4,1,3,2,3,3,0,6,6,0,3,3,2,1,0,7,1,2,0,0,0,,,
"Sep 26, 2021 12:00 AM",21,7,14,2,1,1,4,3,1,7,3,4,2,1,1,3,4,4,0,12,11,1,2,2,2,0,0,4,1,0,1,1,0,,,
"Sep 26, 2021 1:00 AM",12,5,7,5,3,2,6,6,0,5,2,3,4,1,3,0,2,2,0,6,6,0,2,2,1,1,1,3,0,1,0,0,0,,,
"Sep 26, 2021 2:00 AM",2,0,2,5,4,1,5,5,0,5,5,0,0,0,0,2,1,1,0,2,2,0,1,1,1,0,0,1,1,1,0,0,0,,,
"Sep 26, 2021 3:00 AM",1,0,1,0,0,0,0,0,0,1,1,0,0,0,0,0,0,0,0,0,0,0,1,0,0,0,1,0,0,0,0,0,0,,,
"Sep 26, 2021 4:00 AM",6,2,4,0,0,0,3,2,1,1,1,0,1,1,0,0,3,3,0,1,1,0,3,0,0,0,0,2,0,0,0,0,0,,,
"Sep 26, 2021 5:00 AM",8,3,5,0,0,0,0,0,0,0,0,0,2,0,2,0,1,1,0,1,1,0,1,0,0,0,0,3,0,0,1,1,0,,,
"Sep 26, 2021 6:00 AM",8,7,1,7,2,5,12,7,5,8,5,3,1,0,1,6,3,3,0,4,4,0,3,0,0,0,0,12,0,0,0,0,0,,,
"Sep 26, 2021 7:00 AM",13,4,9,20,16,4,15,13,2,18,14,4,1,1,0,2,5,5,0,7,6,1,5,6,6,0,0,12,0,4,2,0,2,,,
"Sep 26, 2021 8:00 AM",39,12,27,97,67,30,87,57,30,95,71,24,4,4,0,5,12,11,1,6,5,1,12,23,18,5,3,27,2,8,2,1,1,,,
"Sep 26, 2021 9:00 AM",56,32,24,144,86,58,128,77,51,139,91,48,14,12,2,11,23,22,1,17,17,0,21,23,18,5,6,46,0,11,5,2,3,,,
"Sep 26, 2021 10:00 AM",49,33,16,164,76,88,142,86,56,133,80,53,31,17,14,13,26,25,1,7,6,1,27,32,23,9,6,26,4,6,5,2,3,,,
"Sep 26, 2021 11:00 AM",69,38,31,211,105,106,210,111,99,198,105,93,49,22,27,20,31,31,0,20,16,4,24,66,40,26,17,35,7,11,14,9,5,,,
"Sep 26, 2021 12:00 PM",85,35,50,218,96,122,229,129,100,182,96,86,41,26,15,27,30,29,1,14,12,2,26,39,22,17,10,43,10,5,12,9,3,,,
"Sep 26, 2021 1:00 PM",77,43,34,163,71,92,193,94,99,151,79,72,30,16,14,26,23,19,4,29,26,3,20,49,33,16,3,55,4,4,11,6,5,,,
"Sep 26, 2021 2:00 PM",78,44,34,178,82,96,218,107,111,157,83,74,36,19,17,21,36,36,0,11,10,1,34,57,27,30,12,54,6,4,10,6,4,,,
"Sep 26, 2021 3:00 PM",65,30,35,155,73,82,186,90,96,136,61,75,46,20,26,26,19,19,0,15,14,1,21,33,14,19,18,48,6,3,10,8,2,,,
"Sep 26, 2021 4:00 PM",52,24,28,134,71,63,170,78,92,110,47,63,36,8,28,26,22,19,3,21,17,4,18,27,13,14,9,59,5,2,6,4,2,,,
"Sep 26, 2021 5:00 PM",56,25,31,52,23,29,87,17,70,53,14,39,11,4,7,13,15,15,0,16,13,3,14,12,4,8,3,34,1,1,1,0,1,,,
"Sep 26, 2021 6:00 PM",34,15,19,36,24,12,24,14,10,17,8,9,8,6,2,5,11,11,0,16,14,2,11,10,4,6,0,17,0,0,0,0,0,,,
"Sep 26, 2021 7:00 PM",18,6,12,15,14,1,15,7,8,8,4,4,6,3,3,10,8,7,1,3,2,1,8,1,1,0,2,9,0,0,1,0,1,,,
"Sep 26, 2021 8:00 PM",17,8,9,4,0,4,5,1,4,4,0,4,4,2,2,2,5,5,0,6,6,0,6,2,0,2,1,9,1,0,0,0,0,,,
"Sep 26, 2021 9:00 PM",13,7,6,7,3,4,9,2,7,8,3,5,1,1,0,6,0,0,0,6,6,0,0,0,0,0,1,7,2,0,1,0,1,,,
"Sep 26, 2021 10:00 PM",9,3,6,6,4,2,5,2,3,2,0,2,3,0,3,2,4,4,0,5,4,1,2,0,0,0,0,2,1,2,0,0,0,,,
"Sep 26, 2021 11:00 PM",8,1,7,4,4,0,3,1,2,5,2,3,0,0,0,0,1,1,0,2,2,0,2,0,0,0,0,2,0,0,0,0,0,,,
"Sep 27, 2021 12:00 AM",4,2,2,0,0,0,0,0,0,1,0,1,0,0,0,2,0,0,0,4,4,0,0,0,0,0,0,1,0,0,0,0,0,,,
"Sep 27, 2021 1:00 AM",4,2,2,0,0,0,0,0,0,0,0,0,1,1,0,2,0,0,0,0,0,0,0,0,0,0,0,0,0,0,0,0,0,,,
"Sep 27, 2021 2:00 AM",2,0,2,0,0,0,0,0,0,0,0,0,0,0,0,0,0,0,0,0,0,0,0,0,0,0,0,0,0,0,0,0,0,,,
"Sep 27, 2021 3:00 AM",0,0,0,0,0,0,0,0,0,0,0,0,0,0,0,0,0,0,0,0,0,0,0,0,0,0,0,1,0,0,0,0,0,,,
"Sep 27, 2021 4:00 AM",1,0,1,0,0,0,1,1,0,0,0,0,0,0,0,1,0,0,0,0,0,0,0,0,0,0,0,0,0,0,0,0,0,,,
"Sep 27, 2021 5:00 AM",4,3,1,0,0,0,4,3,1,2,2,0,0,0,0,2,4,4,0,2,1,1,4,1,1,0,0,8,0,0,0,0,0,,,
"Sep 27, 2021 6:00 AM",32,21,11,15,4,11,19,7,12,13,5,8,5,4,1,1,16,16,0,6,5,1,17,2,1,1,1,28,1,3,1,1,0,,,
"Sep 27, 2021 7:00 AM",102,71,31,57,18,39,82,23,59,61,25,36,8,8,0,15,91,88,3,21,17,4,87,17,9,8,3,90,1,4,6,5,1,,,
"Sep 27, 2021 8:00 AM",297,224,73,103,35,68,132,44,88,104,45,59,40,27,13,43,196,192,4,36,21,15,178,38,8,30,8,168,7,4,15,12,3,,,
"Sep 27, 2021 9:00 AM",156,129,27,75,36,39,100,55,45,87,49,38,17,7,10,11,122,120,2,29,22,7,109,22,11,11,3,70,2,4,4,2,2,,,
"Sep 27, 2021 10:00 AM",84,63,21,68,22,46,74,35,39,69,31,38,15,11,4,7,54,54,0,23,15,8,44,11,4,7,2,30,0,3,2,1,1,,,
"Sep 27, 2021 11:00 AM",77,47,30,63,33,30,60,28,32,61,33,28,10,4,6,8,48,46,2,12,9,3,36,7,4,3,6,30,2,3,4,4,0,,,
"Sep 27, 2021 12:00 PM",93,44,49,57,32,25,73,43,30,54,32,22,17,8,9,8,45,41,4,34,28,6,38,11,8,3,7,29,6,4,1,0,1,,,
"Sep 27, 2021 1:00 PM",129,61,68,60,31,29,90,46,44,66,36,30,18,13,5,20,53,50,3,38,33,5,44,14,9,5,5,43,7,5,9,7,2,,,
"Sep 27, 2021 2:00 PM",103,50,53,68,44,24,97,47,50,68,38,30,21,11,10,17,23,21,2,34,33,1,17,24,13,11,16,47,2,5,8,3,5,,,
"Sep 27, 2021 3:00 PM",109,36,73,57,30,27,81,45,36,54,32,22,27,11,16,12,34,26,8,41,34,7,19,17,14,3,10,38,3,6,4,2,2,,,
"Sep 27, 2021 4:00 PM",153,45,108,72,44,28,105,60,45,75,44,31,11,5,6,19,23,19,4,73,66,7,18,24,15,9,6,50,3,7,10,5,5,,,
"Sep 27, 2021 5:00 PM",211,52,159,78,49,29,132,73,59,88,44,44,30,7,23,26,34,26,8,119,115,4,24,19,14,5,17,62,3,2,6,4,2,,,
"Sep 27, 2021 6:00 PM",189,47,142,60,43,17,116,78,38,68,42,26,21,6,15,21,39,28,11,80,78,2,30,34,27,7,8,41,5,2,14,8,6,,,
"Sep 27, 2021 7:00 PM",106,23,83,33,20,13,56,34,22,41,26,15,8,3,5,11,11,10,1,36,34,2,11,15,11,4,3,26,2,0,7,4,3,,,
"Sep 27, 2021 8:00 PM",67,11,56,11,7,4,17,11,6,18,12,6,2,1,1,4,14,12,2,21,20,1,8,8,6,2,6,15,6,1,5,3,2,,,
"Sep 27, 2021 9:00 PM",38,7,31,5,4,1,11,7,4,10,3,7,0,0,0,10,9,9,0,13,11,2,9,3,3,0,0,17,2,0,2,1,1,,,
"Sep 27, 2021 10:00 PM",18,3,15,3,3,0,7,4,3,4,2,2,1,1,0,2,6,6,0,7,7,0,4,4,3,1,0,6,1,2,0,0,0,,,
"Sep 27, 2021 11:00 PM",9,3,6,3,3,0,6,4,2,4,2,2,0,0,0,0,2,2,0,3,3,0,3,0,0,0,0,2,1,0,0,0,0,,,
"Sep 28, 2021 12:00 AM",6,2,4,0,0,0,3,3,0,3,3,0,1,0,1,0,0,0,0,3,3,0,0,0,0,0,1,1,1,0,0,0,0,,,
"Sep 28, 2021 1:00 AM",1,0,1,1,1,0,0,0,0,0,0,0,0,0,0,0,0,0,0,1,1,0,0,0,0,0,0,0,1,0,0,0,0,,,
"Sep 28, 2021 2:00 AM",3,3,0,1,0,1,1,0,1,1,0,1,0,0,0,0,0,0,0,4,4,0,0,0,0,0,0,1,0,0,0,0,0,,,
"Sep 28, 2021 3:00 AM",0,0,0,0,0,0,0,0,0,0,0,0,0,0,0,0,0,0,0,0,0,0,0,0,0,0,0,0,0,0,0,0,0,,,
"Sep 28, 2021 4:00 AM",0,0,0,0,0,0,1,1,0,0,0,0,0,0,0,3,0,0,0,0,0,0,0,0,0,0,0,0,0,1,0,0,0,,,
"Sep 28, 2021 5:00 AM",6,4,2,0,0,0,5,3,2,7,6,1,2,0,2,4,6,6,0,4,3,1,6,2,1,1,0,12,0,0,0,0,0,,,
"Sep 28, 2021 6:00 AM",32,23,9,34,21,13,39,25,14,28,19,9,5,4,1,5,19,19,0,10,10,0,20,8,6,2,0,37,0,6,4,4,0,,,
"Sep 28, 2021 7:00 AM",123,87,36,59,10,49,93,20,73,58,16,42,14,13,1,20,82,81,1,26,21,5,79,21,7,14,6,92,4,3,7,4,3,,,
"Sep 28, 2021 8:00 AM",293,237,56,119,28,91,164,45,119,127,45,82,43,28,15,26,201,198,3,66,49,17,186,49,10,39,7,199,8,7,20,18,2,,,
"Sep 28, 2021 9:00 AM",147,127,20,65,28,37,89,44,45,72,40,32,14,10,4,10,102,102,0,20,11,9,96,11,2,9,5,54,3,0,3,2,1,,,
"Sep 28, 2021 10:00 AM",95,66,29,45,23,22,53,24,29,45,19,26,7,2,5,11,49,48,1,18,12,6,43,12,8,4,1,36,4,2,0,0,0,,,
"Sep 28, 2021 11:00 AM",84,55,29,56,28,28,61,28,33,66,35,31,13,6,7,19,44,41,3,12,8,4,38,10,7,3,6,32,6,2,1,1,0,,,
"Sep 28, 2021 12:00 PM",89,50,39,57,28,29,64,37,27,47,27,20,24,12,12,12,51,47,4,31,30,1,41,9,7,2,2,37,2,3,5,4,1,,,
"Sep 28, 2021 1:00 PM",124,65,59,66,35,31,78,37,41,52,25,27,15,5,10,13,39,36,3,34,24,10,32,13,12,1,9,32,4,3,5,3,2,,,
"Sep 28, 2021 2:00 PM",104,40,64,63,36,27,75,41,34,62,43,19,17,10,7,12,30,23,7,47,42,5,21,20,10,10,7,25,7,2,9,7,2,,,
"Sep 28, 2021 3:00 PM",133,43,90,51,28,23,82,51,31,53,31,22,14,5,9,11,38,35,3,51,42,9,33,13,8,5,10,36,4,4,3,2,1,,,
"Sep 28, 2021 4:00 PM",184,58,126,71,53,18,109,77,32,76,51,25,19,6,13,10,30,25,5,80,74,6,22,35,28,7,10,40,5,1,5,2,3,,,
"Sep 28, 2021 5:00 PM",232,60,172,84,52,32,147,86,61,94,59,35,27,3,24,19,57,50,7,111,106,5,50,39,31,8,16,68,6,5,6,4,2,,,
"Sep 28, 2021 6:00 PM",175,54,121,96,60,36,170,112,58,108,67,41,20,6,14,21,48,44,4,99,91,8,42,39,28,11,11,59,4,8,8,5,3,,,
"Sep 28, 2021 7:00 PM",154,43,111,48,30,18,101,51,50,62,30,32,8,2,6,11,38,34,4,48,44,4,32,37,20,17,16,52,4,2,10,7,3,,,
"Sep 28, 2021 8:00 PM",83,20,63,14,8,6,34,15,19,19,10,9,13,11,2,13,12,10,2,43,41,2,13,10,7,3,2,21,3,0,2,1,1,,,
"Sep 28, 2021 9:00 PM",60,11,49,7,5,2,10,7,3,8,5,3,0,0,0,6,11,11,0,21,21,0,9,5,4,1,0,17,1,1,1,1,0,,,
"Sep 28, 2021 10:00 PM",23,7,16,6,4,2,7,6,1,5,2,3,0,0,0,2,3,3,0,18,17,1,3,7,4,3,0,5,1,1,0,0,0,,,
"Sep 28, 2021 11:00 PM",20,6,14,2,2,0,7,3,4,3,1,2,4,0,4,4,1,1,0,10,10,0,1,2,1,1,0,3,1,0,0,0,0,,,
"Sep 29, 2021 12:00 AM",9,2,7,0,0,0,2,2,0,1,1,0,0,0,0,0,3,3,0,3,3,0,3,0,0,0,1,1,0,1,0,0,0,,,
"Sep 29, 2021 1:00 AM",3,2,1,0,0,0,0,0,0,0,0,0,0,0,0,0,0,0,0,1,1,0,0,0,0,0,0,0,0,0,0,0,0,,,
"Sep 29, 2021 2:00 AM",4,4,0,0,0,0,0,0,0,0,0,0,0,0,0,1,0,0,0,1,1,0,1,0,0,0,0,0,0,0,0,0,0,,,
"Sep 29, 2021 3:00 AM",0,0,0,0,0,0,0,0,0,0,0,0,0,0,0,0,0,0,0,1,1,0,0,0,0,0,0,0,0,0,0,0,0,,,
"Sep 29, 2021 4:00 AM",0,0,0,0,0,0,0,0,0,0,0,0,0,0,0,3,1,1,0,1,0,1,1,1,1,0,0,0,0,0,0,0,0,,,
"Sep 29, 2021 5:00 AM",9,6,3,0,0,0,4,1,3,1,0,1,0,0,0,4,3,3,0,2,2,0,3,0,0,0,0,14,1,0,0,0,0,,,
"Sep 29, 2021 6:00 AM",37,25,12,14,2,12,19,12,7,10,5,5,2,2,0,7,19,19,0,11,10,1,21,3,3,0,2,28,1,2,0,0,0,,,
"Sep 29, 2021 7:00 AM",126,85,41,59,29,30,107,38,69,75,30,45,13,13,0,16,89,89,0,30,24,6,90,26,11,15,7,99,3,5,6,5,1,,,
"Sep 29, 2021 8:00 AM",300,232,68,111,32,79,197,58,139,140,51,89,39,27,12,44,205,201,4,60,47,13,185,42,17,25,9,222,10,7,18,13,5,,,
"Sep 29, 2021 9:00 AM",184,157,27,79,35,44,107,58,49,95,55,40,14,9,5,12,111,110,1,23,14,9,89,16,10,6,9,66,5,2,7,5,2,,,
"Sep 29, 2021 10:00 AM",100,69,31,63,29,34,79,36,43,62,30,32,10,9,1,9,65,62,3,19,12,7,53,7,4,3,8,42,3,1,6,4,2,,,
"Sep 29, 2021 11:00 AM",80,47,33,62,32,30,50,24,26,49,25,24,9,4,5,9,47,43,4,21,14,7,42,9,4,5,4,32,4,2,2,2,0,,,
"Sep 29, 2021 12:00 PM",88,40,48,82,38,44,69,37,32,52,27,25,33,13,20,9,48,43,5,28,24,4,32,15,6,9,8,37,7,3,4,3,1,,,
"Sep 29, 2021 1:00 PM",135,68,67,88,52,36,134,73,61,114,67,47,25,12,13,20,63,58,5,43,40,3,48,30,27,3,10,39,3,3,12,4,8,,,
"Sep 29, 2021 2:00 PM",105,41,64,55,38,17,71,36,35,70,39,31,30,17,13,23,29,28,1,38,38,0,22,17,14,3,9,31,2,4,4,3,1,,,
"Sep 29, 2021 3:00 PM",116,32,84,63,31,32,72,50,22,50,29,21,21,9,12,18,34,26,8,54,44,10,24,20,15,5,15,34,3,3,5,4,1,,,
"Sep 29, 2021 4:00 PM",174,50,124,71,45,26,122,77,45,69,41,28,19,6,13,20,37,26,11,104,95,9,31,21,13,8,11,44,6,5,10,5,5,,,
"Sep 29, 2021 5:00 PM",248,75,173,93,56,37,132,77,55,91,51,40,26,14,12,50,49,43,6,109,104,5,39,29,22,7,16,76,4,3,9,7,2,,,
"Sep 29, 2021 6:00 PM",196,57,139,107,67,40,168,109,59,112,71,41,15,9,6,16,55,48,7,114,108,6,49,36,29,7,12,61,3,6,9,6,3,,,
"Sep 29, 2021 7:00 PM",131,36,95,49,26,23,77,41,36,60,30,30,6,5,1,13,33,26,7,38,34,4,23,28,20,8,9,48,7,3,7,6,1,,,
"Sep 29, 2021 8:00 PM",84,22,62,26,18,8,62,35,27,44,22,22,4,1,3,11,15,14,1,26,26,0,11,10,6,4,6,22,7,2,8,5,3,,,
"Sep 29, 2021 9:00 PM",38,14,24,7,2,5,21,12,9,19,10,9,0,0,0,12,10,7,3,33,31,2,5,5,4,1,0,20,4,1,8,4,4,,,
"Sep 29, 2021 10:00 PM",35,8,27,11,6,5,18,7,11,11,4,7,1,1,0,1,4,4,0,16,14,2,6,0,0,0,1,6,3,0,1,1,0,,,
"Sep 29, 2021 11:00 PM",19,7,12,1,1,0,4,0,4,2,0,2,0,0,0,4,2,1,1,11,10,1,1,2,1,1,1,4,0,0,0,0,0,,,
"Sep 30, 2021 12:00 AM",12,4,8,0,0,0,0,0,0,1,1,0,1,0,1,0,2,2,0,5,4,1,2,1,1,0,0,4,1,0,1,1,0,,,
"Sep 30, 2021 1:00 AM",2,0,2,0,0,0,0,0,0,0,0,0,0,0,0,1,1,0,1,1,1,0,0,0,0,0,1,1,0,0,0,0,0,,,
"Sep 30, 2021 2:00 AM",1,1,0,2,1,1,1,1,0,2,1,1,0,0,0,0,0,0,0,0,0,0,0,0,0,0,0,0,0,0,0,0,0,,,
"Sep 30, 2021 3:00 AM",1,0,1,0,0,0,0,0,0,0,0,0,1,1,0,0,0,0,0,1,1,0,0,0,0,0,0,0,0,0,0,0,0,,,
"Sep 30, 2021 4:00 AM",1,0,1,0,0,0,1,1,0,0,0,0,0,0,0,3,1,1,0,0,0,0,0,0,0,0,0,1,0,0,0,0,0,,,
"Sep 30, 2021 5:00 AM",4,1,3,0,0,0,1,1,0,2,1,1,0,0,0,2,8,8,0,4,2,2,9,0,0,0,0,8,0,0,1,1,0,,,
"Sep 30, 2021 6:00 AM",37,26,11,15,7,8,18,9,9,15,10,5,0,0,0,3,15,15,0,5,5,0,15,3,2,1,1,23,1,3,0,0,0,,,
"Sep 30, 2021 7:00 AM",108,70,38,69,25,44,105,39,66,77,26,51,8,8,0,12,68,68,0,25,18,7,66,13,4,9,1,95,8,5,6,6,0,,,
"Sep 30, 2021 8:00 AM",242,182,60,85,28,57,183,62,121,122,51,71,37,26,11,38,165,160,5,45,36,9,150,47,13,34,8,167,10,8,21,19,2,,,
"Sep 30, 2021 9:00 AM",138,118,20,47,15,32,77,36,41,54,31,23,17,11,6,10,107,107,0,21,14,7,86,14,7,7,4,68,0,1,3,2,1,,,
"Sep 30, 2021 10:00 AM",100,75,25,20,6,14,32,10,22,22,8,14,10,8,2,10,52,52,0,14,10,4,44,1,0,1,4,27,0,2,1,1,0,,,
"Sep 30, 2021 11:00 AM",72,48,24,29,14,15,34,15,19,24,12,12,7,3,4,13,30,27,3,17,17,0,25,5,3,2,6,24,0,0,1,1,0,,,
"Sep 30, 2021 12:00 PM",85,49,36,34,18,16,33,19,14,32,22,10,13,5,8,8,29,26,3,18,17,1,23,3,2,1,8,26,3,2,4,4,0,,,
"Sep 30, 2021 1:00 PM",111,52,59,23,13,10,40,24,16,25,11,14,14,4,10,5,30,25,5,30,25,5,25,10,7,3,3,22,4,0,3,1,2,,,
"Sep 30, 2021 2:00 PM",97,39,58,24,16,8,44,23,21,37,20,17,13,7,6,22,29,22,7,29,27,2,14,13,6,7,7,26,3,8,7,2,5,,,
"Sep 30, 2021 3:00 PM",101,37,64,30,18,12,73,51,22,39,27,12,14,6,8,14,51,44,7,42,33,9,40,15,11,4,11,37,0,3,12,6,6,,,
"Sep 30, 2021 4:00 PM",168,48,120,56,35,21,87,62,25,64,49,15,14,7,7,15,42,32,10,67,63,4,32,31,23,8,17,33,5,3,8,3,5,,,
"Sep 30, 2021 5:00 PM",232,60,172,74,51,23,120,69,51,87,52,35,25,9,16,19,39,34,5,103,100,3,36,25,18,7,17,62,6,5,8,4,4,,,
"Sep 30, 2021 6:00 PM",154,44,110,73,43,30,122,73,49,81,47,34,21,10,11,23,41,39,2,79,73,6,38,21,11,10,12,35,1,0,5,3,2,,,
"Sep 30, 2021 7:00 PM",104,35,69,39,22,17,51,24,27,48,22,26,20,6,14,6,26,23,3,36,31,5,21,19,9,10,6,32,4,3,11,8,3,,,
"Sep 30, 2021 8:00 PM",80,27,53,11,6,5,30,18,12,18,10,8,2,0,2,9,15,13,2,42,39,3,13,6,4,2,3,21,2,0,4,4,0,,,
"Sep 30, 2021 9:00 PM",50,11,39,11,4,7,23,16,7,17,8,9,2,2,0,3,11,9,2,18,17,1,8,11,6,5,2,12,3,2,1,0,1,,,
"Sep 30, 2021 10:00 PM",29,6,23,4,2,2,12,2,10,8,3,5,5,2,3,4,4,3,1,15,14,1,4,1,1,0,1,12,1,1,1,1,0,,,
"Sep 30, 2021 11:00 PM",16,4,12,7,4,3,6,0,6,7,1,6,1,0,1,1,2,2,0,0,0,0,3,0,0,0,5,4,1,0,0,0,0,,,
"Oct 1, 2021 12:00 AM",6,1,5,0,0,0,2,1,1,4,2,2,0,0,0,1,3,3,0,0,0,0,3,1,1,0,1,1,0,0,0,0,0,,,
"Oct 1, 2021 1:00 AM",5,1,4,0,0,0,2,2,0,0,0,0,0,0,0,2,0,0,0,0,0,0,0,1,1,0,0,1,0,0,1,1,0,,,
"Oct 1, 2021 2:00 AM",8,6,2,0,0,0,1,1,0,0,0,0,0,0,0,0,2,2,0,0,0,0,2,0,0,0,0,0,0,0,0,0,0,,,
"Oct 1, 2021 3:00 AM",0,0,0,0,0,0,1,1,0,0,0,0,0,0,0,0,1,0,1,0,0,0,1,0,0,0,0,0,0,0,0,0,0,,,
"Oct 1, 2021 4:00 AM",0,0,0,0,0,0,1,1,0,0,0,0,0,0,0,2,0,0,0,0,0,0,0,0,0,0,0,1,0,0,0,0,0,,,
"Oct 1, 2021 5:00 AM",5,2,3,3,2,1,3,3,0,4,3,1,1,0,1,3,10,10,0,0,0,0,9,1,0,1,0,9,0,0,2,2,0,,,
"Oct 1, 2021 6:00 AM",34,21,13,10,7,3,24,13,11,14,10,4,1,1,0,2,13,13,0,0,0,0,15,5,4,1,1,18,1,4,3,3,0,,,
"Oct 1, 2021 7:00 AM",89,55,34,44,18,26,87,34,53,39,20,19,9,8,1,15,55,55,0,0,0,0,55,17,9,8,1,71,3,7,4,3,1,,,
"Oct 1, 2021 8:00 AM",235,174,61,98,30,68,170,66,104,108,37,71,45,31,14,27,147,145,2,0,0,0,134,34,10,24,6,142,9,4,15,15,0,,,
"Oct 1, 2021 9:00 AM",131,96,35,59,24,35,111,50,61,76,38,38,21,15,6,10,64,64,0,0,0,0,54,16,7,9,3,63,3,2,3,1,2,,,
"Oct 1, 2021 10:00 AM",82,40,42,47,21,26,73,39,34,37,22,15,12,9,3,8,49,47,2,0,0,0,41,11,8,3,4,36,4,4,5,2,3,,,
"Oct 1, 2021 11:00 AM",75,43,32,36,14,22,55,20,35,36,14,22,10,4,6,7,27,27,0,0,0,0,27,6,3,3,0,36,4,0,7,5,2,,,
"Oct 1, 2021 12:00 PM",102,45,57,65,45,20,76,42,34,56,42,14,21,10,11,17,34,28,6,0,0,0,21,19,13,6,7,26,3,1,1,1,0,,,
"Oct 1, 2021 1:00 PM",120,58,62,71,34,37,79,40,39,62,32,30,10,5,5,20,35,31,4,0,0,0,27,14,10,4,6,44,2,3,7,2,5,,,
"Oct 1, 2021 2:00 PM",79,30,49,51,30,21,73,34,39,65,36,29,14,8,6,14,25,24,1,0,0,0,22,14,8,6,4,29,5,3,8,3,5,,,
"Oct 1, 2021 3:00 PM",125,41,84,40,22,18,62,37,25,58,36,22,9,4,5,20,32,29,3,0,0,0,25,21,15,6,9,44,4,6,7,2,5,,,
"Oct 1, 2021 4:00 PM",67,21,46,63,45,18,75,55,20,63,44,19,19,6,13,18,35,32,3,0,0,0,29,16,11,5,11,39,1,3,12,7,5,,,
"Oct 1, 2021 5:00 PM",91,26,65,61,45,16,84,52,32,73,45,28,14,5,9,24,31,27,4,0,0,0,26,14,9,5,16,43,5,5,8,3,5,,,
"Oct 1, 2021 6:00 PM",128,41,87,58,35,23,94,61,33,74,50,24,11,2,9,16,29,26,3,0,0,0,23,14,11,3,5,41,5,3,9,7,2,,,
"Oct 1, 2021 7:00 PM",89,27,62,44,23,21,62,27,35,45,19,26,16,6,10,6,12,11,1,0,0,0,8,16,13,3,5,37,1,1,1,0,1,,,
"Oct 1, 2021 8:00 PM",42,15,27,6,4,2,15,7,8,10,3,7,5,4,1,5,5,5,0,0,0,0,5,8,6,2,0,14,4,2,1,0,1,,,
"Oct 1, 2021 9:00 PM",28,5,23,4,3,1,17,14,3,12,7,5,0,0,0,2,5,5,0,0,0,0,4,1,1,0,1,11,1,0,6,5,1,,,
"Oct 1, 2021 10:00 PM",23,5,18,7,6,1,14,6,8,14,9,5,3,3,0,2,1,1,0,0,0,0,1,4,3,1,0,9,0,2,4,3,1,,,
"Oct 1, 2021 11:00 PM",21,5,16,7,2,5,16,6,10,7,3,4,5,2,3,2,5,5,0,0,0,0,4,2,2,0,0,6,2,1,1,0,1,,,
"Oct 2, 2021 12:00 AM",16,5,11,0,0,0,3,2,1,4,1,3,2,0,2,0,2,2,0,0,0,0,2,1,1,0,0,6,0,0,2,2,0,,,
"Oct 2, 2021 1:00 AM",4,0,4,0,0,0,6,2,4,2,1,1,0,0,0,0,3,2,1,0,0,0,2,2,1,1,1,5,0,0,1,0,1,,,
"Oct 2, 2021 2:00 AM",8,5,3,2,1,1,1,1,0,2,1,1,0,0,0,2,0,0,0,0,0,0,0,0,0,0,0,0,0,0,0,0,0,,,
"Oct 2, 2021 3:00 AM",7,2,5,3,1,2,0,0,0,0,0,0,0,0,0,1,0,0,0,0,0,0,0,0,0,0,0,0,0,0,0,0,0,,,
"Oct 2, 2021 4:00 AM",0,0,0,0,0,0,2,2,0,0,0,0,0,0,0,3,0,0,0,0,0,0,0,0,0,0,0,1,0,0,0,0,0,,,
"Oct 2, 2021 5:00 AM",5,2,3,1,1,0,2,1,1,2,1,1,0,0,0,1,1,1,0,0,0,0,1,0,0,0,0,1,0,0,0,0,0,,,
"Oct 2, 2021 6:00 AM",7,3,4,5,1,4,5,3,2,5,2,3,1,0,1,2,5,5,0,0,0,0,6,0,0,0,1,11,0,1,0,0,0,,,
"Oct 2, 2021 7:00 AM",11,1,10,11,7,4,20,14,6,11,7,4,1,0,1,3,10,10,0,0,0,0,10,5,4,1,0,16,1,3,0,0,0,,,
"Oct 2, 2021 8:00 AM",36,21,15,36,15,21,38,24,14,29,19,10,14,8,6,4,12,12,0,0,0,0,11,3,2,1,3,16,0,1,2,1,1,,,
"Oct 2, 2021 9:00 AM",44,25,19,78,47,31,74,53,21,59,43,16,12,10,2,9,15,15,0,0,0,0,16,21,17,4,3,21,3,6,3,3,0,,,
"Oct 2, 2021 10:00 AM",38,22,16,68,40,28,110,61,49,73,42,31,19,13,6,15,19,19,0,0,0,0,17,21,12,9,6,40,4,2,3,3,0,,,
"Oct 2, 2021 11:00 AM",55,32,23,94,48,46,123,71,52,94,56,38,42,21,21,19,21,21,0,0,0,0,19,21,17,4,5,40,3,4,6,2,4,,,
"Oct 2, 2021 12:00 PM",71,27,44,86,45,41,138,73,65,95,45,50,35,24,11,17,16,16,0,0,0,0,13,14,5,9,4,38,5,3,5,4,1,,,
"Oct 2, 2021 1:00 PM",69,33,36,93,34,59,70,34,36,62,36,26,14,9,5,8,24,22,2,0,0,0,20,18,8,10,6,20,4,3,4,1,3,,,
"Oct 2, 2021 2:00 PM",67,42,25,75,33,42,71,40,31,68,39,29,14,8,6,16,27,26,1,0,0,0,23,18,13,5,10,26,5,6,5,1,4,,,
"Oct 2, 2021 3:00 PM",60,35,25,94,60,34,113,65,48,96,58,38,27,10,17,21,25,25,0,0,0,0,27,10,7,3,5,32,2,5,3,1,2,,,
"Oct 2, 2021 4:00 PM",53,29,24,106,51,55,88,48,40,86,48,38,11,5,6,24,25,23,2,0,0,0,21,25,12,13,6,35,6,3,13,12,1,,,
"Oct 2, 2021 5:00 PM",56,20,36,94,49,45,100,38,62,83,27,56,25,5,20,13,18,16,2,0,0,0,21,26,10,16,10,46,4,1,4,1,3,,,
"Oct 2, 2021 6:00 PM",49,24,25,57,28,29,60,28,32,54,22,32,6,5,1,21,14,14,0,0,0,0,12,12,8,4,3,31,3,0,7,5,2,,,
"Oct 2, 2021 7:00 PM",44,17,27,27,12,15,42,23,19,30,15,15,11,7,4,6,24,21,3,0,0,0,21,8,4,4,5,27,1,0,2,0,2,,,
"Oct 2, 2021 8:00 PM",26,11,15,10,7,3,21,9,12,13,6,7,10,4,6,2,13,12,1,0,0,0,11,5,5,0,1,12,0,1,0,0,0,,,
"Oct 2, 2021 9:00 PM",11,5,6,10,8,2,11,6,5,6,1,5,2,0,2,1,7,6,1,0,0,0,9,1,1,0,1,4,0,0,0,0,0,,,
"Oct 2, 2021 10:00 PM",16,5,11,9,6,3,7,1,6,4,1,3,0,0,0,2,4,4,0,0,0,0,5,0,0,0,1,9,0,2,0,0,0,,,
"Oct 2, 2021 11:00 PM",19,6,13,10,6,4,5,3,2,3,0,3,4,0,4,0,7,7,0,0,0,0,7,1,1,0,0,4,0,2,1,1,0,,,
"Oct 3, 2021 12:00 AM",12,3,9,1,1,0,3,3,0,8,4,4,2,0,2,2,6,6,0,0,0,0,5,4,2,2,1,10,0,0,0,0,0,,,
"Oct 3, 2021 1:00 AM",8,2,6,0,0,0,5,2,3,4,3,1,0,0,0,0,1,1,0,0,0,0,2,2,2,0,0,2,2,1,1,1,0,,,
"Oct 3, 2021 2:00 AM",3,0,3,1,1,0,3,3,0,3,3,0,0,0,0,1,0,0,0,0,0,0,0,1,1,0,0,3,0,0,0,0,0,,,
"Oct 3, 2021 3:00 AM",0,0,0,1,1,0,3,3,0,4,4,0,1,0,1,0,0,0,0,0,0,0,0,0,0,0,1,1,0,0,0,0,0,,,
"Oct 3, 2021 4:00 AM",2,0,2,1,1,0,1,1,0,0,0,0,0,0,0,1,1,1,0,0,0,0,1,0,0,0,0,0,0,0,1,1,0,,,
"Oct 3, 2021 5:00 AM",1,1,0,0,0,0,0,0,0,0,0,0,0,0,0,0,1,1,0,0,0,0,1,0,0,0,0,3,0,0,1,1,0,,,
"Oct 3, 2021 6:00 AM",3,1,2,2,1,1,6,3,3,3,2,1,0,0,0,4,4,4,0,0,0,0,4,0,0,0,0,7,0,1,0,0,0,,,
"Oct 3, 2021 7:00 AM",12,5,7,17,8,9,11,8,3,15,10,5,3,1,2,2,10,10,0,0,0,0,9,1,1,0,0,18,0,2,0,0,0,,,
"Oct 3, 2021 8:00 AM",32,14,18,54,34,20,58,36,22,48,34,14,3,2,1,0,11,11,0,0,0,0,11,8,7,1,2,25,2,15,1,1,0,,,
"Oct 3, 2021 9:00 AM",48,27,21,84,46,38,101,74,27,80,52,28,13,8,5,7,30,30,0,0,0,0,30,17,14,3,5,37,3,6,5,4,1,,,
"Oct 3, 2021 10:00 AM",60,39,21,144,80,64,159,97,62,114,75,39,17,13,4,13,14,14,0,0,0,0,15,17,13,4,9,50,8,6,7,5,2,,,
"Oct 3, 2021 11:00 AM",53,26,27,132,60,72,201,99,102,120,56,64,17,7,10,20,14,13,1,0,0,0,15,17,11,6,9,46,7,9,11,10,1,,,
"Oct 3, 2021 12:00 PM",59,23,36,150,93,57,169,91,78,152,98,54,22,9,13,12,25,23,2,0,0,0,19,37,29,8,9,41,9,10,4,3,1,,,
"Oct 3, 2021 1:00 PM",72,33,39,128,57,71,123,70,53,112,56,56,25,17,8,11,17,17,0,0,0,0,17,19,14,5,11,46,12,6,7,3,4,,,
"Oct 3, 2021 2:00 PM",60,30,30,127,72,55,117,61,56,121,62,59,27,9,18,11,24,23,1,0,0,0,21,29,21,8,8,38,5,5,0,0,0,,,
"Oct 3, 2021 3:00 PM",38,22,16,97,43,54,89,33,56,75,32,43,22,15,7,9,7,7,0,0,0,0,6,18,5,13,3,50,3,1,7,3,4,,,
"Oct 3, 2021 4:00 PM",46,24,22,62,34,28,68,23,45,66,29,37,20,4,16,17,8,7,1,0,0,0,7,16,9,7,9,31,1,2,7,6,1,,,
"Oct 3, 2021 5:00 PM",44,18,26,39,20,19,38,14,24,29,13,16,18,12,6,13,18,18,0,0,0,0,15,11,2,9,4,24,1,0,3,3,0,,,
"Oct 3, 2021 6:00 PM",53,23,30,44,18,26,44,17,27,35,13,22,16,7,9,19,13,12,1,0,0,0,14,14,6,8,2,30,4,0,10,5,5,,,
"Oct 3, 2021 7:00 PM",37,13,24,18,9,9,26,13,13,19,10,9,4,1,3,9,10,9,1,0,0,0,9,11,3,8,1,15,0,2,3,3,0,,,
"Oct 3, 2021 8:00 PM",15,6,9,8,4,4,22,10,12,16,6,10,0,0,0,0,6,6,0,0,0,0,7,5,4,1,1,12,1,1,2,0,2,,,
"Oct 3, 2021 9:00 PM",20,11,9,4,1,3,8,3,5,5,2,3,1,1,0,3,7,7,0,0,0,0,7,2,2,0,0,8,0,0,1,1,0,,,
"Oct 3, 2021 10:00 PM",4,2,2,3,2,1,3,2,1,4,2,2,1,1,0,1,3,3,0,0,0,0,2,2,2,0,0,3,0,1,0,0,0,,,
"Oct 3, 2021 11:00 PM",4,1,3,2,0,2,2,1,1,1,0,1,2,1,1,2,3,3,0,0,0,0,2,0,0,0,0,4,0,0,0,0,0,,,
"Oct 4, 2021 12:00 AM",4,1,3,1,1,0,2,2,0,3,2,1,2,0,2,1,0,0,0,0,0,0,0,2,1,1,1,1,0,0,0,0,0,,,
"Oct 4, 2021 1:00 AM",2,0,2,0,0,0,0,0,0,0,0,0,0,0,0,0,1,1,0,0,0,0,1,0,0,0,0,1,0,0,0,0,0,,,
"Oct 4, 2021 2:00 AM",1,1,0,0,0,0,1,1,0,1,1,0,0,0,0,0,0,0,0,0,0,0,0,0,0,0,0,2,0,0,0,0,0,,,
"Oct 4, 2021 3:00 AM",0,0,0,0,0,0,0,0,0,0,0,0,0,0,0,0,0,0,0,0,0,0,0,0,0,0,0,0,0,0,0,0,0,,,
"Oct 4, 2021 4:00 AM",1,0,1,0,0,0,1,1,0,0,0,0,0,0,0,2,0,0,0,0,0,0,0,0,0,0,0,0,0,0,0,0,0,,,
"Oct 4, 2021 5:00 AM",6,5,1,0,0,0,3,1,2,3,2,1,0,0,0,2,6,6,0,0,0,0,5,0,0,0,0,10,0,1,0,0,0,,,
"Oct 4, 2021 6:00 AM",34,23,11,14,6,8,23,11,12,13,7,6,5,5,0,3,23,23,0,0,0,0,23,3,1,2,2,32,2,1,1,1,0,,,
"Oct 4, 2021 7:00 AM",121,80,41,72,30,42,96,26,70,74,35,39,10,10,0,14,75,75,0,0,0,0,74,17,8,9,9,111,6,5,4,4,0,,,
"Oct 4, 2021 8:00 AM",288,220,68,113,25,88,190,66,124,136,45,91,39,24,15,36,183,179,4,0,0,0,167,52,10,42,8,195,8,3,20,19,1,,,
"Oct 4, 2021 9:00 AM",160,135,25,53,27,26,100,62,38,73,49,24,14,7,7,14,112,110,2,0,0,0,88,23,13,10,3,75,2,1,3,2,1,,,
"Oct 4, 2021 10:00 AM",112,75,37,45,20,25,65,36,29,50,29,21,11,7,4,13,53,52,1,0,0,0,44,9,3,6,3,37,1,4,3,1,2,,,
"Oct 4, 2021 11:00 AM",79,46,33,55,33,22,80,43,37,38,21,17,14,11,3,8,39,37,2,0,0,0,30,22,18,4,7,30,1,5,4,3,1,,,
"Oct 4, 2021 12:00 PM",99,56,43,56,27,29,93,52,41,54,29,25,11,7,4,16,30,24,6,0,0,0,19,22,15,7,8,26,4,3,5,2,3,,,
"Oct 4, 2021 1:00 PM",115,61,54,77,33,44,95,38,57,64,31,33,19,6,13,15,42,40,2,0,0,0,33,24,8,16,4,39,9,3,5,5,0,,,
"Oct 4, 2021 2:00 PM",110,46,64,62,38,24,69,40,29,54,37,17,11,8,3,16,24,21,3,0,0,0,17,20,13,7,5,31,2,6,7,5,2,,,
"Oct 4, 2021 3:00 PM",114,33,81,67,42,25,62,37,25,57,39,18,15,4,11,12,54,44,10,0,0,0,37,20,16,4,6,37,1,5,5,4,1,,,
"Oct 4, 2021 4:00 PM",179,57,122,55,33,22,98,55,43,84,47,37,28,7,21,25,43,35,8,0,0,0,30,29,28,1,6,52,5,2,9,8,1,,,
"Oct 4, 2021 5:00 PM",240,49,191,87,58,29,129,81,48,91,53,38,16,3,13,38,52,47,5,0,0,0,44,22,13,9,16,62,3,6,10,6,4,,,
"Oct 4, 2021 6:00 PM",200,49,151,56,38,18,82,57,25,59,32,27,16,7,9,22,35,28,7,0,0,0,26,21,17,4,10,42,8,4,6,4,2,,,
"Oct 4, 2021 7:00 PM",88,28,60,20,14,6,36,26,10,23,15,8,7,3,4,11,21,15,6,0,0,0,15,9,5,4,5,19,3,2,6,1,5,,,
"Oct 4, 2021 8:00 PM",65,13,52,3,3,0,14,11,3,9,5,4,2,0,2,6,13,12,1,0,0,0,9,2,2,0,0,14,2,0,6,4,2,,,
"Oct 4, 2021 9:00 PM",22,3,19,5,3,2,10,4,6,7,1,6,2,1,1,4,3,3,0,0,0,0,6,5,3,2,2,9,3,0,5,4,1,,,
"Oct 4, 2021 10:00 PM",19,5,14,4,3,1,6,4,2,3,1,2,0,0,0,2,4,3,1,0,0,0,1,1,1,0,0,6,1,0,3,2,1,,,
"Oct 4, 2021 11:00 PM",9,1,8,3,2,1,3,2,1,4,2,2,0,0,0,4,2,2,0,0,0,0,2,0,0,0,0,5,0,0,0,0,0,,,
"Oct 5, 2021 12:00 AM",6,0,6,0,0,0,0,0,0,1,1,0,1,1,0,0,0,0,0,0,0,0,0,0,0,0,0,1,0,1,0,0,0,,,
"Oct 5, 2021 1:00 AM",5,2,3,0,0,0,0,0,0,0,0,0,0,0,0,0,0,0,0,0,0,0,0,0,0,0,0,0,0,0,0,0,0,,,
"Oct 5, 2021 2:00 AM",4,3,1,0,0,0,1,1,0,0,0,0,0,0,0,0,0,0,0,0,0,0,0,0,0,0,0,0,0,0,0,0,0,,,
"Oct 5, 2021 3:00 AM",1,0,1,0,0,0,0,0,0,0,0,0,0,0,0,0,0,0,0,0,0,0,0,0,0,0,0,0,0,0,0,0,0,,,
"Oct 5, 2021 4:00 AM",1,1,0,0,0,0,1,1,0,0,0,0,0,0,0,1,0,0,0,0,0,0,0,0,0,0,0,1,0,0,1,1,0,,,
"Oct 5, 2021 5:00 AM",10,6,4,0,0,0,4,3,1,3,2,1,0,0,0,2,8,8,0,0,0,0,7,0,0,0,0,7,0,1,0,0,0,,,
"Oct 5, 2021 6:00 AM",44,32,12,20,5,15,26,8,18,19,8,11,4,3,1,5,25,25,0,0,0,0,26,2,1,1,1,36,0,2,0,0,0,,,
"Oct 5, 2021 7:00 AM",120,82,38,65,27,38,102,31,71,80,28,52,10,10,0,15,76,76,0,0,0,0,77,21,5,16,3,98,7,9,6,6,0,,,
"Oct 5, 2021 8:00 AM",302,231,71,110,39,71,172,57,115,135,47,88,38,29,9,29,224,220,4,0,0,0,198,45,9,36,7,217,7,6,17,14,3,,,
"Oct 5, 2021 9:00 AM",170,141,29,70,24,46,97,46,51,75,39,36,20,11,9,7,102,100,2,0,0,0,86,16,5,11,6,69,3,0,7,4,3,,,
"Oct 5, 2021 10:00 AM",92,73,19,49,24,25,80,41,39,64,32,32,15,8,7,15,55,53,2,0,0,0,44,7,5,2,4,30,4,5,4,2,2,,,
"Oct 5, 2021 11:00 AM",92,55,37,60,39,21,70,37,33,54,31,23,11,5,6,6,46,44,2,0,0,0,34,14,11,3,6,36,1,5,3,1,2,,,
"Oct 5, 2021 12:00 PM",101,55,46,55,32,23,77,38,39,57,29,28,24,13,11,9,37,35,2,0,0,0,29,20,18,2,3,25,4,3,9,4,5,,,
"Oct 5, 2021 1:00 PM",105,41,64,58,34,24,76,32,44,66,33,33,12,5,7,7,40,37,3,0,0,0,29,14,11,3,3,35,3,3,5,4,1,,,
"Oct 5, 2021 2:00 PM",73,32,41,63,41,22,70,29,41,74,36,38,21,8,13,20,27,23,4,0,0,0,22,13,8,5,6,33,3,1,3,0,3,,,
"Oct 5, 2021 3:00 PM",100,26,74,41,22,19,76,52,24,42,23,19,16,3,13,15,40,34,6,0,0,0,34,19,11,8,10,34,2,0,8,4,4,,,
"Oct 5, 2021 4:00 PM",163,61,102,104,69,35,111,78,33,119,87,32,13,3,10,21,40,37,3,0,0,0,30,33,27,6,12,50,10,8,6,3,3,,,
"Oct 5, 2021 5:00 PM",271,65,206,79,49,30,122,71,51,83,47,36,18,6,12,30,62,51,11,0,0,0,53,23,16,7,12,71,7,5,7,4,3,,,
"Oct 5, 2021 6:00 PM",238,65,173,105,60,45,145,90,55,118,67,51,20,7,13,24,45,32,13,0,0,0,36,33,28,5,7,59,5,1,17,11,6,,,
"Oct 5, 2021 7:00 PM",134,36,98,62,41,21,76,43,33,57,36,21,21,7,14,18,28,22,6,0,0,0,19,16,15,1,7,40,3,0,8,5,3,,,
"Oct 5, 2021 8:00 PM",91,37,54,25,11,14,31,18,13,20,11,9,10,6,4,5,17,16,1,0,0,0,14,10,8,2,0,20,3,0,5,2,3,,,
"Oct 5, 2021 9:00 PM",47,13,34,6,2,4,16,11,5,10,7,3,0,0,0,5,4,4,0,0,0,0,2,5,3,2,0,10,2,1,2,1,1,,,
"Oct 5, 2021 10:00 PM",28,9,19,6,4,2,10,6,4,5,3,2,3,1,2,7,4,3,1,0,0,0,4,2,2,0,2,9,2,0,1,1,0,,,
"Oct 5, 2021 11:00 PM",21,4,17,1,0,1,3,1,2,1,0,1,5,0,5,2,2,1,1,0,0,0,2,0,0,0,0,5,0,0,0,0,0,,,
"Oct 6, 2021 12:00 AM",8,4,4,0,0,0,0,0,0,3,3,0,0,0,0,0,2,1,1,0,0,0,0,0,0,0,0,0,0,0,1,0,1,,,
"Oct 6, 2021 1:00 AM",4,1,3,2,2,0,1,1,0,1,1,0,1,0,1,0,1,1,0,0,0,0,1,0,0,0,0,0,0,0,0,0,0,,,
"Oct 6, 2021 2:00 AM",1,1,0,0,0,0,0,0,0,0,0,0,0,0,0,0,0,0,0,0,0,0,0,0,0,0,0,0,0,0,0,0,0,,,
"Oct 6, 2021 3:00 AM",1,1,0,0,0,0,0,0,0,0,0,0,0,0,0,0,0,0,0,0,0,0,0,0,0,0,0,1,0,0,0,0,0,,,
"Oct 6, 2021 4:00 AM",1,1,0,1,0,1,0,0,0,0,0,0,0,0,0,3,1,1,0,0,0,0,1,0,0,0,0,1,0,0,0,0,0,,,
"Oct 6, 2021 5:00 AM",9,6,3,4,4,0,8,7,1,11,8,3,0,0,0,4,3,3,0,0,0,0,5,2,2,0,0,7,0,1,0,0,0,,,
"Oct 6, 2021 6:00 AM",34,22,12,20,6,14,23,9,14,19,7,12,2,2,0,3,15,15,0,0,0,0,17,2,1,1,1,38,0,4,1,0,1,,,
"Oct 6, 2021 7:00 AM",120,81,39,78,34,44,97,31,66,66,31,35,13,11,2,18,72,72,0,0,0,0,79,19,11,8,9,89,5,6,5,4,1,,,
"Oct 6, 2021 8:00 AM",341,274,67,132,26,106,187,59,128,151,44,107,39,28,11,41,214,212,2,0,0,0,188,55,29,26,8,205,7,4,19,18,1,,,
"Oct 6, 2021 9:00 AM",191,158,33,83,35,48,109,47,62,89,55,34,15,6,9,9,105,105,0,0,0,0,92,22,12,10,9,79,0,1,8,5,3,,,
"Oct 6, 2021 10:00 AM",113,82,31,55,22,33,73,41,32,59,31,28,13,10,3,15,49,48,1,0,0,0,40,17,9,8,6,38,5,0,5,4,1,,,
"Oct 6, 2021 11:00 AM",87,48,39,69,31,38,88,43,45,59,25,34,12,4,8,11,35,35,0,0,0,0,30,18,12,6,6,33,3,3,1,1,0,,,
"Oct 6, 2021 12:00 PM",95,45,50,69,34,35,95,49,46,61,32,29,18,9,9,10,41,41,0,0,0,0,33,24,24,0,4,49,5,7,5,2,3,,,
"Oct 6, 2021 1:00 PM",106,51,55,77,48,29,107,60,47,83,48,35,23,13,10,15,45,39,6,0,0,0,27,30,30,0,6,49,7,5,3,2,1,,,
"Oct 6, 2021 2:00 PM",93,28,65,42,22,20,55,32,23,42,26,16,19,4,15,19,37,27,10,0,0,0,26,17,17,0,2,27,2,4,5,3,2,,,
"Oct 6, 2021 3:00 PM",105,36,69,30,18,12,43,26,17,29,18,11,9,4,5,11,38,30,8,0,0,0,23,11,11,0,11,35,0,1,6,3,3,,,
"Oct 6, 2021 4:00 PM",162,43,119,30,20,10,69,48,21,46,30,16,12,1,11,17,33,26,7,0,0,0,25,13,13,0,11,46,5,2,2,1,1,,,
"Oct 6, 2021 5:00 PM",236,59,177,82,68,14,107,67,40,74,49,25,15,4,11,30,36,34,2,0,0,0,34,25,25,0,8,69,4,3,11,7,4,,,
"Oct 6, 2021 6:00 PM",231,66,165,101,56,45,138,86,52,98,56,42,25,7,18,17,54,52,2,0,0,0,45,32,32,0,20,55,3,6,12,9,3,,,
"Oct 6, 2021 7:00 PM",125,40,85,53,42,11,77,52,25,59,40,19,12,7,5,13,32,25,7,0,0,0,22,18,13,5,1,36,4,5,9,4,5,,,
"Oct 6, 2021 8:00 PM",83,20,63,27,13,14,36,25,11,24,17,7,4,2,2,3,16,14,2,0,0,0,15,6,4,2,2,15,8,2,4,3,1,,,
"Oct 6, 2021 9:00 PM",51,12,39,18,7,11,22,11,11,19,8,11,4,1,3,5,5,5,0,0,0,0,4,8,6,2,1,8,4,3,4,4,0,,,
"Oct 6, 2021 10:00 PM",20,5,15,14,9,5,21,11,10,21,11,10,1,0,1,2,8,7,1,0,0,0,6,5,3,2,2,12,1,0,1,0,1,,,
"Oct 6, 2021 11:00 PM",9,3,6,3,2,1,8,5,3,2,1,1,0,0,0,4,1,0,1,0,0,0,0,4,2,2,0,3,0,1,0,0,0,,,
"Oct 7, 2021 12:00 AM",8,2,6,0,0,0,1,1,0,3,1,2,2,0,2,2,3,2,1,0,0,0,2,2,2,0,0,1,0,0,0,0,0,,,
"Oct 7, 2021 1:00 AM",5,1,4,1,1,0,4,1,3,0,0,0,0,0,0,0,1,0,1,0,0,0,1,0,0,0,0,1,0,0,0,0,0,,,
"Oct 7, 2021 2:00 AM",1,1,0,0,0,0,0,0,0,0,0,0,0,0,0,0,1,1,0,0,0,0,1,0,0,0,0,0,0,0,0,0,0,,,
"Oct 7, 2021 3:00 AM",1,0,1,0,0,0,0,0,0,0,0,0,0,0,0,0,0,0,0,0,0,0,0,0,0,0,0,1,0,0,0,0,0,,,
"Oct 7, 2021 4:00 AM",2,0,2,0,0,0,1,1,0,0,0,0,0,0,0,0,0,0,0,0,0,0,1,0,0,0,0,0,0,0,0,0,0,,,
"Oct 7, 2021 5:00 AM",6,4,2,2,1,1,2,1,1,2,1,1,0,0,0,2,7,7,0,0,0,0,6,1,1,0,0,8,0,1,1,1,0,,,
"Oct 7, 2021 6:00 AM",41,31,10,27,13,14,31,15,16,28,16,12,4,3,1,6,15,15,0,0,0,0,17,4,3,1,2,32,1,5,3,3,0,,,
"Oct 7, 2021 7:00 AM",109,77,32,71,29,42,97,34,63,66,22,44,8,8,0,15,66,66,0,0,0,0,66,19,8,11,6,99,4,5,4,2,2,,,
"Oct 7, 2021 8:00 AM",272,211,61,110,40,70,133,47,86,118,48,70,42,29,13,44,178,176,2,0,0,0,163,40,12,28,11,192,6,3,17,14,3,,,
"Oct 7, 2021 9:00 AM",177,141,36,62,17,45,99,48,51,69,40,29,13,7,6,15,95,93,2,0,0,0,81,19,4,15,8,60,2,2,4,4,0,,,
"Oct 7, 2021 10:00 AM",110,88,22,64,29,35,64,38,26,47,27,20,6,4,2,13,60,59,1,0,0,0,51,22,15,7,6,40,2,3,2,2,0,,,
"Oct 7, 2021 11:00 AM",80,41,39,49,25,24,75,36,39,45,28,17,7,6,1,8,40,40,0,0,0,0,33,18,11,7,5,33,3,5,2,1,1,,,
"Oct 7, 2021 12:00 PM",94,48,46,50,25,25,83,53,30,47,25,22,21,10,11,16,38,35,3,0,0,0,32,21,15,6,8,35,1,4,5,3,2,,,
"Oct 7, 2021 1:00 PM",92,36,56,72,42,30,128,69,59,60,34,26,17,6,11,19,41,37,4,0,0,0,30,21,11,10,8,40,7,8,5,4,1,,,
"Oct 7, 2021 2:00 PM",107,41,66,39,21,18,99,50,49,51,31,20,20,11,9,27,45,37,8,0,0,0,32,27,17,10,4,38,7,7,4,3,1,,,
"Oct 7, 2021 3:00 PM",110,44,66,51,30,21,98,52,46,63,35,28,14,6,8,22,49,41,8,0,0,0,35,28,20,8,7,55,2,3,3,2,1,,,
"Oct 7, 2021 4:00 PM",175,56,119,58,41,17,101,64,37,76,46,30,16,8,8,19,34,28,6,0,0,0,24,34,28,6,17,50,6,2,4,2,2,,,
"Oct 7, 2021 5:00 PM",206,57,149,98,60,38,144,88,56,116,67,49,34,11,23,26,54,50,4,0,0,0,45,31,24,7,15,63,5,4,8,6,2,,,
"Oct 7, 2021 6:00 PM",221,71,150,85,53,32,112,70,42,89,54,35,17,5,12,24,37,34,3,0,0,0,33,24,16,8,16,63,6,5,10,5,5,,,
"Oct 7, 2021 7:00 PM",131,40,91,46,30,16,75,42,33,62,35,27,13,0,13,11,20,19,1,0,0,0,16,14,12,2,5,40,2,2,9,5,4,,,
"Oct 7, 2021 8:00 PM",84,35,49,22,14,8,45,30,15,33,19,14,3,1,2,9,18,16,2,0,0,0,16,13,8,5,2,25,5,1,3,2,1,,,
"Oct 7, 2021 9:00 PM",60,15,45,12,8,4,28,18,10,18,11,7,2,2,0,8,13,13,0,0,0,0,16,12,8,4,4,13,2,0,5,4,1,,,
"Oct 7, 2021 10:00 PM",43,13,30,9,5,4,16,7,9,11,5,6,2,1,1,5,4,3,1,0,0,0,3,4,3,1,0,9,2,1,4,3,1,,,
"Oct 7, 2021 11:00 PM",19,5,14,7,2,5,12,4,8,12,5,7,3,1,2,4,2,2,0,0,0,0,1,2,2,0,0,3,0,1,0,0,0,,,
"Oct 8, 2021 12:00 AM",14,5,9,0,0,0,0,0,0,3,2,1,0,0,0,4,3,2,1,0,0,0,1,1,1,0,2,3,1,1,2,1,1,,,
"Oct 8, 2021 1:00 AM",9,3,6,0,0,0,0,0,0,0,0,0,0,0,0,0,2,2,0,0,0,0,2,0,0,0,0,2,0,0,1,0,1,,,
"Oct 8, 2021 2:00 AM",9,5,4,1,0,1,1,0,1,1,0,1,0,0,0,0,0,0,0,0,0,0,0,0,0,0,0,2,0,0,0,0,0,,,
"Oct 8, 2021 3:00 AM",4,2,2,0,0,0,1,1,0,0,0,0,0,0,0,1,0,0,0,0,0,0,0,0,0,0,0,1,0,0,0,0,0,,,
"Oct 8, 2021 4:00 AM",3,2,1,1,1,0,1,1,0,0,0,0,0,0,0,1,1,1,0,0,0,0,1,0,0,0,0,0,0,0,0,0,0,,,
"Oct 8, 2021 5:00 AM",6,4,2,1,1,0,3,3,0,2,1,1,0,0,0,1,6,6,0,0,0,0,5,1,1,0,0,7,0,0,1,1,0,,,
"Oct 8, 2021 6:00 AM",25,16,9,13,7,6,20,11,9,22,11,11,2,2,0,1,10,10,0,0,0,0,10,7,6,1,0,30,1,2,0,0,0,,,
"Oct 8, 2021 7:00 AM",80,48,32,57,29,28,55,20,35,47,23,24,13,11,2,7,59,59,0,0,0,0,54,14,6,8,2,64,4,4,3,3,0,,,
"Oct 8, 2021 8:00 AM",218,158,60,96,28,68,138,47,91,126,50,76,29,23,6,32,135,132,3,0,0,0,125,29,9,20,11,136,5,2,12,10,2,,,
"Oct 8, 2021 9:00 AM",145,114,31,58,20,38,81,42,39,72,42,30,14,5,9,17,85,85,0,0,0,0,74,13,7,6,6,64,2,4,3,2,1,,,
"Oct 8, 2021 10:00 AM",85,57,28,53,22,31,59,33,26,46,25,21,8,2,6,8,53,53,0,0,0,0,42,11,5,6,6,30,4,6,2,1,1,,,
"Oct 8, 2021 11:00 AM",70,43,27,45,22,23,67,39,28,54,27,27,3,2,1,4,34,33,1,0,0,0,31,8,5,3,3,34,2,1,1,0,1,,,
"Oct 8, 2021 12:00 PM",76,33,43,73,26,47,97,47,50,52,20,32,19,8,11,11,31,28,3,0,0,0,22,19,10,9,8,32,3,4,6,4,2,,,
"Oct 8, 2021 1:00 PM",124,54,70,55,28,27,127,65,62,61,26,35,11,4,7,11,40,37,3,0,0,0,33,28,11,17,10,41,6,1,8,1,7,,,
"Oct 8, 2021 2:00 PM",107,46,61,58,29,29,97,55,42,63,43,20,12,7,5,20,31,27,4,0,0,0,28,21,12,9,12,29,6,1,10,3,7,,,
"Oct 8, 2021 3:00 PM",104,38,66,64,33,31,85,45,40,54,35,19,15,5,10,19,41,34,7,0,0,0,32,29,21,8,12,46,5,3,7,5,2,,,
"Oct 8, 2021 4:00 PM",145,50,95,82,48,34,113,71,42,86,53,33,17,6,11,20,29,28,1,0,0,0,30,37,29,8,12,59,3,5,11,9,2,,,
"Oct 8, 2021 5:00 PM",169,46,123,106,65,41,111,66,45,94,52,42,19,7,12,25,39,38,1,0,0,0,41,26,16,10,8,50,4,11,5,2,3,,,
"Oct 8, 2021 6:00 PM",131,39,92,91,58,33,107,58,49,104,54,50,14,4,10,19,22,21,1,0,0,0,24,15,12,3,6,53,6,4,5,4,1,,,
"Oct 8, 2021 7:00 PM",97,30,67,56,27,29,59,36,23,48,24,24,17,4,13,10,22,14,8,0,0,0,16,9,7,2,7,48,3,4,5,4,1,,,
"Oct 8, 2021 8:00 PM",54,14,40,22,8,14,38,21,17,32,17,15,5,3,2,9,12,9,3,0,0,0,11,8,5,3,1,16,5,2,3,2,1,,,
"Oct 8, 2021 9:00 PM",35,11,24,9,6,3,22,10,12,16,8,8,3,3,0,8,8,7,1,0,0,0,6,6,4,2,1,19,0,1,1,1,0,,,
"Oct 8, 2021 10:00 PM",24,4,20,10,7,3,4,1,3,7,3,4,5,1,4,3,5,2,3,0,0,0,3,1,1,0,2,11,1,1,3,1,2,,,
"Oct 8, 2021 11:00 PM",21,8,13,6,3,3,13,4,9,14,6,8,6,3,3,1,3,3,0,0,0,0,5,6,5,1,0,4,1,2,1,1,0,,,
"Oct 9, 2021 12:00 AM",16,6,10,0,0,0,3,0,3,4,1,3,2,2,0,2,9,7,2,0,0,0,5,2,2,0,4,7,0,0,1,1,0,,,
"Oct 9, 2021 1:00 AM",8,1,7,1,1,0,6,3,3,3,2,1,1,0,1,0,2,2,0,0,0,0,2,2,2,0,1,4,0,1,0,0,0,,,
"Oct 9, 2021 2:00 AM",7,4,3,0,0,0,2,2,0,1,1,0,1,1,0,2,0,0,0,0,0,0,0,0,0,0,2,0,0,0,0,0,0,,,
"Oct 9, 2021 3:00 AM",1,0,1,0,0,0,1,1,0,0,0,0,0,0,0,0,0,0,0,0,0,0,1,0,0,0,0,0,0,0,0,0,0,,,
"Oct 9, 2021 4:00 AM",5,2,3,0,0,0,1,1,0,1,0,1,0,0,0,4,0,0,0,0,0,0,0,0,0,0,0,0,0,0,0,0,0,,,
"Oct 9, 2021 5:00 AM",5,1,4,0,0,0,1,0,1,1,0,1,0,0,0,1,1,1,0,0,0,0,1,0,0,0,0,3,0,0,0,0,0,,,
"Oct 9, 2021 6:00 AM",9,3,6,3,1,2,3,2,1,4,2,2,0,0,0,1,5,5,0,0,0,0,5,0,0,0,0,6,0,1,0,0,0,,,
"Oct 9, 2021 7:00 AM",12,3,9,3,2,1,9,6,3,7,6,1,0,0,0,1,10,10,0,0,0,0,10,2,1,1,0,6,1,1,1,0,1,,,
"Oct 9, 2021 8:00 AM",18,9,9,11,6,5,14,10,4,13,10,3,5,2,3,8,7,7,0,0,0,0,5,1,1,0,0,15,0,0,3,1,2,,,
"Oct 9, 2021 9:00 AM",36,26,10,25,16,9,31,21,10,34,26,8,5,3,2,7,20,20,0,0,0,0,20,6,5,1,3,12,1,1,2,2,0,,,
"Oct 9, 2021 10:00 AM",52,30,22,55,39,16,49,36,13,44,37,7,12,6,6,12,13,13,0,0,0,0,11,12,11,1,2,20,0,5,2,2,0,,,
"Oct 9, 2021 11:00 AM",50,28,22,76,36,40,84,52,32,68,33,35,18,7,11,8,32,31,1,0,0,0,28,20,16,4,4,30,4,5,2,1,1,,,
"Oct 9, 2021 12:00 PM",71,45,26,109,46,63,120,58,62,111,60,51,16,14,2,23,35,34,1,0,0,0,33,31,11,20,4,44,2,2,3,2,1,,,
"Oct 9, 2021 1:00 PM",65,28,37,91,41,50,113,60,53,77,42,35,14,10,4,19,25,24,1,0,0,0,23,16,8,8,3,25,2,3,5,3,2,,,
"Oct 9, 2021 2:00 PM",66,33,33,98,49,49,130,65,65,85,44,41,29,10,19,11,31,30,1,0,0,0,26,28,15,13,8,48,12,8,3,1,2,,,
"Oct 9, 2021 3:00 PM",77,30,47,101,53,48,167,87,80,97,45,52,26,12,14,19,19,18,1,0,0,0,18,41,27,14,9,28,5,5,9,5,4,,,
"Oct 9, 2021 4:00 PM",82,39,43,136,74,62,183,88,95,115,81,34,28,14,14,18,25,23,2,0,0,0,19,53,30,23,13,45,11,4,11,5,6,,,
"Oct 9, 2021 5:00 PM",76,29,47,155,84,71,139,54,85,126,51,75,23,6,17,19,23,20,3,0,0,0,19,34,18,16,6,48,8,2,11,6,5,,,
"Oct 9, 2021 6:00 PM",52,22,30,83,34,49,79,35,44,73,30,43,24,11,13,13,14,12,2,0,0,0,12,31,15,16,2,34,1,0,6,5,1,,,
"Oct 9, 2021 7:00 PM",57,35,22,39,21,18,55,19,36,35,13,22,6,4,2,6,10,10,0,0,0,0,11,11,5,6,1,41,1,2,2,1,1,,,
"Oct 9, 2021 8:00 PM",30,16,14,13,8,5,34,14,20,21,8,13,6,5,1,2,14,10,4,0,0,0,6,15,8,7,0,10,0,0,2,0,2,,,
"Oct 9, 2021 9:00 PM",20,5,15,10,8,2,11,4,7,15,5,10,2,1,1,4,6,6,0,0,0,0,6,2,1,1,0,18,0,1,2,1,1,,,
"Oct 9, 2021 10:00 PM",17,6,11,13,4,9,6,3,3,6,4,2,5,4,1,1,5,5,0,0,0,0,4,3,2,1,0,6,0,1,1,0,1,,,
"Oct 9, 2021 11:00 PM",14,4,10,9,6,3,15,4,11,15,2,13,3,1,2,3,2,2,0,0,0,0,3,0,0,0,1,2,0,0,2,1,1,,,
"Oct 10, 2021 12:00 AM",13,3,10,0,0,0,5,1,4,7,2,5,5,2,3,1,6,6,0,0,0,0,8,3,2,1,0,18,0,1,0,0,0,,,
"Oct 10, 2021 1:00 AM",10,1,9,6,4,2,7,4,3,3,2,1,3,2,1,4,2,1,1,0,0,0,2,0,0,0,1,5,0,0,0,0,0,,,
"Oct 10, 2021 2:00 AM",2,2,0,1,1,0,3,2,1,0,0,0,0,0,0,0,1,1,0,0,0,0,2,0,0,0,0,0,0,0,0,0,0,,,
"Oct 10, 2021 3:00 AM",1,0,1,0,0,0,0,0,0,0,0,0,1,1,0,0,0,0,0,0,0,0,1,0,0,0,0,2,0,0,0,0,0,,,
"Oct 10, 2021 4:00 AM",1,0,1,0,0,0,0,0,0,0,0,0,0,0,0,0,0,0,0,0,0,0,0,0,0,0,0,1,0,0,0,0,0,,,
"Oct 10, 2021 5:00 AM",1,0,1,0,0,0,2,0,2,1,0,1,0,0,0,2,2,2,0,0,0,0,1,0,0,0,1,5,0,0,1,1,0,,,
"Oct 10, 2021 6:00 AM",8,6,2,5,2,3,10,7,3,6,3,3,0,0,0,5,2,2,0,0,0,0,3,2,2,0,2,6,0,1,2,2,0,,,
"Oct 10, 2021 7:00 AM",18,10,8,17,9,8,15,9,6,17,12,5,1,1,0,2,10,10,0,0,0,0,8,3,3,0,0,12,0,1,1,0,1,,,
"Oct 10, 2021 8:00 AM",46,23,23,95,61,34,76,54,22,76,56,20,1,1,0,8,14,14,0,0,0,0,18,9,6,3,3,19,2,11,2,1,1,,,
"Oct 10, 2021 9:00 AM",55,22,33,158,103,55,148,109,39,128,95,33,16,12,4,8,16,16,0,0,0,0,15,24,15,9,7,44,3,12,3,3,0,,,
"Oct 10, 2021 10:00 AM",57,37,20,191,81,110,194,107,87,179,85,94,10,6,4,9,31,31,0,0,0,0,28,23,17,6,13,70,8,8,4,0,4,,,
"Oct 10, 2021 11:00 AM",81,40,41,224,113,111,211,112,99,171,97,74,34,17,17,25,27,25,2,0,0,0,20,37,29,8,5,66,11,6,10,5,5,,,
"Oct 10, 2021 12:00 PM",91,57,34,249,108,141,230,112,118,205,106,99,35,18,17,20,34,33,1,0,0,0,33,69,41,28,16,67,12,9,6,4,2,,,
"Oct 10, 2021 1:00 PM",83,41,42,197,113,84,220,121,99,180,91,89,46,20,26,17,31,30,1,0,0,0,26,49,29,20,20,65,15,8,15,10,5,,,
"Oct 10, 2021 2:00 PM",81,43,38,206,112,94,236,127,109,178,96,82,40,19,21,35,13,12,1,0,0,0,11,86,44,42,18,60,11,2,9,5,4,,,
"Oct 10, 2021 3:00 PM",67,40,27,211,103,108,254,129,125,166,79,87,26,11,15,14,16,15,1,0,0,0,15,58,34,24,14,58,6,5,4,1,3,,,
"Oct 10, 2021 4:00 PM",70,33,37,167,83,84,210,92,118,141,69,72,24,8,16,19,13,13,0,0,0,0,12,51,21,30,14,50,3,2,4,4,0,,,
"Oct 10, 2021 5:00 PM",70,32,38,120,46,74,151,51,100,98,29,69,30,15,15,22,16,16,0,0,0,0,19,35,10,25,6,70,9,8,5,5,0,,,
"Oct 10, 2021 6:00 PM",61,26,35,51,26,25,86,28,58,52,18,34,10,3,7,12,12,11,1,0,0,0,10,28,10,18,2,33,2,1,3,3,0,,,
"Oct 10, 2021 7:00 PM",38,18,20,41,17,24,39,13,26,21,10,11,10,4,6,14,15,15,0,0,0,0,15,5,2,3,3,25,5,1,5,2,3,,,
"Oct 10, 2021 8:00 PM",26,9,17,12,6,6,17,5,12,13,3,10,0,0,0,5,10,9,1,0,0,0,9,5,3,2,0,14,1,0,4,2,2,,,
"Oct 10, 2021 9:00 PM",19,4,15,9,4,5,15,5,10,12,5,7,2,2,0,5,3,3,0,0,0,0,3,5,4,1,0,9,0,1,1,1,0,,,
"Oct 10, 2021 10:00 PM",9,5,4,2,2,0,8,2,6,3,1,2,8,2,6,1,2,2,0,0,0,0,2,0,0,0,0,10,0,1,0,0,0,,,
"Oct 10, 2021 11:00 PM",9,3,6,0,0,0,7,2,5,3,0,3,0,0,0,1,0,0,0,0,0,0,0,1,1,0,0,6,1,0,2,0,2,,,
"Oct 11, 2021 12:00 AM",7,0,7,0,0,0,0,0,0,0,0,0,0,0,0,3,2,2,0,0,0,0,1,0,0,0,0,2,0,0,0,0,0,,,
"Oct 11, 2021 1:00 AM",4,1,3,0,0,0,1,1,0,1,0,1,0,0,0,0,0,0,0,0,0,0,0,0,0,0,0,2,0,0,0,0,0,,,
"Oct 11, 2021 2:00 AM",2,2,0,0,0,0,1,0,1,0,0,0,0,0,0,1,0,0,0,0,0,0,0,0,0,0,0,2,0,0,0,0,0,,,
"Oct 11, 2021 3:00 AM",1,0,1,0,0,0,0,0,0,0,0,0,0,0,0,0,0,0,0,0,0,0,0,0,0,0,0,1,0,0,0,0,0,,,
"Oct 11, 2021 4:00 AM",2,0,2,0,0,0,0,0,0,0,0,0,0,0,0,1,0,0,0,0,0,0,0,0,0,0,0,0,1,0,0,0,0,,,
"Oct 11, 2021 5:00 AM",10,8,2,0,0,0,2,1,1,1,0,1,0,0,0,4,6,6,0,0,0,0,6,0,0,0,0,12,0,0,0,0,0,,,
"Oct 11, 2021 6:00 AM",37,22,15,14,7,7,19,8,11,16,8,8,5,4,1,3,14,14,0,0,0,0,13,3,3,0,1,33,1,1,2,2,0,,,
"Oct 11, 2021 7:00 AM",120,82,38,66,22,44,77,28,49,66,26,40,9,7,2,12,90,90,0,0,0,0,90,12,12,0,7,97,3,5,4,4,0,,,
"Oct 11, 2021 8:00 AM",306,240,66,105,22,83,159,37,122,109,33,76,37,24,13,40,214,211,3,0,0,0,183,53,53,0,23,216,8,2,23,21,2,,,
"Oct 11, 2021 9:00 AM",173,143,30,69,28,41,92,42,50,79,42,37,12,10,2,8,87,86,1,0,0,0,72,11,11,0,9,71,2,5,6,5,1,,,
"Oct 11, 2021 10:00 AM",109,82,27,53,23,30,47,25,22,44,22,22,8,7,1,11,59,57,2,0,0,0,43,12,12,0,5,40,4,2,3,1,2,,,
"Oct 11, 2021 11:00 AM",72,40,32,62,32,30,58,25,33,54,27,27,10,4,6,12,37,34,3,0,0,0,28,3,3,0,5,30,2,4,0,0,0,,,
"Oct 11, 2021 12:00 PM",77,34,43,65,30,35,79,46,33,70,37,33,15,4,11,8,38,36,2,0,0,0,28,14,14,0,8,35,6,2,3,3,0,,,
"Oct 11, 2021 1:00 PM",115,58,57,84,39,45,108,59,49,68,32,36,18,6,12,16,30,25,5,0,0,0,23,14,14,0,12,35,4,3,5,1,4,,,
"Oct 11, 2021 2:00 PM",92,41,51,71,44,27,104,61,43,62,45,17,14,9,5,12,27,22,5,0,0,0,21,19,19,0,10,38,1,3,6,5,1,,,
"Oct 11, 2021 3:00 PM",127,44,83,73,51,22,136,81,55,73,49,24,20,6,14,21,38,32,6,0,0,0,29,23,23,0,10,34,4,7,4,2,2,,,
"Oct 11, 2021 4:00 PM",183,63,120,89,52,37,134,81,53,88,48,40,23,4,19,20,29,25,4,0,0,0,20,38,38,0,10,57,4,4,10,5,5,,,
"Oct 11, 2021 5:00 PM",215,46,169,111,69,42,165,101,64,115,73,42,28,8,20,25,53,45,8,0,0,0,43,35,35,0,12,77,5,5,10,4,6,,,
"Oct 11, 2021 6:00 PM",221,60,161,115,61,54,193,109,84,119,64,55,13,6,7,25,57,49,8,0,0,0,48,37,32,5,10,64,4,6,,,,,,
"Oct 11, 2021 7:00 PM",114,42,72,52,33,19,81,42,39,48,28,20,12,2,10,13,25,17,8,0,0,0,19,19,7,12,9,55,3,5,11,7,4,,,
"Oct 11, 2021 8:00 PM",83,19,64,19,8,11,23,12,11,23,13,10,3,2,1,11,20,20,0,0,0,0,16,4,3,1,2,22,4,3,5,2,3,,,
"Oct 11, 2021 9:00 PM",54,9,45,6,5,1,22,9,13,10,5,5,2,2,0,4,6,5,1,0,0,0,6,6,4,2,2,21,4,2,3,2,1,,,
"Oct 11, 2021 10:00 PM",40,6,34,4,2,2,4,2,2,4,1,3,1,1,0,6,5,5,0,0,0,0,4,1,1,0,0,6,1,0,2,1,1,,,
"Oct 11, 2021 11:00 PM",11,5,6,2,2,0,3,2,1,1,1,0,2,1,1,2,2,2,0,0,0,0,1,0,0,0,3,2,0,0,0,0,0,,,
"Oct 12, 2021 12:00 AM",6,0,6,0,0,0,1,1,0,2,2,0,1,0,1,1,2,2,0,0,0,0,1,1,1,0,0,3,0,0,0,0,0,,,
"Oct 12, 2021 1:00 AM",3,1,2,0,0,0,0,0,0,0,0,0,2,0,2,0,3,3,0,0,0,0,3,0,0,0,0,0,0,0,0,0,0,,,
"Oct 12, 2021 2:00 AM",7,4,3,0,0,0,1,0,1,0,0,0,0,0,0,1,0,0,0,0,0,0,0,0,0,0,0,0,0,0,0,0,0,,,
"Oct 12, 2021 3:00 AM",0,0,0,1,0,1,0,0,0,0,0,0,2,0,2,0,0,0,0,0,0,0,0,1,0,1,0,0,0,0,0,0,0,,,
"Oct 12, 2021 4:00 AM",2,0,2,0,0,0,0,0,0,1,0,1,0,0,0,3,0,0,0,0,0,0,0,0,0,0,0,0,0,0,1,1,0,,,
"Oct 12, 2021 5:00 AM",10,6,4,0,0,0,7,5,2,5,4,1,0,0,0,3,7,7,0,0,0,0,7,1,1,0,0,14,0,0,0,0,0,,,
"Oct 12, 2021 6:00 AM",42,28,14,27,12,15,31,14,17,24,10,14,4,4,0,5,19,19,0,0,0,0,19,5,2,3,4,42,0,3,4,4,0,,,
"Oct 12, 2021 7:00 AM",124,85,39,67,25,42,99,30,69,72,26,46,10,10,0,18,78,77,1,0,0,0,81,22,10,12,8,111,5,9,5,4,1,,,
"Oct 12, 2021 8:00 AM",312,241,71,139,37,102,192,52,140,158,51,107,27,21,6,49,219,212,7,0,0,0,199,52,10,42,9,227,12,10,19,17,2,,,
"Oct 12, 2021 9:00 AM",166,133,33,75,31,44,101,53,48,92,51,41,21,13,8,7,99,98,1,0,0,0,83,24,12,12,4,84,1,5,8,7,1,,,
"Oct 12, 2021 10:00 AM",123,91,32,64,34,30,48,30,18,51,31,20,14,7,7,16,67,64,3,0,0,0,48,9,3,6,3,41,3,2,1,1,0,,,
"Oct 12, 2021 11:00 AM",82,55,27,59,24,35,63,31,32,57,34,23,18,10,8,9,58,52,6,0,0,0,44,12,7,5,6,32,4,2,2,1,1,,,
"Oct 12, 2021 12:00 PM",80,47,33,60,29,31,81,25,56,59,23,36,15,8,7,5,33,30,3,0,0,0,28,4,3,1,15,45,3,2,4,3,1,,,
"Oct 12, 2021 1:00 PM",111,44,67,62,35,27,70,38,32,54,24,30,11,4,7,20,44,37,7,0,0,0,32,18,10,8,22,44,5,1,6,3,3,,,
"Oct 12, 2021 2:00 PM",101,40,61,49,32,17,75,46,29,51,33,18,13,5,8,17,18,13,5,0,0,0,18,19,14,5,29,31,3,3,7,6,1,,,
"Oct 12, 2021 3:00 PM",104,39,65,60,32,28,88,60,28,61,37,24,14,5,9,14,42,37,5,0,0,0,34,34,24,10,30,39,4,1,8,4,4,,,
"Oct 12, 2021 4:00 PM",188,57,131,62,45,17,118,78,40,77,50,27,19,6,13,22,44,39,5,0,0,0,35,33,26,7,45,56,6,2,6,3,3,,,
"Oct 12, 2021 5:00 PM",245,63,182,91,64,27,154,97,57,101,62,39,32,6,26,29,51,41,10,0,0,0,42,24,18,6,75,66,3,5,9,7,2,,,
"Oct 12, 2021 6:00 PM",225,62,163,101,71,30,147,90,57,102,66,36,13,6,7,17,49,41,8,0,0,0,38,40,24,16,63,63,7,2,12,7,5,,,
"Oct 12, 2021 7:00 PM",159,49,110,45,28,17,86,44,42,50,30,20,8,0,8,20,22,21,1,0,0,0,20,13,8,5,39,39,6,3,6,4,2,,,
"Oct 12, 2021 8:00 PM",97,24,73,18,12,6,37,24,13,21,10,11,5,4,1,5,16,13,3,0,0,0,12,4,3,1,17,19,1,2,4,3,1,,,
"Oct 12, 2021 9:00 PM",62,18,44,11,5,6,14,6,8,11,4,7,0,0,0,4,13,12,1,0,0,0,11,9,5,4,11,26,3,1,2,2,0,,,
"Oct 12, 2021 10:00 PM",40,5,35,5,3,2,8,5,3,6,3,3,2,1,1,6,4,3,1,0,0,0,3,5,3,2,7,6,0,0,3,1,2,,,
"Oct 12, 2021 11:00 PM",13,4,9,4,3,1,6,3,3,5,2,3,0,0,0,5,2,2,0,0,0,0,2,1,1,0,5,8,1,1,2,1,1,,,
"Oct 13, 2021 12:00 AM",11,5,6,1,1,0,0,0,0,2,1,1,0,0,0,0,0,0,0,0,0,0,0,1,1,0,1,2,0,1,0,0,0,,,
"Oct 13, 2021 1:00 AM",4,1,3,1,1,0,2,1,1,1,1,0,0,0,0,0,2,2,0,0,0,0,3,0,0,0,1,1,0,0,0,0,0,,,
"Oct 13, 2021 2:00 AM",6,5,1,0,0,0,0,0,0,0,0,0,0,0,0,0,2,1,1,0,0,0,1,0,0,0,0,0,0,0,0,0,0,,,
"Oct 13, 2021 3:00 AM",2,1,1,0,0,0,0,0,0,0,0,0,0,0,0,0,0,0,0,0,0,0,1,0,0,0,1,0,0,0,0,0,0,,,
"Oct 13, 2021 4:00 AM",2,2,0,0,0,0,0,0,0,0,0,0,0,0,0,3,0,0,0,0,0,0,0,0,0,0,0,0,0,0,1,1,0,,,
"Oct 13, 2021 5:00 AM",6,4,2,2,1,1,9,2,7,4,2,2,0,0,0,2,5,5,0,0,0,0,5,0,0,0,2,13,0,0,0,0,0,,,
"Oct 13, 2021 6:00 AM",51,32,19,18,7,11,21,9,12,16,7,9,6,6,0,2,15,15,0,0,0,0,15,5,2,3,15,37,1,3,1,1,0,,,
"Oct 13, 2021 7:00 AM",129,85,44,63,21,42,98,33,65,52,19,33,12,11,1,17,88,88,0,0,0,0,94,26,14,12,26,119,3,3,5,4,1,,,
"Oct 13, 2021 8:00 AM",332,242,90,129,40,89,214,69,145,140,47,93,51,37,14,39,216,215,1,0,0,0,200,42,22,20,25,227,13,5,17,15,2,,,
"Oct 13, 2021 9:00 AM",196,168,28,83,28,55,104,45,59,93,51,42,13,10,3,7,110,109,1,0,0,0,85,19,10,9,18,109,1,5,5,1,4,,,
"Oct 13, 2021 10:00 AM",107,73,34,39,18,21,63,31,32,47,20,27,9,6,3,9,54,54,0,0,0,0,48,9,6,3,20,39,3,3,5,5,0,,,
"Oct 13, 2021 11:00 AM",100,52,48,53,27,26,55,34,21,59,32,27,5,3,2,12,46,46,0,0,0,0,38,6,4,2,20,34,1,5,2,2,0,,,
"Oct 13, 2021 12:00 PM",91,43,48,66,33,33,67,33,34,51,21,30,21,8,13,10,51,45,6,0,0,0,38,15,8,7,16,37,2,6,3,3,0,,,
"Oct 13, 2021 1:00 PM",117,55,62,73,43,30,89,51,38,69,45,24,28,11,17,16,34,31,3,0,0,0,28,22,13,9,27,46,4,2,6,2,4,,,
"Oct 13, 2021 2:00 PM",86,41,45,59,34,25,58,35,23,58,40,18,15,6,9,26,38,32,6,0,0,0,27,16,9,7,25,33,2,2,7,3,4,,,
"Oct 13, 2021 3:00 PM",124,50,74,36,25,11,62,38,24,40,25,15,13,3,10,13,42,37,5,0,0,0,26,15,9,6,41,34,3,0,9,5,4,,,
"Oct 13, 2021 4:00 PM",173,54,119,57,34,23,79,46,33,54,34,20,21,11,10,23,32,25,7,0,0,0,24,21,12,9,34,54,7,2,4,4,0,,,
"Oct 13, 2021 5:00 PM",271,70,201,87,59,28,137,76,61,87,45,42,21,5,16,27,48,43,5,0,0,0,43,31,16,15,83,72,4,5,15,10,5,,,
"Oct 13, 2021 6:00 PM",225,56,169,87,59,28,157,102,55,95,61,34,19,10,9,19,42,35,7,0,0,0,34,20,11,9,74,62,9,8,19,13,6,,,
"Oct 13, 2021 7:00 PM",108,31,77,49,37,12,72,50,22,45,36,9,13,1,12,10,30,26,4,0,0,0,25,16,9,7,38,39,7,2,8,3,5,,,
"Oct 13, 2021 8:00 PM",73,23,50,16,10,6,36,20,16,25,14,11,10,7,3,7,17,12,5,0,0,0,11,2,2,0,19,19,2,5,4,4,0,,,
"Oct 13, 2021 9:00 PM",58,20,38,8,4,4,19,10,9,14,4,10,2,1,1,5,18,17,1,0,0,0,15,3,2,1,9,19,6,2,6,3,3,,,
"Oct 13, 2021 10:00 PM",34,6,28,7,5,2,11,6,5,9,4,5,3,2,1,6,7,4,3,0,0,0,5,0,0,0,10,10,4,1,2,1,1,,,
"Oct 13, 2021 11:00 PM",21,3,18,5,4,1,9,6,3,4,2,2,3,0,3,3,5,4,1,0,0,0,4,2,1,1,1,5,0,0,0,0,0,,,
"Oct 14, 2021 12:00 AM",10,7,3,0,0,0,0,0,0,1,1,0,0,0,0,2,1,1,0,0,0,0,1,0,0,0,0,2,0,0,3,2,1,,,
"Oct 14, 2021 1:00 AM",1,0,1,0,0,0,1,1,0,0,0,0,0,0,0,0,0,0,0,0,0,0,0,0,0,0,0,2,0,0,0,0,0,,,
"Oct 14, 2021 2:00 AM",6,6,0,0,0,0,0,0,0,0,0,0,0,0,0,0,1,0,1,0,0,0,1,0,0,0,1,0,0,0,0,0,0,,,
"Oct 14, 2021 3:00 AM",0,0,0,0,0,0,0,0,0,0,0,0,0,0,0,0,0,0,0,0,0,0,0,0,0,0,0,0,0,0,0,0,0,,,
"Oct 14, 2021 4:00 AM",2,1,1,0,0,0,2,2,0,1,0,1,0,0,0,2,1,1,0,0,0,0,0,0,0,0,2,2,0,0,0,0,0,,,
"Oct 14, 2021 5:00 AM",8,7,1,1,1,0,5,3,2,4,3,1,0,0,0,3,6,6,0,0,0,0,6,2,1,1,1,13,0,0,0,0,0,,,
"Oct 14, 2021 6:00 AM",42,32,10,27,11,16,24,14,10,27,15,12,7,6,1,5,18,18,0,0,0,0,20,2,1,1,19,27,2,4,1,1,0,,,
"Oct 14, 2021 7:00 AM",112,75,37,57,18,39,99,30,69,59,20,39,10,8,2,14,76,76,0,0,0,0,77,26,14,12,37,103,7,3,5,4,1,,,
"Oct 14, 2021 8:00 AM",297,219,78,125,39,86,194,66,128,142,57,85,46,36,10,42,181,175,6,0,0,0,166,60,30,30,39,219,14,6,18,17,1,,,
"Oct 14, 2021 9:00 AM",164,131,33,67,25,42,104,45,59,75,40,35,15,11,4,18,103,103,0,0,0,0,78,21,11,10,23,74,3,2,4,4,0,,,
"Oct 14, 2021 10:00 AM",110,81,29,49,22,27,55,31,24,41,23,18,15,9,6,11,58,55,3,0,0,0,48,18,10,8,19,39,1,6,5,3,2,,,
"Oct 14, 2021 11:00 AM",80,55,25,44,20,24,67,31,36,47,20,27,20,13,7,7,40,35,5,0,0,0,29,9,5,4,29,37,4,2,3,2,1,,,
"Oct 14, 2021 12:00 PM",97,56,41,48,30,18,61,42,19,43,27,16,23,4,19,22,45,42,3,0,0,0,38,14,7,7,30,35,1,3,3,3,0,,,
"Oct 14, 2021 1:00 PM",96,43,53,71,39,32,66,34,32,53,32,21,20,10,10,11,31,29,2,0,0,0,27,15,8,7,27,36,13,4,9,5,4,,,
"Oct 14, 2021 2:00 PM",100,43,57,59,35,24,48,31,17,51,26,25,39,17,22,16,39,35,4,0,0,0,28,8,5,3,27,28,3,6,8,5,3,,,
"Oct 14, 2021 3:00 PM",123,43,80,43,23,20,55,34,21,52,33,19,19,5,14,21,46,41,5,0,0,0,32,20,10,10,34,39,2,2,8,5,3,,,
"Oct 14, 2021 4:00 PM",183,55,128,61,42,19,93,67,26,64,46,18,16,6,10,20,31,25,6,0,0,0,26,27,14,13,61,49,7,6,8,5,3,,,
"Oct 14, 2021 5:00 PM",245,65,180,61,37,24,130,72,58,86,48,38,24,7,17,38,48,38,10,0,0,0,33,25,13,12,88,66,5,8,13,10,3,,,
"Oct 14, 2021 6:00 PM",206,57,149,89,57,32,115,75,40,81,55,26,19,7,12,17,49,40,9,0,0,0,40,22,13,9,84,55,6,1,13,9,4,,,
"Oct 14, 2021 7:00 PM",147,42,105,50,39,11,67,49,18,52,38,14,9,1,8,15,26,22,4,0,0,0,22,14,8,6,43,32,7,3,8,8,0,,,
"Oct 14, 2021 8:00 PM",83,23,60,31,17,14,41,21,20,34,18,16,7,4,3,7,17,17,0,0,0,0,15,10,6,4,23,22,2,1,5,2,3,,,
"Oct 14, 2021 9:00 PM",71,14,57,5,3,2,17,6,11,14,4,10,5,2,3,9,13,9,4,0,0,0,10,3,3,0,13,18,4,1,2,1,1,,,
"Oct 14, 2021 10:00 PM",37,13,24,11,8,3,14,9,5,11,5,6,3,3,0,4,5,5,0,0,0,0,6,6,3,3,8,11,1,2,0,0,0,,,
"Oct 14, 2021 11:00 PM",23,4,19,3,2,1,9,5,4,6,2,4,0,0,0,4,8,6,2,0,0,0,7,4,2,2,8,5,1,0,1,0,1,,,
"Oct 15, 2021 12:00 AM",12,3,9,0,0,0,1,1,0,2,1,1,1,1,0,4,1,1,0,0,0,0,2,1,1,0,3,1,0,0,0,0,0,,,
"Oct 15, 2021 1:00 AM",5,2,3,1,0,1,0,0,0,0,0,0,0,0,0,4,1,0,1,0,0,0,0,1,1,0,2,1,1,0,0,0,0,,,
"Oct 15, 2021 2:00 AM",10,5,5,0,0,0,0,0,0,0,0,0,0,0,0,0,0,0,0,0,0,0,0,0,0,0,0,0,0,0,0,0,0,,,
"Oct 15, 2021 3:00 AM",0,0,0,0,0,0,1,1,0,0,0,0,1,0,1,0,0,0,0,0,0,0,0,0,0,0,1,0,0,0,0,0,0,,,
"Oct 15, 2021 4:00 AM",1,1,0,0,0,0,0,0,0,0,0,0,0,0,0,1,2,2,0,0,0,0,2,0,0,0,0,0,0,0,0,0,0,,,
"Oct 15, 2021 5:00 AM",7,5,2,1,1,0,2,2,0,1,1,0,0,0,0,4,9,9,0,0,0,0,7,1,1,0,2,6,0,0,0,0,0,,,
"Oct 15, 2021 6:00 AM",35,22,13,18,10,8,28,16,12,20,11,9,3,2,1,3,17,17,0,0,0,0,15,6,4,2,16,36,0,2,2,2,0,,,
"Oct 15, 2021 7:00 AM",86,54,32,69,27,42,84,38,46,45,21,24,8,8,0,12,57,57,0,0,0,0,57,21,9,12,29,86,2,3,4,3,1,,,
"Oct 15, 2021 8:00 AM",251,187,64,113,39,74,174,64,110,131,51,80,45,32,13,21,134,130,4,0,0,0,120,29,6,23,42,166,9,1,24,22,2,,,
"Oct 15, 2021 9:00 AM",135,99,36,63,30,33,110,52,58,70,40,30,11,8,3,7,67,67,0,0,0,0,56,21,8,13,20,80,4,7,7,4,3,,,
"Oct 15, 2021 10:00 AM",88,57,31,76,35,41,94,47,47,66,32,34,17,10,7,8,46,46,0,0,0,0,42,19,12,7,23,51,2,3,1,1,0,,,
"Oct 15, 2021 11:00 AM",64,41,23,73,30,43,94,51,43,70,36,34,11,5,6,6,34,30,4,0,0,0,23,21,12,9,35,33,5,4,3,2,1,,,
"Oct 15, 2021 12:00 PM",105,41,64,87,47,40,97,50,47,57,37,20,13,3,10,20,35,32,3,0,0,0,29,29,15,14,23,34,4,4,6,4,2,,,
"Oct 15, 2021 1:00 PM",111,49,62,83,33,50,105,55,50,71,30,41,19,9,10,12,45,39,6,0,0,0,32,39,21,18,27,38,3,6,12,6,6,,,
"Oct 15, 2021 2:00 PM",105,51,54,59,35,24,79,39,40,70,41,29,16,7,9,20,45,41,4,0,0,0,41,22,14,8,35,32,8,2,12,3,9,,,
"Oct 15, 2021 3:00 PM",114,33,81,66,33,33,87,48,39,56,29,27,16,8,8,20,37,29,8,0,0,0,26,34,17,17,38,47,6,5,8,6,2,,,
"Oct 15, 2021 4:00 PM",144,52,92,67,37,30,114,67,47,76,43,33,19,6,13,28,36,33,3,0,0,0,24,37,17,20,54,49,4,1,14,5,9,,,
"Oct 15, 2021 5:00 PM",204,54,150,71,43,28,114,72,42,74,46,28,16,6,10,22,32,30,2,0,0,0,34,42,26,16,71,53,3,4,7,6,1,,,
"Oct 15, 2021 6:00 PM",133,47,86,67,41,26,98,70,28,67,38,29,10,5,5,16,32,29,3,0,0,0,26,31,21,10,60,43,3,4,8,6,2,,,
"Oct 15, 2021 7:00 PM",89,35,54,30,19,11,57,33,24,36,19,17,10,3,7,19,22,21,1,0,0,0,21,8,6,2,28,43,6,4,10,5,5,,,
"Oct 15, 2021 8:00 PM",52,21,31,14,9,5,27,18,9,17,9,8,2,0,2,9,8,7,1,0,0,0,8,10,7,3,21,22,2,2,5,3,2,,,
"Oct 15, 2021 9:00 PM",31,8,23,12,9,3,16,5,11,16,9,7,4,3,1,5,6,6,0,0,0,0,8,5,3,2,7,18,1,1,1,1,0,,,
"Oct 15, 2021 10:00 PM",21,4,17,5,4,1,12,6,6,6,4,2,4,1,3,3,4,4,0,0,0,0,3,4,3,1,5,10,3,2,2,2,0,,,
"Oct 15, 2021 11:00 PM",21,5,16,6,5,1,13,9,4,12,8,4,3,1,2,3,7,6,1,0,0,0,5,2,2,0,3,5,0,0,1,1,0,,,
"Oct 16, 2021 12:00 AM",21,3,18,0,0,0,8,5,3,17,8,9,1,1,0,0,3,1,2,0,0,0,1,6,3,3,4,9,0,1,0,0,0,,,
"Oct 16, 2021 1:00 AM",11,3,8,4,4,0,6,2,4,3,1,2,0,0,0,2,5,5,0,0,0,0,5,0,0,0,3,4,1,1,1,1,0,,,
"Oct 16, 2021 2:00 AM",7,3,4,2,2,0,3,3,0,2,2,0,0,0,0,0,1,1,0,0,0,0,1,0,0,0,1,3,0,0,0,0,0,,,
"Oct 16, 2021 3:00 AM",3,0,3,1,1,0,1,1,0,1,1,0,0,0,0,0,0,0,0,0,0,0,1,0,0,0,1,0,0,0,0,0,0,,,
"Oct 16, 2021 4:00 AM",2,1,1,1,1,0,1,1,0,1,1,0,0,0,0,1,3,3,0,0,0,0,3,0,0,0,1,0,0,0,0,0,0,,,
"Oct 16, 2021 5:00 AM",6,1,5,3,1,2,3,1,2,3,1,2,0,0,0,0,0,0,0,0,0,0,0,0,0,0,2,3,1,0,1,1,0,,,
"Oct 16, 2021 6:00 AM",9,5,4,5,1,4,9,7,2,6,3,3,1,1,0,2,9,9,0,0,0,0,9,2,2,0,4,9,1,0,2,1,1,,,
"Oct 16, 2021 7:00 AM",20,12,8,26,15,11,29,23,6,21,17,4,7,4,3,3,9,9,0,0,0,0,9,3,3,0,17,20,1,2,3,3,0,,,
"Oct 16, 2021 8:00 AM",43,27,16,55,34,21,66,46,20,61,44,17,11,5,6,9,16,16,0,0,0,0,16,13,7,6,21,20,0,6,4,0,4,,,
"Oct 16, 2021 9:00 AM",67,40,27,83,48,35,120,77,43,83,55,28,13,10,3,14,26,26,0,0,0,0,24,37,20,17,33,33,6,11,8,6,2,,,
"Oct 16, 2021 10:00 AM",60,44,16,144,70,74,182,104,78,129,78,51,31,25,6,8,21,21,0,0,0,0,14,52,27,25,53,50,5,4,7,6,1,,,
"Oct 16, 2021 11:00 AM",73,38,35,175,97,78,209,105,104,172,95,77,23,12,11,19,23,19,4,0,0,0,19,51,27,24,28,66,4,7,8,5,3,,,
"Oct 16, 2021 12:00 PM",77,38,39,140,60,80,144,77,67,119,59,60,26,17,9,23,29,28,1,0,0,0,27,49,26,23,38,46,5,4,6,3,3,,,
"Oct 16, 2021 1:00 PM",68,31,37,88,38,50,131,60,71,114,52,62,23,10,13,22,39,35,4,0,0,0,25,37,19,18,35,48,14,2,3,2,1,,,
"Oct 16, 2021 2:00 PM",60,33,27,64,38,26,110,55,55,81,48,33,38,14,24,24,24,24,0,0,0,0,24,34,19,15,27,25,7,6,4,2,2,,,
"Oct 16, 2021 3:00 PM",53,27,26,64,37,27,92,46,46,67,32,35,14,10,4,22,28,24,4,0,0,0,25,32,16,16,26,40,8,4,10,7,3,,,
"Oct 16, 2021 4:00 PM",74,42,32,92,48,44,103,43,60,87,37,50,28,8,20,23,24,22,2,0,0,0,21,31,17,14,22,42,7,2,9,1,8,,,
"Oct 16, 2021 5:00 PM",68,25,43,65,27,38,79,32,47,77,30,47,20,9,11,11,17,17,0,0,0,0,21,38,20,18,24,46,4,3,7,6,1,,,
"Oct 16, 2021 6:00 PM",52,25,27,47,24,23,48,20,28,45,21,24,14,5,9,21,13,13,0,0,0,0,12,16,7,9,15,36,2,1,4,2,2,,,
"Oct 16, 2021 7:00 PM",56,15,41,15,11,4,23,14,9,21,12,9,15,4,11,10,7,7,0,0,0,0,4,8,5,3,17,17,3,1,3,1,2,,,
"Oct 16, 2021 8:00 PM",34,12,22,6,3,3,15,2,13,7,4,3,1,0,1,3,6,6,0,0,0,0,6,5,3,2,7,3,1,0,0,0,0,,,
"Oct 16, 2021 9:00 PM",19,7,12,7,4,3,7,5,2,6,4,2,6,5,1,4,5,5,0,0,0,0,6,3,2,1,0,5,1,2,2,1,1,,,
"Oct 16, 2021 10:00 PM",7,1,6,6,5,1,9,4,5,7,5,2,6,4,2,0,3,3,0,0,0,0,4,0,0,0,5,1,0,2,1,1,0,,,
"Oct 16, 2021 11:00 PM",14,5,9,2,2,0,8,5,3,7,2,5,0,0,0,6,9,9,0,0,0,0,7,0,0,0,3,7,0,0,1,0,1,,,
"Oct 17, 2021 12:00 AM",4,0,4,1,1,0,3,1,2,6,2,4,1,0,1,2,2,1,1,0,0,0,2,3,3,0,4,3,0,0,0,0,0,,,
"Oct 17, 2021 1:00 AM",11,3,8,2,1,1,8,6,2,3,3,0,1,0,1,2,1,1,0,0,0,0,1,1,1,0,5,3,0,0,1,0,1,,,
"Oct 17, 2021 2:00 AM",7,2,5,1,0,1,2,1,1,3,1,2,0,0,0,1,1,1,0,0,0,0,2,0,0,0,0,4,0,0,1,0,1,,,
"Oct 17, 2021 3:00 AM",4,2,2,0,0,0,2,1,1,1,0,1,0,0,0,2,0,0,0,0,0,0,1,1,1,0,1,1,0,0,0,0,0,,,
"Oct 17, 2021 4:00 AM",2,1,1,0,0,0,3,3,0,1,1,0,1,0,1,0,0,0,0,0,0,0,0,1,1,0,1,0,0,0,1,1,0,,,
"Oct 17, 2021 5:00 AM",1,0,1,0,0,0,0,0,0,0,0,0,0,0,0,0,1,1,0,0,0,0,1,0,0,0,0,0,1,0,0,0,0,,,
"Oct 17, 2021 6:00 AM",8,3,5,6,2,4,6,4,2,5,3,2,0,0,0,3,1,1,0,0,0,0,1,0,0,0,6,5,0,0,1,1,0,,,
"Oct 17, 2021 7:00 AM",12,8,4,20,12,8,23,18,5,20,14,6,1,1,0,3,10,10,0,0,0,0,10,7,5,2,3,14,0,0,1,1,0,,,
"Oct 17, 2021 8:00 AM",23,13,10,64,46,18,74,47,27,65,47,18,1,1,0,3,7,7,0,0,0,0,7,9,6,3,21,38,1,8,6,3,3,,,
"Oct 17, 2021 9:00 AM",35,22,13,120,64,56,135,80,55,98,60,38,10,4,6,14,23,23,0,0,0,0,19,35,18,17,32,37,2,11,3,2,1,,,
"Oct 17, 2021 10:00 AM",74,41,33,136,84,52,188,116,72,139,87,52,13,8,5,16,30,30,0,0,0,0,26,53,28,25,39,68,2,7,2,2,0,,,
"Oct 17, 2021 11:00 AM",66,40,26,197,113,84,213,128,85,155,102,53,37,19,18,25,26,25,1,0,0,0,23,65,34,31,49,58,11,9,2,2,0,,,
"Oct 17, 2021 12:00 PM",75,35,40,180,90,90,229,110,119,165,86,79,31,22,9,25,26,26,0,0,0,0,24,74,38,36,59,64,8,13,9,7,2,,,
"Oct 17, 2021 1:00 PM",81,48,33,184,91,93,190,104,86,139,83,56,28,18,10,19,19,18,1,0,0,0,18,53,27,26,49,64,3,2,4,4,0,,,
"Oct 17, 2021 2:00 PM",55,25,30,156,87,69,171,81,90,162,84,78,19,10,9,24,24,22,2,0,0,0,24,64,33,31,32,43,8,3,9,6,3,,,
"Oct 17, 2021 3:00 PM",69,35,34,136,68,68,141,65,76,130,61,69,27,4,23,9,28,27,1,0,0,0,29,57,29,28,30,29,8,5,8,7,1,,,
"Oct 17, 2021 4:00 PM",67,39,28,120,51,69,134,57,77,125,57,68,30,13,17,22,19,19,0,0,0,0,17,63,32,31,30,41,6,6,4,4,0,,,
"Oct 17, 2021 5:00 PM",66,24,42,103,51,52,125,47,78,104,40,64,17,9,8,26,20,18,2,0,0,0,16,48,24,24,34,27,6,3,5,5,0,,,
"Oct 17, 2021 6:00 PM",71,20,51,50,20,30,107,38,69,77,27,50,10,3,7,16,14,12,2,0,0,0,16,32,17,15,13,41,3,0,4,2,2,,,
"Oct 17, 2021 7:00 PM",52,22,30,25,13,12,30,13,17,25,12,13,9,4,5,6,14,14,0,0,0,0,13,4,3,1,8,21,2,0,7,3,4,,,
"Oct 17, 2021 8:00 PM",46,17,29,18,11,7,23,11,12,17,8,9,3,1,2,6,8,7,1,0,0,0,5,8,5,3,3,14,2,1,4,3,1,,,
"Oct 17, 2021 9:00 PM",11,4,7,1,0,1,14,8,6,4,1,3,2,0,2,3,5,5,0,0,0,0,5,12,8,4,4,9,1,2,3,2,1,,,
"Oct 17, 2021 10:00 PM",11,6,5,5,2,3,5,2,3,4,1,3,2,2,0,2,2,2,0,0,0,0,2,3,2,1,4,5,0,3,1,0,1,,,
"Oct 17, 2021 11:00 PM",4,1,3,5,3,2,5,2,3,6,2,4,2,0,2,2,2,2,0,0,0,0,2,3,2,1,2,4,0,0,2,1,1,,,
"Oct 18, 2021 12:00 AM",3,0,3,0,0,0,0,0,0,0,0,0,1,1,0,0,6,5,1,0,0,0,5,2,2,0,1,1,0,0,0,0,0,,,
"Oct 18, 2021 1:00 AM",4,1,3,4,2,2,1,0,1,2,1,1,2,0,2,0,0,0,0,0,0,0,0,0,0,0,0,0,0,0,0,0,0,,,
"Oct 18, 2021 2:00 AM",2,0,2,0,0,0,1,0,1,1,0,1,0,0,0,0,0,0,0,0,0,0,0,1,1,0,0,2,0,0,0,0,0,,,
"Oct 18, 2021 3:00 AM",0,0,0,0,0,0,0,0,0,0,0,0,0,0,0,0,0,0,0,0,0,0,0,0,0,0,0,0,0,0,0,0,0,,,
"Oct 18, 2021 4:00 AM",2,1,1,0,0,0,1,1,0,0,0,0,0,0,0,2,1,1,0,0,0,0,1,0,0,0,1,1,0,0,1,1,0,,,
"Oct 18, 2021 5:00 AM",5,5,0,2,1,1,6,4,2,7,6,1,0,0,0,3,4,4,0,0,0,0,4,0,0,0,4,9,0,0,0,0,0,,,
"Oct 18, 2021 6:00 AM",28,18,10,14,7,7,18,5,13,15,4,11,2,2,0,5,17,17,0,0,0,0,18,5,3,2,15,25,1,3,0,0,0,,,
"Oct 18, 2021 7:00 AM",94,63,31,40,14,26,48,16,32,32,13,19,8,8,0,12,61,61,0,0,0,0,62,17,8,9,28,71,1,3,3,3,0,,,
"Oct 18, 2021 8:00 AM",233,174,59,70,17,53,121,42,79,91,37,54,30,19,11,26,173,172,1,0,0,0,154,40,6,34,30,155,6,2,20,16,4,,,
"Oct 18, 2021 9:00 AM",181,144,37,32,11,21,66,33,33,50,27,23,15,13,2,11,87,84,3,0,0,0,64,28,12,16,26,65,4,4,4,4,0,,,
"Oct 18, 2021 10:00 AM",71,52,19,38,19,19,56,29,27,39,19,20,7,6,1,14,42,42,0,0,0,0,33,9,2,7,23,33,2,4,3,2,1,,,
"Oct 18, 2021 11:00 AM",68,46,22,40,11,29,49,29,20,28,13,15,7,4,3,6,44,42,2,0,0,0,38,18,6,12,26,32,3,2,5,4,1,,,
"Oct 18, 2021 12:00 PM",67,36,31,38,22,16,87,57,30,45,28,17,9,3,6,14,43,36,7,0,0,0,28,24,11,13,28,22,1,5,3,3,0,,,
"Oct 18, 2021 1:00 PM",99,55,44,60,36,24,97,46,51,48,24,24,10,5,5,21,43,37,6,0,0,0,35,37,18,19,31,24,3,2,2,1,1,,,
"Oct 18, 2021 2:00 PM",100,35,65,53,35,18,85,41,44,50,37,13,23,11,12,17,31,28,3,0,0,0,22,28,15,13,23,38,5,3,4,3,1,,,
"Oct 18, 2021 3:00 PM",111,25,86,64,33,31,83,49,34,63,38,25,19,6,13,20,31,29,2,0,0,0,22,32,23,9,42,39,2,2,7,3,4,,,
"Oct 18, 2021 4:00 PM",177,63,114,82,50,32,94,57,37,68,44,24,17,8,9,14,38,30,8,0,0,0,25,35,18,17,85,39,4,6,9,4,5,,,
"Oct 18, 2021 5:00 PM",207,55,152,97,64,33,129,78,51,105,59,46,24,5,19,23,48,42,6,0,0,0,37,42,32,10,112,74,5,6,8,5,3,,,
"Oct 18, 2021 6:00 PM",202,55,147,87,51,36,107,70,37,78,49,29,20,2,18,15,36,32,4,0,0,0,29,42,33,9,108,55,7,4,6,3,3,,,
"Oct 18, 2021 7:00 PM",113,36,77,42,18,24,59,32,27,40,21,19,4,3,1,19,27,18,9,0,0,0,18,14,14,0,41,37,6,3,10,7,3,,,
"Oct 18, 2021 8:00 PM",97,27,70,20,15,5,28,16,12,19,14,5,7,3,4,7,17,16,1,0,0,0,13,7,6,1,20,18,5,1,7,2,5,,,
"Oct 18, 2021 9:00 PM",59,16,43,12,7,5,19,8,11,11,3,8,2,1,1,11,6,3,3,0,0,0,4,9,5,4,16,17,3,1,3,1,2,,,
"Oct 18, 2021 10:00 PM",33,4,29,4,1,3,8,4,4,3,0,3,1,1,0,7,3,2,1,0,0,0,2,2,2,0,8,2,1,1,2,1,1,,,
"Oct 18, 2021 11:00 PM",20,6,14,3,1,2,4,1,3,2,0,2,2,1,1,1,7,3,4,0,0,0,5,1,1,0,4,5,0,0,0,0,0,,,
"Oct 19, 2021 12:00 AM",5,2,3,2,1,1,2,2,0,1,1,0,0,0,0,2,2,2,0,0,0,0,0,1,1,0,3,3,0,0,0,0,0,,,
"Oct 19, 2021 1:00 AM",2,0,2,2,1,1,0,0,0,0,0,0,3,0,3,0,1,1,0,0,0,0,2,0,0,0,3,0,0,0,0,0,0,,,
"Oct 19, 2021 2:00 AM",4,3,1,0,0,0,0,0,0,0,0,0,0,0,0,0,0,0,0,0,0,0,0,0,0,0,1,0,0,0,0,0,0,,,
"Oct 19, 2021 3:00 AM",0,0,0,0,0,0,0,0,0,0,0,0,0,0,0,1,0,0,0,0,0,0,0,0,0,0,1,0,0,0,0,0,0,,,
"Oct 19, 2021 4:00 AM",1,1,0,0,0,0,0,0,0,0,0,0,0,0,0,2,1,1,0,0,0,0,1,0,0,0,0,0,0,0,0,0,0,,,
"Oct 19, 2021 5:00 AM",6,3,3,0,0,0,2,0,2,1,0,1,0,0,0,2,6,6,0,0,0,0,7,1,1,0,1,7,0,0,0,0,0,,,
"Oct 19, 2021 6:00 AM",28,20,8,8,4,4,14,4,10,12,5,7,1,1,0,3,14,14,0,7,5,2,14,6,1,5,15,31,0,2,1,1,0,,,
"Oct 19, 2021 7:00 AM",105,72,33,45,15,30,65,21,44,46,15,31,9,8,1,10,82,82,0,21,13,8,75,18,8,10,45,87,4,9,10,9,1,,,
"Oct 19, 2021 8:00 AM",284,222,62,107,27,80,168,47,121,113,35,78,37,27,10,30,211,208,3,63,46,17,186,68,22,46,65,206,6,6,20,18,2,,,
"Oct 19, 2021 9:00 AM",157,125,32,41,15,26,86,49,37,64,40,24,5,2,3,9,102,101,1,24,15,9,78,41,21,20,26,58,1,1,6,4,2,,,
"Oct 19, 2021 10:00 AM",100,81,19,54,19,35,61,33,28,43,19,24,8,5,3,9,59,56,3,12,9,3,43,27,15,12,18,31,1,0,1,1,0,,,
"Oct 19, 2021 11:00 AM",76,46,30,40,18,22,69,42,27,35,21,14,9,9,0,10,40,38,2,20,15,5,26,17,11,6,24,32,2,1,6,5,1,,,
"Oct 19, 2021 12:00 PM",102,47,55,61,34,27,78,36,42,52,22,30,12,4,8,18,27,25,2,19,18,1,23,26,13,13,36,32,1,3,2,2,0,,,
"Oct 19, 2021 1:00 PM",108,45,63,53,30,23,88,43,45,47,27,20,17,10,7,14,47,43,4,28,23,5,38,44,26,18,23,31,2,7,2,2,0,,,
"Oct 19, 2021 2:00 PM",93,44,49,44,22,22,83,43,40,41,26,15,29,13,16,12,23,21,2,44,41,3,17,32,19,13,49,26,1,4,8,5,3,,,
"Oct 19, 2021 3:00 PM",127,50,77,61,41,20,95,63,32,48,37,11,14,6,8,20,39,33,6,37,30,7,26,35,16,19,45,30,2,2,9,3,6,,,
"Oct 19, 2021 4:00 PM",186,57,129,70,38,32,78,50,28,68,37,31,19,4,15,20,42,29,13,82,79,3,26,37,27,10,67,49,7,3,7,4,3,,,
"Oct 19, 2021 5:00 PM",241,64,177,101,67,34,133,68,65,109,60,49,27,5,22,20,49,42,7,80,76,4,40,41,24,17,132,73,3,7,8,4,4,,,
"Oct 19, 2021 6:00 PM",188,60,128,113,81,32,136,101,35,119,87,32,20,6,14,23,48,42,6,0,0,0,39,42,35,7,100,67,7,4,19,13,6,,,
"Oct 19, 2021 7:00 PM",134,39,95,47,22,25,75,40,35,51,29,22,5,0,5,12,20,17,3,0,0,0,15,22,19,3,59,41,5,1,11,6,5,,,
"Oct 19, 2021 8:00 PM",85,18,67,17,10,7,34,21,13,23,14,9,7,4,3,8,19,18,1,0,0,0,16,9,9,0,30,13,2,0,4,2,2,,,
"Oct 19, 2021 9:00 PM",55,9,46,14,11,3,24,11,13,18,11,7,1,0,1,12,14,11,3,0,0,0,10,7,5,2,20,23,1,1,5,2,3,,,
"Oct 19, 2021 10:00 PM",44,9,35,7,7,0,14,11,3,9,8,1,4,2,2,6,7,6,1,0,0,0,6,6,4,2,18,5,1,0,0,0,0,,,
"Oct 19, 2021 11:00 PM",13,6,7,10,4,6,12,4,8,13,1,12,1,0,1,4,4,3,1,0,0,0,3,4,3,1,5,9,0,0,0,0,0,,,
"Oct 20, 2021 12:00 AM",6,1,5,0,0,0,1,1,0,2,0,2,0,0,0,0,2,2,0,0,0,0,2,1,1,0,1,1,0,0,0,0,0,,,
"Oct 20, 2021 1:00 AM",2,0,2,1,1,0,3,1,2,1,0,1,1,0,1,0,2,2,0,0,0,0,3,0,0,0,2,0,0,0,0,0,0,,,
"Oct 20, 2021 2:00 AM",4,3,1,0,0,0,1,1,0,1,1,0,0,0,0,0,1,0,1,0,0,0,0,0,0,0,2,1,0,0,0,0,0,,,
"Oct 20, 2021 3:00 AM",0,0,0,0,0,0,1,1,0,0,0,0,0,0,0,0,0,0,0,0,0,0,0,0,0,0,0,0,0,0,0,0,0,,,
"Oct 20, 2021 4:00 AM",0,0,0,0,0,0,0,0,0,0,0,0,0,0,0,1,1,1,0,0,0,0,1,0,0,0,0,1,0,0,0,0,0,,,
"Oct 20, 2021 5:00 AM",7,7,0,3,2,1,6,4,2,6,5,1,0,0,0,2,5,5,0,0,0,0,5,0,0,0,4,12,0,0,2,2,0,,,
"Oct 20, 2021 6:00 AM",34,24,10,16,4,12,24,5,19,20,5,15,3,3,0,6,20,20,0,0,0,0,19,7,0,7,18,33,0,1,2,2,0,,,
"Oct 20, 2021 7:00 AM",79,53,26,38,12,26,53,14,39,37,12,25,5,5,0,8,45,45,0,0,0,0,46,12,6,6,24,80,0,2,3,3,0,,,
"Oct 20, 2021 8:00 AM",206,161,45,35,9,26,71,27,44,46,19,27,8,6,2,19,116,115,1,0,0,0,102,28,8,20,38,99,2,1,8,8,0,,,
"Oct 20, 2021 9:00 AM",120,104,16,25,6,19,33,11,22,27,10,17,8,6,2,12,62,62,0,0,0,0,53,19,7,12,17,48,2,0,3,3,0,,,
"Oct 20, 2021 10:00 AM",58,47,11,10,5,5,15,5,10,9,4,5,6,5,1,6,36,35,1,0,0,0,25,5,2,3,12,20,1,2,0,0,0,,,
"Oct 20, 2021 11:00 AM",54,28,26,14,5,9,19,7,12,15,7,8,3,1,2,9,31,31,0,0,0,0,25,4,3,1,10,11,2,3,3,2,1,,,
"Oct 20, 2021 12:00 PM",62,34,28,20,10,10,37,22,15,9,5,4,8,6,2,7,29,29,0,0,0,0,25,14,6,8,24,21,0,1,3,2,1,,,
"Oct 20, 2021 1:00 PM",99,48,51,45,20,25,65,34,31,44,26,18,12,6,6,15,29,26,3,0,0,0,21,30,14,16,32,33,2,3,5,2,3,,,
"Oct 20, 2021 2:00 PM",77,40,37,26,16,10,40,25,15,32,25,7,18,11,7,29,27,25,2,0,0,0,19,14,11,3,23,28,2,2,6,5,1,,,
"Oct 20, 2021 3:00 PM",86,36,50,50,28,22,61,37,24,36,22,14,14,8,6,15,34,29,5,0,0,0,26,27,18,9,46,25,2,0,8,3,5,,,
"Oct 20, 2021 4:00 PM",114,39,75,56,31,25,70,42,28,62,38,24,20,10,10,8,27,24,3,0,0,0,29,24,15,9,56,56,2,3,6,4,2,,,
"Oct 20, 2021 5:00 PM",207,52,155,74,51,23,104,62,42,72,45,27,14,1,13,25,43,41,2,0,0,0,36,40,25,15,101,51,8,2,16,11,5,,,
"Oct 20, 2021 6:00 PM",168,48,120,76,45,31,103,61,42,86,53,33,7,2,5,23,45,42,3,0,0,0,37,31,20,11,76,64,7,5,19,11,8,,,
"Oct 20, 2021 7:00 PM",112,36,76,61,35,26,65,41,24,46,27,19,7,1,6,7,30,26,4,0,0,0,23,21,12,9,49,33,6,1,8,8,0,,,
"Oct 20, 2021 8:00 PM",89,29,60,25,12,13,31,18,13,32,16,16,6,3,3,8,25,22,3,0,0,0,20,7,6,1,35,31,2,2,0,0,0,,,
"Oct 20, 2021 9:00 PM",41,11,30,12,4,8,30,13,17,13,5,8,2,1,1,4,10,7,3,0,0,0,8,7,5,2,9,17,5,1,2,1,1,,,
"Oct 20, 2021 10:00 PM",26,10,16,14,11,3,17,10,7,17,11,6,2,0,2,3,8,6,2,0,0,0,6,6,4,2,15,9,1,0,1,0,1,,,
"Oct 20, 2021 11:00 PM",20,3,17,4,3,1,7,5,2,2,1,1,6,0,6,2,2,2,0,0,0,0,2,4,0,4,5,6,1,0,1,1,0,,,
"Oct 21, 2021 12:00 AM",5,0,5,0,0,0,1,0,1,3,1,2,4,2,2,1,0,0,0,0,0,0,0,1,1,0,2,0,0,0,1,1,0,,,
"Oct 21, 2021 1:00 AM",3,1,2,0,0,0,1,1,0,0,0,0,0,0,0,0,3,3,0,0,0,0,3,0,0,0,2,0,0,1,0,0,0,,,
"Oct 21, 2021 2:00 AM",5,5,0,0,0,0,2,1,1,2,1,1,0,0,0,0,1,1,0,0,0,0,1,1,0,1,3,0,0,0,0,0,0,,,
"Oct 21, 2021 3:00 AM",0,0,0,0,0,0,0,0,0,0,0,0,0,0,0,0,0,0,0,0,0,0,0,0,0,0,0,0,0,0,0,0,0,,,
"Oct 21, 2021 4:00 AM",3,1,2,0,0,0,1,1,0,0,0,0,0,0,0,0,0,0,0,0,0,0,0,0,0,0,1,2,0,0,0,0,0,,,
"Oct 21, 2021 5:00 AM",6,4,2,1,0,1,3,1,2,3,2,1,0,0,0,3,9,9,0,0,0,0,9,1,0,1,3,13,1,0,0,0,0,,,
"Oct 21, 2021 6:00 AM",36,24,12,23,8,15,27,8,19,26,11,15,5,4,1,6,21,21,0,0,0,0,19,2,1,1,20,32,2,2,2,2,0,,,
"Oct 21, 2021 7:00 AM",96,66,30,44,18,26,70,27,43,50,21,29,10,9,1,10,67,67,0,0,0,0,67,22,7,15,41,99,4,7,5,2,3,,,
"Oct 21, 2021 8:00 AM",264,190,74,119,32,87,171,55,116,126,51,75,38,25,13,36,162,159,3,0,0,0,151,59,15,44,63,198,7,1,19,16,3,,,
"Oct 21, 2021 9:00 AM",163,127,36,65,22,43,71,31,40,70,34,36,14,9,5,12,103,103,0,0,0,0,80,30,17,13,29,77,4,4,6,3,3,,,
"Oct 21, 2021 10:00 AM",108,83,25,50,23,27,72,33,39,52,22,30,12,11,1,11,47,46,1,0,0,0,39,32,15,17,23,29,3,0,2,1,1,,,
"Oct 21, 2021 11:00 AM",82,47,35,55,26,29,59,36,23,45,22,23,18,13,5,7,40,37,3,0,0,0,26,29,15,14,25,21,3,5,2,2,0,,,
"Oct 21, 2021 12:00 PM",72,41,31,67,35,32,81,44,37,51,31,20,14,6,8,9,45,42,3,0,0,0,32,25,15,10,33,31,3,4,2,2,0,,,
"Oct 21, 2021 1:00 PM",99,48,51,54,30,24,100,40,60,52,24,28,22,9,13,14,35,28,7,0,0,0,29,26,11,15,34,33,12,2,3,3,0,,,
"Oct 21, 2021 2:00 PM",103,41,62,49,19,30,70,40,30,43,22,21,18,9,9,11,26,19,7,0,0,0,16,29,20,9,36,31,1,5,4,4,0,,,
"Oct 21, 2021 3:00 PM",120,44,76,54,28,26,78,45,33,64,41,23,23,11,12,13,59,52,7,0,0,0,41,35,23,12,53,32,3,5,5,4,1,,,
"Oct 21, 2021 4:00 PM",143,46,97,60,40,20,90,65,25,75,52,23,18,4,14,18,32,25,7,0,0,0,25,32,22,10,67,52,5,3,4,1,3,,,
"Oct 21, 2021 5:00 PM",219,58,161,69,45,24,121,67,54,85,46,39,24,5,19,28,46,42,4,0,0,0,47,42,27,15,118,83,6,3,8,7,1,,,
"Oct 21, 2021 6:00 PM",190,44,146,77,53,24,103,68,35,86,50,36,12,6,6,17,41,38,3,0,0,0,38,46,31,15,93,49,2,5,15,8,7,,,
"Oct 21, 2021 7:00 PM",118,34,84,42,29,13,53,37,16,46,29,17,2,0,2,14,22,20,2,0,0,0,18,20,16,4,49,34,3,2,2,1,1,,,
"Oct 21, 2021 8:00 PM",85,26,59,24,17,7,39,29,10,30,20,10,4,2,2,3,12,12,0,0,0,0,10,10,7,3,30,17,4,0,1,1,0,,,
"Oct 21, 2021 9:00 PM",39,12,27,6,5,1,7,2,5,7,3,4,4,2,2,5,7,6,1,0,0,0,8,3,3,0,18,19,3,0,3,3,0,,,
"Oct 21, 2021 10:00 PM",32,7,25,10,8,2,11,7,4,10,6,4,3,0,3,6,5,3,2,0,0,0,3,2,1,1,18,6,3,1,2,1,1,,,
"Oct 21, 2021 11:00 PM",29,9,20,3,2,1,12,5,7,5,2,3,1,0,1,2,6,5,1,0,0,0,6,2,2,0,8,6,0,0,1,0,1,,,
"Oct 22, 2021 12:00 AM",10,2,8,0,0,0,1,1,0,5,2,3,1,0,1,3,2,2,0,0,0,0,1,0,0,0,6,3,1,0,1,0,1,,,
"Oct 22, 2021 1:00 AM",8,1,7,1,1,0,2,1,1,0,0,0,0,0,0,1,1,1,0,0,0,0,1,0,0,0,2,0,0,0,0,0,0,,,
"Oct 22, 2021 2:00 AM",4,3,1,0,0,0,1,0,1,2,1,1,1,1,0,0,0,0,0,0,0,0,0,0,0,0,2,1,0,0,0,0,0,,,
"Oct 22, 2021 3:00 AM",2,2,0,0,0,0,2,2,0,1,1,0,1,0,1,0,0,0,0,0,0,0,0,0,0,0,3,1,1,0,0,0,0,,,
"Oct 22, 2021 4:00 AM",1,1,0,0,0,0,1,1,0,0,0,0,0,0,0,1,1,1,0,0,0,0,1,0,0,0,1,1,0,0,0,0,0,,,
"Oct 22, 2021 5:00 AM",6,4,2,1,1,0,2,0,2,2,1,1,0,0,0,1,3,3,0,0,0,0,4,1,1,0,4,10,0,0,0,0,0,,,
"Oct 22, 2021 6:00 AM",28,19,9,22,7,15,21,6,15,21,8,13,5,4,1,7,12,12,0,0,0,0,10,4,4,0,18,36,1,3,0,0,0,,,
"Oct 22, 2021 7:00 AM",77,45,32,69,24,45,73,27,46,69,32,37,9,8,1,16,59,58,1,0,0,0,56,15,15,0,39,80,1,5,6,5,1,,,
"Oct 22, 2021 8:00 AM",206,160,46,88,32,56,112,41,71,97,43,54,24,18,6,17,111,110,1,0,0,0,110,49,45,4,48,131,10,3,15,14,1,,,
"Oct 22, 2021 9:00 AM",135,101,34,42,15,27,58,31,27,51,33,18,13,10,3,11,70,70,0,0,0,0,65,24,23,1,26,60,2,2,9,5,4,,,
"Oct 22, 2021 10:00 AM",85,53,32,37,14,23,53,26,27,44,24,20,14,9,5,5,38,38,0,0,0,0,29,17,10,7,20,38,0,3,5,3,2,,,
"Oct 22, 2021 11:00 AM",75,42,33,25,14,11,56,35,21,37,21,16,9,5,4,4,41,37,4,0,0,0,27,13,9,4,17,20,11,2,3,3,0,,,
"Oct 22, 2021 12:00 PM",71,30,41,56,26,30,68,40,28,52,27,25,15,6,9,13,40,40,0,0,0,0,36,18,9,9,34,32,1,2,2,0,2,,,
"Oct 22, 2021 1:00 PM",117,47,70,51,27,24,101,51,50,58,28,30,8,1,7,17,33,33,0,0,0,0,31,35,23,12,29,45,1,2,3,2,1,,,
"Oct 22, 2021 2:00 PM",92,46,46,56,32,24,74,41,33,54,35,19,10,6,4,10,26,21,5,0,0,0,20,24,18,6,36,33,5,0,6,3,3,,,
"Oct 22, 2021 3:00 PM",106,34,72,36,21,15,61,30,31,46,27,19,14,3,11,18,38,32,6,0,0,0,32,28,22,6,58,35,6,2,4,4,0,,,
"Oct 22, 2021 4:00 PM",127,33,94,83,57,26,113,71,42,78,47,31,21,13,8,18,32,30,2,0,0,0,28,36,24,12,70,51,3,4,4,2,2,,,
"Oct 22, 2021 5:00 PM",172,49,123,63,31,32,98,49,49,70,36,34,17,5,12,30,36,34,2,0,0,0,32,42,25,17,76,62,2,4,6,4,2,,,
"Oct 22, 2021 6:00 PM",147,39,108,59,47,12,75,57,18,54,38,16,15,7,8,19,27,23,4,0,0,0,25,29,24,5,61,38,4,1,8,8,0,,,
"Oct 22, 2021 7:00 PM",80,34,46,42,27,15,36,18,18,34,20,14,9,2,7,4,22,20,2,0,0,0,22,15,9,6,27,36,5,1,9,6,3,,,
"Oct 22, 2021 8:00 PM",41,18,23,10,8,2,19,15,4,9,8,1,10,5,5,9,8,7,1,0,0,0,6,5,4,1,17,16,3,0,6,3,3,,,
"Oct 22, 2021 9:00 PM",39,16,23,7,5,2,23,6,17,16,4,12,2,0,2,2,7,6,1,0,0,0,4,4,3,1,8,14,0,0,4,1,3,,,
"Oct 22, 2021 10:00 PM",26,4,22,4,3,1,18,11,7,6,3,3,0,0,0,3,6,5,1,0,0,0,5,4,2,2,14,9,2,1,1,1,0,,,
"Oct 22, 2021 11:00 PM",20,4,16,13,10,3,16,9,7,15,8,7,3,0,3,4,8,6,2,0,0,0,4,3,3,0,6,8,0,1,1,1,0,,,
"Oct 23, 2021 12:00 AM",15,4,11,0,0,0,3,3,0,9,4,5,3,2,1,1,1,1,0,0,0,0,1,2,2,0,6,5,0,0,0,0,0,,,
"Oct 23, 2021 1:00 AM",8,4,4,2,2,0,5,3,2,3,2,1,1,0,1,0,2,0,2,0,0,0,1,3,3,0,8,0,0,0,0,0,0,,,
"Oct 23, 2021 2:00 AM",8,5,3,1,1,0,6,4,2,3,3,0,0,0,0,1,0,0,0,0,0,0,0,1,1,0,5,4,0,0,0,0,0,,,
"Oct 23, 2021 3:00 AM",3,0,3,0,0,0,1,1,0,0,0,0,0,0,0,0,0,0,0,0,0,0,0,0,0,0,2,1,0,0,0,0,0,,,
"Oct 23, 2021 4:00 AM",4,2,2,0,0,0,0,0,0,0,0,0,1,0,1,1,1,1,0,0,0,0,1,0,0,0,1,0,0,0,0,0,0,,,
"Oct 23, 2021 5:00 AM",4,0,4,1,0,1,1,0,1,1,0,1,0,0,0,0,1,1,0,0,0,0,1,0,0,0,4,3,0,0,0,0,0,,,
"Oct 23, 2021 6:00 AM",9,4,5,3,1,2,5,3,2,5,1,4,0,0,0,3,4,4,0,0,0,0,4,0,0,0,6,13,0,0,1,0,1,,,
"Oct 23, 2021 7:00 AM",20,8,12,12,4,8,25,17,8,21,14,7,2,0,2,4,4,4,0,0,0,0,4,7,6,1,8,16,1,2,3,0,3,,,
"Oct 23, 2021 8:00 AM",46,23,23,44,25,19,35,23,12,33,24,9,12,4,8,6,16,15,1,0,0,0,13,19,12,7,13,10,0,4,4,0,4,,,
"Oct 23, 2021 9:00 AM",51,30,21,74,42,32,66,42,24,63,39,24,15,8,7,11,18,18,0,0,0,0,21,22,14,8,30,21,3,2,4,4,0,,,
"Oct 23, 2021 10:00 AM",46,24,22,89,40,49,91,58,33,90,58,32,26,16,10,10,30,28,2,9,6,3,22,37,25,12,26,23,4,4,2,2,0,,,
"Oct 23, 2021 11:00 AM",57,34,23,111,52,59,116,58,58,104,48,56,22,14,8,10,20,19,1,17,17,0,16,38,17,21,34,35,3,4,4,1,3,,,
"Oct 23, 2021 12:00 PM",64,39,25,108,40,68,151,70,81,93,40,53,22,9,13,15,26,25,1,20,16,4,21,36,20,16,26,36,10,3,8,5,3,,,
"Oct 23, 2021 1:00 PM",52,29,23,66,36,30,88,40,48,60,30,30,16,9,7,17,23,22,1,17,14,3,22,37,15,22,40,23,3,7,14,8,6,,,
"Oct 23, 2021 2:00 PM",54,24,30,64,33,31,94,55,39,68,38,30,18,8,10,21,18,17,1,0,0,0,18,37,16,21,25,36,7,0,7,5,2,,,
"Oct 23, 2021 3:00 PM",53,20,33,68,40,28,98,45,53,60,32,28,24,22,2,19,21,21,0,0,0,0,19,27,12,15,25,25,2,2,3,2,1,,,
"Oct 23, 2021 4:00 PM",39,18,21,44,22,22,58,21,37,35,15,20,11,3,8,23,11,11,0,0,0,0,10,25,14,11,21,26,7,2,5,4,1,,,
"Oct 23, 2021 5:00 PM",37,16,21,36,17,19,48,27,21,33,13,20,13,3,10,20,13,11,2,0,0,0,10,23,12,11,19,26,4,1,7,4,3,,,
"Oct 23, 2021 6:00 PM",42,18,24,33,16,17,33,14,19,27,10,17,6,3,3,12,12,10,2,0,0,0,12,9,5,4,15,27,0,1,4,2,2,,,
"Oct 23, 2021 7:00 PM",33,16,17,21,14,7,25,14,11,16,8,8,1,0,1,4,8,8,0,0,0,0,7,14,8,6,12,11,1,0,4,4,0,,,
"Oct 23, 2021 8:00 PM",21,11,10,8,3,5,13,5,8,10,5,5,1,0,1,2,5,5,0,0,0,0,4,8,5,3,9,5,1,1,2,1,1,,,
"Oct 23, 2021 9:00 PM",17,9,8,7,2,5,9,5,4,7,2,5,1,0,1,1,7,6,1,0,0,0,3,2,2,0,4,5,1,0,2,1,1,,,
"Oct 23, 2021 10:00 PM",10,5,5,7,4,3,4,4,0,6,3,3,2,1,1,1,0,0,0,0,0,0,0,1,1,0,5,6,0,1,3,1,2,,,
"Oct 23, 2021 11:00 PM",8,0,8,5,4,1,4,1,3,5,3,2,1,0,1,0,3,3,0,0,0,0,2,0,0,0,5,7,0,0,1,1,0,,,
"Oct 24, 2021 12:00 AM",10,4,6,1,1,0,1,0,1,5,2,3,3,1,2,0,0,0,0,0,0,0,1,2,2,0,3,3,0,0,2,1,1,,,
"Oct 24, 2021 1:00 AM",6,2,4,4,3,1,1,0,1,3,2,1,0,0,0,1,2,2,0,0,0,0,2,2,1,1,6,2,0,0,1,0,1,,,
"Oct 24, 2021 2:00 AM",4,2,2,0,0,0,2,2,0,0,0,0,0,0,0,1,2,1,1,0,0,0,0,1,1,0,2,3,0,0,0,0,0,,,
"Oct 24, 2021 3:00 AM",3,0,3,1,1,0,0,0,0,1,1,0,0,0,0,1,0,0,0,0,0,0,0,0,0,0,1,0,0,1,0,0,0,,,
"Oct 24, 2021 4:00 AM",3,1,2,1,1,0,3,2,1,1,1,0,1,0,1,0,0,0,0,0,0,0,0,3,2,1,1,1,0,0,0,0,0,,,
"Oct 24, 2021 5:00 AM",1,0,1,0,0,0,0,0,0,0,0,0,0,0,0,0,2,2,0,0,0,0,2,0,0,0,1,2,0,0,1,1,0,,,
"Oct 24, 2021 6:00 AM",4,2,2,5,1,4,8,4,4,2,1,1,0,0,0,4,1,1,0,0,0,0,1,2,1,1,5,5,0,0,0,0,0,,,
"Oct 24, 2021 7:00 AM",12,5,7,10,5,5,11,8,3,11,6,5,1,1,0,1,4,4,0,0,0,0,5,1,1,0,7,11,1,1,0,0,0,,,
"Oct 24, 2021 8:00 AM",26,10,16,51,31,20,50,36,14,50,38,12,3,2,1,2,9,8,1,0,0,0,9,19,10,9,16,21,1,3,1,0,1,,,
"Oct 24, 2021 9:00 AM",25,12,13,105,65,40,82,54,28,80,54,26,7,3,4,9,11,11,0,0,0,0,10,26,14,12,35,28,6,6,3,3,0,,,
"Oct 24, 2021 10:00 AM",38,24,14,108,59,49,99,60,39,96,55,41,11,6,5,20,32,32,0,0,0,0,27,25,13,12,24,37,7,4,8,6,2,,,
"Oct 24, 2021 11:00 AM",54,30,24,119,66,53,126,65,61,103,58,45,17,13,4,21,15,15,0,0,0,0,11,56,29,27,36,29,6,3,3,3,0,,,
"Oct 24, 2021 12:00 PM",61,30,31,175,91,84,200,112,88,165,106,59,29,17,12,14,27,25,2,0,0,0,25,65,34,31,54,52,6,3,10,9,1,,,
"Oct 24, 2021 1:00 PM",58,26,32,172,85,87,185,109,76,135,71,64,36,19,17,15,22,20,2,0,0,0,16,80,42,38,65,37,9,7,8,4,4,,,
"Oct 24, 2021 2:00 PM",50,24,26,177,90,87,223,119,104,159,96,63,25,9,16,16,19,18,1,0,0,0,20,85,63,22,53,45,1,1,14,10,4,,,
"Oct 24, 2021 3:00 PM",51,30,21,164,70,94,235,111,124,170,67,103,39,18,21,20,31,31,0,0,0,0,25,75,53,22,40,45,2,6,2,1,1,,,
"Oct 24, 2021 4:00 PM",53,22,31,112,71,41,138,56,82,118,52,66,27,7,20,16,19,19,0,0,0,0,13,76,74,2,34,35,7,2,9,7,2,,,
"Oct 24, 2021 5:00 PM",47,20,27,68,27,41,102,42,60,72,33,39,10,7,3,7,14,13,1,0,0,0,10,33,26,7,17,40,7,0,7,6,1,,,
"Oct 24, 2021 6:00 PM",60,24,36,36,16,20,52,16,36,43,11,32,11,4,7,9,16,16,0,0,0,0,15,24,17,7,16,23,0,3,2,1,1,,,
"Oct 24, 2021 7:00 PM",38,21,17,24,12,12,32,8,24,24,10,14,5,2,3,10,13,13,0,0,0,0,10,5,4,1,11,15,1,0,3,3,0,,,
"Oct 24, 2021 8:00 PM",25,5,20,16,9,7,20,5,15,11,5,6,4,3,1,7,8,6,2,0,0,0,5,7,4,3,12,15,0,1,2,2,0,,,
"Oct 24, 2021 9:00 PM",19,7,12,7,1,6,6,1,5,6,2,4,1,0,1,6,2,2,0,0,0,0,3,4,3,1,1,4,0,0,0,0,0,,,
"Oct 24, 2021 10:00 PM",14,8,6,9,7,2,7,5,2,8,4,4,2,2,0,1,3,3,0,0,0,0,4,1,1,0,8,8,0,2,0,0,0,,,
"Oct 24, 2021 11:00 PM",6,2,4,2,1,1,10,4,6,6,2,4,1,1,0,0,0,0,0,0,0,0,0,1,1,0,5,12,0,0,1,0,1,,,
"Oct 25, 2021 12:00 AM",11,2,9,0,0,0,3,0,3,5,0,5,0,0,0,1,4,4,0,0,0,0,4,0,0,0,5,3,0,0,2,1,1,,,
"Oct 25, 2021 1:00 AM",2,2,0,1,0,1,2,1,1,1,0,1,2,0,2,2,2,2,0,0,0,0,3,2,1,1,4,2,0,0,0,0,0,,,
"Oct 25, 2021 2:00 AM",3,1,2,1,1,0,0,0,0,1,1,0,0,0,0,0,1,1,0,0,0,0,1,1,1,0,2,0,0,0,0,0,0,,,
"Oct 25, 2021 3:00 AM",2,0,2,0,0,0,0,0,0,0,0,0,0,0,0,0,0,0,0,0,0,0,0,2,2,0,0,0,0,1,0,0,0,,,
"Oct 25, 2021 4:00 AM",2,0,2,0,0,0,0,0,0,0,0,0,0,0,0,2,0,0,0,0,0,0,0,0,0,0,0,0,0,0,1,1,0,,,
"Oct 25, 2021 5:00 AM",1,1,0,0,0,0,1,1,0,0,0,0,0,0,0,1,1,1,0,0,0,0,1,1,1,0,2,4,0,0,0,0,0,,,
"Oct 25, 2021 6:00 AM",12,6,6,5,1,4,7,2,5,6,1,5,0,0,0,4,6,6,0,0,0,0,7,1,1,0,4,11,0,0,0,0,0,,,
"Oct 25, 2021 7:00 AM",12,3,9,21,8,13,15,11,4,16,11,5,3,1,2,4,12,12,0,0,0,0,11,4,3,1,11,11,2,3,1,0,1,,,
"Oct 25, 2021 8:00 AM",27,12,15,52,28,24,42,23,19,41,24,17,6,5,1,5,16,16,0,0,0,0,18,18,10,8,13,17,1,4,2,1,1,,,
"Oct 25, 2021 9:00 AM",33,19,14,41,19,22,58,33,25,42,23,19,15,13,2,8,18,15,3,0,0,0,13,20,11,9,20,33,1,4,0,0,0,,,
"Oct 25, 2021 10:00 AM",35,18,17,104,64,40,94,57,37,90,67,23,8,6,2,20,17,17,0,0,0,0,16,27,14,13,25,35,4,7,5,3,2,,,
"Oct 25, 2021 11:00 AM",49,17,32,141,81,60,152,89,63,135,81,54,20,15,5,12,23,22,1,0,0,0,21,54,28,26,39,38,6,9,5,4,1,,,
"Oct 25, 2021 12:00 PM",56,33,23,177,92,85,144,91,53,134,73,61,32,20,12,17,24,24,0,0,0,0,28,52,27,25,39,38,7,9,4,2,2,,,
"Oct 25, 2021 1:00 PM",59,36,23,158,78,80,195,108,87,141,78,63,41,19,22,15,16,15,1,0,0,0,14,64,33,31,57,43,6,2,3,2,1,,,
"Oct 25, 2021 2:00 PM",45,23,22,147,70,77,176,101,75,131,76,55,20,8,12,24,11,10,1,0,0,0,12,74,38,36,40,43,2,2,8,6,2,,,
"Oct 25, 2021 3:00 PM",59,27,32,167,89,78,184,85,99,136,66,70,22,13,9,25,23,23,0,0,0,0,21,77,40,37,52,51,9,0,9,8,1,,,
"Oct 25, 2021 4:00 PM",55,21,34,131,50,81,141,51,90,108,43,65,11,5,6,6,30,29,1,0,0,0,24,49,25,24,34,34,6,1,4,4,0,,,
"Oct 25, 2021 5:00 PM",76,27,49,63,32,31,86,36,50,59,26,33,15,9,6,9,11,11,0,0,0,0,12,44,24,20,35,24,2,3,6,3,3,,,
"Oct 25, 2021 6:00 PM",47,18,29,47,24,23,75,26,49,55,22,33,16,3,13,12,13,12,1,0,0,0,15,27,14,13,21,32,2,1,6,4,2,,,
"Oct 25, 2021 7:00 PM",32,16,16,8,4,4,19,7,12,14,7,7,1,1,0,5,9,9,0,0,0,0,8,11,6,5,12,11,2,0,3,2,1,,,
"Oct 25, 2021 8:00 PM",21,9,12,9,5,4,9,4,5,8,5,3,8,6,2,1,11,10,1,0,0,0,9,5,2,3,6,10,1,1,4,1,3,,,
"Oct 25, 2021 9:00 PM",12,5,7,6,4,2,9,6,3,11,7,4,1,1,0,3,6,4,2,0,0,0,4,9,6,3,3,12,2,0,1,0,1,,,
"Oct 25, 2021 10:00 PM",14,4,10,3,2,1,8,3,5,5,2,3,2,1,1,3,8,4,4,0,0,0,3,1,1,0,7,9,0,1,2,1,1,,,
"Oct 25, 2021 11:00 PM",8,4,4,1,0,1,3,1,2,1,0,1,2,2,0,0,4,4,0,0,0,0,3,1,1,0,4,5,0,0,0,0,0,,,
"Oct 26, 2021 12:00 AM",3,0,3,0,0,0,0,0,0,1,1,0,0,0,0,1,1,1,0,0,0,0,2,1,1,0,1,0,0,0,0,0,0,,,
"Oct 26, 2021 1:00 AM",3,1,2,1,1,0,3,2,1,1,1,0,0,0,0,0,1,1,0,0,0,0,1,0,0,0,3,2,0,0,0,0,0,,,
"Oct 26, 2021 2:00 AM",4,4,0,0,0,0,2,1,1,3,2,1,0,0,0,0,1,1,0,0,0,0,1,0,0,0,0,0,0,0,0,0,0,,,
"Oct 26, 2021 3:00 AM",0,0,0,0,0,0,0,0,0,0,0,0,0,0,0,0,0,0,0,0,0,0,0,1,1,0,0,0,0,0,0,0,0,,,
"Oct 26, 2021 4:00 AM",1,1,0,0,0,0,0,0,0,0,0,0,0,0,0,2,0,0,0,0,0,0,0,0,0,0,1,0,0,0,0,0,0,,,
"Oct 26, 2021 5:00 AM",6,4,2,3,0,3,5,2,3,4,1,3,1,1,0,1,7,7,0,0,0,0,7,0,0,0,3,15,0,0,1,0,1,,,
"Oct 26, 2021 6:00 AM",38,30,8,17,6,11,18,7,11,11,5,6,4,2,2,6,18,18,0,0,0,0,16,3,1,2,14,24,0,1,1,1,0,,,
"Oct 26, 2021 7:00 AM",76,51,25,43,14,29,58,17,41,48,19,29,8,8,0,3,57,57,0,0,0,0,56,18,4,14,41,75,1,3,3,2,1,,,
"Oct 26, 2021 8:00 AM",190,142,48,44,15,29,90,34,56,62,26,36,13,10,3,18,134,133,1,0,0,0,130,35,9,26,42,118,0,3,5,4,1,,,
"Oct 26, 2021 9:00 AM",109,87,22,45,19,26,53,24,29,53,31,22,18,7,11,14,72,71,1,0,0,0,49,24,10,14,24,60,3,4,3,2,1,,,
"Oct 26, 2021 10:00 AM",82,57,25,30,18,12,40,23,17,28,19,9,6,5,1,1,36,36,0,0,0,0,26,22,16,6,19,20,2,2,2,0,2,,,
"Oct 26, 2021 11:00 AM",68,40,28,34,16,18,43,21,22,30,13,17,7,2,5,9,23,22,1,0,0,0,16,23,16,7,15,23,3,4,2,2,0,,,
"Oct 26, 2021 12:00 PM",75,40,35,47,21,26,38,17,21,33,16,17,10,4,6,6,23,22,1,0,0,0,17,22,13,9,17,20,5,0,4,1,3,,,
"Oct 26, 2021 1:00 PM",87,43,44,52,22,30,70,43,27,54,26,28,18,5,13,18,32,31,1,0,0,0,26,31,15,16,23,24,4,8,7,5,2,,,
"Oct 26, 2021 2:00 PM",75,42,33,48,25,23,70,43,27,48,29,19,11,2,9,7,27,25,2,0,0,0,22,31,14,17,24,17,2,2,6,5,1,,,
"Oct 26, 2021 3:00 PM",100,41,59,42,28,14,64,41,23,46,33,13,15,4,11,13,27,24,3,0,0,0,15,32,16,16,35,26,3,1,10,9,1,,,
"Oct 26, 2021 4:00 PM",125,42,83,48,32,16,88,35,53,63,30,33,17,4,13,23,30,22,8,0,0,0,22,40,26,14,48,34,7,3,9,6,3,,,
"Oct 26, 2021 5:00 PM",186,57,129,51,30,21,97,54,43,75,34,41,14,2,12,24,50,44,6,0,0,0,43,37,25,12,103,51,5,5,9,5,4,,,
"Oct 26, 2021 6:00 PM",165,47,118,50,32,18,82,53,29,60,39,21,27,16,11,14,34,29,5,0,0,0,30,36,26,10,77,38,5,1,5,3,2,,,
"Oct 26, 2021 7:00 PM",107,30,77,26,20,6,35,29,6,22,18,4,11,3,8,25,24,16,8,0,0,0,17,13,9,4,38,15,1,2,12,7,5,,,
"Oct 26, 2021 8:00 PM",68,9,59,11,4,7,20,12,8,16,7,9,3,3,0,6,20,17,3,0,0,0,16,9,6,3,19,27,1,0,4,3,1,,,
"Oct 26, 2021 9:00 PM",48,16,32,4,4,0,15,8,7,8,4,4,1,1,0,4,8,5,3,0,0,0,6,5,4,1,21,15,2,1,4,2,2,,,
"Oct 26, 2021 10:00 PM",24,5,19,4,2,2,10,7,3,2,1,1,3,3,0,2,8,7,1,0,0,0,7,3,3,0,7,5,1,0,4,1,3,,,
"Oct 26, 2021 11:00 PM",12,2,10,1,1,0,8,1,7,4,2,2,1,0,1,4,3,3,0,0,0,0,3,3,3,0,1,3,0,0,1,1,0,,,
"Oct 27, 2021 12:00 AM",5,0,5,0,0,0,1,1,0,1,1,0,2,0,2,1,3,3,0,0,0,0,3,1,1,0,2,3,0,0,2,2,0,,,
"Oct 27, 2021 1:00 AM",2,0,2,0,0,0,0,0,0,0,0,0,0,0,0,0,2,1,1,0,0,0,1,1,1,0,0,0,0,0,1,1,0,,,
"Oct 27, 2021 2:00 AM",9,7,2,0,0,0,0,0,0,0,0,0,0,0,0,0,0,0,0,0,0,0,0,0,0,0,2,0,0,0,0,0,0,,,
"Oct 27, 2021 3:00 AM",1,0,1,0,0,0,0,0,0,0,0,0,0,0,0,0,0,0,0,0,0,0,0,0,0,0,0,0,0,1,0,0,0,,,
"Oct 27, 2021 4:00 AM",1,0,1,0,0,0,0,0,0,0,0,0,0,0,0,1,0,0,0,0,0,0,0,0,0,0,0,0,0,0,0,0,0,,,
"Oct 27, 2021 5:00 AM",5,2,3,1,1,0,3,3,0,4,3,1,0,0,0,2,6,6,0,0,0,0,6,2,1,1,3,4,0,0,1,1,0,,,
"Oct 27, 2021 6:00 AM",24,17,7,6,1,5,9,2,7,7,1,6,2,2,0,4,12,12,0,0,0,0,13,3,2,1,12,24,0,1,2,2,0,,,
"Oct 27, 2021 7:00 AM",59,40,19,28,8,20,39,15,24,31,14,17,6,6,0,7,49,48,1,0,0,0,48,17,9,8,26,61,4,3,8,5,3,,,
"Oct 27, 2021 8:00 AM",170,131,39,46,11,35,70,27,43,55,20,35,14,9,5,7,108,107,1,0,0,0,98,31,7,24,34,99,1,1,6,4,2,,,
"Oct 27, 2021 9:00 AM",111,91,20,31,8,23,43,17,26,32,20,12,10,8,2,14,59,58,1,0,0,0,45,20,7,13,13,48,0,3,2,1,1,,,
"Oct 27, 2021 10:00 AM",78,56,22,17,8,9,27,11,16,23,11,12,5,4,1,9,35,35,0,0,0,0,26,11,7,4,12,17,3,1,1,0,1,,,
"Oct 27, 2021 11:00 AM",46,30,16,17,10,7,14,10,4,16,10,6,1,1,0,6,27,26,1,0,0,0,19,13,10,3,8,17,2,2,4,2,2,,,
"Oct 27, 2021 12:00 PM",46,22,24,19,9,10,24,12,12,17,9,8,5,3,2,4,21,20,1,0,0,0,17,8,4,4,15,13,4,1,2,2,0,,,
"Oct 27, 2021 1:00 PM",68,40,28,29,17,12,44,28,16,34,19,15,14,7,7,9,18,17,1,0,0,0,12,20,15,5,17,15,1,4,4,3,1,,,
"Oct 27, 2021 2:00 PM",60,32,28,51,29,22,45,28,17,34,22,12,27,14,13,11,27,20,7,0,0,0,20,21,17,4,18,15,1,1,3,3,0,,,
"Oct 27, 2021 3:00 PM",68,30,38,27,20,7,52,33,19,32,20,12,11,4,7,7,15,15,0,0,0,0,15,21,12,9,26,20,4,1,4,3,1,,,
"Oct 27, 2021 4:00 PM",95,26,69,33,21,12,46,18,28,38,20,18,9,4,5,9,21,18,3,0,0,0,15,20,11,9,39,31,1,1,3,1,2,,,
"Oct 27, 2021 5:00 PM",169,43,126,51,30,21,75,42,33,42,22,20,19,4,15,15,29,26,3,0,0,0,27,27,19,8,73,40,4,4,9,4,5,,,
"Oct 27, 2021 6:00 PM",125,28,97,36,24,12,60,38,22,56,35,21,18,10,8,15,35,31,4,0,0,0,28,22,15,7,73,28,3,5,8,6,2,,,
"Oct 27, 2021 7:00 PM",79,20,59,13,10,3,15,7,8,14,9,5,3,0,3,6,8,5,3,0,0,0,6,13,2,11,21,17,3,4,5,5,0,,,
"Oct 27, 2021 8:00 PM",45,8,37,8,5,3,12,9,3,14,8,6,2,0,2,6,11,9,2,0,0,0,8,8,4,4,21,14,5,0,4,2,2,,,
"Oct 27, 2021 9:00 PM",30,5,25,2,1,1,9,6,3,4,2,2,1,1,0,1,7,5,2,0,0,0,9,4,4,0,5,9,1,0,3,1,2,,,
"Oct 27, 2021 10:00 PM",10,3,7,2,2,0,4,2,2,3,0,3,1,1,0,1,1,0,1,0,0,0,0,2,2,0,3,2,2,0,1,1,0,,,
"Oct 27, 2021 11:00 PM",7,1,6,2,2,0,3,1,2,2,0,2,1,0,1,1,2,2,0,0,0,0,1,0,0,0,4,2,0,0,0,0,0,,,
"Oct 28, 2021 12:00 AM",3,0,3,0,0,0,0,0,0,0,0,0,1,1,0,1,1,1,0,0,0,0,1,0,0,0,0,2,1,0,0,0,0,,,
"Oct 28, 2021 1:00 AM",1,0,1,0,0,0,1,1,0,0,0,0,0,0,0,1,0,0,0,0,0,0,0,0,0,0,3,0,0,0,0,0,0,,,
"Oct 28, 2021 2:00 AM",5,2,3,0,0,0,0,0,0,0,0,0,0,0,0,0,1,0,1,0,0,0,0,0,0,0,2,1,0,0,0,0,0,,,
"Oct 28, 2021 3:00 AM",0,0,0,0,0,0,0,0,0,0,0,0,0,0,0,0,0,0,0,0,0,0,0,0,0,0,0,0,0,0,0,0,0,,,
"Oct 28, 2021 4:00 AM",0,0,0,0,0,0,2,2,0,0,0,0,0,0,0,0,0,0,0,0,0,0,0,0,0,0,2,0,0,0,0,0,0,,,
"Oct 28, 2021 5:00 AM",9,7,2,1,1,0,1,0,1,2,1,1,0,0,0,1,5,5,0,0,0,0,5,0,0,0,3,10,0,0,0,0,0,,,
"Oct 28, 2021 6:00 AM",25,19,6,7,4,3,11,4,7,10,3,7,3,3,0,3,13,13,0,0,0,0,14,2,1,1,8,25,1,1,1,1,0,,,
"Oct 28, 2021 7:00 AM",54,37,17,10,4,6,24,7,17,15,6,9,9,5,4,5,44,42,2,0,0,0,44,11,5,6,28,43,1,0,2,1,1,,,
"Oct 28, 2021 8:00 AM",122,97,25,24,8,16,54,24,30,34,19,15,5,5,0,7,84,84,0,0,0,0,71,19,4,15,27,75,0,1,4,3,1,,,
"Oct 28, 2021 9:00 AM",77,63,14,12,6,6,27,14,13,18,12,6,7,2,5,4,37,36,1,0,0,0,20,12,7,5,6,34,1,1,1,0,1,,,
"Oct 28, 2021 10:00 AM",41,28,13,0,0,0,4,3,1,3,3,0,2,2,0,0,16,16,0,0,0,0,11,0,0,0,1,7,1,1,0,0,0,,,
"Oct 28, 2021 11:00 AM",30,17,13,8,1,7,6,4,2,7,3,4,1,1,0,2,13,11,2,0,0,0,9,3,3,0,6,6,1,0,0,0,0,,,
"Oct 28, 2021 12:00 PM",36,20,16,9,6,3,10,7,3,13,11,2,4,2,2,2,6,5,1,0,0,0,2,2,1,1,10,10,0,2,1,1,0,,,
"Oct 28, 2021 1:00 PM",48,24,24,18,12,6,25,13,12,23,11,12,7,2,5,11,25,21,4,0,0,0,13,12,9,3,19,10,0,2,2,1,1,,,
"Oct 28, 2021 2:00 PM",75,35,40,26,11,15,35,22,13,24,18,6,12,7,5,20,20,18,2,0,0,0,15,10,8,2,14,19,2,3,6,4,2,,,
"Oct 28, 2021 3:00 PM",58,25,33,38,25,13,53,30,23,35,16,19,10,5,5,9,21,18,3,0,0,0,15,17,12,5,24,18,6,2,8,6,2,,,
"Oct 28, 2021 4:00 PM",108,36,72,53,21,32,68,31,37,55,29,26,15,6,9,12,22,18,4,0,0,0,18,26,14,12,39,38,7,1,7,5,2,,,
"Oct 28, 2021 5:00 PM",140,45,95,49,26,23,88,45,43,50,18,32,24,9,15,17,38,33,5,0,0,0,33,31,17,14,55,47,3,2,7,2,5,,,
"Oct 28, 2021 6:00 PM",136,45,91,51,26,25,72,36,36,61,29,32,23,12,11,22,35,33,2,0,0,0,29,21,15,6,46,37,3,2,5,2,3,,,
"Oct 28, 2021 7:00 PM",74,23,51,19,15,4,45,28,17,26,17,9,1,1,0,8,18,18,0,0,0,0,18,13,12,1,37,20,5,3,3,2,1,,,
"Oct 28, 2021 8:00 PM",56,9,47,17,11,6,21,14,7,9,5,4,8,3,5,10,12,10,2,0,0,0,10,5,4,1,16,17,4,0,5,3,2,,,
"Oct 28, 2021 9:00 PM",33,7,26,10,6,4,11,6,5,15,8,7,3,3,0,15,9,5,4,0,0,0,5,2,2,0,11,10,1,0,6,3,3,,,
"Oct 28, 2021 10:00 PM",25,9,16,5,4,1,4,4,0,6,5,1,2,1,1,3,2,2,0,0,0,0,4,7,4,3,10,7,2,1,2,2,0,,,
"Oct 28, 2021 11:00 PM",11,1,10,7,3,4,10,2,8,10,3,7,2,0,2,3,4,4,0,0,0,0,4,5,2,3,12,5,0,0,0,0,0,,,
"Oct 29, 2021 12:00 AM",11,3,8,0,0,0,2,2,0,4,2,2,2,2,0,2,3,2,1,0,0,0,2,0,0,0,5,2,0,0,1,1,0,,,
"Oct 29, 2021 1:00 AM",4,0,4,0,0,0,1,1,0,0,0,0,0,0,0,0,1,0,1,0,0,0,0,0,0,0,3,0,1,0,0,0,0,,,
"Oct 29, 2021 2:00 AM",4,2,2,2,2,0,0,0,0,0,0,0,0,0,0,0,0,0,0,0,0,0,0,0,0,0,0,0,0,0,0,0,0,,,
"Oct 29, 2021 3:00 AM",3,1,2,0,0,0,1,1,0,0,0,0,0,0,0,0,0,0,0,0,0,0,0,0,0,0,1,0,0,0,0,0,0,,,
"Oct 29, 2021 4:00 AM",0,0,0,0,0,0,1,1,0,0,0,0,0,0,0,0,1,0,1,0,0,0,0,0,0,0,1,1,0,0,0,0,0,,,
"Oct 29, 2021 5:00 AM",3,1,2,1,1,0,2,1,1,2,1,1,0,0,0,1,5,5,0,0,0,0,5,2,1,1,4,6,0,1,0,0,0,,,
"Oct 29, 2021 6:00 AM",19,13,6,5,1,4,10,2,8,8,2,6,2,2,0,2,6,6,0,0,0,0,7,1,1,0,8,19,0,0,1,0,1,,,
"Oct 29, 2021 7:00 AM",40,25,15,23,11,12,31,7,24,26,11,15,5,4,1,5,38,38,0,0,0,0,36,6,4,2,21,41,1,1,4,2,2,,,
"Oct 29, 2021 8:00 AM",97,71,26,24,7,17,44,21,23,29,16,13,4,4,0,4,60,60,0,0,0,0,62,14,4,10,28,61,1,0,6,5,1,,,
"Oct 29, 2021 9:00 AM",85,75,10,25,6,19,31,17,14,28,18,10,6,3,3,4,31,30,1,0,0,0,22,12,5,7,16,33,2,0,0,0,0,,,
"Oct 29, 2021 10:00 AM",71,47,24,17,7,10,40,19,21,19,10,9,8,8,0,4,28,26,2,0,0,0,16,15,7,8,8,19,5,4,4,2,2,,,
"Oct 29, 2021 11:00 AM",65,43,22,40,21,19,43,22,21,40,23,17,13,7,6,3,25,25,0,0,0,0,18,15,9,6,12,34,4,2,2,2,0,,,
"Oct 29, 2021 12:00 PM",53,24,29,63,39,24,66,38,28,55,33,22,12,7,5,7,27,25,2,0,0,0,22,41,25,16,25,21,2,2,3,3,0,,,
"Oct 29, 2021 1:00 PM",83,41,42,67,29,38,65,27,38,63,28,35,15,7,8,14,26,24,2,0,0,0,20,29,9,20,22,22,6,5,4,3,1,,,
"Oct 29, 2021 2:00 PM",77,40,37,58,36,22,88,50,38,47,32,15,23,16,7,14,23,21,2,0,0,0,19,24,13,11,35,28,10,3,7,6,1,,,
"Oct 29, 2021 3:00 PM",69,20,49,75,37,38,91,50,41,66,39,27,15,6,9,18,29,24,5,0,0,0,22,42,24,18,29,43,6,3,4,3,1,,,
"Oct 29, 2021 4:00 PM",95,31,64,80,47,33,96,53,43,79,48,31,29,14,15,26,30,26,4,0,0,0,26,35,18,17,43,32,8,3,3,3,0,,,
"Oct 29, 2021 5:00 PM",138,47,91,75,34,41,93,44,49,75,31,44,26,8,18,32,24,18,6,0,0,0,15,34,19,15,67,52,8,3,6,4,2,,,
"Oct 29, 2021 6:00 PM",91,28,63,47,26,21,77,39,38,59,32,27,17,9,8,12,32,29,3,0,0,0,30,25,17,8,54,46,3,2,11,5,6,,,
"Oct 29, 2021 7:00 PM",73,35,38,23,14,9,37,20,17,22,8,14,5,2,3,8,18,16,2,0,0,0,16,6,3,3,22,25,4,0,6,5,1,,,
"Oct 29, 2021 8:00 PM",30,13,17,11,8,3,21,13,8,13,7,6,5,1,4,6,10,8,2,0,0,0,9,5,5,0,24,15,0,0,2,1,1,,,
"Oct 29, 2021 9:00 PM",32,10,22,6,5,1,10,3,7,7,0,7,5,4,1,7,5,4,1,0,0,0,4,4,4,0,8,12,2,0,2,0,2,,,
"Oct 29, 2021 10:00 PM",21,6,15,3,2,1,10,6,4,9,6,3,1,1,0,4,3,3,0,0,0,0,3,2,2,0,5,4,3,1,1,1,0,,,
"Oct 29, 2021 11:00 PM",9,4,5,5,2,3,3,0,3,4,1,3,0,0,0,1,0,0,0,0,0,0,0,1,1,0,6,7,1,0,2,1,1,,,
"Oct 30, 2021 12:00 AM",19,7,12,0,0,0,3,2,1,5,2,3,3,1,2,1,1,1,0,0,0,0,3,4,1,3,3,2,0,1,0,0,0,,,
"Oct 30, 2021 1:00 AM",7,2,5,3,3,0,9,6,3,4,4,0,3,2,1,0,0,0,0,0,0,0,0,4,4,0,2,3,0,0,0,0,0,,,
"Oct 30, 2021 2:00 AM",6,3,3,1,1,0,2,2,0,1,1,0,0,0,0,0,0,0,0,0,0,0,0,0,0,0,3,0,0,1,0,0,0,,,
"Oct 30, 2021 3:00 AM",0,0,0,0,0,0,0,0,0,0,0,0,0,0,0,0,0,0,0,0,0,0,0,0,0,0,1,1,0,0,0,0,0,,,
"Oct 30, 2021 4:00 AM",1,1,0,1,0,1,1,0,1,1,0,1,1,1,0,1,0,0,0,0,0,0,0,0,0,0,0,0,0,0,0,0,0,,,
"Oct 30, 2021 5:00 AM",3,0,3,2,0,2,1,0,1,2,0,2,0,0,0,1,1,1,0,0,0,0,1,0,0,0,4,3,1,0,0,0,0,,,
"Oct 30, 2021 6:00 AM",13,7,6,4,0,4,9,4,5,3,0,3,1,1,0,4,3,3,0,0,0,0,3,2,1,1,4,12,1,1,1,1,0,,,
"Oct 30, 2021 7:00 AM",19,11,8,16,7,9,16,15,1,13,13,0,5,2,3,4,10,10,0,0,0,0,10,1,1,0,16,11,1,2,0,0,0,,,
"Oct 30, 2021 8:00 AM",38,17,21,43,20,23,46,29,17,43,28,15,5,4,1,4,8,8,0,0,0,0,8,12,6,6,18,21,2,3,4,1,3,,,
"Oct 30, 2021 9:00 AM",58,25,33,79,55,24,113,80,33,87,62,25,11,6,5,6,25,24,1,0,0,0,21,27,16,11,26,31,2,8,4,2,2,,,
"Oct 30, 2021 10:00 AM",75,49,26,133,67,66,126,74,52,112,68,44,15,11,4,10,20,17,3,0,0,0,18,31,17,14,33,21,4,2,4,2,2,,,
"Oct 30, 2021 11:00 AM",71,40,31,120,56,64,144,58,86,128,73,55,17,9,8,15,35,35,0,0,0,0,32,45,21,24,42,46,6,10,11,9,2,,,
"Oct 30, 2021 12:00 PM",79,39,40,172,67,105,172,91,81,144,76,68,34,15,19,21,26,25,1,0,0,0,19,40,23,17,40,38,8,7,8,4,4,,,
"Oct 30, 2021 1:00 PM",77,40,37,134,77,57,140,68,72,129,72,57,23,11,12,12,27,26,1,0,0,0,21,52,33,19,47,57,3,3,5,3,2,,,
"Oct 30, 2021 2:00 PM",92,40,52,154,73,81,155,92,63,135,77,58,30,22,8,29,30,27,3,0,0,0,24,51,30,21,52,38,8,9,7,5,2,,,
"Oct 30, 2021 3:00 PM",70,33,37,149,71,78,121,64,57,119,58,61,20,14,6,22,18,17,1,0,0,0,18,65,36,29,40,46,8,3,8,4,4,,,
"Oct 30, 2021 4:00 PM",71,34,37,132,66,66,137,63,74,113,59,54,27,13,14,22,22,21,1,0,0,0,22,56,29,27,36,45,7,3,2,0,2,,,
"Oct 30, 2021 5:00 PM",60,24,36,109,55,54,127,47,80,106,47,59,34,12,22,33,28,27,1,0,0,0,20,39,15,24,30,48,1,2,4,3,1,,,
"Oct 30, 2021 6:00 PM",59,24,35,53,25,28,68,15,53,49,11,38,10,4,6,18,15,15,0,0,0,0,16,26,12,14,25,38,0,3,3,1,2,,,
"Oct 30, 2021 7:00 PM",41,15,26,9,5,4,20,10,10,12,7,5,5,3,2,8,8,8,0,0,0,0,9,9,6,3,11,22,3,3,7,5,2,,,
"Oct 30, 2021 8:00 PM",30,15,15,6,4,2,13,10,3,6,4,2,3,0,3,2,8,8,0,0,0,0,8,3,2,1,14,6,1,0,4,1,3,,,
"Oct 30, 2021 9:00 PM",15,4,11,10,6,4,9,4,5,10,6,4,1,1,0,1,9,9,0,0,0,0,8,5,2,3,7,4,0,0,1,1,0,,,
"Oct 30, 2021 10:00 PM",11,5,6,9,8,1,11,6,5,7,4,3,1,0,1,1,4,3,1,0,0,0,3,3,1,2,3,8,1,1,1,1,0,,,
"Oct 30, 2021 11:00 PM",14,7,7,12,6,6,9,3,6,6,1,5,4,0,4,3,4,4,0,0,0,0,3,2,0,2,8,7,0,1,0,0,0,,,
"Oct 31, 2021 12:00 AM",6,1,5,0,0,0,0,0,0,4,2,2,3,1,2,4,2,2,0,0,0,0,1,1,1,0,0,4,0,0,2,1,1,,,
"Oct 31, 2021 1:00 AM",8,5,3,2,0,2,8,3,5,7,2,5,2,1,1,0,1,1,0,0,0,0,1,2,2,0,5,16,0,0,1,0,1,,,
"Oct 31, 2021 2:00 AM",5,0,5,0,0,0,0,0,0,0,0,0,0,0,0,0,0,0,0,0,0,0,1,0,0,0,4,0,0,1,0,0,0,,,
"Oct 31, 2021 3:00 AM",2,1,1,4,0,4,0,0,0,2,0,2,0,0,0,2,1,1,0,0,0,0,2,0,0,0,3,1,0,0,0,0,0,,,
"Oct 31, 2021 4:00 AM",1,0,1,3,3,0,1,1,0,4,4,0,0,0,0,0,1,1,0,0,0,0,1,0,0,0,2,0,0,0,0,0,0,,,
"Oct 31, 2021 5:00 AM",1,1,0,1,1,0,0,0,0,0,0,0,0,0,0,1,0,0,0,0,0,0,0,0,0,0,1,3,1,0,0,0,0,,,
"Oct 31, 2021 6:00 AM",15,6,9,7,1,6,11,5,6,6,1,5,1,0,1,3,5,5,0,0,0,0,7,1,1,0,9,9,1,1,0,0,0,,,
"Oct 31, 2021 7:00 AM",10,4,6,19,13,6,20,16,4,22,14,8,0,0,0,3,9,9,0,0,0,0,10,5,4,1,11,16,1,3,0,0,0,,,
"Oct 31, 2021 8:00 AM",29,16,13,79,54,25,92,70,22,78,58,20,3,1,2,5,18,18,0,0,0,0,19,25,14,11,30,28,1,6,0,0,0,,,
"Oct 31, 2021 9:00 AM",39,20,19,130,77,53,171,108,63,98,66,32,5,3,2,17,21,20,1,0,0,0,19,43,33,10,38,39,9,20,7,7,0,,,
"Oct 31, 2021 10:00 AM",51,29,22,194,99,95,209,119,90,174,98,76,18,11,7,16,41,40,1,0,0,0,43,62,38,24,45,51,4,6,8,5,3,,,
"Oct 31, 2021 11:00 AM",74,35,39,180,89,91,198,111,87,178,105,73,26,10,16,25,24,22,2,0,0,0,19,70,40,30,58,59,9,6,11,9,2,,,
"Oct 31, 2021 12:00 PM",74,36,38,154,78,76,126,58,68,127,62,65,17,9,8,17,23,22,1,0,0,0,22,47,31,16,27,35,15,5,13,10,3,,,
"Oct 31, 2021 1:00 PM",47,30,17,120,62,58,105,49,56,84,38,46,35,18,17,14,25,22,3,0,0,0,21,34,20,14,31,35,8,3,7,7,0,,,
"Oct 31, 2021 2:00 PM",47,35,12,93,33,60,85,28,57,79,29,50,10,5,5,9,18,17,1,0,0,0,15,34,9,25,24,31,9,1,3,3,0,,,
"Oct 31, 2021 3:00 PM",32,20,12,56,32,24,58,26,32,50,21,29,12,4,8,12,18,18,0,0,0,0,18,33,18,15,19,30,1,3,8,6,2,,,
"Oct 31, 2021 4:00 PM",45,25,20,41,16,25,49,22,27,41,15,26,13,6,7,9,14,12,2,0,0,0,14,15,7,8,16,25,3,1,4,4,0,,,
"Oct 31, 2021 5:00 PM",38,13,25,30,16,14,30,17,13,32,15,17,4,1,3,5,10,10,0,0,0,0,9,5,3,2,20,6,1,0,2,1,1,,,
"Oct 31, 2021 6:00 PM",24,7,17,14,6,8,14,9,5,9,4,5,4,2,2,5,5,4,1,0,0,0,5,4,2,2,7,9,0,0,3,2,1,,,
"Oct 31, 2021 7:00 PM",19,7,12,7,2,5,9,3,6,8,2,6,2,0,2,5,10,10,0,0,0,0,10,1,1,0,6,9,0,2,5,3,2,,,
"Oct 31, 2021 8:00 PM",11,6,5,3,2,1,8,2,6,4,2,2,3,1,2,4,5,5,0,0,0,0,5,3,1,2,8,7,0,0,2,2,0,,,
"Oct 31, 2021 9:00 PM",9,2,7,3,2,1,2,0,2,2,1,1,1,1,0,0,2,2,0,0,0,0,2,1,1,0,3,5,0,0,3,1,2,,,
"Oct 31, 2021 10:00 PM",8,4,4,0,0,0,2,1,1,2,1,1,1,1,0,1,1,0,1,0,0,0,0,1,0,1,4,2,0,1,1,0,1,,,
"Oct 31, 2021 11:00 PM",1,0,1,1,1,0,2,2,0,4,3,1,0,0,0,1,2,2,0,0,0,0,2,0,0,0,3,1,0,0,2,1,1,,,
"Nov 1, 2021 12:00 AM",2,1,1,2,1,1,5,1,4,2,0,2,0,0,0,1,3,3,0,0,0,0,3,2,1,1,1,1,0,0,4,3,1,,,
"Nov 1, 2021 1:00 AM",7,4,3,0,0,0,0,0,0,1,0,1,,,,0,0,0,0,0,0,0,0,0,0,0,3,1,0,1,1,0,1,,,
"Nov 1, 2021 2:00 AM",2,2,0,0,0,0,0,0,0,0,0,0,0,0,0,0,0,0,,0,0,0,0,0,0,0,1,1,0,0,1,0,1,,,
"Nov 1, 2021 3:00 AM",4,3,1,0,0,0,1,1,0,0,0,0,0,0,0,0,0,0,0,0,0,0,2,0,0,0,1,0,0,0,0,0,0,,,
"Nov 1, 2021 4:00 AM",0,0,,2,1,1,1,1,0,2,1,1,0,0,0,4,0,0,0,0,0,0,8,0,0,0,0,8,0,0,,,,,,
"Nov 1, 2021 5:00 AM",5,4,1,1,1,0,5,2,3,2,1,1,0,0,0,1,3,3,0,0,0,0,5,0,0,0,3,11,0,0,0,0,0,,,
"Nov 1, 2021 6:00 AM",27,16,11,9,1,8,15,4,11,13,3,10,5,5,0,1,14,14,0,0,0,0,13,4,0,4,12,27,0,2,0,0,0,,,
"Nov 1, 2021 7:00 AM",112,76,36,41,9,32,68,16,52,50,16,34,10,8,2,6,70,70,0,0,0,0,74,28,9,19,43,86,2,1,8,6,2,,,
"Nov 1, 2021 8:00 AM",225,169,56,60,13,47,113,39,74,87,31,56,28,21,7,20,149,147,2,0,0,0,127,54,12,42,44,147,7,1,10,9,1,,,
"Nov 1, 2021 9:00 AM",141,120,21,36,16,20,60,25,35,46,23,23,9,5,4,5,81,79,2,0,0,0,60,26,15,11,20,39,2,0,1,1,0,,,
"Nov 1, 2021 10:00 AM",74,52,22,18,5,13,29,15,14,16,8,8,4,4,0,4,29,29,0,0,0,0,24,8,4,4,12,26,2,3,1,1,0,,,
"Nov 1, 2021 11:00 AM",59,31,28,19,12,7,37,22,15,21,14,7,21,13,8,3,33,29,4,0,0,0,20,13,6,7,18,21,1,1,2,1,1,,,
"Nov 1, 2021 12:00 PM",61,31,30,35,15,20,36,21,15,23,13,10,16,8,8,11,39,39,0,0,0,0,36,15,13,2,13,14,2,1,2,2,0,,,
"Nov 1, 2021 1:00 PM",94,39,55,41,24,17,50,28,22,42,24,18,8,2,6,14,22,19,3,0,0,0,13,15,6,9,19,27,2,3,3,1,2,,,
"Nov 1, 2021 2:00 PM",84,36,48,43,23,20,43,25,18,38,25,13,12,5,7,18,21,21,0,0,0,0,16,23,18,5,26,12,4,2,7,4,3,,,
"Nov 1, 2021 3:00 PM",76,27,49,67,37,30,76,46,30,51,25,26,10,5,5,13,40,37,3,0,0,0,31,20,15,5,35,35,3,0,2,2,0,,,
"Nov 1, 2021 4:00 PM",145,44,101,54,35,19,78,47,31,56,34,22,16,4,12,19,39,31,8,0,0,0,32,37,25,12,51,48,5,3,11,1,10,,,
"Nov 1, 2021 5:00 PM",189,45,144,43,28,15,70,40,30,49,26,23,20,4,16,22,36,31,5,0,0,0,26,28,19,9,75,47,6,2,12,4,8,,,
"Nov 1, 2021 6:00 PM",159,30,129,26,21,5,61,39,22,54,36,18,10,4,6,15,37,28,9,0,0,0,25,31,27,4,80,37,3,3,2,0,2,,,
"Nov 1, 2021 7:00 PM",80,27,53,15,10,5,31,22,9,23,16,7,7,1,6,8,16,12,4,0,0,0,14,12,10,2,25,21,2,2,0,0,0,,,
"Nov 1, 2021 8:00 PM",70,11,59,11,7,4,22,13,9,17,11,6,2,1,1,6,14,11,3,0,0,0,12,4,2,2,23,13,2,0,2,0,2,,,
"Nov 1, 2021 9:00 PM",36,10,26,5,3,2,6,1,5,5,1,4,2,2,0,4,6,4,2,0,0,0,3,5,4,1,11,5,1,0,1,1,0,,,
"Nov 1, 2021 10:00 PM",14,4,10,5,5,0,5,4,1,6,4,2,1,1,0,4,3,1,2,0,0,0,2,2,2,0,6,3,2,1,0,0,0,,,
"Nov 1, 2021 11:00 PM",10,2,8,,,,,,,2,2,0,0,0,0,0,2,2,0,0,0,0,2,0,0,0,5,1,0,0,0,0,0,,,
"Nov 2, 2021 12:00 AM",3,1,2,0,0,0,0,0,0,,,,1,1,0,0,0,0,0,0,0,0,0,1,1,0,2,0,0,0,1,0,1,,,
"Nov 2, 2021 1:00 AM",1,1,0,0,0,0,0,0,0,0,0,0,0,0,0,0,1,0,1,0,0,0,1,0,0,0,1,0,0,0,0,0,0,,,
"Nov 2, 2021 2:00 AM",3,3,0,0,0,0,1,1,0,1,1,0,0,0,0,0,0,0,0,0,0,0,0,0,0,0,1,0,0,0,0,0,0,,,
"Nov 2, 2021 3:00 AM",0,0,0,4,2,2,2,1,1,2,1,1,0,0,0,0,0,0,0,0,0,0,0,0,0,0,0,0,0,0,0,0,0,,,
"Nov 2, 2021 4:00 AM",1,1,0,1,1,0,1,1,0,0,0,0,0,0,0,4,0,0,0,0,0,0,0,0,0,0,1,0,0,0,1,1,0,,,
"Nov 2, 2021 5:00 AM",7,5,2,1,0,1,2,1,1,1,0,1,0,0,0,3,4,4,0,0,0,0,5,0,0,0,2,9,1,0,2,2,0,,,
"Nov 2, 2021 6:00 AM",37,25,12,29,14,15,36,13,23,33,16,17,4,2,2,4,23,23,0,0,0,0,23,7,3,4,24,37,3,1,3,3,0,,,
"Nov 2, 2021 7:00 AM",111,75,36,65,19,46,94,30,64,66,26,40,13,12,1,10,71,71,0,0,0,0,74,32,10,22,39,90,4,5,6,4,2,,,
"Nov 2, 2021 8:00 AM",284,216,68,113,29,84,189,62,127,124,49,75,41,31,10,28,199,193,6,0,0,0,183,74,22,52,65,202,8,4,16,12,4,,,
"Nov 2, 2021 9:00 AM",131,110,21,69,23,46,112,53,59,82,41,41,24,12,12,7,73,73,0,0,0,0,63,32,11,21,28,58,3,2,2,2,0,,,
"Nov 2, 2021 10:00 AM",98,83,15,49,28,21,74,38,36,46,25,21,10,6,4,11,61,59,2,0,0,0,42,20,11,9,22,35,5,2,7,6,1,,,
"Nov 2, 2021 11:00 AM",93,59,34,53,28,25,73,29,44,55,28,27,13,8,5,7,34,31,3,0,0,0,23,24,14,10,20,28,6,2,7,5,2,,,
"Nov 2, 2021 12:00 PM",74,37,37,52,25,27,60,31,29,42,17,25,13,5,8,8,38,38,0,0,0,0,34,18,9,9,24,22,5,2,2,2,0,,,
"Nov 2, 2021 1:00 PM",106,51,55,66,31,35,70,32,38,45,27,18,10,3,7,10,37,35,2,0,0,0,30,29,17,12,30,34,4,3,5,3,2,,,
"Nov 2, 2021 2:00 PM",78,43,35,49,22,27,44,25,19,37,25,12,24,14,10,17,37,33,4,0,0,0,26,21,15,6,37,25,2,1,6,3,3,,,
"Nov 2, 2021 3:00 PM",114,41,73,63,41,22,72,52,20,65,40,25,24,8,16,16,50,41,9,0,0,0,37,25,18,7,42,42,3,3,8,1,7,,,
"Nov 2, 2021 4:00 PM",172,62,110,64,35,29,103,62,41,75,44,31,13,6,7,19,29,25,4,0,0,0,26,22,18,4,80,49,6,3,7,1,6,,,
"Nov 2, 2021 5:00 PM",241,43,198,61,47,14,96,53,43,76,45,31,31,3,28,15,46,34,12,0,0,0,34,37,26,11,107,64,10,3,11,5,6,,,
"Nov 2, 2021 6:00 PM",211,60,151,54,40,14,89,59,30,74,43,31,22,6,16,15,36,31,5,0,0,0,31,35,25,10,102,43,4,1,2,0,2,,,
"Nov 2, 2021 7:00 PM",124,37,87,29,20,9,61,43,18,39,28,11,9,3,6,9,20,17,3,0,0,0,15,26,17,9,42,19,5,3,7,5,2,,,
"Nov 2, 2021 8:00 PM",82,17,65,12,5,7,22,14,8,22,11,11,4,2,2,6,13,8,5,0,0,0,9,6,3,3,28,15,5,0,3,3,0,,,
"Nov 2, 2021 9:00 PM",46,8,38,8,8,0,21,14,7,14,6,8,2,0,2,8,13,10,3,0,0,0,10,4,2,2,22,19,1,0,1,0,1,,,
"Nov 2, 2021 10:00 PM",35,10,25,5,5,0,7,4,3,7,5,2,1,1,0,5,2,1,1,0,0,0,2,5,3,2,10,1,1,3,0,0,0,,,
"Nov 2, 2021 11:00 PM",15,2,13,2,2,0,6,0,6,4,1,3,0,0,0,1,0,0,0,0,0,0,0,1,0,1,2,3,0,0,2,1,1,,,
"Nov 3, 2021 12:00 AM",6,2,4,0,0,0,0,0,0,1,0,1,2,2,0,0,1,1,0,0,0,0,1,2,1,1,2,1,0,0,0,0,0,,,
"Nov 3, 2021 1:00 AM",3,1,2,0,0,0,1,0,1,1,0,1,1,0,1,0,2,2,0,0,0,0,2,1,0,1,0,0,0,0,0,0,0,,,
"Nov 3, 2021 2:00 AM",7,6,1,0,0,0,1,1,0,1,1,0,0,0,0,0,0,0,0,0,0,0,0,0,0,0,2,0,0,0,0,0,0,,,
"Nov 3, 2021 3:00 AM",0,0,0,0,0,0,0,0,0,0,0,0,0,0,0,0,0,0,0,0,0,0,0,0,0,0,0,1,0,0,0,0,0,,,
"Nov 3, 2021 4:00 AM",2,1,1,1,0,1,2,1,1,1,0,1,0,0,0,3,0,0,0,0,0,0,0,0,0,0,2,3,0,0,0,0,0,,,
"Nov 3, 2021 5:00 AM",9,6,3,4,0,4,3,1,2,3,1,2,0,0,0,2,6,6,0,0,0,0,8,0,0,0,1,12,1,0,1,1,0,,,
"Nov 3, 2021 6:00 AM",38,29,9,23,10,13,25,12,13,24,13,11,3,3,0,5,20,20,0,0,0,0,17,8,6,2,19,33,1,2,3,3,0,,,
"Nov 3, 2021 7:00 AM",114,75,39,61,25,36,101,36,65,65,30,35,8,6,2,13,95,94,1,0,0,0,94,30,20,10,45,98,4,4,9,7,2,,,
"Nov 3, 2021 8:00 AM",285,203,82,110,35,75,159,50,109,119,42,77,47,35,12,25,210,206,4,0,0,0,185,70,19,51,65,205,10,5,15,12,3,,,
"Nov 3, 2021 9:00 AM",183,143,40,65,27,38,93,51,42,73,37,36,20,9,11,4,92,91,1,0,0,0,64,36,19,17,32,71,1,3,5,2,3,,,
"Nov 3, 2021 10:00 AM",84,56,28,47,24,23,79,50,29,48,30,18,9,6,3,9,49,47,2,0,0,0,39,33,22,11,24,41,3,1,2,2,0,,,
"Nov 3, 2021 11:00 AM",79,46,33,48,26,22,68,28,40,53,29,24,16,9,7,13,36,35,1,0,0,0,30,25,12,13,25,25,7,6,6,5,1,,,
"Nov 3, 2021 12:00 PM",80,41,39,72,31,41,85,32,53,62,25,37,21,10,11,5,51,48,3,0,0,0,32,35,15,20,23,31,3,2,4,3,1,,,
"Nov 3, 2021 1:00 PM",109,51,58,91,59,32,99,70,29,92,61,31,29,11,18,28,38,35,3,0,0,0,34,43,30,13,41,32,6,3,4,3,1,,,
"Nov 3, 2021 2:00 PM",89,41,48,35,21,14,46,26,20,42,29,13,20,8,12,20,37,28,9,0,0,0,20,29,19,10,23,29,4,4,2,1,1,,,
"Nov 3, 2021 3:00 PM",93,40,53,37,20,17,51,35,16,40,19,21,16,7,9,11,44,39,5,0,0,0,35,16,12,4,40,30,2,3,6,4,2,,,
"Nov 3, 2021 4:00 PM",158,51,107,45,33,12,70,44,26,60,32,28,27,7,20,17,32,25,7,0,0,0,21,21,15,6,54,53,4,5,7,4,3,,,
"Nov 3, 2021 5:00 PM",219,48,171,64,46,18,92,54,38,73,43,30,20,6,14,20,40,28,12,0,0,0,26,32,28,4,103,55,5,5,13,9,4,,,
"Nov 3, 2021 6:00 PM",201,56,145,38,27,11,79,58,21,47,36,11,17,8,9,17,54,42,12,0,0,0,44,42,25,17,91,57,1,3,7,3,4,,,
"Nov 3, 2021 7:00 PM",116,43,73,32,23,9,45,33,12,39,28,11,11,1,10,20,22,15,7,0,0,0,15,16,12,4,53,33,2,1,3,3,0,,,
"Nov 3, 2021 8:00 PM",74,22,52,18,13,5,27,17,10,22,13,9,1,0,1,6,15,13,2,0,0,0,15,12,10,2,29,12,3,0,1,1,0,,,
"Nov 3, 2021 9:00 PM",61,13,48,11,6,5,16,6,10,15,4,11,0,0,0,4,14,8,6,0,0,0,10,8,4,4,7,12,3,1,1,0,1,,,
"Nov 3, 2021 10:00 PM",25,5,20,7,3,4,12,5,7,10,4,6,1,0,1,3,5,3,2,0,0,0,3,2,2,0,9,10,2,0,2,2,0,,,
"Nov 3, 2021 11:00 PM",12,3,9,2,2,0,2,1,1,1,1,0,2,1,1,2,2,2,0,0,0,0,2,0,0,0,5,3,0,0,0,0,0,,,
"Nov 4, 2021 12:00 AM",6,1,5,0,0,0,0,0,0,2,1,1,3,2,1,2,0,0,0,0,0,0,0,0,0,0,4,2,0,0,0,0,0,,,
"Nov 4, 2021 1:00 AM",2,1,1,0,0,0,0,0,0,0,0,0,0,0,0,0,0,0,0,0,0,0,0,0,0,0,1,0,0,0,1,1,0,,,
"Nov 4, 2021 2:00 AM",5,4,1,0,0,0,1,1,0,2,1,1,0,0,0,0,0,0,0,0,0,0,0,0,0,0,2,0,0,0,0,0,0,,,
"Nov 4, 2021 3:00 AM",0,0,0,0,0,0,0,0,0,0,0,0,0,0,0,0,0,0,0,0,0,0,0,0,0,0,1,2,0,0,0,0,0,,,
"Nov 4, 2021 4:00 AM",2,1,1,0,0,0,2,1,1,1,0,1,0,0,0,0,0,0,0,0,0,0,0,0,0,0,2,0,0,0,1,1,0,,,
"Nov 4, 2021 5:00 AM",7,5,2,2,1,1,5,5,0,4,4,0,0,0,0,2,7,7,0,0,0,0,11,1,1,0,2,9,1,1,1,1,0,,,
"Nov 4, 2021 6:00 AM",40,27,13,20,10,10,23,7,16,20,7,13,5,4,1,5,20,20,0,0,0,0,18,2,1,1,18,30,1,1,0,0,0,,,
"Nov 4, 2021 7:00 AM",118,79,39,60,21,39,92,33,59,67,28,39,10,9,1,14,68,68,0,0,0,0,64,36,9,27,42,87,3,2,4,4,0,,,
"Nov 4, 2021 8:00 AM",257,190,67,112,30,82,152,43,109,121,51,70,44,32,12,31,188,184,4,0,0,0,172,64,12,52,67,207,6,4,14,13,1,,,
"Nov 4, 2021 9:00 AM",134,105,29,80,32,48,107,62,45,85,44,41,21,8,13,17,88,88,0,0,0,0,71,38,27,11,30,80,0,3,0,0,0,,,
"Nov 4, 2021 10:00 AM",94,70,24,45,18,27,63,30,33,45,20,25,9,7,2,13,49,49,0,0,0,0,39,13,4,9,21,39,1,4,1,1,0,,,
"Nov 4, 2021 11:00 AM",66,38,28,50,22,28,68,36,32,47,22,25,13,6,7,4,27,24,3,0,0,0,21,15,12,3,33,35,2,1,0,0,0,,,
"Nov 4, 2021 12:00 PM",82,47,35,42,20,22,72,37,35,45,26,19,22,10,12,13,28,24,4,0,0,0,20,23,16,7,31,38,2,5,7,4,3,,,
"Nov 4, 2021 1:00 PM",86,50,36,54,34,20,65,34,31,44,26,18,17,10,7,21,31,27,4,0,0,0,22,19,14,5,25,25,5,1,4,2,2,,,
"Nov 4, 2021 2:00 PM",84,36,48,51,37,14,63,34,29,53,34,19,19,12,7,20,41,33,8,0,0,0,24,25,16,9,38,32,7,4,10,6,4,,,
"Nov 4, 2021 3:00 PM",113,41,72,44,25,19,74,42,32,54,33,21,18,9,9,28,32,29,3,0,0,0,21,16,9,7,49,33,4,3,3,1,2,,,
"Nov 4, 2021 4:00 PM",165,54,111,52,32,20,104,65,39,66,36,30,18,8,10,18,38,26,12,0,0,0,25,43,31,12,56,47,6,6,4,3,1,,,
"Nov 4, 2021 5:00 PM",207,62,145,47,31,16,85,48,37,60,31,29,20,5,15,13,47,38,9,0,0,0,42,43,33,10,90,57,8,3,8,3,5,,,
"Nov 4, 2021 6:00 PM",162,40,122,43,30,13,72,47,25,58,35,23,20,3,17,9,37,33,4,0,0,0,34,26,22,4,89,37,3,0,3,2,1,,,
"Nov 4, 2021 7:00 PM",112,34,78,37,24,13,38,28,10,35,23,12,8,0,8,8,25,21,4,0,0,0,22,17,15,2,42,25,5,1,6,4,2,,,
"Nov 4, 2021 8:00 PM",84,25,59,7,6,1,27,16,11,11,7,4,11,3,8,8,12,11,1,0,0,0,10,8,8,0,23,24,0,1,0,0,0,,,
"Nov 4, 2021 9:00 PM",41,15,26,9,9,0,12,7,5,5,3,2,3,1,2,5,14,13,1,0,0,0,14,6,4,2,18,16,2,0,1,1,0,,,
"Nov 4, 2021 10:00 PM",34,6,28,5,4,1,10,7,3,6,3,3,1,1,0,8,3,2,1,0,0,0,2,4,3,1,16,8,3,1,1,1,0,,,
"Nov 4, 2021 11:00 PM",14,5,9,5,4,1,5,2,3,2,1,1,2,0,2,2,3,2,1,0,0,0,2,2,1,1,6,4,0,2,1,1,0,,,
"Nov 5, 2021 12:00 AM",8,0,8,0,0,0,2,1,1,2,1,1,0,0,0,1,3,3,0,0,0,0,2,0,0,0,5,5,0,0,0,0,0,,,
"Nov 5, 2021 1:00 AM",8,2,6,0,0,0,0,0,0,0,0,0,0,0,0,0,4,2,2,0,0,0,1,0,0,0,1,1,0,0,0,0,0,,,
"Nov 5, 2021 2:00 AM",9,5,4,1,0,1,0,0,0,0,0,0,0,0,0,0,0,0,0,0,0,0,1,0,0,0,0,0,0,0,0,0,0,,,
"Nov 5, 2021 3:00 AM",3,2,1,0,0,0,1,1,0,0,0,0,0,0,0,0,0,0,0,0,0,0,0,0,0,0,2,0,0,0,0,0,0,,,
"Nov 5, 2021 4:00 AM",2,2,0,0,0,0,1,1,0,0,0,0,0,0,0,2,2,1,1,0,0,0,1,0,0,0,1,1,0,0,0,0,0,,,
"Nov 5, 2021 5:00 AM",7,5,2,2,1,1,4,2,2,4,2,2,0,0,0,1,7,7,0,0,0,0,7,1,1,0,2,14,0,1,0,0,0,,,
"Nov 5, 2021 6:00 AM",37,26,11,25,10,15,25,13,12,21,10,11,5,5,0,2,16,16,0,0,0,0,16,5,4,1,17,29,4,1,2,2,0,,,
"Nov 5, 2021 7:00 AM",97,62,35,72,23,49,78,26,52,64,21,43,8,8,0,8,64,64,0,0,0,0,66,30,22,8,43,88,2,4,6,6,0,,,
"Nov 5, 2021 8:00 AM",229,172,57,96,28,68,145,47,98,104,31,73,35,26,9,25,122,120,2,0,0,0,111,62,40,22,53,164,12,0,12,9,3,,,
"Nov 5, 2021 9:00 AM",129,101,28,59,20,39,86,52,34,67,35,32,20,10,10,5,69,68,1,0,0,0,59,41,40,1,20,56,2,4,4,1,3,,,
"Nov 5, 2021 10:00 AM",81,54,27,54,25,29,65,35,30,45,28,17,19,14,5,9,42,41,1,0,0,0,35,20,20,0,22,34,4,3,1,1,0,,,
"Nov 5, 2021 11:00 AM",75,46,29,49,24,25,74,40,34,48,23,25,22,9,13,11,32,29,3,0,0,0,19,32,32,0,21,25,6,2,1,1,0,,,
"Nov 5, 2021 12:00 PM",100,47,53,44,26,18,73,36,37,50,27,23,17,6,11,13,41,37,4,0,0,0,35,20,20,0,23,36,6,6,4,2,2,,,
"Nov 5, 2021 1:00 PM",133,62,71,59,38,21,97,52,45,59,39,20,15,4,11,15,39,32,7,0,0,0,29,29,27,2,41,27,8,3,2,1,1,,,
"Nov 5, 2021 2:00 PM",68,39,29,50,30,20,61,34,27,46,27,19,16,6,10,17,25,25,0,0,0,0,25,16,14,2,34,31,3,2,9,5,4,,,
"Nov 5, 2021 3:00 PM",101,40,61,49,23,26,79,40,39,52,26,26,21,7,14,18,34,30,4,0,0,0,26,36,10,26,45,32,5,2,8,6,2,,,
"Nov 5, 2021 4:00 PM",151,47,104,54,39,15,95,59,36,76,45,31,17,5,12,23,38,33,5,0,0,0,32,36,19,17,65,44,8,7,6,5,1,,,
"Nov 5, 2021 5:00 PM",176,50,126,43,30,13,78,49,29,53,31,22,13,3,10,23,35,25,10,0,0,0,22,28,12,16,60,48,4,2,5,2,3,,,
"Nov 5, 2021 6:00 PM",147,46,101,38,25,13,56,44,12,49,36,13,5,0,5,16,27,21,6,0,0,0,20,19,15,4,58,30,0,3,5,2,3,,,
"Nov 5, 2021 7:00 PM",95,35,60,26,17,9,41,29,12,33,21,12,7,1,6,7,16,14,2,0,0,0,13,10,10,0,19,30,4,1,5,4,1,,,
"Nov 5, 2021 8:00 PM",58,18,40,11,8,3,17,11,6,12,6,6,5,4,1,7,11,7,4,0,0,0,7,2,2,0,16,20,2,1,2,0,2,,,
"Nov 5, 2021 9:00 PM",32,8,24,10,5,5,13,6,7,8,1,7,0,0,0,7,8,7,1,0,0,0,4,2,2,0,7,15,1,2,4,3,1,,,
"Nov 5, 2021 10:00 PM",29,9,20,7,6,1,12,7,5,11,6,5,1,1,0,5,9,8,1,0,0,0,6,4,3,1,13,7,2,1,4,3,1,,,
"Nov 5, 2021 11:00 PM",10,2,8,3,2,1,15,4,11,9,3,6,1,0,1,5,1,1,0,0,0,0,1,0,0,0,5,11,0,1,1,1,0,,,
"Nov 6, 2021 12:00 AM",13,2,11,1,0,1,5,0,5,11,3,8,3,3,0,2,4,4,0,0,0,0,4,4,3,1,11,2,0,0,3,2,1,,,
"Nov 6, 2021 1:00 AM",8,2,6,5,3,2,4,3,1,5,3,2,1,1,0,0,1,0,1,0,0,0,0,1,1,0,9,4,1,1,1,1,0,,,
"Nov 6, 2021 2:00 AM",6,1,5,2,1,1,4,3,1,6,2,4,1,0,1,0,1,0,1,0,0,0,0,0,0,0,6,0,0,0,1,1,0,,,
"Nov 6, 2021 3:00 AM",3,1,2,0,0,0,1,0,1,1,1,0,2,2,0,2,0,0,0,0,0,0,0,0,0,0,2,1,1,0,1,0,1,,,
"Nov 6, 2021 4:00 AM",2,1,1,2,1,1,3,1,2,1,0,1,0,0,0,1,1,1,0,0,0,0,1,0,0,0,1,1,0,0,0,0,0,,,
"Nov 6, 2021 5:00 AM",2,1,1,1,0,1,1,0,1,1,0,1,0,0,0,0,1,1,0,0,0,0,2,0,0,0,2,4,0,0,0,0,0,,,
"Nov 6, 2021 6:00 AM",12,8,4,2,1,1,5,3,2,3,2,1,1,1,0,2,5,4,1,0,0,0,6,0,0,0,8,7,0,0,0,0,0,,,
"Nov 6, 2021 7:00 AM",21,12,9,21,15,6,23,18,5,22,19,3,5,3,2,6,8,8,0,0,0,0,8,5,5,0,11,23,3,1,2,1,1,,,
"Nov 6, 2021 8:00 AM",40,14,26,48,27,21,47,25,22,37,24,13,13,4,9,4,18,18,0,0,0,0,18,9,7,2,13,24,2,3,0,0,0,,,
"Nov 6, 2021 9:00 AM",50,30,20,79,41,38,71,44,27,69,45,24,22,14,8,9,20,19,1,0,0,0,16,26,15,11,16,27,2,2,3,3,0,,,
"Nov 6, 2021 10:00 AM",60,30,30,99,51,48,91,52,39,83,45,38,28,17,11,17,21,20,1,0,0,0,19,35,24,11,25,28,3,1,4,4,0,,,
"Nov 6, 2021 11:00 AM",53,36,17,95,42,53,95,44,51,69,43,26,28,13,15,12,26,24,2,0,0,0,24,36,24,12,31,26,3,4,1,1,0,,,
"Nov 6, 2021 12:00 PM",59,38,21,55,22,33,86,36,50,57,21,36,12,6,6,20,24,23,1,0,0,0,18,30,17,13,23,32,2,1,4,3,1,,,
"Nov 6, 2021 1:00 PM",52,32,20,55,29,26,59,32,27,61,28,33,19,14,5,13,22,21,1,0,0,0,16,32,15,17,20,26,3,2,2,1,1,,,
"Nov 6, 2021 2:00 PM",38,22,16,32,18,14,56,28,28,36,18,18,16,10,6,19,21,20,1,0,0,0,18,13,9,4,13,18,5,3,1,1,0,,,
"Nov 6, 2021 3:00 PM",51,22,29,50,16,34,49,25,24,37,21,16,12,6,6,11,22,19,3,0,0,0,21,25,15,10,29,14,4,1,5,4,1,,,
"Nov 6, 2021 4:00 PM",71,30,41,40,23,17,56,38,18,39,21,18,5,3,2,7,11,11,0,0,0,0,8,34,23,11,23,22,3,2,9,6,3,,,
"Nov 6, 2021 5:00 PM",47,21,26,32,20,12,42,24,18,51,27,24,16,7,9,14,15,14,1,0,0,0,13,11,10,1,14,27,2,3,2,1,1,,,
"Nov 6, 2021 6:00 PM",33,13,20,5,4,1,18,9,9,12,7,5,5,3,2,7,7,5,2,0,0,0,5,6,6,0,17,15,3,0,1,0,1,,,
"Nov 6, 2021 7:00 PM",29,13,16,16,7,9,14,9,5,15,9,6,9,1,8,4,8,8,0,0,0,0,6,6,6,0,10,14,1,1,2,1,1,,,
"Nov 6, 2021 8:00 PM",24,13,11,6,4,2,10,5,5,8,6,2,11,3,8,4,10,10,0,0,0,0,8,3,3,0,6,8,1,0,2,1,1,,,
"Nov 6, 2021 9:00 PM",16,7,9,12,7,5,7,4,3,7,5,2,1,0,1,1,5,5,0,0,0,0,5,1,1,0,7,5,2,0,2,0,2,,,
"Nov 6, 2021 10:00 PM",14,6,8,9,7,2,7,2,5,6,4,2,0,0,0,1,2,2,0,0,0,0,1,0,0,0,1,5,2,1,0,0,0,,,
"Nov 6, 2021 11:00 PM",12,6,6,5,4,1,10,7,3,11,7,4,4,0,4,1,7,6,1,0,0,0,5,0,0,0,5,2,0,1,0,0,0,,,
"Nov 7, 2021 12:00 AM",2,1,1,0,0,0,1,0,1,7,2,5,1,1,0,0,1,1,0,0,0,0,3,2,1,1,7,8,0,0,1,1,0,,,
"Nov 7, 2021 1:00 AM",3,1,2,1,1,0,1,1,0,1,1,0,2,0,2,0,1,1,0,0,0,0,1,1,1,0,5,1,0,0,0,0,0,,,
"Nov 7, 2021 2:00 AM",8,3,5,0,0,0,0,0,0,0,0,0,0,0,0,0,2,0,2,0,0,0,0,0,0,0,3,1,0,0,0,0,0,,,
"Nov 7, 2021 3:00 AM",3,0,3,1,1,0,1,1,0,1,1,0,0,0,0,0,0,0,0,0,0,0,0,2,2,0,3,0,0,0,0,0,0,,,
"Nov 7, 2021 4:00 AM",0,0,0,0,0,0,1,1,0,0,0,0,0,0,0,0,0,0,0,0,0,0,0,0,0,0,2,1,0,0,0,0,0,,,
"Nov 7, 2021 5:00 AM",2,1,1,0,0,0,1,0,1,1,0,1,0,0,0,0,2,2,0,0,0,0,1,0,0,0,1,2,0,0,0,0,0,,,
"Nov 7, 2021 6:00 AM",5,2,3,5,2,3,4,3,1,3,3,0,0,0,0,1,1,1,0,0,0,0,1,1,1,0,5,12,0,2,0,0,0,,,
"Nov 7, 2021 7:00 AM",10,3,7,13,9,4,14,10,4,17,12,5,0,0,0,1,10,10,0,0,0,0,11,3,3,0,7,10,2,3,1,0,1,,,
"Nov 7, 2021 8:00 AM",38,18,20,70,38,32,66,48,18,62,44,18,6,4,2,3,13,12,1,0,0,0,14,16,13,3,20,25,1,5,4,1,3,,,
"Nov 7, 2021 9:00 AM",51,23,28,108,63,45,110,70,40,108,71,37,9,4,5,9,16,14,2,0,0,0,12,25,18,7,38,33,4,16,5,5,0,,,
"Nov 7, 2021 10:00 AM",53,31,22,148,82,66,157,96,61,135,83,52,10,8,2,8,22,21,1,0,0,0,22,42,21,21,45,48,6,6,7,1,6,,,
"Nov 7, 2021 11:00 AM",75,36,39,172,91,81,179,101,78,149,85,64,37,25,12,12,26,25,1,0,0,0,19,65,49,16,43,50,13,10,3,3,0,,,
"Nov 7, 2021 12:00 PM",73,44,29,205,92,113,215,115,100,166,89,77,31,22,9,19,21,21,0,0,0,0,24,67,44,23,54,66,9,10,8,4,4,,,
"Nov 7, 2021 1:00 PM",67,32,35,149,79,70,190,95,95,137,70,67,17,5,12,37,22,22,0,0,0,0,19,60,34,26,55,42,16,6,5,4,1,,,
"Nov 7, 2021 2:00 PM",72,39,33,124,63,61,153,76,77,129,61,68,24,11,13,27,22,21,1,0,0,0,19,59,37,22,44,23,11,3,8,4,4,,,
"Nov 7, 2021 3:00 PM",52,27,25,148,72,76,173,76,97,122,56,66,27,16,11,27,21,20,1,0,0,0,21,63,28,35,27,53,10,7,5,3,2,,,
"Nov 7, 2021 4:00 PM",58,27,31,114,53,61,103,38,65,95,31,64,28,11,17,24,20,20,0,0,0,0,19,42,14,28,22,44,5,8,9,8,1,,,
"Nov 7, 2021 5:00 PM",41,14,27,56,26,30,52,14,38,43,13,30,13,6,7,8,13,13,0,0,0,0,12,16,2,14,8,39,0,0,1,1,0,,,
"Nov 7, 2021 6:00 PM",48,20,28,21,18,3,22,9,13,14,6,8,13,3,10,12,13,11,2,0,0,0,13,4,2,2,6,16,1,1,1,1,0,,,
"Nov 7, 2021 7:00 PM",37,14,23,7,5,2,17,7,10,14,7,7,1,0,1,11,9,8,1,0,0,0,6,1,0,1,7,12,0,0,4,2,2,,,
"Nov 7, 2021 8:00 PM",19,4,15,8,6,2,13,5,8,13,5,8,3,1,2,3,4,4,0,0,0,0,5,0,0,0,4,6,1,0,4,2,2,,,
"Nov 7, 2021 9:00 PM",14,5,9,5,1,4,4,1,3,4,0,4,0,0,0,3,7,7,0,0,0,0,5,2,0,2,3,4,0,0,0,0,0,,,
"Nov 7, 2021 10:00 PM",8,2,6,0,0,0,6,0,6,2,0,2,0,0,0,3,1,0,1,0,0,0,1,1,1,0,6,7,1,1,0,0,0,,,
"Nov 7, 2021 11:00 PM",6,2,4,5,2,3,5,2,3,6,1,5,2,0,2,3,0,0,0,0,0,0,0,0,0,0,3,4,0,0,0,0,0,,,
"Nov 8, 2021 12:00 AM",6,1,5,0,0,0,1,0,1,0,0,0,0,0,0,0,1,1,0,0,0,0,1,0,0,0,4,0,0,0,0,0,0,,,
"Nov 8, 2021 1:00 AM",3,1,2,1,1,0,1,1,0,1,1,0,0,0,0,0,0,0,0,0,0,0,0,0,0,0,2,0,0,0,0,0,0,,,
"Nov 8, 2021 2:00 AM",1,1,0,0,0,0,0,0,0,0,0,0,0,0,0,0,0,0,0,0,0,0,0,0,0,0,0,0,0,0,0,0,0,,,
"Nov 8, 2021 3:00 AM",1,1,0,0,0,0,0,0,0,0,0,0,0,0,0,0,0,0,0,0,0,0,0,0,0,0,0,0,0,0,0,0,0,,,
"Nov 8, 2021 4:00 AM",1,0,1,0,0,0,0,0,0,0,0,0,0,0,0,1,1,1,0,0,0,0,1,0,0,0,0,0,0,0,0,0,0,,,
"Nov 8, 2021 5:00 AM",7,6,1,0,0,0,4,3,1,3,2,1,0,0,0,1,7,7,0,0,0,0,6,3,1,2,2,9,0,0,0,0,0,,,
"Nov 8, 2021 6:00 AM",31,23,8,13,4,9,23,9,14,17,7,10,5,5,0,2,20,20,0,0,0,0,18,5,1,4,14,44,0,1,2,2,0,,,
"Nov 8, 2021 7:00 AM",110,65,45,43,12,31,70,18,52,49,18,31,4,4,0,10,67,67,0,0,0,0,72,27,11,16,41,92,3,6,5,3,2,,,
"Nov 8, 2021 8:00 AM",230,173,57,67,18,49,105,28,77,80,33,47,38,29,9,31,158,156,2,0,0,0,145,48,45,3,53,138,9,3,16,13,3,,,
"Nov 8, 2021 9:00 AM",134,110,24,39,13,26,42,22,20,34,16,18,6,5,1,12,69,69,0,0,0,0,60,15,15,0,15,36,0,0,1,1,0,,,
"Nov 8, 2021 10:00 AM",56,43,13,17,4,13,24,10,14,18,5,13,7,5,2,2,36,35,1,0,0,0,26,6,6,0,11,24,3,0,2,1,1,,,
"Nov 8, 2021 11:00 AM",65,39,26,20,11,9,40,25,15,24,17,7,4,3,1,9,28,26,2,0,0,0,23,15,15,0,12,25,1,0,3,2,1,,,
"Nov 8, 2021 12:00 PM",61,32,29,24,15,9,36,23,13,21,12,9,13,6,7,13,28,28,0,0,0,0,26,15,14,1,9,15,3,0,4,4,0,,,
"Nov 8, 2021 1:00 PM",72,37,35,51,30,21,73,35,38,58,32,26,14,6,8,4,31,26,5,0,0,0,25,25,16,9,26,22,4,0,2,1,1,,,
"Nov 8, 2021 2:00 PM",65,33,32,55,32,23,67,38,29,43,25,18,9,5,4,13,23,19,4,0,0,0,19,30,18,12,30,30,4,6,6,5,1,,,
"Nov 8, 2021 3:00 PM",96,33,63,57,30,27,88,50,38,54,31,23,17,6,11,15,37,37,0,0,0,0,30,34,18,16,37,28,6,2,8,4,4,,,
"Nov 8, 2021 4:00 PM",150,41,109,72,44,28,93,59,34,69,49,20,17,5,12,27,41,31,10,0,0,0,25,39,26,13,58,56,6,3,8,2,6,,,
"Nov 8, 2021 5:00 PM",196,49,147,64,37,27,93,51,42,64,34,30,17,4,13,23,37,29,8,0,0,0,27,32,27,5,105,46,9,4,13,7,6,,,
"Nov 8, 2021 6:00 PM",161,37,124,41,30,11,70,48,22,61,38,23,8,1,7,12,37,33,4,0,0,0,33,32,19,13,70,35,2,1,11,7,4,,,
"Nov 8, 2021 7:00 PM",95,31,64,19,14,5,32,22,10,22,15,7,5,3,2,13,21,14,7,0,0,0,16,16,11,5,47,26,6,3,5,2,3,,,
"Nov 8, 2021 8:00 PM",71,17,54,16,12,4,33,22,11,24,17,7,8,5,3,13,27,22,5,0,0,0,18,6,5,1,23,18,4,1,3,1,2,,,
"Nov 8, 2021 9:00 PM",46,10,36,8,4,4,21,12,9,16,10,6,0,0,0,7,11,8,3,0,0,0,5,9,9,0,12,13,2,0,1,0,1,,,
"Nov 8, 2021 10:00 PM",33,9,24,6,2,4,6,2,4,6,2,4,1,0,1,7,5,2,3,0,0,0,2,4,3,1,12,6,0,0,2,2,0,,,
"Nov 8, 2021 11:00 PM",11,1,10,2,2,0,7,6,1,6,3,3,3,1,2,0,1,1,0,0,0,0,1,1,1,0,5,4,0,2,1,1,0,,,
"Nov 9, 2021 12:00 AM",11,4,7,0,0,0,1,1,0,2,1,1,2,1,1,0,1,1,0,0,0,0,1,0,0,0,3,2,0,0,1,1,0,,,
"Nov 9, 2021 1:00 AM",1,1,0,1,1,0,0,0,0,0,0,0,0,0,0,0,0,0,0,0,0,0,0,0,0,0,0,0,0,0,0,0,0,,,
"Nov 9, 2021 2:00 AM",3,3,0,0,0,0,0,0,0,0,0,0,0,0,0,0,0,0,0,0,0,0,0,0,0,0,0,0,0,0,0,0,0,,,
"Nov 9, 2021 3:00 AM",0,0,0,0,0,0,0,0,0,0,0,0,0,0,0,0,0,0,0,0,0,0,0,0,0,0,0,0,0,0,0,0,0,,,
"Nov 9, 2021 4:00 AM",1,1,0,0,0,0,1,1,0,0,0,0,0,0,0,1,1,1,0,0,0,0,1,0,0,0,2,0,0,0,0,0,0,,,
"Nov 9, 2021 5:00 AM",10,6,4,1,0,1,2,0,2,1,0,1,0,0,0,1,8,8,0,0,0,0,8,0,0,0,3,12,1,0,0,0,0,,,
"Nov 9, 2021 6:00 AM",40,29,11,16,7,9,38,18,20,22,12,10,3,2,1,5,25,25,0,0,0,0,25,6,3,3,18,33,1,3,4,3,1,,,
"Nov 9, 2021 7:00 AM",121,87,34,65,25,40,90,28,62,70,27,43,7,7,0,8,70,70,0,0,0,0,68,31,12,19,51,109,4,6,3,2,1,,,
"Nov 9, 2021 8:00 AM",297,228,69,126,32,94,162,49,113,129,42,87,44,29,15,27,191,187,4,0,0,0,179,76,36,40,58,185,10,5,11,11,0,,,
"Nov 9, 2021 9:00 AM",140,117,23,58,18,40,95,48,47,82,45,37,10,6,4,10,96,95,1,0,0,0,81,37,18,19,35,78,1,5,4,1,3,,,
"Nov 9, 2021 10:00 AM",77,52,25,61,29,32,65,36,29,52,22,30,11,7,4,12,57,55,2,0,0,0,45,21,11,10,19,33,2,2,3,2,1,,,
"Nov 9, 2021 11:00 AM",67,43,24,53,25,28,61,31,30,50,27,23,7,4,3,8,26,25,1,0,0,0,17,12,3,9,23,19,6,2,1,1,0,,,
"Nov 9, 2021 12:00 PM",87,46,41,50,30,20,76,44,32,58,30,28,18,8,10,14,34,33,1,0,0,0,33,17,13,4,28,25,0,5,2,1,1,,,
"Nov 9, 2021 1:00 PM",102,40,62,61,38,23,91,44,47,67,36,31,13,7,6,14,33,29,4,0,0,0,31,39,22,17,36,38,7,3,3,3,0,,,
"Nov 9, 2021 2:00 PM",84,37,47,62,35,27,84,48,36,62,43,19,17,12,5,10,23,20,3,0,0,0,14,38,22,16,30,28,8,5,3,1,2,,,
"Nov 9, 2021 3:00 PM",118,47,71,54,36,18,74,51,23,61,45,16,23,10,13,20,42,33,9,0,0,0,28,35,28,7,57,30,2,3,7,2,5,,,
"Nov 9, 2021 4:00 PM",160,52,108,83,55,28,116,73,43,95,58,37,23,11,12,13,37,34,3,0,0,0,27,43,29,14,86,54,8,4,7,5,2,,,
"Nov 9, 2021 5:00 PM",222,49,173,61,36,25,108,57,51,79,38,41,26,7,19,18,43,40,3,0,0,0,38,31,26,5,97,69,3,2,7,4,3,,,
"Nov 9, 2021 6:00 PM",185,35,150,66,51,15,96,63,33,78,49,29,25,7,18,17,46,39,7,0,0,0,36,41,35,6,89,38,5,3,7,7,0,,,
"Nov 9, 2021 7:00 PM",127,32,95,43,27,16,67,46,21,49,35,14,6,1,5,6,17,15,2,0,0,0,12,25,24,1,64,32,0,3,5,4,1,,,
"Nov 9, 2021 8:00 PM",87,17,70,28,20,8,33,22,11,33,19,14,8,4,4,13,18,15,3,0,0,0,19,16,10,6,25,19,2,1,10,4,6,,,
"Nov 9, 2021 9:00 PM",40,13,27,2,1,1,17,12,5,8,5,3,5,5,0,2,16,11,5,0,0,0,11,4,3,1,14,14,1,0,0,0,0,,,
"Nov 9, 2021 10:00 PM",29,7,22,8,7,1,10,6,4,5,4,1,0,0,0,5,7,5,2,0,0,0,3,5,5,0,6,10,1,0,0,0,0,,,
"Nov 9, 2021 11:00 PM",16,2,14,7,7,0,4,3,1,7,4,3,3,1,2,1,1,1,0,0,0,0,1,5,3,2,7,3,0,0,0,0,0,,,
"Nov 10, 2021 12:00 AM",14,3,11,1,1,0,3,1,2,3,1,2,0,0,0,0,1,1,0,0,0,0,0,0,0,0,7,6,0,1,0,0,0,,,
"Nov 10, 2021 1:00 AM",1,0,1,0,0,0,2,0,2,0,0,0,0,0,0,0,3,3,0,0,0,0,2,1,0,1,1,2,0,0,0,0,0,,,
"Nov 10, 2021 2:00 AM",6,3,3,0,0,0,1,0,1,0,0,0,0,0,0,0,0,0,0,0,0,0,0,1,1,0,0,0,0,0,0,0,0,,,
"Nov 10, 2021 3:00 AM",3,0,3,0,0,0,0,0,0,0,0,0,0,0,0,0,0,0,0,0,0,0,0,0,0,0,1,0,0,0,0,0,0,,,
"Nov 10, 2021 4:00 AM",2,1,1,0,0,0,1,1,0,0,0,0,0,0,0,0,1,1,0,0,0,0,1,0,0,0,1,0,0,0,0,0,0,,,
"Nov 10, 2021 5:00 AM",11,6,5,0,0,0,4,3,1,3,1,2,0,0,0,1,6,6,0,0,0,0,7,3,2,1,5,14,0,0,0,0,0,,,
"Nov 10, 2021 6:00 AM",40,30,10,21,9,12,31,15,16,29,14,15,8,5,3,5,29,29,0,0,0,0,29,11,4,7,15,39,0,2,3,3,0,,,
"Nov 10, 2021 7:00 AM",114,75,39,70,30,40,98,33,65,75,33,42,13,12,1,15,86,86,0,0,0,0,84,26,5,21,43,120,3,5,7,4,3,,,
"Nov 10, 2021 8:00 AM",278,212,66,116,22,94,169,59,110,129,37,92,44,31,13,42,174,169,5,0,0,0,168,76,17,59,67,182,12,6,21,16,5,,,
"Nov 10, 2021 9:00 AM",158,136,22,93,43,50,94,49,45,87,50,37,17,9,8,5,95,95,0,0,0,0,78,45,22,23,32,73,0,4,1,0,1,,,
"Nov 10, 2021 10:00 AM",77,61,16,59,26,33,61,28,33,54,27,27,15,11,4,6,47,47,0,0,0,0,30,19,12,7,22,41,3,6,4,4,0,,,
"Nov 10, 2021 11:00 AM",89,56,33,58,32,26,57,34,23,45,30,15,15,8,7,6,41,40,1,0,0,0,29,24,13,11,36,22,5,2,7,5,2,,,
"Nov 10, 2021 12:00 PM",106,50,56,74,34,40,96,44,52,69,31,38,5,1,4,14,38,33,5,0,0,0,28,21,6,15,28,33,4,3,5,3,2,,,
"Nov 10, 2021 1:00 PM",120,59,61,81,47,34,103,70,33,79,53,26,15,6,9,20,40,36,4,0,0,0,32,48,30,18,48,42,2,6,4,2,2,,,
"Nov 10, 2021 2:00 PM",84,31,53,47,33,14,58,37,21,51,34,17,24,6,18,24,38,32,6,0,0,0,28,21,16,5,34,36,0,3,1,1,0,,,
"Nov 10, 2021 3:00 PM",132,46,86,38,25,13,72,43,29,38,22,16,16,5,11,25,47,38,9,0,0,0,35,29,18,11,50,34,4,2,9,4,5,,,
"Nov 10, 2021 4:00 PM",166,55,111,70,46,24,113,63,50,75,48,27,15,7,8,23,26,22,4,0,0,0,19,35,23,12,70,49,4,6,9,4,5,,,
"Nov 10, 2021 5:00 PM",246,54,192,55,38,17,88,54,34,56,35,21,19,5,14,29,45,36,9,0,0,0,37,47,37,10,124,62,6,6,15,8,7,,,
"Nov 10, 2021 6:00 PM",194,43,151,61,41,20,114,83,31,82,53,29,15,7,8,25,48,39,9,0,0,0,38,53,30,23,89,44,6,4,7,7,0,,,
"Nov 10, 2021 7:00 PM",112,39,73,31,25,6,52,38,14,47,31,16,8,5,3,13,24,19,5,0,0,0,22,20,11,9,46,30,3,3,2,1,1,,,
"Nov 10, 2021 8:00 PM",79,21,58,24,18,6,33,22,11,21,14,7,9,5,4,11,18,14,4,0,0,0,15,6,5,1,30,29,1,1,1,1,0,,,
"Nov 10, 2021 9:00 PM",53,15,38,11,8,3,16,9,7,10,4,6,3,0,3,3,16,11,5,0,0,0,11,6,3,3,13,16,6,3,5,3,2,,,
"Nov 10, 2021 10:00 PM",37,8,29,9,6,3,15,5,10,11,6,5,0,0,0,4,4,3,1,0,0,0,3,9,5,4,20,13,0,1,3,2,1,,,
"Nov 10, 2021 11:00 PM",13,2,11,1,0,1,5,2,3,2,0,2,3,2,1,3,1,0,1,0,0,0,0,1,0,1,13,6,1,0,2,1,1,,,
"Nov 11, 2021 12:00 AM",8,3,5,0,0,0,2,1,1,2,1,1,0,0,0,2,1,0,1,0,0,0,0,0,0,0,6,1,0,0,0,0,0,,,
"Nov 11, 2021 1:00 AM",4,3,1,0,0,0,0,0,0,0,0,0,1,0,1,0,2,1,1,0,0,0,1,0,0,0,4,0,0,0,0,0,0,,,
"Nov 11, 2021 2:00 AM",4,3,1,0,0,0,0,0,0,0,0,0,0,0,0,1,0,0,0,0,0,0,0,1,1,0,0,1,0,0,0,0,0,,,
"Nov 11, 2021 3:00 AM",1,0,1,0,0,0,1,0,1,0,0,0,0,0,0,0,0,0,0,0,0,0,0,2,2,0,0,0,0,0,0,0,0,,,
"Nov 11, 2021 4:00 AM",1,1,0,1,0,1,2,2,0,0,0,0,0,0,0,1,1,1,0,0,0,0,1,1,0,1,3,1,0,0,1,1,0,,,
"Nov 11, 2021 5:00 AM",7,4,3,1,1,0,5,3,2,4,3,1,0,0,0,1,8,8,0,0,0,0,8,1,1,0,4,11,0,0,0,0,0,,,
"Nov 11, 2021 6:00 AM",45,32,13,16,5,11,19,4,15,16,6,10,4,3,1,6,20,20,0,0,0,0,19,4,1,3,15,30,0,2,2,2,0,,,
"Nov 11, 2021 7:00 AM",125,84,41,51,16,35,85,25,60,57,20,37,10,9,1,9,81,81,0,0,0,0,83,34,8,26,39,88,6,3,5,4,1,,,
"Nov 11, 2021 8:00 AM",255,193,62,125,40,85,167,52,115,128,56,72,32,24,8,28,166,164,2,0,0,0,159,64,8,56,59,181,5,3,13,11,2,,,
"Nov 11, 2021 9:00 AM",123,97,26,51,15,36,72,34,38,58,26,32,7,4,3,15,89,88,1,0,0,0,76,31,17,14,21,65,3,2,3,3,0,,,
"Nov 11, 2021 10:00 AM",92,67,25,55,31,24,58,38,20,48,35,13,8,4,4,10,53,51,2,0,0,0,36,30,17,13,22,28,1,7,4,2,2,,,
"Nov 11, 2021 11:00 AM",63,38,25,46,17,29,59,31,28,52,25,27,8,6,2,11,36,32,4,0,0,0,26,30,24,6,20,24,2,1,4,1,3,,,
"Nov 11, 2021 12:00 PM",73,52,21,52,32,20,60,35,25,43,26,17,19,11,8,15,36,31,5,0,0,0,27,24,15,9,25,26,2,1,5,4,1,,,
"Nov 11, 2021 1:00 PM",99,47,52,60,32,28,88,47,41,64,28,36,19,7,12,12,35,31,4,0,0,0,26,23,15,8,37,37,4,2,6,6,0,,,
"Nov 11, 2021 2:00 PM",94,53,41,55,30,25,70,33,37,47,22,25,16,8,8,17,24,22,2,0,0,0,18,27,13,14,30,32,2,1,1,0,1,,,
"Nov 11, 2021 3:00 PM",119,46,73,27,13,14,67,41,26,41,27,14,11,3,8,28,29,28,1,0,0,0,26,19,11,8,37,35,3,1,6,4,2,,,
"Nov 11, 2021 4:00 PM",162,56,106,54,38,16,83,58,25,44,32,12,18,8,10,12,52,41,11,0,0,0,40,45,33,12,61,56,3,2,2,1,1,,,
"Nov 11, 2021 5:00 PM",206,58,148,42,29,13,78,42,36,56,32,24,11,0,11,19,43,37,6,0,0,0,35,45,28,17,96,56,2,1,2,2,0,,,
"Nov 11, 2021 6:00 PM",167,44,123,50,40,10,91,61,30,63,36,27,15,2,13,10,41,31,10,0,0,0,33,27,14,13,77,55,4,1,7,5,2,,,
"Nov 11, 2021 7:00 PM",112,32,80,15,13,2,35,28,7,26,20,6,11,3,8,17,15,13,2,0,0,0,13,21,11,10,50,16,0,2,5,1,4,,,
"Nov 11, 2021 8:00 PM",59,16,43,18,12,6,23,16,7,20,14,6,2,0,2,5,16,10,6,0,0,0,9,13,7,6,23,17,3,0,3,1,2,,,
"Nov 11, 2021 9:00 PM",42,7,35,6,5,1,17,10,7,9,4,5,1,0,1,6,9,8,1,0,0,0,9,8,5,3,12,16,3,1,2,1,1,,,
"Nov 11, 2021 10:00 PM",41,6,35,8,6,2,11,6,5,9,4,5,0,0,0,3,4,2,2,0,0,0,2,7,5,2,19,8,2,0,1,1,0,,,
"Nov 11, 2021 11:00 PM",17,2,15,4,3,1,6,3,3,7,5,2,1,0,1,2,4,3,1,0,0,0,2,2,1,1,10,4,2,0,2,1,1,,,
"Nov 12, 2021 12:00 AM",8,2,6,0,0,0,0,0,0,0,0,0,0,0,0,3,3,2,1,0,0,0,2,0,0,0,6,4,0,1,0,0,0,,,
"Nov 12, 2021 1:00 AM",10,3,7,0,0,0,1,1,0,0,0,0,0,0,0,0,1,1,0,0,0,0,1,3,2,1,2,3,0,0,0,0,0,,,
"Nov 12, 2021 2:00 AM",4,2,2,0,0,0,0,0,0,0,0,0,0,0,0,0,1,1,0,0,0,0,1,0,0,0,2,0,0,0,0,0,0,,,
"Nov 12, 2021 3:00 AM",2,1,1,0,0,0,1,1,0,0,0,0,0,0,0,0,0,0,0,0,0,0,0,0,0,0,1,0,0,0,0,0,0,,,
"Nov 12, 2021 4:00 AM",1,0,1,0,0,0,1,1,0,1,1,0,0,0,0,2,0,0,0,0,0,0,0,0,0,0,2,2,0,0,0,0,0,,,
"Nov 12, 2021 5:00 AM",10,5,5,1,1,0,4,3,1,3,2,1,0,0,0,1,9,8,1,0,0,0,9,2,2,0,3,12,0,1,0,0,0,,,
"Nov 12, 2021 6:00 AM",27,15,12,11,4,7,11,4,7,11,5,6,4,1,3,3,15,14,1,0,0,0,16,3,3,0,10,23,2,0,2,2,0,,,
"Nov 12, 2021 7:00 AM",90,55,35,47,13,34,79,24,55,56,19,37,11,11,0,9,54,54,0,0,0,0,51,23,12,11,46,80,4,2,8,6,2,,,
"Nov 12, 2021 8:00 AM",193,145,48,85,27,58,123,44,79,109,44,65,29,18,11,22,107,106,1,0,0,0,101,61,28,33,53,138,6,2,20,16,4,,,
"Nov 12, 2021 9:00 AM",113,91,22,64,32,32,92,53,39,75,45,30,13,7,6,11,66,66,0,0,0,0,58,32,18,14,21,54,0,0,2,0,2,,,
"Nov 12, 2021 10:00 AM",79,50,29,54,26,28,60,32,28,46,26,20,18,9,9,4,34,33,1,0,0,0,24,20,13,7,16,31,3,1,6,5,1,,,
"Nov 12, 2021 11:00 AM",71,39,32,31,9,22,33,9,24,23,8,15,14,9,5,8,30,27,3,0,0,0,16,14,5,9,15,28,1,3,4,3,1,,,
"Nov 12, 2021 12:00 PM",73,39,34,42,24,18,47,26,21,41,20,21,13,10,3,9,19,15,4,0,0,0,13,12,8,4,26,22,6,1,3,3,0,,,
"Nov 12, 2021 1:00 PM",109,49,60,37,15,22,39,20,19,29,14,15,11,6,5,10,28,26,2,0,0,0,21,21,12,9,27,29,0,3,9,4,5,,,
"Nov 12, 2021 2:00 PM",99,46,53,50,34,16,60,39,21,66,41,25,15,6,9,16,24,24,0,0,0,0,24,14,10,4,36,26,1,2,6,3,3,,,
"Nov 12, 2021 3:00 PM",110,36,74,39,16,23,69,43,26,48,23,25,18,5,13,17,25,21,4,0,0,0,23,38,25,13,44,36,2,3,1,0,1,,,
"Nov 12, 2021 4:00 PM",137,46,91,54,39,15,83,52,31,57,36,21,17,5,12,16,31,25,6,0,0,0,22,30,16,14,59,48,4,3,9,5,4,,,
"Nov 12, 2021 5:00 PM",172,53,119,45,30,15,69,45,24,59,32,27,9,1,8,10,34,28,6,0,0,0,30,27,17,10,79,44,1,2,11,3,8,,,
"Nov 12, 2021 6:00 PM",98,23,75,32,22,10,52,31,21,36,24,12,8,2,6,12,24,21,3,0,0,0,19,26,13,13,61,30,3,2,4,4,0,,,
"Nov 12, 2021 7:00 PM",83,33,50,15,11,4,24,17,7,27,17,10,7,3,4,6,15,12,3,0,0,0,11,11,7,4,31,33,3,1,5,2,3,,,
"Nov 12, 2021 8:00 PM",45,16,29,11,9,2,25,19,6,21,15,6,4,1,3,6,19,16,3,0,0,0,13,8,5,3,20,16,4,1,6,4,2,,,
"Nov 12, 2021 9:00 PM",31,11,20,6,4,2,19,12,7,10,6,4,0,0,0,4,12,9,3,0,0,0,9,12,6,6,10,13,0,0,1,0,1,,,
"Nov 12, 2021 10:00 PM",25,3,22,11,10,1,13,7,6,13,7,6,0,0,0,1,3,2,1,0,0,0,2,4,3,1,7,5,0,0,2,2,0,,,
"Nov 12, 2021 11:00 PM",20,9,11,6,4,2,12,4,8,13,4,9,2,1,1,1,4,4,0,0,0,0,2,4,2,2,6,7,1,0,3,2,1,,,
"Nov 13, 2021 12:00 AM",17,3,14,0,0,0,5,1,4,4,1,3,0,0,0,0,4,3,1,0,0,0,3,5,4,1,9,1,0,1,0,0,0,,,
"Nov 13, 2021 1:00 AM",1,1,0,2,2,0,4,1,3,3,1,2,1,1,0,0,4,2,2,0,0,0,1,1,1,0,4,0,0,0,0,0,0,,,
"Nov 13, 2021 2:00 AM",9,4,5,2,2,0,5,2,3,4,1,3,0,0,0,0,0,0,0,0,0,0,0,1,1,0,5,1,0,0,2,1,1,,,
"Nov 13, 2021 3:00 AM",0,0,0,1,1,0,1,1,0,0,0,0,0,0,0,0,0,0,0,0,0,0,0,0,0,0,1,0,0,0,0,0,0,,,
"Nov 13, 2021 4:00 AM",6,1,5,0,0,0,1,1,0,1,0,1,0,0,0,1,1,1,0,0,0,0,1,0,0,0,1,1,0,0,0,0,0,,,
"Nov 13, 2021 5:00 AM",4,2,2,0,0,0,3,3,0,1,1,0,0,0,0,2,0,0,0,0,0,0,0,1,1,0,4,1,0,0,0,0,0,,,
"Nov 13, 2021 6:00 AM",8,4,4,8,3,5,10,7,3,8,5,3,1,0,1,2,5,5,0,0,0,0,5,0,0,0,6,11,0,0,5,2,3,,,
"Nov 13, 2021 7:00 AM",22,10,12,10,6,4,21,17,4,16,13,3,2,0,2,3,14,14,0,0,0,0,14,5,3,2,17,18,1,4,2,2,0,,,
"Nov 13, 2021 8:00 AM",44,24,20,50,29,21,72,48,24,53,35,18,13,6,7,9,20,20,0,0,0,0,20,17,9,8,21,15,0,4,1,1,0,,,
"Nov 13, 2021 9:00 AM",56,36,20,95,52,43,121,78,43,81,52,29,24,9,15,15,33,31,2,0,0,0,32,34,19,15,28,36,6,5,4,4,0,,,
"Nov 13, 2021 10:00 AM",64,34,30,154,83,71,153,75,78,132,77,55,22,17,5,18,31,30,1,0,0,0,32,49,24,25,38,42,2,9,5,2,3,,,
"Nov 13, 2021 11:00 AM",68,39,29,126,67,59,117,66,51,122,82,40,14,10,4,20,31,31,0,0,0,0,24,35,19,16,33,46,6,3,9,5,4,,,
"Nov 13, 2021 12:00 PM",69,40,29,148,54,94,132,48,84,122,46,76,25,13,12,23,31,29,2,0,0,0,28,33,14,19,48,29,3,3,5,3,2,,,
"Nov 13, 2021 1:00 PM",66,36,30,121,67,54,99,53,46,88,54,34,22,13,9,34,42,39,3,0,0,0,40,28,14,14,27,56,7,2,12,3,9,,,
"Nov 13, 2021 2:00 PM",89,56,33,89,35,54,86,35,51,81,36,45,13,6,7,20,38,36,2,0,0,0,31,37,20,17,39,52,12,0,9,7,2,,,
"Nov 13, 2021 3:00 PM",51,24,27,64,37,27,77,45,32,65,42,23,13,5,8,21,25,24,1,0,0,0,27,37,26,11,25,28,7,1,0,0,0,,,
"Nov 13, 2021 4:00 PM",53,25,28,49,22,27,63,28,35,50,17,33,18,8,10,18,15,14,1,0,0,0,11,24,8,16,17,32,5,2,3,2,1,,,
"Nov 13, 2021 5:00 PM",59,23,36,41,22,19,61,31,30,48,20,28,8,3,5,11,13,12,1,0,0,0,17,30,24,6,28,24,4,0,6,4,2,,,
"Nov 13, 2021 6:00 PM",63,20,43,34,24,10,60,34,26,34,24,10,9,2,7,13,21,17,4,0,0,0,15,17,12,5,31,10,2,0,2,2,0,,,
"Nov 13, 2021 7:00 PM",43,14,29,18,6,12,23,10,13,24,8,16,2,1,1,6,11,11,0,0,0,0,10,11,3,8,8,20,2,0,5,2,3,,,
"Nov 13, 2021 8:00 PM",24,8,16,16,6,10,15,5,10,18,6,12,8,7,1,6,10,10,0,0,0,0,10,1,1,0,7,7,0,0,1,1,0,,,
"Nov 13, 2021 9:00 PM",18,14,4,16,15,1,12,7,5,13,9,4,0,0,0,0,5,5,0,0,0,0,5,7,6,1,13,11,0,0,1,1,0,,,
"Nov 13, 2021 10:00 PM",14,4,10,3,0,3,7,2,5,10,3,7,5,0,5,0,6,6,0,0,0,0,6,3,3,0,4,7,1,2,1,1,0,,,
"Nov 13, 2021 11:00 PM",7,2,5,13,6,7,10,3,7,14,2,12,2,2,0,0,3,2,1,0,0,0,3,1,1,0,6,17,0,1,0,0,0,,,
"Nov 14, 2021 12:00 AM",9,4,5,0,0,0,2,2,0,5,2,3,1,1,0,0,3,3,0,0,0,0,1,0,0,0,8,4,0,0,0,0,0,,,
"Nov 14, 2021 1:00 AM",6,2,4,2,1,1,4,2,2,3,3,0,2,1,1,1,2,1,1,0,0,0,2,1,1,0,3,2,0,0,0,0,0,,,
"Nov 14, 2021 2:00 AM",4,3,1,0,0,0,3,0,3,2,0,2,0,0,0,0,0,0,0,0,0,0,0,0,0,0,1,3,0,1,0,0,0,,,
"Nov 14, 2021 3:00 AM",7,0,7,0,0,0,0,0,0,0,0,0,2,1,1,0,0,0,0,0,0,0,0,2,2,0,1,2,0,0,0,0,0,,,
"Nov 14, 2021 4:00 AM",2,0,2,0,0,0,6,3,3,0,0,0,0,0,0,0,0,0,0,0,0,0,0,0,0,0,1,1,0,0,2,1,1,,,
"Nov 14, 2021 5:00 AM",5,3,2,1,0,1,2,2,0,3,2,1,0,0,0,0,1,1,0,0,0,0,1,1,0,1,1,2,0,0,0,0,0,,,
"Nov 14, 2021 6:00 AM",11,6,5,9,3,6,3,1,2,6,2,4,0,0,0,1,0,0,0,0,0,0,0,1,1,0,3,8,0,0,1,1,0,,,
"Nov 14, 2021 7:00 AM",11,3,8,12,9,3,20,17,3,11,9,2,1,0,1,7,13,11,2,0,0,0,11,7,4,3,11,11,0,2,1,0,1,,,
"Nov 14, 2021 8:00 AM",37,16,21,76,44,32,84,56,28,82,59,23,5,5,0,4,9,9,0,0,0,0,10,30,16,14,25,21,1,5,1,0,1,,,
"Nov 14, 2021 9:00 AM",49,20,29,119,68,51,168,124,44,119,91,28,10,3,7,10,29,28,1,0,0,0,25,43,27,16,58,54,1,14,3,2,1,,,
"Nov 14, 2021 10:00 AM",47,30,17,193,89,104,199,102,97,162,78,84,31,20,11,3,20,19,1,0,0,0,19,68,41,27,38,55,12,4,10,10,0,,,
"Nov 14, 2021 11:00 AM",73,37,36,214,120,94,223,121,102,189,120,69,41,19,22,35,18,16,2,0,0,0,15,64,35,29,48,60,5,13,3,2,1,,,
"Nov 14, 2021 12:00 PM",63,36,27,221,93,128,190,87,103,171,81,90,33,16,17,20,25,24,1,0,0,0,24,91,42,49,51,50,9,8,10,5,5,,,
"Nov 14, 2021 1:00 PM",62,32,30,172,81,91,148,72,76,158,85,73,35,25,10,24,26,23,3,0,0,0,28,56,24,32,40,34,9,6,6,6,0,,,
"Nov 14, 2021 2:00 PM",60,28,32,111,45,66,115,48,67,99,47,52,20,8,12,15,29,28,1,0,0,0,21,36,14,22,26,48,5,2,7,5,2,,,
"Nov 14, 2021 3:00 PM",44,27,17,117,59,58,90,44,46,97,42,55,25,10,15,20,23,23,0,0,0,0,25,46,19,27,29,26,7,0,3,1,2,,,
"Nov 14, 2021 4:00 PM",67,26,41,87,50,37,95,35,60,86,32,54,30,9,21,15,15,14,1,0,0,0,11,38,15,23,12,35,3,2,2,2,0,,,
"Nov 14, 2021 5:00 PM",39,13,26,59,31,28,65,33,32,52,23,29,20,4,16,11,14,13,1,0,0,0,13,22,11,11,18,25,2,0,2,1,1,,,
"Nov 14, 2021 6:00 PM",33,11,22,27,18,9,37,22,15,24,13,11,7,4,3,4,16,14,2,0,0,0,14,15,10,5,12,10,1,2,2,2,0,,,
"Nov 14, 2021 7:00 PM",27,16,11,12,10,2,19,10,9,15,9,6,3,3,0,13,8,8,0,0,0,0,6,6,2,4,8,13,1,1,2,1,1,,,
"Nov 14, 2021 8:00 PM",21,2,19,16,10,6,16,4,12,15,5,10,2,0,2,2,8,8,0,0,0,0,7,2,0,2,8,5,1,0,1,0,1,,,
"Nov 14, 2021 9:00 PM",9,1,8,4,1,3,11,6,5,6,3,3,1,1,0,6,6,6,0,0,0,0,7,5,2,3,10,4,0,1,0,0,0,,,
"Nov 14, 2021 10:00 PM",7,1,6,5,1,4,3,0,3,2,1,1,2,2,0,3,3,2,1,0,0,0,1,4,2,2,4,12,1,0,2,1,1,,,
"Nov 14, 2021 11:00 PM",10,1,9,1,1,0,3,2,1,3,1,2,1,0,1,2,3,3,0,0,0,0,2,1,1,0,5,4,0,0,0,0,0,,,
"Nov 15, 2021 12:00 AM",2,0,2,0,0,0,1,0,1,1,0,1,0,0,0,0,0,0,0,0,0,0,2,0,0,0,3,0,1,0,0,0,0,,,
"Nov 15, 2021 1:00 AM",2,1,1,0,0,0,0,0,0,1,1,0,0,0,0,0,0,0,0,0,0,0,0,0,0,0,1,0,0,0,0,0,0,,,
"Nov 15, 2021 2:00 AM",1,1,0,0,0,0,0,0,0,0,0,0,0,0,0,0,0,0,0,0,0,0,0,0,0,0,0,1,0,0,0,0,0,,,
"Nov 15, 2021 3:00 AM",0,0,0,0,0,0,0,0,0,0,0,0,0,0,0,0,0,0,0,0,0,0,0,0,0,0,0,0,0,0,0,0,0,,,
"Nov 15, 2021 4:00 AM",1,0,1,0,0,0,0,0,0,0,0,0,0,0,0,1,0,0,0,0,0,0,0,0,0,0,0,0,0,0,0,0,0,,,
"Nov 15, 2021 5:00 AM",6,5,1,0,0,0,3,2,1,2,1,1,0,0,0,2,5,5,0,0,0,0,5,0,0,0,5,11,1,0,0,0,0,,,
"Nov 15, 2021 6:00 AM",27,15,12,11,3,8,20,8,12,13,5,8,2,1,1,2,14,14,0,0,0,0,14,6,4,2,15,37,1,3,0,0,0,,,
"Nov 15, 2021 7:00 AM",83,53,30,45,16,29,86,24,62,51,20,31,10,9,1,8,72,71,1,0,0,0,77,41,20,21,37,87,3,8,5,5,0,,,
"Nov 15, 2021 8:00 AM",236,171,65,91,30,61,157,53,104,109,45,64,36,21,15,30,145,142,3,0,0,0,128,70,23,47,66,167,8,1,22,18,4,,,
"Nov 15, 2021 9:00 AM",138,109,29,47,14,33,77,41,36,62,28,34,17,8,9,9,85,84,1,0,0,0,65,32,15,17,24,60,0,1,2,2,0,,,
"Nov 15, 2021 10:00 AM",81,57,24,40,22,18,66,37,29,46,25,21,16,15,1,11,52,51,1,0,0,0,41,16,10,6,26,39,6,1,12,10,2,,,
"Nov 15, 2021 11:00 AM",57,36,21,51,26,25,62,24,38,46,20,26,12,7,5,7,42,41,1,0,0,0,32,26,8,18,16,32,8,5,2,1,1,,,
"Nov 15, 2021 12:00 PM",78,43,35,54,29,25,52,30,22,36,22,14,18,9,9,17,32,29,3,0,0,0,29,22,11,11,28,20,0,2,4,2,2,,,
"Nov 15, 2021 1:00 PM",97,44,53,57,27,30,66,26,40,47,21,26,17,5,12,17,32,30,2,0,0,0,21,35,21,14,25,27,4,3,1,0,1,,,
"Nov 15, 2021 2:00 PM",78,29,49,72,45,27,77,38,39,50,36,14,25,14,11,14,27,25,2,0,0,0,21,30,20,10,38,26,4,1,7,6,1,,,
"Nov 15, 2021 3:00 PM",93,30,63,54,36,18,77,54,23,60,37,23,24,10,14,19,38,29,9,0,0,0,24,22,14,8,39,30,3,5,10,4,6,,,
"Nov 15, 2021 4:00 PM",138,36,102,60,34,26,95,60,35,72,42,30,16,7,9,21,31,27,4,0,0,0,24,35,18,17,65,42,3,2,9,3,6,,,
"Nov 15, 2021 5:00 PM",190,48,142,65,40,25,95,47,48,79,39,40,20,7,13,25,42,35,7,0,0,0,31,46,32,14,108,64,8,3,7,5,2,,,
"Nov 15, 2021 6:00 PM",178,40,138,33,28,5,83,59,24,56,33,23,13,3,10,12,43,32,11,0,0,0,33,36,17,19,84,40,4,2,11,7,4,,,
"Nov 15, 2021 7:00 PM",88,24,64,36,26,10,51,36,15,39,28,11,7,3,4,20,22,17,5,0,0,0,20,22,20,2,49,28,4,4,4,2,2,,,
"Nov 15, 2021 8:00 PM",88,15,73,15,8,7,27,18,9,21,11,10,3,3,0,10,11,10,1,0,0,0,10,8,5,3,29,21,3,1,6,1,5,,,
"Nov 15, 2021 9:00 PM",43,9,34,9,6,3,17,7,10,11,5,6,1,0,1,7,11,8,3,0,0,0,9,5,4,1,17,8,2,2,7,3,4,,,
"Nov 15, 2021 10:00 PM",30,5,25,4,3,1,6,3,3,10,3,7,1,1,0,4,4,1,3,0,0,0,1,1,0,1,7,3,1,0,2,2,0,,,
"Nov 15, 2021 11:00 PM",13,5,8,2,1,1,5,2,3,1,1,0,1,0,1,1,1,1,0,0,0,0,1,4,1,3,2,4,1,0,3,3,0,,,
"Nov 16, 2021 12:00 AM",3,0,3,0,0,0,0,0,0,1,0,1,2,2,0,0,1,0,1,0,0,0,0,0,0,0,0,2,0,0,0,0,0,,,
"Nov 16, 2021 1:00 AM",2,1,1,0,0,0,0,0,0,0,0,0,0,0,0,0,2,1,1,0,0,0,1,0,0,0,0,0,0,0,0,0,0,,,
"Nov 16, 2021 2:00 AM",4,3,1,0,0,0,0,0,0,0,0,0,0,0,0,0,0,0,0,0,0,0,0,0,0,0,0,0,0,0,0,0,0,,,
"Nov 16, 2021 3:00 AM",2,1,1,0,0,0,0,0,0,0,0,0,0,0,0,0,0,0,0,0,0,0,0,0,0,0,1,0,0,0,0,0,0,,,
"Nov 16, 2021 4:00 AM",0,0,0,0,0,0,2,1,1,1,0,1,0,0,0,2,0,0,0,0,0,0,0,0,0,0,1,4,0,0,0,0,0,,,
"Nov 16, 2021 5:00 AM",6,5,1,3,1,2,2,1,1,3,2,1,0,0,0,2,9,9,0,0,0,0,9,1,0,1,3,9,1,0,0,0,0,,,
"Nov 16, 2021 6:00 AM",42,31,11,19,9,10,31,12,19,29,12,17,2,1,1,6,21,21,0,0,0,0,21,4,0,4,16,37,1,4,2,2,0,,,
"Nov 16, 2021 7:00 AM",93,64,29,52,15,37,99,34,65,56,19,37,10,7,3,12,68,68,0,0,0,0,69,34,7,27,50,117,3,7,4,3,1,,,
"Nov 16, 2021 8:00 AM",267,212,55,108,25,83,197,63,134,128,46,82,35,23,12,24,159,157,2,0,0,0,149,86,23,63,66,175,8,4,14,10,4,,,
"Nov 16, 2021 9:00 AM",148,122,26,64,23,41,105,52,53,79,45,34,16,8,8,13,78,76,2,0,0,0,62,35,17,18,22,78,4,3,5,2,3,,,
"Nov 16, 2021 10:00 AM",72,57,15,40,24,16,74,38,36,46,26,20,10,7,3,15,50,48,2,0,0,0,44,33,19,14,21,38,2,1,1,1,0,,,
"Nov 16, 2021 11:00 AM",52,43,9,52,31,21,61,40,21,49,33,16,8,4,4,7,31,27,4,0,0,0,24,21,13,8,25,23,2,1,5,3,2,,,
"Nov 16, 2021 12:00 PM",59,41,18,50,30,20,81,41,40,55,33,22,13,6,7,5,35,33,2,0,0,0,28,19,14,5,26,45,4,2,4,3,1,,,
"Nov 16, 2021 1:00 PM",105,50,55,66,35,31,64,27,37,55,27,28,17,8,9,10,44,42,2,0,0,0,34,20,9,11,48,29,2,4,0,0,0,,,
"Nov 16, 2021 2:00 PM",85,42,43,49,26,23,49,29,20,44,25,19,12,5,7,11,29,26,3,0,0,0,22,21,8,13,24,31,2,1,1,0,1,,,
"Nov 16, 2021 3:00 PM",103,39,64,61,37,24,60,38,22,51,28,23,15,3,12,12,43,38,5,0,0,0,33,21,13,8,37,33,5,2,4,2,2,,,
"Nov 16, 2021 4:00 PM",152,53,99,67,40,27,95,66,29,82,49,33,23,13,10,13,39,30,9,0,0,0,25,35,26,9,71,50,4,2,8,5,3,,,
"Nov 16, 2021 5:00 PM",218,46,172,56,41,15,102,61,41,79,39,40,26,5,21,13,46,35,11,0,0,0,41,44,28,16,127,62,6,5,4,2,2,,,
"Nov 16, 2021 6:00 PM",166,43,123,44,36,8,89,60,29,64,45,19,20,6,14,22,38,33,5,0,0,0,38,35,25,10,100,36,4,4,15,10,5,,,
"Nov 16, 2021 7:00 PM",119,24,95,31,22,9,59,35,24,44,26,18,12,5,7,15,20,17,3,0,0,0,16,24,13,11,46,33,3,1,4,2,2,,,
"Nov 16, 2021 8:00 PM",69,19,50,16,10,6,32,21,11,20,12,8,6,3,3,3,18,15,3,0,0,0,20,6,3,3,25,24,3,2,7,3,4,,,
"Nov 16, 2021 9:00 PM",56,16,40,11,9,2,22,14,8,15,10,5,6,5,1,7,8,8,0,0,0,0,6,9,8,1,14,10,0,3,2,1,1,,,
"Nov 16, 2021 10:00 PM",32,4,28,5,4,1,12,10,2,6,5,1,4,3,1,2,3,1,2,0,0,0,1,6,5,1,19,3,1,0,2,2,0,,,
"Nov 16, 2021 11:00 PM",16,1,15,6,5,1,2,2,0,3,2,1,0,0,0,2,2,2,0,0,0,0,2,2,2,0,4,2,1,0,1,1,0,,,
"Nov 17, 2021 12:00 AM",4,2,2,0,0,0,1,0,1,3,1,2,1,0,1,0,1,1,0,0,0,0,1,1,1,0,3,1,0,0,0,0,0,,,
"Nov 17, 2021 1:00 AM",3,1,2,1,1,0,2,1,1,2,1,1,0,0,0,0,1,0,1,0,0,0,0,0,0,0,3,0,0,0,0,0,0,,,
"Nov 17, 2021 2:00 AM",6,6,0,0,0,0,0,0,0,0,0,0,0,0,0,0,0,0,0,0,0,0,0,0,0,0,0,0,0,0,0,0,0,,,
"Nov 17, 2021 3:00 AM",1,0,1,0,0,0,1,1,0,0,0,0,0,0,0,0,0,0,0,0,0,0,0,1,1,0,0,0,0,0,0,0,0,,,
"Nov 17, 2021 4:00 AM",0,0,0,0,0,0,2,1,1,1,0,1,0,0,0,1,0,0,0,0,0,0,0,0,0,0,5,2,0,0,1,1,0,,,
"Nov 17, 2021 5:00 AM",9,5,4,6,5,1,3,3,0,6,6,0,0,0,0,1,11,11,0,0,0,0,11,1,1,0,4,10,0,0,0,0,0,,,
"Nov 17, 2021 6:00 AM",37,20,17,12,5,7,22,10,12,19,8,11,0,0,0,3,18,18,0,0,0,0,20,4,3,1,13,33,1,3,3,3,0,,,
"Nov 17, 2021 7:00 AM",105,75,30,53,20,33,88,28,60,58,25,33,7,4,3,11,65,65,0,0,0,0,58,28,10,18,43,116,2,3,4,2,2,,,
"Nov 17, 2021 8:00 AM",250,180,70,106,23,83,159,59,100,106,42,64,32,22,10,34,166,163,3,0,0,0,152,74,20,54,66,160,8,5,18,12,6,,,
"Nov 17, 2021 9:00 AM",143,114,29,62,21,41,98,46,52,64,34,30,21,16,5,8,74,72,2,0,0,0,61,40,17,23,21,70,2,3,4,2,2,,,
"Nov 17, 2021 10:00 AM",91,63,28,57,24,33,64,33,31,48,27,21,8,6,2,5,45,43,2,0,0,0,39,28,18,10,30,40,6,5,3,2,1,,,
"Nov 17, 2021 11:00 AM",64,44,20,37,14,23,79,44,35,41,16,25,22,9,13,8,38,37,1,0,0,0,34,22,17,5,20,39,8,2,4,2,2,,,
"Nov 17, 2021 12:00 PM",97,53,44,42,18,24,78,29,49,52,27,25,18,3,15,5,35,33,2,0,0,0,32,35,16,19,27,29,5,5,7,4,3,,,
"Nov 17, 2021 1:00 PM",96,46,50,74,50,24,99,60,39,72,50,22,23,10,13,22,39,33,6,0,0,0,29,38,24,14,34,33,4,9,7,4,3,,,
"Nov 17, 2021 2:00 PM",101,56,45,69,40,29,59,34,25,52,35,17,19,10,9,15,33,30,3,0,0,0,27,27,19,8,26,31,7,7,3,1,2,,,
"Nov 17, 2021 3:00 PM",100,40,60,46,28,18,54,36,18,43,25,18,17,5,12,8,43,37,6,0,0,0,31,28,18,10,52,37,2,4,5,1,4,,,
"Nov 17, 2021 4:00 PM",139,52,87,33,20,13,71,46,25,50,30,20,16,10,6,22,24,20,4,0,0,0,19,29,17,12,57,47,6,2,6,2,4,,,
"Nov 17, 2021 5:00 PM",217,47,170,42,33,9,77,46,31,58,29,29,9,3,6,17,49,44,5,0,0,0,40,41,32,9,106,56,6,2,8,6,2,,,
"Nov 17, 2021 6:00 PM",168,55,113,63,47,16,109,84,25,67,50,17,9,1,8,24,45,37,8,0,0,0,35,45,30,15,79,49,5,3,10,7,3,,,
"Nov 17, 2021 7:00 PM",110,37,73,32,18,14,50,34,16,39,23,16,15,6,9,14,18,15,3,0,0,0,17,21,10,11,37,34,1,2,5,3,2,,,
"Nov 17, 2021 8:00 PM",77,16,61,17,11,6,28,14,14,15,9,6,2,1,1,7,16,14,2,0,0,0,15,7,2,5,40,21,3,1,4,2,2,,,
"Nov 17, 2021 9:00 PM",45,11,34,9,8,1,16,10,6,13,6,7,2,1,1,5,12,10,2,0,0,0,11,6,5,1,14,13,2,1,3,1,2,,,
"Nov 17, 2021 10:00 PM",27,6,21,9,6,3,12,6,6,12,5,7,1,1,0,7,5,2,3,0,0,0,2,1,1,0,12,6,1,1,2,1,1,,,
"Nov 17, 2021 11:00 PM",12,0,12,4,4,0,4,3,1,3,1,2,1,0,1,3,1,0,1,0,0,0,0,0,0,0,4,2,0,1,1,1,0,,,
"Nov 18, 2021 12:00 AM",11,2,9,0,0,0,1,1,0,1,1,0,0,0,0,1,2,2,0,0,0,0,2,2,2,0,6,1,0,0,1,1,0,,,
"Nov 18, 2021 1:00 AM",6,0,6,0,0,0,0,0,0,0,0,0,0,0,0,1,0,0,0,0,0,0,0,1,0,1,0,0,0,0,1,1,0,,,
"Nov 18, 2021 2:00 AM",3,2,1,0,0,0,0,0,0,0,0,0,0,0,0,0,0,0,0,0,0,0,0,0,0,0,0,0,0,0,0,0,0,,,
"Nov 18, 2021 3:00 AM",0,0,0,0,0,0,0,0,0,0,0,0,0,0,0,0,0,0,0,0,0,0,0,0,0,0,0,0,0,0,0,0,0,,,
"Nov 18, 2021 4:00 AM",1,1,0,0,0,0,1,1,0,2,0,2,0,0,0,1,0,0,0,0,0,0,0,0,0,0,1,3,0,0,0,0,0,,,
"Nov 18, 2021 5:00 AM",6,4,2,2,0,2,5,2,3,4,2,2,0,0,0,4,8,8,0,0,0,0,9,2,0,2,2,10,0,0,0,0,0,,,
"Nov 18, 2021 6:00 AM",27,17,10,19,7,12,19,8,11,21,12,9,3,2,1,4,22,22,0,0,0,0,22,4,3,1,9,36,1,2,1,0,1,,,
"Nov 18, 2021 7:00 AM",99,70,29,56,23,33,78,28,50,49,20,29,5,5,0,11,63,63,0,0,0,0,58,28,13,15,36,89,3,6,4,4,0,,,
"Nov 18, 2021 8:00 AM",234,168,66,102,29,73,157,57,100,108,43,65,29,13,16,31,143,141,2,0,0,0,137,76,36,40,59,156,7,4,24,21,3,,,
"Nov 18, 2021 9:00 AM",134,107,27,54,20,34,112,58,54,82,40,42,26,13,13,9,80,78,2,0,0,0,74,44,26,18,24,69,2,5,4,1,3,,,
"Nov 18, 2021 10:00 AM",87,69,18,49,18,31,77,39,38,42,25,17,14,9,5,12,61,58,3,0,0,0,45,25,13,12,33,38,2,3,2,1,1,,,
"Nov 18, 2021 11:00 AM",62,38,24,39,19,20,71,36,35,46,23,23,23,16,7,9,51,47,4,0,0,0,35,21,10,11,16,31,3,0,4,4,0,,,
"Nov 18, 2021 12:00 PM",104,57,47,57,24,33,94,47,47,52,25,27,18,8,10,9,23,20,3,0,0,0,19,22,14,8,26,33,1,5,3,3,0,,,
"Nov 18, 2021 1:00 PM",121,59,62,55,29,26,79,36,43,52,24,28,13,6,7,16,42,35,7,0,0,0,28,34,17,17,36,31,4,2,2,1,1,,,
"Nov 18, 2021 2:00 PM",94,46,48,50,31,19,53,28,25,45,33,12,31,15,16,11,32,24,8,0,0,0,19,23,17,6,32,26,2,3,8,6,2,,,
"Nov 18, 2021 3:00 PM",101,31,70,37,29,8,62,45,17,41,33,8,13,6,7,10,38,32,6,0,0,0,32,22,16,6,33,28,2,3,4,2,2,,,
"Nov 18, 2021 4:00 PM",142,47,95,61,40,21,95,61,34,68,44,24,24,12,12,17,33,29,4,0,0,0,29,26,17,9,65,56,5,5,8,4,4,,,
"Nov 18, 2021 5:00 PM",177,52,125,39,21,18,73,41,32,48,22,26,24,10,14,15,36,31,5,0,0,0,31,41,27,14,81,64,7,2,8,6,2,,,
"Nov 18, 2021 6:00 PM",178,45,133,48,36,12,79,57,22,56,32,24,6,1,5,19,49,40,9,0,0,0,41,32,23,9,88,36,2,1,6,4,2,,,
"Nov 18, 2021 7:00 PM",111,33,78,29,19,10,51,32,19,43,30,13,10,0,10,7,25,23,2,0,0,0,22,21,14,7,44,28,3,1,9,4,5,,,
"Nov 18, 2021 8:00 PM",77,22,55,25,16,9,25,16,9,20,14,6,3,1,2,6,18,14,4,0,0,0,14,8,6,2,20,22,3,0,3,3,0,,,
"Nov 18, 2021 9:00 PM",55,18,37,11,8,3,14,10,4,10,9,1,4,4,0,14,9,7,2,0,0,0,8,14,12,2,7,14,1,1,4,3,1,,,
"Nov 18, 2021 10:00 PM",34,11,23,12,9,3,12,7,5,12,8,4,8,1,7,5,7,6,1,0,0,0,4,5,4,1,13,8,0,1,3,3,0,,,
"Nov 18, 2021 11:00 PM",15,1,14,8,5,3,11,7,4,9,4,5,6,4,2,0,5,3,2,0,0,0,5,3,1,2,11,1,1,0,0,0,0,,,
"Nov 19, 2021 12:00 AM",15,2,13,0,0,0,4,1,3,10,4,6,1,0,1,0,2,0,2,0,0,0,0,2,2,0,6,5,1,0,0,0,0,,,
"Nov 19, 2021 1:00 AM",4,2,2,2,2,0,2,1,1,0,0,0,1,0,1,1,1,1,0,0,0,0,1,0,0,0,0,2,0,0,0,0,0,,,
"Nov 19, 2021 2:00 AM",9,4,5,0,0,0,0,0,0,0,0,0,0,0,0,0,1,0,1,0,0,0,0,0,0,0,2,0,0,0,0,0,0,,,
"Nov 19, 2021 3:00 AM",0,0,0,0,0,0,1,1,0,0,0,0,2,2,0,0,0,0,0,0,0,0,0,1,1,0,1,0,0,0,0,0,0,,,
"Nov 19, 2021 4:00 AM",1,1,0,0,0,0,0,0,0,1,0,1,0,0,0,4,0,0,0,0,0,0,0,0,0,0,1,0,0,0,0,0,0,,,
"Nov 19, 2021 5:00 AM",3,2,1,1,1,0,6,6,0,2,2,0,0,0,0,0,7,7,0,0,0,0,7,2,2,0,7,9,0,1,0,0,0,,,
"Nov 19, 2021 6:00 AM",31,16,15,16,8,8,24,11,13,22,9,13,1,1,0,5,18,18,0,0,0,0,19,3,1,2,20,40,3,2,1,1,0,,,
"Nov 19, 2021 7:00 AM",79,53,26,61,19,42,72,25,47,59,24,35,8,7,1,9,49,49,0,0,0,0,44,25,15,10,32,83,1,3,4,3,1,,,
"Nov 19, 2021 8:00 AM",202,148,54,103,37,66,126,47,79,99,43,56,28,20,8,16,120,118,2,0,0,0,109,62,16,46,56,117,7,2,14,10,4,,,
"Nov 19, 2021 9:00 AM",135,109,26,81,34,47,94,49,45,87,47,40,28,15,13,6,71,71,0,0,0,0,64,36,20,16,20,45,1,4,4,0,4,,,
"Nov 19, 2021 10:00 AM",77,52,25,64,24,40,94,51,43,61,31,30,14,13,1,6,31,30,1,0,0,0,27,32,19,13,23,30,6,2,5,4,1,,,
"Nov 19, 2021 11:00 AM",77,45,32,80,45,35,92,51,41,67,41,26,11,6,5,7,34,29,5,0,0,0,28,39,29,10,27,27,7,4,2,0,2,,,
"Nov 19, 2021 12:00 PM",76,36,40,82,40,42,107,54,53,68,36,32,8,4,4,9,26,23,3,0,0,0,22,45,26,19,27,29,5,2,5,2,3,,,
"Nov 19, 2021 1:00 PM",125,47,78,88,47,41,113,47,66,76,35,41,12,7,5,17,40,34,6,0,0,0,24,46,25,21,40,41,4,2,2,1,1,,,
"Nov 19, 2021 2:00 PM",90,45,45,78,43,35,83,50,33,58,38,20,32,20,12,17,29,28,1,0,0,0,26,31,17,14,42,38,5,5,5,2,3,,,
"Nov 19, 2021 3:00 PM",99,44,55,85,46,39,85,49,36,64,39,25,22,4,18,18,29,25,4,0,0,0,25,36,24,12,45,33,5,2,3,2,1,,,
"Nov 19, 2021 4:00 PM",104,30,74,66,42,24,82,51,31,67,46,21,26,8,18,28,31,27,4,0,0,0,28,29,23,6,57,51,3,2,5,2,3,,,
"Nov 19, 2021 5:00 PM",152,47,105,53,34,19,73,46,27,57,31,26,11,3,8,23,29,22,7,0,0,0,19,26,19,7,66,50,7,2,7,4,3,,,
"Nov 19, 2021 6:00 PM",134,37,97,28,19,9,52,39,13,41,30,11,22,11,11,30,26,22,4,0,0,0,23,29,18,11,60,34,4,2,7,6,1,,,
"Nov 19, 2021 7:00 PM",81,28,53,28,20,8,42,25,17,39,21,18,6,1,5,9,14,12,2,0,0,0,13,16,13,3,27,33,7,0,6,3,3,,,
"Nov 19, 2021 8:00 PM",50,18,32,7,4,3,22,11,11,6,3,3,5,1,4,5,17,15,2,0,0,0,18,7,5,2,12,20,1,3,0,0,0,,,
"Nov 19, 2021 9:00 PM",36,14,22,6,3,3,16,8,8,16,6,10,7,2,5,6,7,7,0,0,0,0,7,9,8,1,14,15,3,1,2,0,2,,,
"Nov 19, 2021 10:00 PM",25,5,20,11,5,6,15,9,6,10,7,3,3,3,0,3,10,7,3,0,0,0,7,4,3,1,16,9,1,3,2,2,0,,,
"Nov 19, 2021 11:00 PM",22,3,19,5,4,1,13,4,9,11,2,9,2,2,0,0,5,4,1,0,0,0,5,5,3,2,8,3,1,0,0,0,0,,,
"Nov 20, 2021 12:00 AM",28,6,22,0,0,0,4,3,1,14,7,7,5,1,4,2,4,3,1,0,0,0,3,4,3,1,13,8,1,0,0,0,0,,,
"Nov 20, 2021 1:00 AM",9,1,8,3,1,2,2,1,1,2,0,2,0,0,0,3,1,1,0,0,0,0,0,2,2,0,4,1,0,0,0,0,0,,,
"Nov 20, 2021 2:00 AM",4,3,1,1,1,0,0,0,0,0,0,0,0,0,0,0,2,2,0,0,0,0,2,1,1,0,0,2,0,0,2,1,1,,,
"Nov 20, 2021 3:00 AM",5,2,3,1,1,0,0,0,0,2,1,1,0,0,0,0,0,0,0,0,0,0,0,0,0,0,2,0,0,0,0,0,0,,,
"Nov 20, 2021 4:00 AM",1,0,1,0,0,0,1,0,1,1,0,1,0,0,0,1,0,0,0,0,0,0,0,0,0,0,1,0,0,0,0,0,0,,,
"Nov 20, 2021 5:00 AM",1,1,0,1,1,0,2,0,2,1,0,1,0,0,0,0,0,0,0,0,0,0,0,2,2,0,1,2,0,0,1,1,0,,,
"Nov 20, 2021 6:00 AM",10,5,5,6,4,2,8,7,1,5,4,1,0,0,0,2,8,8,0,0,0,0,8,1,1,0,6,12,0,0,0,0,0,,,
"Nov 20, 2021 7:00 AM",18,10,8,12,9,3,20,14,6,17,13,4,4,2,2,5,8,8,0,0,0,0,9,2,2,0,17,17,0,3,0,0,0,,,
"Nov 20, 2021 8:00 AM",33,18,15,49,30,19,52,30,22,39,25,14,16,6,10,5,16,16,0,0,0,0,18,10,4,6,29,18,2,5,4,2,2,,,
"Nov 20, 2021 9:00 AM",49,28,21,111,64,47,90,62,28,99,72,27,6,6,0,11,10,10,0,0,0,0,12,33,23,10,32,39,7,3,5,5,0,,,
"Nov 20, 2021 10:00 AM",67,36,31,106,50,56,122,68,54,83,47,36,17,11,6,15,35,35,0,0,0,0,36,38,24,14,40,43,2,4,4,2,2,,,
"Nov 20, 2021 11:00 AM",71,39,32,150,80,70,199,119,80,135,86,49,17,12,5,16,19,19,0,0,0,0,13,63,48,15,50,40,5,3,4,2,2,,,
"Nov 20, 2021 12:00 PM",74,38,36,163,67,96,191,92,99,129,54,75,43,36,7,17,26,25,1,0,0,0,25,75,46,29,31,37,7,2,4,3,1,,,
"Nov 20, 2021 1:00 PM",66,33,33,136,60,76,172,70,102,124,71,53,32,18,14,21,29,25,4,0,0,0,25,46,20,26,37,46,3,1,10,10,0,,,
"Nov 20, 2021 2:00 PM",54,30,24,66,32,34,99,30,69,78,31,47,19,9,10,14,24,24,0,0,0,0,23,18,7,11,25,43,3,3,4,4,0,,,
"Nov 20, 2021 3:00 PM",46,26,20,46,23,23,53,22,31,51,26,25,13,10,3,14,11,11,0,0,0,0,11,14,4,10,19,27,2,6,3,2,1,,,
"Nov 20, 2021 4:00 PM",56,31,25,40,23,17,59,22,37,45,22,23,4,2,2,15,18,17,1,0,0,0,14,24,15,9,19,28,3,4,3,1,2,,,
"Nov 20, 2021 5:00 PM",46,14,32,37,23,14,41,17,24,35,11,24,10,2,8,14,13,12,1,0,0,0,12,11,4,7,11,24,4,2,3,2,1,,,
"Nov 20, 2021 6:00 PM",38,11,27,14,6,8,19,9,10,16,8,8,3,2,1,11,10,10,0,0,0,0,8,8,4,4,15,8,1,0,0,0,0,,,
"Nov 20, 2021 7:00 PM",43,22,21,12,9,3,14,9,5,15,9,6,11,4,7,6,15,15,0,0,0,0,15,8,3,5,13,10,2,0,6,2,4,,,
"Nov 20, 2021 8:00 PM",19,9,10,15,10,5,10,6,4,11,6,5,3,3,0,3,3,3,0,0,0,0,4,0,0,0,6,9,1,1,0,0,0,,,
"Nov 20, 2021 9:00 PM",19,5,14,14,3,11,12,2,10,12,2,10,9,2,7,7,7,7,0,0,0,0,5,2,2,0,2,6,1,0,2,1,1,,,
"Nov 20, 2021 10:00 PM",9,0,9,3,2,1,4,2,2,5,5,0,1,0,1,1,2,1,1,0,0,0,1,2,2,0,3,8,1,3,0,0,0,,,
"Nov 20, 2021 11:00 PM",11,4,7,8,3,5,8,2,6,12,4,8,6,5,1,1,4,4,0,0,0,0,3,2,2,0,4,6,0,1,0,0,0,,,
"Nov 21, 2021 12:00 AM",15,3,12,0,0,0,1,0,1,4,2,2,4,4,0,4,1,1,0,0,0,0,1,1,1,0,9,6,0,0,0,0,0,,,
"Nov 21, 2021 1:00 AM",4,1,3,1,0,1,6,2,4,2,0,2,1,1,0,0,2,0,2,0,0,0,0,1,1,0,1,2,1,0,0,0,0,,,
"Nov 21, 2021 2:00 AM",3,2,1,1,1,0,2,2,0,1,1,0,0,0,0,0,1,0,1,0,0,0,1,0,0,0,2,1,0,0,1,1,0,,,
"Nov 21, 2021 3:00 AM",0,0,0,0,0,0,1,0,1,1,1,0,0,0,0,0,0,0,0,0,0,0,0,0,0,0,0,1,0,1,0,0,0,,,
"Nov 21, 2021 4:00 AM",1,0,1,0,0,0,1,1,0,0,0,0,0,0,0,0,0,0,0,0,0,0,0,1,1,0,2,0,0,0,0,0,0,,,
"Nov 21, 2021 5:00 AM",1,0,1,0,0,0,0,0,0,0,0,0,0,0,0,0,1,1,0,0,0,0,0,0,0,0,0,1,0,0,0,0,0,,,
"Nov 21, 2021 6:00 AM",13,6,7,2,0,2,4,3,1,3,1,2,0,0,0,1,3,3,0,0,0,0,4,0,0,0,3,5,0,0,0,0,0,,,
"Nov 21, 2021 7:00 AM",9,5,4,17,10,7,23,18,5,17,14,3,0,0,0,0,7,7,0,0,0,0,8,7,7,0,10,13,0,3,3,2,1,,,
"Nov 21, 2021 8:00 AM",27,14,13,68,39,29,70,48,22,65,43,22,3,2,1,2,10,10,0,0,0,0,12,16,13,3,31,30,1,4,0,0,0,,,
"Nov 21, 2021 9:00 AM",44,23,21,81,49,32,104,69,35,89,61,28,10,3,7,15,16,16,0,0,0,0,17,27,17,10,27,38,4,15,5,4,1,,,
"Nov 21, 2021 10:00 AM",62,37,25,134,76,58,159,92,67,119,73,46,15,11,4,13,20,19,1,0,0,0,19,41,29,12,40,41,2,6,3,3,0,,,
"Nov 21, 2021 11:00 AM",66,37,29,147,63,84,207,112,95,142,73,69,30,16,14,10,25,22,3,0,0,0,19,55,42,13,54,58,21,6,17,14,3,,,
"Nov 21, 2021 12:00 PM",62,30,32,175,84,91,216,109,107,148,76,72,34,14,20,18,20,19,1,0,0,0,21,67,32,35,49,51,10,5,4,4,0,,,
"Nov 21, 2021 1:00 PM",77,54,23,122,82,40,185,81,104,132,70,62,31,16,15,26,26,26,0,0,0,0,21,67,40,27,47,58,10,4,9,6,3,,,
"Nov 21, 2021 2:00 PM",65,38,27,98,50,48,123,61,62,82,43,39,23,7,16,15,22,22,0,0,0,0,14,43,30,13,33,46,9,4,8,3,5,,,
"Nov 21, 2021 3:00 PM",34,22,12,73,32,41,95,41,54,84,36,48,25,21,4,9,26,26,0,0,0,0,22,44,16,28,29,36,3,3,0,0,0,,,
"Nov 21, 2021 4:00 PM",80,27,53,60,33,27,71,26,45,61,29,32,21,4,17,15,16,14,2,0,0,0,13,24,12,12,32,32,3,1,2,1,1,,,
"Nov 21, 2021 5:00 PM",38,15,23,40,23,17,31,17,14,26,16,10,7,4,3,13,15,15,0,0,0,0,14,11,6,5,23,14,3,1,5,4,1,,,
"Nov 21, 2021 6:00 PM",48,20,28,13,9,4,19,10,9,13,7,6,5,3,2,11,6,6,0,0,0,0,7,11,5,6,12,10,1,0,1,0,1,,,
"Nov 21, 2021 7:00 PM",32,15,17,4,1,3,10,5,5,9,6,3,3,1,2,5,10,8,2,0,0,0,8,4,3,1,10,8,2,0,0,0,0,,,
"Nov 21, 2021 8:00 PM",24,8,16,8,4,4,10,3,7,8,4,4,4,1,3,3,7,5,2,0,0,0,3,1,0,1,8,8,3,1,1,1,0,,,
"Nov 21, 2021 9:00 PM",19,5,14,4,2,2,10,6,4,7,4,3,0,0,0,7,3,3,0,0,0,0,4,4,3,1,3,11,0,0,0,0,0,,,
"Nov 21, 2021 10:00 PM",8,3,5,1,0,1,2,0,2,1,0,1,0,0,0,3,0,0,0,0,0,0,0,0,0,0,5,5,1,1,0,0,0,,,
"Nov 21, 2021 11:00 PM",8,2,6,0,0,0,3,1,2,1,0,1,0,0,0,2,2,2,0,0,0,0,1,2,1,1,5,3,0,0,0,0,0,,,
"Nov 22, 2021 12:00 AM",7,2,5,0,0,0,1,0,1,2,1,1,0,0,0,2,1,1,0,0,0,0,1,0,0,0,2,1,0,1,0,0,0,,,
"Nov 22, 2021 1:00 AM",4,0,4,1,1,0,0,0,0,0,0,0,1,0,1,0,2,1,1,0,0,0,2,0,0,0,1,0,0,0,0,0,0,,,
"Nov 22, 2021 2:00 AM",3,1,2,0,0,0,0,0,0,0,0,0,0,0,0,0,0,0,0,0,0,0,0,0,0,0,0,0,0,0,0,0,0,,,
"Nov 22, 2021 3:00 AM",0,0,0,0,0,0,0,0,0,0,0,0,1,0,1,0,0,0,0,0,0,0,0,0,0,0,0,0,0,0,0,0,0,,,
"Nov 22, 2021 4:00 AM",2,1,1,0,0,0,0,0,0,0,0,0,0,0,0,2,0,0,0,0,0,0,0,0,0,0,0,1,0,0,1,1,0,,,
"Nov 22, 2021 5:00 AM",8,6,2,1,1,0,6,5,1,4,3,1,0,0,0,2,5,5,0,0,0,0,6,1,1,0,2,10,0,0,0,0,0,,,
"Nov 22, 2021 6:00 AM",32,21,11,19,4,15,20,5,15,14,4,10,0,0,0,4,21,21,0,0,0,0,20,6,3,3,14,35,1,3,2,2,0,,,
"Nov 22, 2021 7:00 AM",88,62,26,44,20,24,70,28,42,58,28,30,7,4,3,11,64,64,0,0,0,0,67,20,9,11,27,71,1,5,3,1,2,,,
"Nov 22, 2021 8:00 AM",201,146,55,81,13,68,103,32,71,78,27,51,28,22,6,20,128,126,2,0,0,0,117,60,18,42,58,128,7,2,0,0,0,,,
"Nov 22, 2021 9:00 AM",146,126,20,35,13,22,88,46,42,61,33,28,16,9,7,10,69,68,1,0,0,0,60,32,21,11,23,46,2,0,0,0,0,,,
"Nov 22, 2021 10:00 AM",81,57,24,53,35,18,63,36,27,46,28,18,11,7,4,8,53,53,0,0,0,0,38,26,16,10,17,26,1,2,0,0,0,,,
"Nov 22, 2021 11:00 AM",53,25,28,54,24,30,53,25,28,37,18,19,20,16,4,6,23,23,0,0,0,0,23,12,5,7,14,27,2,1,0,0,0,,,
"Nov 22, 2021 12:00 PM",79,37,42,79,45,34,80,44,36,52,28,24,16,10,6,14,37,34,3,0,0,0,19,34,21,13,23,26,3,2,0,0,0,,,
"Nov 22, 2021 1:00 PM",83,47,36,74,36,38,88,42,46,62,27,35,16,3,13,34,26,21,5,0,0,0,18,32,18,14,31,32,2,1,0,0,0,,,
"Nov 22, 2021 2:00 PM",81,36,45,57,35,22,79,39,40,56,30,26,13,6,7,20,40,33,7,0,0,0,31,28,16,12,29,33,2,2,0,0,0,,,
"Nov 22, 2021 3:00 PM",102,38,64,40,20,20,58,31,27,37,21,16,15,5,10,19,34,27,7,0,0,0,21,20,11,9,36,34,5,3,0,0,0,,,
"Nov 22, 2021 4:00 PM",136,40,96,44,24,20,75,43,32,52,32,20,9,6,3,16,32,26,6,0,0,0,26,33,25,8,56,48,7,3,0,0,0,,,
"Nov 22, 2021 5:00 PM",177,37,140,48,29,19,85,43,42,73,39,34,16,6,10,11,43,36,7,0,0,0,28,33,20,13,69,59,7,1,0,0,0,,,
"Nov 22, 2021 6:00 PM",127,36,91,32,26,6,65,47,18,54,34,20,10,2,8,17,29,26,3,0,0,0,30,33,27,6,62,33,6,3,0,0,0,,,
"Nov 22, 2021 7:00 PM",106,32,74,34,22,12,45,35,10,36,29,7,2,1,1,9,21,13,8,0,0,0,14,14,12,2,38,18,4,0,0,0,0,,,
"Nov 22, 2021 8:00 PM",71,16,55,15,12,3,15,13,2,13,9,4,2,1,1,6,17,13,4,0,0,0,10,4,4,0,22,22,2,0,0,0,0,,,
"Nov 22, 2021 9:00 PM",42,10,32,4,3,1,13,7,6,12,7,5,0,0,0,8,13,11,2,0,0,0,11,8,6,2,15,13,1,2,0,0,0,,,
"Nov 22, 2021 10:00 PM",25,7,18,3,2,1,6,5,1,5,3,2,1,1,0,3,3,3,0,0,0,0,4,3,2,1,6,3,0,0,0,0,0,,,
"Nov 22, 2021 11:00 PM",13,3,10,3,2,1,2,0,2,3,1,2,4,1,3,1,1,0,1,0,0,0,0,1,0,1,2,2,0,0,0,0,0,,,
"Nov 23, 2021 12:00 AM",6,0,6,0,0,0,0,0,0,0,0,0,0,0,0,1,1,1,0,0,0,0,1,0,0,0,4,2,0,0,0,0,0,,,
"Nov 23, 2021 1:00 AM",3,0,3,0,0,0,0,0,0,0,0,0,0,0,0,1,2,1,1,0,0,0,0,1,0,1,1,1,0,0,0,0,0,,,
"Nov 23, 2021 2:00 AM",2,2,0,0,0,0,0,0,0,0,0,0,0,0,0,0,1,0,1,0,0,0,0,0,0,0,1,0,0,0,0,0,0,,,
"Nov 23, 2021 3:00 AM",0,0,0,0,0,0,0,0,0,0,0,0,0,0,0,0,0,0,0,0,0,0,0,0,0,0,1,0,0,0,0,0,0,,,
"Nov 23, 2021 4:00 AM",1,1,0,0,0,0,0,0,0,0,0,0,0,0,0,1,1,1,0,0,0,0,1,0,0,0,0,0,0,0,0,0,0,,,
"Nov 23, 2021 5:00 AM",8,4,4,3,1,2,4,1,3,3,1,2,1,1,0,0,8,8,0,0,0,0,7,1,0,1,4,10,1,0,0,0,0,,,
"Nov 23, 2021 6:00 AM",36,27,9,16,7,9,25,9,16,19,7,12,2,1,1,8,15,15,0,0,0,0,17,6,4,2,16,40,1,3,0,0,0,,,
"Nov 23, 2021 7:00 AM",97,70,27,53,19,34,81,24,57,62,26,36,6,4,2,10,57,57,0,0,0,0,61,26,8,18,39,78,2,9,0,0,0,,,
"Nov 23, 2021 8:00 AM",225,166,59,116,34,82,139,35,104,101,34,67,27,21,6,31,132,128,4,0,0,0,122,56,12,44,45,168,5,3,0,0,0,,,
"Nov 23, 2021 9:00 AM",125,108,17,30,12,18,72,38,34,64,36,28,16,9,7,12,71,71,0,0,0,0,62,30,16,14,23,51,1,4,0,0,0,,,
"Nov 23, 2021 10:00 AM",81,59,22,48,29,19,53,34,19,37,26,11,8,6,2,8,38,35,3,0,0,0,35,16,7,9,16,27,4,2,0,0,0,,,
"Nov 23, 2021 11:00 AM",59,40,19,43,21,22,43,18,25,33,15,18,8,6,2,14,33,28,5,0,0,0,20,15,6,9,17,23,2,1,0,0,0,,,
"Nov 23, 2021 12:00 PM",67,42,25,56,27,29,60,31,29,47,27,20,15,7,8,9,39,39,0,0,0,0,31,24,12,12,20,18,6,2,0,0,0,,,
"Nov 23, 2021 1:00 PM",82,39,43,50,26,24,51,28,23,36,15,21,15,5,10,19,31,29,2,0,0,0,24,18,8,10,28,34,5,2,0,0,0,,,
"Nov 23, 2021 2:00 PM",88,46,42,41,24,17,55,25,30,47,29,18,10,8,2,12,34,30,4,0,0,0,28,26,10,16,35,26,2,2,0,0,0,,,
"Nov 23, 2021 3:00 PM",98,41,57,36,22,14,64,38,26,48,25,23,16,7,9,7,35,32,3,0,0,0,29,19,17,2,35,30,4,4,0,0,0,,,
"Nov 23, 2021 4:00 PM",127,37,90,52,34,18,72,44,28,63,39,24,18,7,11,17,31,27,4,0,0,0,25,28,21,7,58,46,3,2,0,0,0,,,
"Nov 23, 2021 5:00 PM",192,52,140,42,31,11,79,50,29,52,33,19,18,4,14,10,40,33,7,0,0,0,32,23,17,6,86,45,4,2,0,0,0,,,
"Nov 23, 2021 6:00 PM",124,33,91,29,21,8,75,55,20,48,30,18,15,10,5,15,30,26,4,0,0,0,31,31,24,7,62,46,2,0,0,0,0,,,
"Nov 23, 2021 7:00 PM",125,32,93,27,22,5,34,23,11,34,21,13,8,2,6,11,21,18,3,0,0,0,19,11,8,3,39,21,2,0,0,0,0,,,
"Nov 23, 2021 8:00 PM",80,17,63,11,9,2,20,13,7,13,9,4,11,3,8,15,9,8,1,0,0,0,13,16,14,2,26,15,2,0,0,0,0,,,
"Nov 23, 2021 9:00 PM",43,15,28,6,3,3,18,12,6,12,7,5,1,1,0,9,7,4,3,0,0,0,5,5,3,2,11,11,0,2,0,0,0,,,
"Nov 23, 2021 10:00 PM",39,13,26,4,4,0,13,7,6,11,5,6,2,2,0,4,10,9,1,0,0,0,6,6,4,2,8,5,1,0,0,0,0,,,
"Nov 23, 2021 11:00 PM",10,1,9,0,0,0,4,3,1,0,0,0,3,0,3,2,3,3,0,0,0,0,3,1,1,0,1,5,0,0,0,0,0,,,
"Nov 24, 2021 12:00 AM",4,1,3,0,0,0,3,3,0,5,4,1,0,0,0,0,1,1,0,0,0,0,1,0,0,0,4,0,0,0,0,0,0,,,
"Nov 24, 2021 1:00 AM",5,1,4,0,0,0,0,0,0,0,0,0,0,0,0,0,3,1,2,0,0,0,1,0,0,0,3,0,0,0,0,0,0,,,
"Nov 24, 2021 2:00 AM",1,1,0,0,0,0,1,1,0,1,1,0,0,0,0,1,0,0,0,0,0,0,0,0,0,0,0,0,0,0,0,0,0,,,
"Nov 24, 2021 3:00 AM",0,0,0,0,0,0,0,0,0,0,0,0,0,0,0,0,0,0,0,0,0,0,0,0,0,0,0,0,0,0,0,0,0,,,
"Nov 24, 2021 4:00 AM",0,0,0,0,0,0,1,1,0,0,0,0,1,1,0,1,2,2,0,0,0,0,1,0,0,0,0,1,0,0,0,0,0,,,
"Nov 24, 2021 5:00 AM",5,3,2,2,1,1,3,1,2,3,2,1,0,0,0,2,6,6,0,0,0,0,8,1,1,0,2,12,0,0,0,0,0,,,
"Nov 24, 2021 6:00 AM",37,26,11,18,8,10,20,12,8,18,10,8,3,3,0,3,13,13,0,0,0,0,13,1,1,0,14,28,1,2,0,0,0,,,
"Nov 24, 2021 7:00 AM",108,75,33,50,19,31,64,20,44,56,24,32,6,5,1,17,62,62,0,0,0,0,63,16,5,11,36,73,0,4,0,0,0,,,
"Nov 24, 2021 8:00 AM",210,150,60,95,23,72,125,36,89,109,38,71,30,22,8,25,136,133,3,0,0,0,135,66,17,49,38,139,6,3,0,0,0,,,
"Nov 24, 2021 9:00 AM",132,97,35,58,24,34,71,41,30,64,35,29,16,8,8,13,60,60,0,0,0,0,47,19,12,7,27,51,2,3,0,0,0,,,
"Nov 24, 2021 10:00 AM",66,50,16,27,14,13,39,17,22,28,15,13,3,3,0,8,39,37,2,0,0,0,34,14,6,8,22,28,1,0,0,0,0,,,
"Nov 24, 2021 11:00 AM",49,27,22,23,8,15,34,12,22,25,10,15,10,5,5,11,25,22,3,0,0,0,15,10,6,4,11,22,2,1,0,0,0,,,
"Nov 24, 2021 12:00 PM",55,36,19,15,10,5,22,10,12,17,11,6,6,3,3,0,32,31,1,0,0,0,22,10,7,3,21,22,2,2,0,0,0,,,
"Nov 24, 2021 1:00 PM",85,37,48,47,33,14,81,57,24,59,43,16,16,9,7,14,28,21,7,0,0,0,14,30,23,7,35,32,3,4,0,0,0,,,
"Nov 24, 2021 2:00 PM",73,43,30,37,18,19,42,19,23,44,24,20,17,10,7,20,24,21,3,0,0,0,18,27,13,14,24,30,2,5,0,0,0,,,
"Nov 24, 2021 3:00 PM",105,38,67,43,27,16,42,29,13,48,36,12,15,6,9,10,36,32,4,0,0,0,28,25,14,11,28,28,0,0,0,0,0,,,
"Nov 24, 2021 4:00 PM",104,36,68,32,16,16,63,33,30,52,22,30,19,9,10,23,31,26,5,0,0,0,24,31,19,12,44,42,5,2,0,0,0,,,
"Nov 24, 2021 5:00 PM",180,44,136,37,26,11,71,45,26,47,34,13,16,4,12,19,33,28,5,0,0,0,26,22,20,2,93,51,5,2,0,0,0,,,
"Nov 24, 2021 6:00 PM",157,42,115,31,21,10,71,51,20,44,26,18,6,2,4,14,31,27,4,0,0,0,27,37,27,10,66,34,3,4,0,0,0,,,
"Nov 24, 2021 7:00 PM",100,29,71,30,18,12,33,21,12,28,18,10,9,5,4,4,15,11,4,0,0,0,11,12,9,3,30,30,7,1,0,0,0,,,
"Nov 24, 2021 8:00 PM",66,18,48,20,14,6,24,15,9,26,16,10,7,2,5,7,12,9,3,0,0,0,7,7,2,5,20,12,1,1,0,0,0,,,
"Nov 24, 2021 9:00 PM",39,10,29,9,8,1,11,6,5,5,3,2,3,0,3,3,11,7,4,0,0,0,6,11,8,3,8,15,5,0,0,0,0,,,
"Nov 24, 2021 10:00 PM",18,8,10,1,1,0,5,4,1,3,1,2,1,1,0,4,5,4,1,0,0,0,4,1,1,0,6,5,0,0,0,0,0,,,
"Nov 24, 2021 11:00 PM",19,3,16,2,1,1,3,2,1,2,0,2,2,0,2,2,4,3,1,0,0,0,4,1,1,0,7,4,1,0,0,0,0,,,
"Nov 25, 2021 12:00 AM",4,0,4,0,0,0,1,1,0,0,0,0,0,0,0,1,0,0,0,0,0,0,1,0,0,0,5,2,1,0,0,0,0,,,
"Nov 25, 2021 1:00 AM",4,2,2,0,0,0,2,1,1,1,0,1,0,0,0,0,1,1,0,0,0,0,1,0,0,0,0,1,0,0,0,0,0,,,
"Nov 25, 2021 2:00 AM",2,1,1,0,0,0,0,0,0,0,0,0,0,0,0,1,0,0,0,0,0,0,0,0,0,0,0,1,0,0,0,0,0,,,
"Nov 25, 2021 3:00 AM",0,0,0,0,0,0,1,1,0,0,0,0,0,0,0,0,0,0,0,0,0,0,0,0,0,0,1,0,0,0,0,0,0,,,
"Nov 25, 2021 4:00 AM",1,1,0,0,0,0,2,2,0,0,0,0,0,0,0,1,1,1,0,0,0,0,1,0,0,0,2,0,0,0,0,0,0,,,
"Nov 25, 2021 5:00 AM",6,4,2,1,0,1,2,1,1,3,2,1,0,0,0,2,6,6,0,0,0,0,6,2,0,2,4,7,0,0,0,0,0,,,
"Nov 25, 2021 6:00 AM",38,26,12,16,4,12,19,6,13,15,6,9,3,2,1,7,19,19,0,0,0,0,19,3,2,1,10,26,2,2,0,0,0,,,
"Nov 25, 2021 7:00 AM",85,58,27,29,13,16,49,18,31,46,21,25,4,3,1,14,50,50,0,0,0,0,47,19,10,9,30,64,1,3,0,0,0,,,
"Nov 25, 2021 8:00 AM",200,137,63,82,23,59,115,30,85,76,29,47,23,14,9,27,118,116,2,0,0,0,108,51,12,39,29,131,8,3,0,0,0,,,
"Nov 25, 2021 9:00 AM",117,92,25,58,23,35,72,38,34,57,27,30,19,14,5,5,70,69,1,0,0,0,59,28,14,14,21,48,0,1,0,0,0,,,
"Nov 25, 2021 10:00 AM",78,61,17,43,19,24,52,26,26,33,20,13,13,11,2,10,41,39,2,0,0,0,35,19,11,8,15,35,3,7,0,0,0,,,
"Nov 25, 2021 11:00 AM",56,29,27,36,22,14,41,20,21,30,13,17,13,8,5,10,29,23,6,0,0,0,20,19,10,9,15,16,1,1,0,0,0,,,
"Nov 25, 2021 12:00 PM",81,47,34,47,17,30,59,31,28,41,17,24,13,6,7,15,37,35,2,0,0,0,28,31,16,15,15,28,2,4,0,0,0,,,
"Nov 25, 2021 1:00 PM",94,48,46,42,31,11,81,40,41,43,24,19,10,4,6,10,40,32,8,0,0,0,27,27,18,9,26,29,7,2,0,0,0,,,
"Nov 25, 2021 2:00 PM",89,51,38,39,22,17,63,35,28,48,25,23,17,7,10,14,25,22,3,0,0,0,21,25,10,15,23,32,3,6,0,0,0,,,
"Nov 25, 2021 3:00 PM",87,39,48,37,19,18,78,46,32,43,27,16,12,2,10,14,37,32,5,0,0,0,28,24,17,7,36,35,1,0,0,0,0,,,
"Nov 25, 2021 4:00 PM",140,34,106,46,30,16,67,45,22,50,34,16,15,5,10,16,33,29,4,0,0,0,25,34,27,7,48,43,4,1,0,0,0,,,
"Nov 25, 2021 5:00 PM",173,52,121,48,30,18,75,43,32,56,32,24,15,4,11,18,35,32,3,0,0,0,27,28,21,7,69,48,4,3,0,0,0,,,
"Nov 25, 2021 6:00 PM",144,45,99,37,31,6,60,45,15,45,30,15,4,0,4,6,38,32,6,0,0,0,34,24,19,5,73,30,3,3,0,0,0,,,
"Nov 25, 2021 7:00 PM",92,30,62,19,15,4,34,25,9,29,20,9,5,1,4,3,13,10,3,0,0,0,10,9,7,2,30,17,1,0,0,0,0,,,
"Nov 25, 2021 8:00 PM",67,18,49,14,12,2,23,18,5,13,10,3,2,0,2,11,18,14,4,0,0,0,14,12,11,1,20,18,1,1,0,0,0,,,
"Nov 25, 2021 9:00 PM",32,9,23,11,6,5,13,4,9,10,4,6,2,0,2,2,7,5,2,0,0,0,5,4,2,2,9,6,2,0,0,0,0,,,
"Nov 25, 2021 10:00 PM",22,9,13,4,3,1,9,8,1,6,3,3,0,0,0,6,8,6,2,0,0,0,3,3,1,2,14,8,0,1,0,0,0,,,
"Nov 25, 2021 11:00 PM",12,1,11,4,1,3,6,2,4,4,1,3,1,1,0,4,3,2,1,0,0,0,1,0,0,0,8,3,1,0,0,0,0,,,
"Nov 26, 2021 12:00 AM",9,3,6,1,1,0,3,1,2,3,1,2,0,0,0,1,1,1,0,0,0,0,2,2,2,0,4,4,0,0,,,,,,
"Nov 26, 2021 1:00 AM",6,2,4,0,0,0,1,1,0,0,0,0,0,0,0,1,2,1,1,0,0,0,1,0,0,0,0,0,0,0,,,,,,
"Nov 26, 2021 2:00 AM",8,4,4,0,0,0,0,0,0,0,0,0,0,0,0,0,1,0,1,0,0,0,0,0,0,0,0,0,0,0,,,,,,
"Nov 26, 2021 3:00 AM",2,0,2,0,0,0,0,0,0,0,0,0,0,0,0,0,0,0,0,0,0,0,0,0,0,0,0,0,0,0,,,,,,
"Nov 26, 2021 4:00 AM",2,1,1,0,0,0,0,0,0,0,0,0,0,0,0,2,0,0,0,0,0,0,0,0,0,0,0,0,0,0,,,,,,
"Nov 26, 2021 5:00 AM",5,4,1,1,1,0,2,1,1,2,1,1,0,0,0,1,4,4,0,0,0,0,5,0,0,0,3,9,0,0,,,,,,
"Nov 26, 2021 6:00 AM",29,21,8,9,2,7,11,4,7,10,4,6,3,2,1,3,8,8,0,0,0,0,7,1,1,0,7,23,1,1,,,,,,
"Nov 26, 2021 7:00 AM",59,37,22,32,14,18,44,18,26,37,20,17,9,8,1,9,28,28,0,0,0,0,30,8,5,3,24,71,2,2,,,,,,
"Nov 26, 2021 8:00 AM",150,100,50,64,22,42,73,28,45,67,26,41,24,18,6,15,77,77,0,0,0,0,79,40,12,28,22,87,5,3,,,,,,
"Nov 26, 2021 9:00 AM",96,78,18,30,9,21,44,19,25,38,16,22,9,7,2,3,56,56,0,0,0,0,47,29,12,17,18,54,1,0,,,,,,
"Nov 26, 2021 10:00 AM",70,46,24,20,7,13,33,14,19,25,13,12,4,2,2,5,28,27,1,0,0,0,20,10,4,6,22,19,4,1,,,,,,
"Nov 26, 2021 11:00 AM",57,40,17,22,10,12,27,17,10,25,13,12,12,6,6,1,23,19,4,0,0,0,17,16,8,8,14,16,4,4,,,,,,
"Nov 26, 2021 12:00 PM",49,28,21,25,16,9,36,21,15,23,13,10,12,9,3,7,24,20,4,0,0,0,21,14,11,3,14,25,1,0,,,,,,
"Nov 26, 2021 1:00 PM",86,37,49,34,19,15,39,24,15,31,17,14,13,6,7,8,23,17,6,0,0,0,16,11,9,2,18,20,3,1,,,,,,
"Nov 26, 2021 2:00 PM",54,39,15,11,8,3,28,19,9,19,13,6,6,3,3,16,17,17,0,0,0,0,17,13,11,2,14,21,2,2,,,,,,
"Nov 26, 2021 3:00 PM",78,36,42,13,8,5,33,24,9,32,24,8,8,2,6,12,24,23,1,0,0,0,14,23,16,7,34,24,1,0,,,,,,
"Nov 26, 2021 4:00 PM",108,39,69,31,21,10,39,27,12,39,26,13,8,2,6,16,26,22,4,0,0,0,14,21,15,6,38,26,1,1,,,,,,
"Nov 26, 2021 5:00 PM",135,39,96,22,16,6,36,26,10,24,16,8,11,6,5,15,25,19,6,0,0,0,20,13,10,3,44,31,3,2,,,,,,
"Nov 26, 2021 6:00 PM",73,21,52,22,14,8,35,26,9,19,14,5,6,2,4,14,22,15,7,0,0,0,16,16,12,4,42,15,1,0,,,,,,
"Nov 26, 2021 7:00 PM",53,18,35,14,7,7,18,9,9,17,10,7,6,3,3,7,15,15,0,0,0,0,15,7,6,1,23,16,1,0,,,,,,
"Nov 26, 2021 8:00 PM",46,12,34,6,5,1,10,6,4,8,6,2,3,1,2,9,9,6,3,0,0,0,5,3,1,2,7,14,0,1,,,,,,
"Nov 26, 2021 9:00 PM",19,6,13,2,2,0,6,4,2,5,3,2,1,1,0,5,5,4,1,0,0,0,4,3,2,1,7,2,0,0,,,,,,
"Nov 26, 2021 10:00 PM",13,6,7,3,1,2,7,3,4,5,2,3,0,0,0,4,3,3,0,0,0,0,3,2,1,1,12,8,0,1,,,,,,
"Nov 26, 2021 11:00 PM",12,4,8,4,4,0,4,1,3,5,2,3,0,0,0,5,4,4,0,0,0,0,2,2,2,0,5,7,0,0,,,,,,
"Nov 27, 2021 12:00 AM",22,9,13,0,0,0,1,0,1,1,1,0,1,0,1,5,4,2,2,0,0,0,3,4,2,2,6,3,0,0,,,,,,
"Nov 27, 2021 1:00 AM",5,2,3,1,1,0,2,1,1,2,0,2,0,0,0,1,0,0,0,0,0,0,0,0,0,0,6,1,0,0,,,,,,
"Nov 27, 2021 2:00 AM",5,3,2,0,0,0,1,1,0,2,1,1,3,0,3,0,0,0,0,0,0,0,0,1,1,0,2,1,0,0,,,,,,
"Nov 27, 2021 3:00 AM",0,0,0,0,0,0,1,1,0,0,0,0,0,0,0,0,0,0,0,0,0,0,0,1,1,0,0,1,0,0,,,,,,
"Nov 27, 2021 4:00 AM",3,1,2,0,0,0,0,0,0,0,0,0,1,1,0,3,0,0,0,0,0,0,0,0,0,0,1,0,0,0,,,,,,
"Nov 27, 2021 5:00 AM",2,1,1,0,0,0,1,0,1,1,0,1,0,0,0,0,2,2,0,0,0,0,1,0,0,0,2,0,0,0,,,,,,
"Nov 27, 2021 6:00 AM",7,4,3,2,0,2,3,2,1,3,1,2,0,0,0,3,3,3,0,0,0,0,3,0,0,0,3,7,0,0,,,,,,
"Nov 27, 2021 7:00 AM",18,11,7,10,9,1,10,9,1,11,10,1,5,3,2,3,7,7,0,0,0,0,7,3,3,0,13,7,0,1,,,,,,
"Nov 27, 2021 8:00 AM",37,25,12,20,13,7,21,13,8,16,13,3,6,4,2,3,6,6,0,0,0,0,6,5,2,3,12,8,0,2,,,,,,
"Nov 27, 2021 9:00 AM",35,23,12,47,40,7,55,43,12,43,35,8,14,4,10,9,14,14,0,0,0,0,12,12,9,3,23,15,0,6,,,,,,
"Nov 27, 2021 10:00 AM",51,26,25,71,41,30,44,24,20,40,30,10,13,8,5,12,19,17,2,0,0,0,15,16,7,9,17,24,1,1,,,,,,
"Nov 27, 2021 11:00 AM",40,22,18,57,31,26,59,29,30,61,35,26,20,10,10,17,13,11,2,0,0,0,12,28,19,9,20,24,3,4,,,,,,
"Nov 27, 2021 12:00 PM",56,27,29,48,22,26,56,28,28,45,23,22,6,2,4,16,21,21,0,0,0,0,19,29,17,12,16,25,6,1,,,,,,
"Nov 27, 2021 1:00 PM",57,27,30,63,31,32,68,41,27,59,34,25,22,16,6,28,20,20,0,0,0,0,18,25,17,8,17,19,4,5,,,,,,
"Nov 27, 2021 2:00 PM",51,26,25,63,35,28,60,30,30,53,26,27,17,6,11,15,20,19,1,0,0,0,15,23,12,11,18,22,7,2,,,,,,
"Nov 27, 2021 3:00 PM",37,18,19,50,21,29,68,38,30,52,32,20,7,6,1,9,15,14,1,0,0,0,16,19,15,4,18,15,7,0,,,,,,
"Nov 27, 2021 4:00 PM",43,17,26,33,15,18,53,20,33,42,15,27,16,4,12,13,20,19,1,0,0,0,17,18,7,11,9,24,1,1,,,,,,
"Nov 27, 2021 5:00 PM",43,17,26,22,14,8,21,7,14,26,11,15,6,1,5,8,14,13,1,0,0,0,9,7,3,4,11,13,2,0,,,,,,
"Nov 27, 2021 6:00 PM",38,21,17,6,5,1,11,7,4,11,7,4,1,1,0,3,11,10,1,0,0,0,10,7,1,6,8,10,0,2,,,,,,
"Nov 27, 2021 7:00 PM",39,22,17,3,2,1,13,7,6,13,8,5,4,3,1,4,6,6,0,0,0,0,6,4,1,3,4,22,2,1,,,,,,
"Nov 27, 2021 8:00 PM",28,8,20,4,3,1,3,2,1,7,4,3,4,0,4,2,8,8,0,0,0,0,8,3,2,1,4,8,0,0,,,,,,
"Nov 27, 2021 9:00 PM",17,3,14,3,0,3,6,2,4,5,1,4,1,0,1,3,4,4,0,0,0,0,4,1,1,0,11,3,0,2,,,,,,
"Nov 27, 2021 10:00 PM",13,4,9,6,4,2,3,3,0,6,4,2,0,0,0,2,5,5,0,0,0,0,4,5,5,0,6,2,1,1,,,,,,
"Nov 27, 2021 11:00 PM",9,3,6,2,2,0,2,2,0,4,2,2,1,1,0,2,3,3,0,0,0,0,2,0,0,0,6,4,2,0,,,,,,
"Nov 28, 2021 12:00 AM",10,3,7,0,0,0,2,2,0,4,2,2,1,1,0,1,0,0,0,0,0,0,1,5,4,1,9,2,0,0,,,,,,
"Nov 28, 2021 1:00 AM",4,2,2,1,1,0,3,3,0,1,1,0,1,1,0,1,0,0,0,0,0,0,0,1,1,0,2,3,1,0,,,,,,
"Nov 28, 2021 2:00 AM",5,2,3,1,0,1,3,2,1,1,0,1,0,0,0,0,0,0,0,0,0,0,0,1,1,0,1,2,0,0,,,,,,
"Nov 28, 2021 3:00 AM",1,0,1,0,0,0,0,0,0,0,0,0,0,0,0,0,0,0,0,0,0,0,0,2,2,0,0,0,0,0,,,,,,
"Nov 28, 2021 4:00 AM",2,1,1,0,0,0,0,0,0,0,0,0,0,0,0,0,0,0,0,0,0,0,0,0,0,0,0,0,0,0,,,,,,
"Nov 28, 2021 5:00 AM",1,0,1,0,0,0,1,1,0,1,1,0,0,0,0,0,0,0,0,0,0,0,0,0,0,0,1,0,0,0,,,,,,
"Nov 28, 2021 6:00 AM",7,5,2,3,0,3,6,3,3,3,0,3,0,0,0,3,4,4,0,0,0,0,5,2,2,0,2,1,0,0,,,,,,
"Nov 28, 2021 7:00 AM",12,5,7,3,2,1,7,7,0,3,3,0,0,0,0,4,5,5,0,0,0,0,5,2,2,0,8,6,0,2,,,,,,
"Nov 28, 2021 8:00 AM",35,23,12,58,33,25,52,35,17,50,36,14,3,1,2,3,6,6,0,0,0,0,7,6,4,2,16,18,0,3,,,,,,
"Nov 28, 2021 9:00 AM",27,14,13,104,64,40,114,84,30,104,82,22,5,5,0,8,17,17,0,0,0,0,18,24,13,11,31,37,3,4,,,,,,
"Nov 28, 2021 10:00 AM",37,18,19,76,43,33,94,46,48,75,43,32,11,4,7,8,20,20,0,0,0,0,17,32,17,15,14,21,4,4,,,,,,
"Nov 28, 2021 11:00 AM",39,27,12,96,49,47,69,33,36,76,44,32,14,11,3,9,16,14,2,0,0,0,17,28,20,8,26,35,6,3,,,,,,
"Nov 28, 2021 12:00 PM",56,26,30,151,58,93,99,48,51,95,49,46,22,15,7,14,23,22,1,0,0,0,23,29,14,15,48,23,5,1,,,,,,
"Nov 28, 2021 1:00 PM",54,33,21,94,52,42,82,54,28,77,38,39,23,12,11,14,19,19,0,0,0,0,16,23,19,4,28,28,6,5,,,,,,
"Nov 28, 2021 2:00 PM",54,25,29,95,48,47,80,43,37,80,39,41,17,10,7,17,25,24,1,0,0,0,24,30,17,13,18,20,7,2,,,,,,
"Nov 28, 2021 3:00 PM",36,25,11,83,35,48,103,35,68,83,36,47,17,8,9,17,15,15,0,0,0,0,17,22,12,10,14,31,3,2,,,,,,
"Nov 28, 2021 4:00 PM",40,26,14,50,30,20,51,21,30,38,15,23,19,10,9,10,12,11,1,0,0,0,9,12,4,8,16,32,2,0,,,,,,
"Nov 28, 2021 5:00 PM",42,21,21,19,13,6,24,11,13,19,8,11,5,0,5,15,18,15,3,0,0,0,14,4,3,1,10,20,1,1,,,,,,
"Nov 28, 2021 6:00 PM",32,11,21,8,5,3,12,8,4,10,8,2,1,1,0,6,7,7,0,0,0,0,5,6,3,3,10,10,0,0,,,,,,
"Nov 28, 2021 7:00 PM",36,12,24,2,1,1,6,4,2,4,2,2,0,0,0,8,7,6,1,0,0,0,5,2,2,0,9,12,0,1,,,,,,
"Nov 28, 2021 8:00 PM",14,5,9,2,1,1,9,3,6,2,1,1,2,2,0,4,6,6,0,0,0,0,5,1,1,0,7,9,1,0,,,,,,
"Nov 28, 2021 9:00 PM",16,5,11,1,0,1,5,4,1,4,1,3,0,0,0,2,4,4,0,0,0,0,4,2,1,1,10,10,0,1,,,,,,
"Nov 28, 2021 10:00 PM",9,1,8,2,1,1,7,2,5,3,0,3,0,0,0,3,1,1,0,0,0,0,1,2,2,0,5,7,1,1,,,,,,
"Nov 28, 2021 11:00 PM",8,2,6,1,0,1,3,0,3,4,0,4,0,0,0,3,3,3,0,0,0,0,3,3,2,1,3,7,0,0,,,,,,
"Nov 29, 2021 12:00 AM",3,0,3,0,0,0,1,0,1,1,0,1,1,0,1,0,1,1,0,0,0,0,1,1,1,0,2,4,0,0,,,,,,
"Nov 29, 2021 1:00 AM",2,1,1,0,0,0,2,1,1,0,0,0,0,0,0,0,0,0,0,0,0,0,0,0,0,0,1,0,0,0,,,,,,
"Nov 29, 2021 2:00 AM",2,2,0,0,0,0,2,2,0,1,1,0,0,0,0,0,0,0,0,0,0,0,0,0,0,0,1,0,0,0,,,,,,
"Nov 29, 2021 3:00 AM",1,0,1,0,0,0,0,0,0,0,0,0,0,0,0,0,0,0,0,0,0,0,0,0,0,0,0,0,0,0,,,,,,
"Nov 29, 2021 4:00 AM",1,0,1,0,0,0,0,0,0,0,0,0,0,0,0,1,0,0,0,0,0,0,0,0,0,0,0,0,0,0,,,,,,
"Nov 29, 2021 5:00 AM",11,7,4,1,1,0,2,2,0,3,2,1,0,0,0,2,5,5,0,0,0,0,5,0,0,0,1,9,0,0,0,0,0,,,
"Nov 29, 2021 6:00 AM",28,19,9,14,4,10,22,7,15,15,5,10,1,1,0,7,17,17,0,0,0,0,17,5,2,3,8,36,2,3,0,0,0,,,
"Nov 29, 2021 7:00 AM",95,73,22,38,13,25,56,19,37,40,15,25,4,4,0,14,46,46,0,0,0,0,50,24,8,16,28,71,2,5,0,0,0,,,
"Nov 29, 2021 8:00 AM",184,134,50,67,22,45,96,38,58,77,30,47,32,18,14,26,112,108,4,0,0,0,111,43,13,30,44,111,9,2,0,0,0,,,
"Nov 29, 2021 9:00 AM",114,94,20,40,14,26,74,38,36,46,26,20,6,6,0,12,61,60,1,0,0,0,63,25,11,14,26,42,1,6,0,0,0,,,
"Nov 29, 2021 10:00 AM",63,41,22,40,21,19,49,26,23,44,24,20,5,3,2,12,48,47,1,0,0,0,42,11,5,6,15,21,3,3,0,0,0,,,
"Nov 29, 2021 11:00 AM",56,31,25,30,11,19,38,18,20,33,19,14,8,6,2,8,26,23,3,0,0,0,18,11,8,3,9,29,0,1,0,0,0,,,
"Nov 29, 2021 12:00 PM",57,32,25,47,32,15,42,26,16,38,22,16,12,6,6,8,21,19,2,0,0,0,18,14,9,5,13,16,3,1,0,0,0,,,
"Nov 29, 2021 1:00 PM",68,39,29,47,27,20,46,26,20,46,20,26,20,9,11,17,26,22,4,0,0,0,16,17,15,2,22,22,4,1,0,0,0,,,
"Nov 29, 2021 2:00 PM",66,25,41,48,25,23,49,18,31,43,24,19,11,8,3,13,26,23,3,0,0,0,19,22,13,9,14,24,5,2,0,0,0,,,
"Nov 29, 2021 3:00 PM",79,29,50,36,24,12,51,33,18,40,23,17,16,6,10,12,31,23,8,0,0,0,19,15,10,5,31,29,3,1,0,0,0,,,
"Nov 29, 2021 4:00 PM",135,45,90,37,21,16,64,38,26,51,31,20,12,4,8,21,27,24,3,0,0,0,21,24,19,5,31,30,2,1,0,0,0,,,
"Nov 29, 2021 5:00 PM",151,39,112,47,28,19,66,40,26,52,30,22,10,3,7,12,29,24,5,0,0,0,28,24,16,8,71,47,4,3,0,0,0,,,
"Nov 29, 2021 6:00 PM",142,39,103,42,29,13,61,42,19,46,28,18,16,4,12,14,28,24,4,0,0,0,26,30,23,7,61,43,2,0,0,0,0,,,
"Nov 29, 2021 7:00 PM",90,20,70,19,15,4,37,29,8,26,21,5,4,1,3,13,18,16,2,0,0,0,16,15,13,2,26,20,2,4,0,0,0,,,
"Nov 29, 2021 8:00 PM",68,13,55,19,12,7,18,14,4,9,6,3,3,2,1,6,20,17,3,0,0,0,14,3,2,1,23,20,2,0,0,0,0,,,
"Nov 29, 2021 9:00 PM",31,7,24,5,4,1,10,5,5,6,3,3,0,0,0,8,8,7,1,0,0,0,5,3,1,2,9,6,3,1,0,0,0,,,
"Nov 29, 2021 10:00 PM",31,7,24,4,2,2,4,2,2,7,4,3,0,0,0,7,3,0,3,0,0,0,1,4,3,1,10,3,1,1,0,0,0,,,
"Nov 29, 2021 11:00 PM",9,3,6,1,1,0,1,1,0,1,0,1,0,0,0,3,6,4,2,0,0,0,3,1,0,1,2,2,0,1,0,0,0,,,
"Nov 30, 2021 12:00 AM",6,2,4,1,0,1,0,0,0,4,1,3,4,4,0,3,1,1,0,0,0,0,2,0,0,0,4,2,1,0,0,0,0,,,
"Nov 30, 2021 1:00 AM",3,0,3,1,0,1,2,1,1,0,0,0,0,0,0,0,1,1,0,0,0,0,1,0,0,0,1,1,0,0,0,0,0,,,
"Nov 30, 2021 2:00 AM",5,5,0,0,0,0,0,0,0,0,0,0,0,0,0,0,1,0,1,0,0,0,0,0,0,0,0,0,0,0,0,0,0,,,
"Nov 30, 2021 3:00 AM",0,0,0,0,0,0,0,0,0,0,0,0,0,0,0,0,0,0,0,0,0,0,0,0,0,0,0,0,0,0,0,0,0,,,
"Nov 30, 2021 4:00 AM",1,1,0,0,0,0,0,0,0,0,0,0,0,0,0,0,0,0,0,0,0,0,0,0,0,0,0,1,0,0,0,0,0,,,
"Nov 30, 2021 5:00 AM",9,6,3,3,1,2,7,4,3,6,4,2,0,0,0,1,4,4,0,0,0,0,4,2,2,0,4,12,1,0,0,0,0,,,
"Nov 30, 2021 6:00 AM",34,25,9,22,11,11,25,12,13,20,9,11,2,1,1,6,19,19,0,0,0,0,19,3,2,1,15,31,1,2,0,0,0,,,
"Nov 30, 2021 7:00 AM",105,74,31,41,15,26,71,26,45,52,22,30,2,1,1,15,59,59,0,0,0,0,62,24,10,14,32,64,3,5,0,0,0,,,
"Nov 30, 2021 8:00 AM",104,59,45,88,28,60,130,40,90,94,35,59,31,22,9,22,129,126,3,0,0,0,117,41,14,27,40,126,9,6,0,0,0,,,
"Nov 30, 2021 9:00 AM",113,90,23,36,11,25,85,40,45,37,18,19,6,6,0,8,58,58,0,0,0,0,50,37,14,23,16,48,0,1,0,0,0,,,
"Nov 30, 2021 10:00 AM",67,48,19,43,26,17,49,28,21,53,35,18,7,5,2,9,48,46,2,0,0,0,40,33,24,9,10,14,5,1,0,0,0,,,
"Nov 30, 2021 11:00 AM",60,41,19,53,32,21,53,32,21,34,20,14,22,6,16,8,28,25,3,0,0,0,20,17,12,5,12,22,6,3,0,0,0,,,
"Nov 30, 2021 12:00 PM",54,21,33,31,16,15,26,11,15,29,16,13,19,8,11,5,37,34,3,0,0,0,22,12,3,9,17,26,2,1,0,0,0,,,
"Nov 30, 2021 1:00 PM",85,40,45,44,21,23,55,28,27,52,19,33,16,5,11,9,34,32,2,0,0,0,24,23,13,10,23,24,3,2,0,0,0,,,
"Nov 30, 2021 2:00 PM",65,33,32,51,32,19,58,35,23,50,36,14,25,15,10,12,17,12,5,0,0,0,8,18,11,7,22,21,2,7,0,0,0,,,
"Nov 30, 2021 3:00 PM",86,29,57,52,27,25,47,28,19,41,23,18,10,5,5,14,36,26,10,0,0,0,24,31,21,10,29,23,5,1,0,0,0,,,
"Nov 30, 2021 4:00 PM",115,37,78,44,28,16,61,36,25,47,25,22,15,5,10,13,23,17,6,0,0,0,17,25,19,6,38,35,2,2,0,0,0,,,
"Nov 30, 2021 5:00 PM",150,42,108,29,19,10,49,32,17,40,22,18,6,1,5,11,25,23,2,0,0,0,21,16,16,0,55,48,5,4,0,0,0,,,
"Nov 30, 2021 6:00 PM",116,27,89,24,19,5,47,34,13,34,23,11,2,1,1,7,24,20,4,0,0,0,19,16,12,4,49,27,2,1,0,0,0,,,
"Nov 30, 2021 7:00 PM",92,30,62,12,10,2,32,22,10,24,17,7,2,0,2,4,10,5,5,0,0,0,7,9,7,2,25,14,0,0,0,0,0,,,
"Nov 30, 2021 8:00 PM",47,8,39,8,7,1,17,11,6,7,4,3,0,0,0,8,9,7,2,0,0,0,7,7,4,3,17,14,2,1,0,0,0,,,
"Nov 30, 2021 9:00 PM",25,6,19,3,3,0,13,9,4,8,7,1,1,0,1,3,10,8,2,0,0,0,9,4,4,0,14,10,1,2,0,0,0,,,
"Nov 30, 2021 10:00 PM",16,4,12,6,5,1,9,7,2,6,5,1,0,0,0,1,10,5,5,0,0,0,5,2,1,1,12,0,1,0,0,0,0,,,
"Nov 30, 2021 11:00 PM",11,2,9,1,0,1,3,3,0,3,2,1,0,0,0,0,3,3,0,0,0,0,3,0,0,0,4,2,0,0,0,0,0,,,
"Dec 1, 2021 12:00 AM",6,0,6,0,0,0,2,0,2,1,0,1,0,0,0,0,0,0,0,0,0,0,0,0,0,0,4,1,0,0,0,0,0,,,
"Dec 1, 2021 1:00 AM",1,0,1,0,0,0,1,0,1,1,1,0,0,0,0,0,0,0,0,0,0,0,0,0,0,0,0,0,0,1,0,0,0,,,
"Dec 1, 2021 2:00 AM",8,6,2,0,0,0,1,0,1,0,0,0,0,0,0,1,0,0,0,0,0,0,0,0,0,0,0,1,0,0,0,0,0,,,
"Dec 1, 2021 3:00 AM",0,0,0,0,0,0,0,0,0,0,0,0,0,0,0,0,0,0,0,0,0,0,0,0,0,0,0,0,0,0,0,0,0,,,
"Dec 1, 2021 4:00 AM",1,1,0,0,0,0,1,1,0,0,0,0,0,0,0,0,0,0,0,0,0,0,0,0,0,0,1,1,0,0,0,0,0,,,
"Dec 1, 2021 5:00 AM",6,5,1,0,0,0,3,2,1,4,3,1,0,0,0,4,7,7,0,0,0,0,6,1,1,0,2,12,0,1,0,0,0,,,
"Dec 1, 2021 6:00 AM",35,25,10,8,4,4,17,7,10,9,4,5,2,2,0,4,15,15,0,0,0,0,14,6,3,3,14,24,1,2,0,0,0,,,
"Dec 1, 2021 7:00 AM",81,50,31,50,15,35,61,22,39,43,17,26,5,5,0,10,56,56,0,0,0,0,56,16,4,12,26,68,1,5,0,0,0,,,
"Dec 1, 2021 8:00 AM",187,134,53,76,26,50,100,41,59,69,25,44,20,10,10,22,113,111,2,0,0,0,99,57,23,34,43,110,4,4,0,0,0,,,
"Dec 1, 2021 9:00 AM",103,81,22,53,19,34,81,40,41,56,28,28,14,10,4,3,50,49,1,0,0,0,44,31,15,16,22,53,2,1,0,0,0,,,
"Dec 1, 2021 10:00 AM",62,49,13,32,9,23,53,24,29,33,15,18,6,6,0,8,37,37,0,0,0,0,36,14,8,6,12,29,2,1,0,0,0,,,
"Dec 1, 2021 11:00 AM",73,49,24,24,15,9,45,27,18,27,17,10,12,7,5,12,37,36,1,0,0,0,30,20,15,5,11,20,5,3,0,0,0,,,
"Dec 1, 2021 12:00 PM",72,41,31,18,12,6,25,13,12,17,9,8,14,6,8,14,29,24,5,0,0,0,22,12,8,4,12,21,5,2,0,0,0,,,
"Dec 1, 2021 1:00 PM",79,37,42,42,26,16,58,32,26,56,33,23,12,6,6,15,28,28,0,0,0,0,18,13,7,6,26,34,1,5,0,0,0,,,
"Dec 1, 2021 2:00 PM",69,33,36,28,16,12,24,16,8,25,15,10,19,8,11,14,18,14,4,0,0,0,12,11,6,5,21,14,4,1,0,0,0,,,
"Dec 1, 2021 3:00 PM",90,35,55,28,20,8,36,18,18,34,21,13,20,11,9,18,29,24,5,0,0,0,24,15,11,4,19,32,3,3,0,0,0,,,
"Dec 1, 2021 4:00 PM",125,43,82,27,14,13,55,34,21,37,15,22,12,3,9,12,31,26,5,0,0,0,27,20,14,6,37,37,3,4,0,0,0,,,
"Dec 1, 2021 5:00 PM",184,43,141,36,24,12,65,39,26,52,30,22,20,11,9,14,26,21,5,0,0,0,20,27,22,5,58,56,4,3,0,0,0,,,
"Dec 1, 2021 6:00 PM",126,35,91,31,22,9,61,45,16,37,26,11,16,5,11,19,36,29,7,0,0,0,31,15,14,1,57,30,3,1,0,0,0,,,
"Dec 1, 2021 7:00 PM",77,27,50,35,28,7,36,26,10,32,27,5,6,3,3,9,24,18,6,0,0,0,16,17,13,4,36,27,2,2,0,0,0,,,
"Dec 1, 2021 8:00 PM",58,17,41,12,7,5,16,11,5,12,5,7,4,1,3,7,12,6,6,0,0,0,7,5,4,1,25,11,2,1,0,0,0,,,
"Dec 1, 2021 9:00 PM",41,5,36,9,5,4,12,8,4,13,8,5,2,1,1,6,9,7,2,0,0,0,8,9,5,4,11,6,4,1,0,0,0,,,
"Dec 1, 2021 10:00 PM",28,13,15,8,4,4,14,9,5,12,8,4,0,0,0,3,3,0,3,0,0,0,0,5,4,1,6,7,2,0,0,0,0,,,
"Dec 1, 2021 11:00 PM",10,1,9,3,3,0,3,0,3,2,0,2,0,0,0,1,3,3,0,0,0,0,2,1,0,1,2,5,1,1,0,0,0,,,
"Dec 2, 2021 12:00 AM",10,2,8,0,0,0,0,0,0,1,1,0,0,0,0,1,2,1,1,0,0,0,1,0,0,0,3,1,0,0,,,,,,
"Dec 2, 2021 1:00 AM",0,0,0,0,0,0,0,0,0,0,0,0,0,0,0,0,2,1,1,0,0,0,1,0,0,0,1,0,0,0,,,,,,
"Dec 2, 2021 2:00 AM",4,2,2,0,0,0,0,0,0,0,0,0,0,0,0,1,0,0,0,0,0,0,0,0,0,0,1,0,1,0,,,,,,
"Dec 2, 2021 3:00 AM",1,0,1,0,0,0,1,0,1,1,0,1,0,0,0,0,0,0,0,0,0,0,0,0,0,0,0,0,0,0,,,,,,
"Dec 2, 2021 4:00 AM",1,1,0,0,0,0,1,1,0,0,0,0,0,0,0,0,0,0,0,0,0,0,0,0,0,0,1,0,0,0,,,,,,
"Dec 2, 2021 5:00 AM",6,6,0,2,1,1,4,2,2,3,2,1,1,1,0,2,7,7,0,0,0,0,8,1,0,1,1,11,0,1,,,,,,
"Dec 2, 2021 6:00 AM",30,17,13,17,6,11,16,5,11,14,6,8,3,1,2,4,16,16,0,0,0,0,14,4,1,3,10,23,1,2,,,,,,
"Dec 2, 2021 7:00 AM",89,61,28,32,9,23,57,22,35,42,19,23,6,4,2,15,49,49,0,0,0,0,50,22,11,11,26,48,2,3,,,,,,
"Dec 2, 2021 8:00 AM",200,135,65,76,23,53,107,39,68,68,30,38,26,15,11,28,98,96,2,0,0,0,100,42,14,28,41,112,5,3,,,,,,
"Dec 2, 2021 9:00 AM",107,85,22,50,21,29,88,49,39,61,35,26,10,5,5,10,75,75,0,0,0,0,64,29,21,8,20,54,1,1,,,,,,
"Dec 2, 2021 10:00 AM",67,53,14,40,15,25,56,31,25,40,21,19,10,6,4,9,37,36,1,0,0,0,32,10,4,6,23,29,0,3,,,,,,
"Dec 2, 2021 11:00 AM",61,37,24,36,22,14,57,30,27,34,20,14,13,3,10,9,34,28,6,0,0,0,18,15,11,4,20,21,1,4,,,,,,
"Dec 2, 2021 12:00 PM",70,39,31,32,17,15,61,24,37,29,14,15,13,5,8,10,21,21,0,0,0,0,18,27,15,12,20,32,3,3,,,,,,
"Dec 2, 2021 1:00 PM",95,50,45,50,28,22,72,45,27,52,33,19,11,4,7,14,28,24,4,0,0,0,17,19,10,9,23,22,5,1,,,,,,
"Dec 2, 2021 2:00 PM",85,39,46,44,20,24,56,24,32,41,21,20,8,7,1,10,23,21,2,0,0,0,16,22,11,11,24,22,1,7,,,,,,
"Dec 2, 2021 3:00 PM",95,40,55,49,24,25,64,36,28,49,25,24,17,6,11,9,30,23,7,0,0,0,21,14,8,6,30,25,3,0,,,,,,
"Dec 2, 2021 4:00 PM",139,49,90,35,26,9,72,45,27,52,28,24,13,4,9,26,26,23,3,0,0,0,22,23,16,7,29,45,4,2,,,,,,
"Dec 2, 2021 5:00 PM",182,54,128,23,15,8,55,34,21,49,25,24,16,3,13,20,24,19,5,0,0,0,26,23,18,5,58,52,2,2,,,,,,
"Dec 2, 2021 6:00 PM",123,38,85,28,24,4,55,35,20,38,22,16,6,1,5,10,28,23,5,0,0,0,26,24,21,3,54,26,2,0,,,,,,
"Dec 2, 2021 7:00 PM",61,14,47,14,11,3,19,14,5,15,9,6,2,0,2,3,12,9,3,0,0,0,10,12,9,3,28,12,1,2,,,,,,
"Dec 2, 2021 8:00 PM",40,7,33,4,4,0,12,10,2,6,5,1,4,0,4,4,6,3,3,0,0,0,5,10,7,3,5,12,3,0,,,,,,
"Dec 2, 2021 9:00 PM",26,2,24,3,3,0,7,5,2,4,4,0,3,2,1,3,5,5,0,0,0,0,6,2,2,0,8,8,0,0,,,,,,
"Dec 2, 2021 10:00 PM",13,4,9,1,1,0,1,0,1,4,1,3,1,1,0,8,4,3,1,0,0,0,3,2,2,0,11,5,1,1,,,,,,
"Dec 2, 2021 11:00 PM",16,4,12,2,1,1,8,4,4,7,2,5,1,0,1,1,2,1,1,0,0,0,1,2,1,1,7,6,1,0,,,,,,
"Dec 3, 2021 12:00 AM",10,2,8,0,0,0,1,1,0,1,1,0,0,0,0,0,1,0,1,0,0,0,0,0,0,0,5,3,0,0,,,,,,
"Dec 3, 2021 1:00 AM",4,0,4,0,0,0,2,1,1,1,1,0,1,0,1,0,1,0,1,0,0,0,0,0,0,0,1,0,0,0,,,,,,
"Dec 3, 2021 2:00 AM",5,4,1,0,0,0,0,0,0,0,0,0,0,0,0,0,0,0,0,0,0,0,0,1,1,0,1,0,0,0,,,,,,
"Dec 3, 2021 3:00 AM",2,2,0,0,0,0,1,1,0,0,0,0,0,0,0,0,0,0,0,0,0,0,0,0,0,0,1,0,0,0,,,,,,
"Dec 3, 2021 4:00 AM",3,1,2,0,0,0,0,0,0,0,0,0,0,0,0,1,1,1,0,0,0,0,1,0,0,0,0,1,0,0,,,,,,
"Dec 3, 2021 5:00 AM",8,5,3,1,1,0,2,1,1,2,1,1,0,0,0,0,8,8,0,0,0,0,8,1,1,0,0,9,0,0,,,,,,
"Dec 3, 2021 6:00 AM",19,11,8,16,5,11,18,6,12,15,7,8,3,2,1,4,12,12,0,0,0,0,12,5,3,2,11,23,1,1,,,,,,
"Dec 3, 2021 7:00 AM",72,43,29,35,12,23,47,17,30,39,17,22,4,4,0,14,41,41,0,0,0,0,39,16,8,8,25,62,0,3,,,,,,
"Dec 3, 2021 8:00 AM",157,111,46,94,29,65,107,46,61,80,31,49,22,16,6,22,77,75,2,0,0,0,78,39,15,24,35,112,5,2,,,,,,
"Dec 3, 2021 9:00 AM",99,79,20,46,20,26,69,34,35,51,31,20,8,7,1,7,49,49,0,0,0,0,46,30,14,16,26,50,3,2,,,,,,
"Dec 3, 2021 10:00 AM",69,42,27,36,18,18,63,30,33,41,20,21,6,3,3,13,24,21,3,0,0,0,17,17,10,7,18,23,0,2,,,,,,
"Dec 3, 2021 11:00 AM",60,36,24,36,20,16,40,27,13,34,22,12,3,2,1,6,26,23,3,0,0,0,18,16,12,4,9,13,5,2,,,,,,
"Dec 3, 2021 12:00 PM",66,31,35,41,19,22,58,20,38,42,16,26,20,11,9,8,25,23,2,0,0,0,19,23,11,12,14,16,1,2,,,,,,
"Dec 3, 2021 1:00 PM",96,43,53,36,19,17,62,35,27,38,23,15,14,9,5,8,30,27,3,0,0,0,20,26,16,10,19,25,3,3,,,,,,
"Dec 3, 2021 2:00 PM",82,44,38,37,22,15,51,31,20,42,26,16,10,4,6,22,22,19,3,0,0,0,16,23,13,10,25,19,7,1,,,,,,
"Dec 3, 2021 3:00 PM",66,27,39,40,15,25,38,16,22,33,19,14,12,6,6,19,31,27,4,0,0,0,23,15,8,7,23,26,3,2,,,,,,
"Dec 3, 2021 4:00 PM",111,41,70,50,36,14,63,39,24,50,29,21,8,4,4,11,24,23,1,0,0,0,20,25,19,6,44,41,2,1,,,,,,
"Dec 3, 2021 5:00 PM",118,38,80,36,23,13,40,26,14,37,21,16,9,1,8,21,22,18,4,0,0,0,18,18,17,1,50,31,4,1,,,,,,
"Dec 3, 2021 6:00 PM",94,26,68,21,16,5,49,36,13,26,17,9,3,0,3,10,26,19,7,0,0,0,16,22,18,4,45,28,3,0,,,,,,
"Dec 3, 2021 7:00 PM",64,27,37,16,12,4,27,15,12,18,10,8,9,1,8,6,17,17,0,0,0,0,17,17,9,8,26,26,2,2,,,,,,
"Dec 3, 2021 8:00 PM",41,15,26,10,8,2,12,11,1,11,8,3,3,1,2,9,14,12,2,0,0,0,13,11,6,5,18,20,0,1,,,,,,
"Dec 3, 2021 9:00 PM",32,4,28,6,4,2,17,9,8,14,7,7,2,2,0,6,9,8,1,0,0,0,7,5,3,2,16,8,2,2,,,,,,
"Dec 3, 2021 10:00 PM",27,8,19,6,2,4,13,7,6,8,4,4,3,2,1,7,2,1,1,0,0,0,2,3,3,0,7,4,0,1,,,,,,
"Dec 3, 2021 11:00 PM",15,4,11,4,2,2,6,4,2,4,3,1,1,0,1,3,5,4,1,0,0,0,1,4,1,3,6,8,0,0,,,,,,
"Dec 4, 2021 12:00 AM",17,1,16,0,0,0,4,3,1,3,1,2,1,0,1,2,4,4,0,0,0,0,4,4,3,1,10,5,0,0,,,,,,
"Dec 4, 2021 1:00 AM",9,1,8,0,0,0,3,0,3,2,0,2,0,0,0,1,0,0,0,0,0,0,0,0,0,0,3,2,0,0,,,,,,
"Dec 4, 2021 2:00 AM",5,2,3,0,0,0,1,1,0,0,0,0,0,0,0,0,3,3,0,0,0,0,1,1,0,1,1,0,0,1,,,,,,
"Dec 4, 2021 3:00 AM",1,0,1,0,0,0,0,0,0,0,0,0,0,0,0,0,0,0,0,0,0,0,0,0,0,0,2,0,0,0,,,,,,
"Dec 4, 2021 4:00 AM",4,1,3,0,0,0,0,0,0,0,0,0,0,0,0,0,1,1,0,0,0,0,1,0,0,0,0,0,0,0,,,,,,
"Dec 4, 2021 5:00 AM",2,2,0,1,0,1,2,0,2,2,0,2,0,0,0,0,2,2,0,0,0,0,1,0,0,0,1,3,0,0,,,,,,
"Dec 4, 2021 6:00 AM",8,1,7,1,1,0,6,4,2,3,2,1,1,0,1,3,2,2,0,0,0,0,2,0,0,0,5,5,0,0,,,,,,
"Dec 4, 2021 7:00 AM",17,11,6,8,3,5,8,6,2,6,4,2,0,0,0,1,9,9,0,0,0,0,9,2,2,0,9,12,0,0,,,,,,
"Dec 4, 2021 8:00 AM",23,13,10,11,8,3,19,17,2,13,12,1,7,2,5,4,10,9,1,0,0,0,8,8,8,0,15,17,0,3,,,,,,
"Dec 4, 2021 9:00 AM",40,25,15,74,46,28,70,50,20,62,42,20,8,7,1,11,9,9,0,0,0,0,13,13,8,5,19,22,2,1,,,,,,
"Dec 4, 2021 10:00 AM",62,38,24,56,26,30,84,41,43,50,28,22,10,8,2,14,20,19,1,0,0,0,17,21,18,3,20,42,2,1,,,,,,
"Dec 4, 2021 11:00 AM",46,23,23,49,24,25,94,48,46,65,41,24,17,10,7,18,26,23,3,0,0,0,21,27,15,12,20,20,4,0,,,,,,
"Dec 4, 2021 12:00 PM",49,23,26,76,34,42,75,38,37,68,33,35,22,10,12,13,22,18,4,0,0,0,15,28,13,15,36,29,1,1,,,,,,
"Dec 4, 2021 1:00 PM",49,25,24,84,54,30,81,52,29,74,49,25,24,11,13,14,23,23,0,0,0,0,23,31,20,11,26,30,5,3,,,,,,
"Dec 4, 2021 2:00 PM",52,27,25,60,26,34,54,19,35,49,23,26,13,11,2,13,20,19,1,0,0,0,16,24,13,11,14,25,4,4,,,,,,
"Dec 4, 2021 3:00 PM",55,27,28,53,24,29,63,21,42,60,24,36,14,5,9,23,19,18,1,0,0,0,17,32,15,17,22,23,4,0,,,,,,
"Dec 4, 2021 4:00 PM",49,24,25,35,20,15,37,20,17,34,14,20,9,5,4,21,20,20,0,0,0,0,17,22,12,10,21,23,2,3,,,,,,
"Dec 4, 2021 5:00 PM",38,14,24,22,9,13,23,6,17,26,7,19,6,1,5,13,13,11,2,0,0,0,10,9,4,5,13,18,1,0,,,,,,
"Dec 4, 2021 6:00 PM",38,18,20,6,2,4,17,5,12,10,5,5,0,0,0,2,8,6,2,0,0,0,11,7,2,5,14,21,2,0,,,,,,
"Dec 4, 2021 7:00 PM",24,16,8,8,4,4,9,4,5,6,2,4,6,5,1,9,12,11,1,0,0,0,9,5,3,2,5,11,0,1,,,,,,
"Dec 4, 2021 8:00 PM",28,11,17,8,5,3,14,9,5,7,4,3,2,1,1,4,13,12,1,0,0,0,12,1,0,1,16,11,0,2,,,,,,
"Dec 4, 2021 9:00 PM",10,4,6,0,0,0,5,3,2,4,2,2,3,2,1,6,7,7,0,0,0,0,6,3,0,3,1,7,1,0,,,,,,
"Dec 4, 2021 10:00 PM",9,2,7,1,1,0,2,1,1,1,0,1,0,0,0,1,2,2,0,0,0,0,2,0,0,0,5,3,1,1,,,,,,
"Dec 4, 2021 11:00 PM",14,2,12,2,1,1,2,1,1,3,0,3,0,0,0,0,2,2,0,0,0,0,2,5,3,2,3,2,1,0,,,,,,
"Dec 5, 2021 12:00 AM",11,3,8,0,0,0,0,0,0,3,1,2,3,3,0,3,3,2,1,0,0,0,0,1,1,0,7,4,0,0,,,,,,
"Dec 5, 2021 1:00 AM",7,3,4,0,0,0,1,0,1,0,0,0,0,0,0,2,2,1,1,0,0,0,2,3,2,1,2,3,1,1,,,,,,
"Dec 5, 2021 2:00 AM",3,2,1,1,1,0,1,1,0,1,1,0,1,0,1,0,0,0,0,0,0,0,0,2,2,0,1,1,1,0,,,,,,
"Dec 5, 2021 3:00 AM",0,0,0,0,0,0,0,0,0,0,0,0,0,0,0,0,0,0,0,0,0,0,0,0,0,0,1,1,0,0,,,,,,
"Dec 5, 2021 4:00 AM",2,0,2,0,0,0,2,1,1,1,0,1,0,0,0,0,0,0,0,0,0,0,0,0,0,0,1,1,0,0,,,,,,
"Dec 5, 2021 5:00 AM",0,0,0,1,1,0,1,1,0,1,1,0,0,0,0,0,0,0,0,0,0,0,0,1,1,0,2,3,0,0,,,,,,
"Dec 5, 2021 6:00 AM",6,3,3,4,1,3,4,3,1,4,3,1,0,0,0,1,1,1,0,0,0,0,1,0,0,0,3,3,0,0,,,,,,
"Dec 5, 2021 7:00 AM",5,3,2,10,5,5,9,5,4,11,7,4,2,0,2,3,7,7,0,0,0,0,7,1,1,0,11,15,2,0,,,,,,
"Dec 5, 2021 8:00 AM",28,13,15,61,33,28,49,39,10,51,39,12,4,4,0,2,5,5,0,0,0,0,6,11,5,6,15,16,0,6,,,,,,
"Dec 5, 2021 9:00 AM",47,24,23,115,72,43,102,73,29,109,88,21,9,7,2,14,14,13,1,0,0,0,13,22,18,4,27,45,4,18,,,,,,
"Dec 5, 2021 10:00 AM",36,21,15,128,75,53,141,90,51,127,81,46,8,3,5,12,21,21,0,0,0,0,22,65,52,13,38,39,3,10,,,,,,
"Dec 5, 2021 11:00 AM",57,33,24,143,75,68,170,90,80,140,76,64,21,8,13,19,25,24,1,0,0,0,20,37,20,17,30,36,10,4,,,,,,
"Dec 5, 2021 12:00 PM",60,33,27,134,51,83,137,64,73,99,52,47,14,9,5,16,25,20,5,0,0,0,18,47,28,19,48,36,6,6,,,,,,
"Dec 5, 2021 1:00 PM",67,33,34,113,60,53,137,80,57,99,54,45,17,8,9,19,31,30,1,0,0,0,28,42,34,8,28,39,8,1,,,,,,
"Dec 5, 2021 2:00 PM",59,33,26,113,56,57,107,52,55,100,47,53,22,14,8,16,25,23,2,0,0,0,20,46,23,23,23,31,7,2,,,,,,
"Dec 5, 2021 3:00 PM",53,26,27,91,47,44,107,47,60,108,44,64,14,5,9,10,25,24,1,0,0,0,22,38,14,24,24,41,3,1,,,,,,
"Dec 5, 2021 4:00 PM",56,22,34,75,43,32,67,22,45,46,16,30,9,4,5,9,14,12,2,0,0,0,11,20,5,15,12,33,3,2,,,,,,
"Dec 5, 2021 5:00 PM",38,14,24,24,16,8,38,20,18,30,15,15,18,3,15,9,13,11,2,0,0,0,9,7,5,2,16,12,1,0,,,,,,
"Dec 5, 2021 6:00 PM",31,11,20,2,2,0,16,9,7,16,8,8,6,4,2,1,9,8,1,0,0,0,6,5,4,1,12,14,0,0,,,,,,
"Dec 5, 2021 7:00 PM",31,13,18,8,5,3,12,4,8,9,4,5,2,0,2,3,4,3,1,0,0,0,4,1,1,0,5,11,0,0,,,,,,
"Dec 5, 2021 8:00 PM",22,10,12,5,1,4,13,4,9,8,3,5,10,1,9,3,6,4,2,0,0,0,4,2,2,0,6,7,0,0,,,,,,
"Dec 5, 2021 9:00 PM",20,9,11,2,1,1,10,5,5,12,6,6,0,0,0,2,9,9,0,0,0,0,7,2,1,1,5,8,0,0,,,,,,
"Dec 5, 2021 10:00 PM",12,4,8,2,1,1,4,0,4,3,0,3,3,3,0,2,2,2,0,0,0,0,3,0,0,0,4,6,1,1,,,,,,
"Dec 5, 2021 11:00 PM",7,1,6,1,1,0,3,1,2,1,0,1,4,3,1,0,3,3,0,0,0,0,3,1,1,0,4,4,0,0,,,,,,
"Dec 6, 2021 12:00 AM",1,0,1,0,0,0,0,0,0,0,0,0,0,0,0,1,2,2,0,0,0,0,2,0,0,0,6,1,0,0,,,,,,
"Dec 6, 2021 1:00 AM",3,0,3,0,0,0,3,2,1,0,0,0,0,0,0,0,1,1,0,0,0,0,1,1,1,0,2,1,0,0,,,,,,
"Dec 6, 2021 2:00 AM",3,2,1,0,0,0,1,1,0,0,0,0,0,0,0,0,1,1,0,0,0,0,1,0,0,0,1,1,0,0,,,,,,
"Dec 6, 2021 3:00 AM",1,0,1,0,0,0,0,0,0,0,0,0,0,0,0,0,0,0,0,0,0,0,0,0,0,0,0,0,0,0,,,,,,
"Dec 6, 2021 4:00 AM",1,0,1,0,0,0,0,0,0,0,0,0,0,0,0,1,0,0,0,0,0,0,0,0,0,0,0,1,0,0,,,,,,
"Dec 6, 2021 5:00 AM",6,5,1,0,0,0,1,1,0,3,2,1,0,0,0,5,3,3,0,0,0,0,2,0,0,0,2,11,0,0,,,,,,
"Dec 6, 2021 6:00 AM",22,13,9,8,2,6,14,2,12,10,2,8,2,2,0,2,16,16,0,0,0,0,15,3,1,2,9,25,1,2,,,,,,
"Dec 6, 2021 7:00 AM",57,41,16,35,9,26,40,11,29,35,13,22,5,5,0,9,41,41,0,0,0,0,43,10,5,5,26,56,0,4,,,,,,
"Dec 6, 2021 8:00 AM",131,99,32,51,16,35,80,36,44,71,32,39,38,23,15,20,89,89,0,0,0,0,88,40,12,28,32,103,5,4,,,,,,
"Dec 6, 2021 9:00 AM",100,78,22,34,13,21,62,32,30,48,26,22,8,6,2,6,58,57,1,0,0,0,52,23,11,12,27,41,3,3,,,,,,
"Dec 6, 2021 10:00 AM",39,31,8,25,15,10,42,29,13,29,21,8,8,2,6,10,29,28,1,0,0,0,26,16,9,7,6,17,1,1,,,,,,
"Dec 6, 2021 11:00 AM",33,24,9,37,25,12,52,26,26,39,23,16,13,4,9,8,16,13,3,0,0,0,13,9,6,3,18,19,0,0,,,,,,
"Dec 6, 2021 12:00 PM",50,22,28,46,24,22,60,32,28,41,20,21,20,14,6,5,15,15,0,0,0,0,13,16,12,4,15,31,3,3,,,,,,
"Dec 6, 2021 1:00 PM",65,38,27,31,18,13,52,28,24,42,17,25,13,3,10,14,20,18,2,0,0,0,15,22,13,9,19,23,3,2,,,,,,
"Dec 6, 2021 2:00 PM",38,19,19,34,16,18,54,31,23,42,24,18,13,9,4,15,18,17,1,0,0,0,14,18,14,4,22,15,1,5,,,,,,
"Dec 6, 2021 3:00 PM",61,22,39,31,16,15,39,20,19,33,14,19,15,7,8,13,27,24,3,0,0,0,21,21,12,9,26,33,1,1,,,,,,
"Dec 6, 2021 4:00 PM",89,34,55,38,23,15,46,31,15,48,27,21,13,2,11,15,21,20,1,0,0,0,16,20,15,5,35,28,2,3,,,,,,
"Dec 6, 2021 5:00 PM",118,35,83,32,25,7,56,37,19,43,27,16,11,4,7,12,22,22,0,0,0,0,22,25,18,7,62,41,2,0,,,,,,
"Dec 6, 2021 6:00 PM",115,29,86,28,24,4,50,35,15,34,25,9,7,1,6,20,22,18,4,0,0,0,20,30,24,6,38,21,2,0,,,,,,
"Dec 6, 2021 7:00 PM",63,11,52,22,17,5,37,24,13,23,13,10,9,5,4,5,19,16,3,0,0,0,14,11,8,3,24,23,2,2,,,,,,
"Dec 6, 2021 8:00 PM",39,6,33,2,2,0,10,8,2,8,8,0,1,1,0,10,14,10,4,0,0,0,12,6,4,2,11,14,0,0,,,,,,
"Dec 6, 2021 9:00 PM",25,5,20,3,2,1,5,3,2,5,2,3,0,0,0,8,8,7,1,0,0,0,7,5,5,0,13,9,2,0,,,,,,
"Dec 6, 2021 10:00 PM",22,6,16,4,2,2,3,2,1,2,1,1,0,0,0,5,3,2,1,0,0,0,3,4,2,2,6,1,0,0,,,,,,
"Dec 6, 2021 11:00 PM",5,2,3,2,2,0,2,2,0,2,2,0,1,0,1,0,1,1,0,0,0,0,1,1,1,0,6,2,0,0,,,,,,
"Dec 7, 2021 12:00 AM",8,2,6,0,0,0,0,0,0,1,0,1,1,1,0,0,2,1,1,0,0,0,1,0,0,0,3,0,0,0,,,,,,
"Dec 7, 2021 1:00 AM",2,1,1,1,1,0,1,1,0,0,0,0,0,0,0,3,0,0,0,0,0,0,0,1,1,0,2,3,0,0,,,,,,
"Dec 7, 2021 2:00 AM",6,4,2,1,0,1,1,0,1,0,0,0,0,0,0,1,0,0,0,0,0,0,0,0,0,0,1,1,0,0,,,,,,
"Dec 7, 2021 3:00 AM",0,0,0,0,0,0,0,0,0,0,0,0,0,0,0,0,0,0,0,0,0,0,0,0,0,0,0,0,0,0,,,,,,
"Dec 7, 2021 4:00 AM",0,0,0,1,0,1,1,0,1,2,0,2,0,0,0,0,0,0,0,0,0,0,0,0,0,0,1,1,0,0,,,,,,
"Dec 7, 2021 5:00 AM",3,2,1,1,1,0,4,3,1,2,2,0,0,0,0,2,2,2,0,0,0,0,2,0,0,0,2,6,0,0,,,,,,
"Dec 7, 2021 6:00 AM",12,6,6,2,1,1,2,0,2,4,2,2,0,0,0,4,4,4,0,0,0,0,5,1,1,0,4,10,1,2,,,,,,
"Dec 7, 2021 7:00 AM",17,6,11,2,1,1,6,4,2,3,2,1,4,2,2,0,6,6,0,0,0,0,6,3,1,2,5,10,0,0,,,,,,
"Dec 7, 2021 8:00 AM",10,7,3,2,2,0,3,1,2,2,2,0,1,0,1,0,4,4,0,0,0,0,2,5,2,3,2,4,1,0,,,,,,
"Dec 7, 2021 9:00 AM",5,3,2,2,0,2,1,1,0,2,1,1,0,0,0,0,2,1,1,0,0,0,1,1,1,0,2,1,0,0,,,,,,
"Dec 7, 2021 10:00 AM",4,2,2,2,0,2,3,2,1,1,1,0,1,0,1,2,3,3,0,0,0,0,2,1,1,0,2,2,1,0,,,,,,
"Dec 7, 2021 11:00 AM",4,2,2,1,0,1,3,2,1,3,3,0,0,0,0,0,0,0,0,0,0,0,0,0,0,0,3,1,0,0,,,,,,
"Dec 7, 2021 12:00 PM",8,6,2,0,0,0,3,2,1,4,2,2,2,0,2,1,1,1,0,0,0,0,1,3,3,0,3,4,0,0,,,,,,
"Dec 7, 2021 1:00 PM",13,7,6,4,2,2,5,4,1,3,2,1,8,2,6,2,2,2,0,0,0,0,1,1,0,1,2,4,0,1,,,,,,
"Dec 7, 2021 2:00 PM",3,1,2,5,3,2,7,4,3,5,3,2,0,0,0,0,1,0,1,0,0,0,1,1,0,1,2,5,1,0,,,,,,
"Dec 7, 2021 3:00 PM",18,8,10,11,6,5,11,4,7,8,5,3,3,2,1,2,7,7,0,0,0,0,5,0,0,0,2,4,0,0,,,,,,
"Dec 7, 2021 4:00 PM",14,4,10,1,0,1,2,1,1,4,2,2,2,1,1,5,3,3,0,0,0,0,3,4,3,1,4,6,2,0,,,,,,
"Dec 7, 2021 5:00 PM",18,9,9,9,6,3,6,4,2,7,6,1,3,0,3,4,1,1,0,0,0,0,2,2,1,1,4,6,0,0,,,,,,
"Dec 7, 2021 6:00 PM",22,8,14,4,2,2,10,4,6,6,1,5,1,0,1,4,5,5,0,0,0,0,4,5,2,3,4,6,1,1,,,,,,
"Dec 7, 2021 7:00 PM",8,4,4,3,3,0,2,0,2,0,0,0,0,0,0,1,2,2,0,0,0,0,2,0,0,0,8,2,0,0,,,,,,
"Dec 7, 2021 8:00 PM",8,5,3,1,0,1,2,1,1,2,0,2,0,0,0,4,3,3,0,0,0,0,3,1,1,0,2,5,0,0,,,,,,
"Dec 7, 2021 9:00 PM",6,2,4,0,0,0,5,3,2,1,1,0,0,0,0,1,2,1,1,0,0,0,2,2,2,0,0,2,0,1,,,,,,
"Dec 7, 2021 10:00 PM",4,0,4,0,0,0,2,1,1,0,0,0,0,0,0,0,1,1,0,0,0,0,1,1,1,0,3,2,0,0,,,,,,
"Dec 7, 2021 11:00 PM",3,0,3,0,0,0,3,2,1,2,1,1,0,0,0,1,0,0,0,0,0,0,0,0,0,0,0,1,0,0,,,,,,
"Dec 8, 2021 12:00 AM",0,0,0,0,0,0,0,0,0,0,0,0,0,0,0,0,0,0,0,0,0,0,0,2,2,0,0,0,0,0,,,,,,
"Dec 8, 2021 1:00 AM",0,0,0,0,0,0,0,0,0,0,0,0,0,0,0,0,1,1,0,0,0,0,0,0,0,0,0,0,0,0,,,,,,
"Dec 8, 2021 2:00 AM",1,1,0,0,0,0,0,0,0,0,0,0,0,0,0,2,0,0,0,0,0,0,0,0,0,0,0,0,0,0,,,,,,
"Dec 8, 2021 3:00 AM",0,0,0,0,0,0,0,0,0,0,0,0,0,0,0,0,0,0,0,0,0,0,0,0,0,0,0,0,0,0,,,,,,
"Dec 8, 2021 4:00 AM",0,0,0,0,0,0,0,0,0,0,0,0,0,0,0,0,0,0,0,0,0,0,0,0,0,0,0,0,0,0,,,,,,
"Dec 8, 2021 5:00 AM",7,6,1,0,0,0,1,1,0,0,0,0,0,0,0,3,1,1,0,0,0,0,2,0,0,0,1,2,0,0,0,0,0,,,
"Dec 8, 2021 6:00 AM",4,2,2,1,0,1,2,0,2,1,0,1,0,0,0,2,5,5,0,0,0,0,4,1,1,0,4,4,0,1,0,0,0,,,
"Dec 8, 2021 7:00 AM",19,13,6,3,1,2,9,4,5,8,3,5,1,1,0,4,6,6,0,0,0,0,7,3,2,1,11,14,1,1,0,0,0,,,
"Dec 8, 2021 8:00 AM",46,29,17,5,3,2,6,4,2,6,4,2,1,0,1,1,22,22,0,0,0,0,22,3,1,2,9,19,1,0,0,0,0,,,
"Dec 8, 2021 9:00 AM",29,23,6,10,4,6,14,6,8,7,3,4,4,4,0,2,12,12,0,0,0,0,12,16,8,8,7,6,0,0,0,0,0,,,
"Dec 8, 2021 10:00 AM",31,26,5,11,10,1,4,2,2,6,5,1,0,0,0,2,11,10,1,0,0,0,8,3,0,3,3,8,0,0,0,0,0,,,
"Dec 8, 2021 11:00 AM",19,12,7,7,3,4,7,3,4,4,2,2,6,6,0,4,9,7,2,0,0,0,7,9,3,6,5,9,2,0,0,0,0,,,
"Dec 8, 2021 12:00 PM",32,17,15,8,4,4,10,7,3,9,6,3,4,2,2,3,8,7,1,0,0,0,6,4,2,2,4,8,0,0,0,0,0,,,
"Dec 8, 2021 1:00 PM",29,14,15,12,8,4,10,3,7,6,2,4,5,4,1,6,9,6,3,0,0,0,8,2,1,1,3,4,1,3,0,0,0,,,
"Dec 8, 2021 2:00 PM",11,6,5,4,3,1,7,3,4,4,2,2,3,0,3,4,6,4,2,0,0,0,5,0,0,0,11,10,0,0,0,0,0,,,
"Dec 8, 2021 3:00 PM",24,9,15,3,1,2,4,1,3,2,1,1,2,2,0,6,3,2,1,0,0,0,2,3,1,2,1,4,0,0,0,0,0,,,
"Dec 8, 2021 4:00 PM",39,16,23,10,5,5,11,7,4,13,8,5,4,2,2,8,9,9,0,0,0,0,10,6,3,3,9,8,0,0,0,0,0,,,
"Dec 8, 2021 5:00 PM",47,17,30,9,4,5,13,6,7,10,5,5,3,0,3,9,4,4,0,0,0,0,4,3,1,2,14,11,1,0,0,0,0,,,
"Dec 8, 2021 6:00 PM",76,20,56,8,6,2,15,9,6,11,7,4,2,1,1,12,5,5,0,0,0,0,5,8,7,1,13,12,0,1,0,0,0,,,
"Dec 8, 2021 7:00 PM",24,9,15,6,6,0,12,7,5,9,8,1,2,2,0,3,3,2,1,0,0,0,1,11,8,3,10,15,3,0,0,0,0,,,
"Dec 8, 2021 8:00 PM",26,10,16,3,3,0,2,0,2,1,0,1,2,2,0,7,5,4,1,0,0,0,6,1,1,0,7,5,2,1,0,0,0,,,
"Dec 8, 2021 9:00 PM",9,4,5,3,1,2,5,5,0,3,2,1,1,0,1,10,3,1,2,0,0,0,2,3,3,0,7,3,2,0,0,0,0,,,
"Dec 8, 2021 10:00 PM",8,1,7,3,1,2,4,1,3,4,1,3,2,1,1,1,2,1,1,0,0,0,2,2,0,2,3,4,0,0,0,0,0,,,
"Dec 8, 2021 11:00 PM",7,3,4,0,0,0,0,0,0,1,0,1,0,0,0,0,1,0,1,0,0,0,0,0,0,0,2,1,0,0,0,0,0,,,
"Dec 9, 2021 12:00 AM",1,0,1,0,0,0,0,0,0,0,0,0,0,0,0,2,1,0,1,0,0,0,0,0,0,0,0,1,0,0,,,,,,
"Dec 9, 2021 1:00 AM",4,2,2,0,0,0,0,0,0,0,0,0,0,0,0,1,0,0,0,0,0,0,0,0,0,0,0,1,0,1,,,,,,
"Dec 9, 2021 2:00 AM",2,2,0,0,0,0,0,0,0,0,0,0,0,0,0,1,0,0,0,0,0,0,0,0,0,0,0,1,0,0,,,,,,
"Dec 9, 2021 3:00 AM",1,1,0,0,0,0,0,0,0,0,0,0,0,0,0,0,0,0,0,0,0,0,0,0,0,0,0,0,0,0,,,,,,
"Dec 9, 2021 4:00 AM",0,0,0,0,0,0,1,1,0,0,0,0,0,0,0,0,0,0,0,0,0,0,0,0,0,0,0,1,0,0,,,,,,
"Dec 9, 2021 5:00 AM",7,6,1,1,0,1,2,0,2,2,1,1,0,0,0,2,4,4,0,0,0,0,5,1,0,1,4,7,0,0,,,,,,
"Dec 9, 2021 6:00 AM",24,18,6,15,5,10,21,7,14,13,7,6,3,2,1,6,16,16,0,0,0,0,17,6,1,5,12,14,0,3,,,,,,
"Dec 9, 2021 7:00 AM",59,37,22,27,11,16,43,13,30,30,14,16,4,4,0,9,29,28,1,0,0,0,28,21,13,8,19,48,3,2,,,,,,
"Dec 9, 2021 8:00 AM",160,104,56,62,22,40,95,37,58,66,31,35,20,10,10,24,74,73,1,0,0,0,76,38,10,28,30,106,1,2,,,,,,
"Dec 9, 2021 9:00 AM",100,73,27,27,7,20,51,27,24,42,23,19,12,9,3,8,37,37,0,0,0,0,36,22,16,6,16,36,1,1,,,,,,
"Dec 9, 2021 10:00 AM",51,36,15,33,14,19,39,20,19,30,18,12,4,2,2,12,32,31,1,0,0,0,31,20,11,9,12,21,1,3,,,,,,
"Dec 9, 2021 11:00 AM",38,26,12,32,17,15,43,25,18,35,23,12,8,3,5,3,18,16,2,0,0,0,14,10,6,4,16,24,4,5,,,,,,
"Dec 9, 2021 12:00 PM",49,24,25,22,9,13,32,13,19,26,10,16,7,3,4,10,20,17,3,0,0,0,17,11,6,5,18,20,4,3,,,,,,
"Dec 9, 2021 1:00 PM",66,32,34,50,30,20,57,35,22,41,23,18,17,6,11,12,15,15,0,0,0,0,12,20,11,9,23,15,4,1,,,,,,
"Dec 9, 2021 2:00 PM",45,22,23,41,17,24,49,23,26,33,16,17,14,4,10,17,17,16,1,0,0,0,12,15,9,6,19,20,2,1,,,,,,
"Dec 9, 2021 3:00 PM",73,38,35,15,7,8,38,17,21,26,12,14,5,2,3,10,17,15,2,0,0,0,14,21,12,9,15,15,1,3,,,,,,
"Dec 9, 2021 4:00 PM",73,27,46,26,23,3,40,31,9,30,20,10,18,5,13,14,15,13,2,0,0,0,12,16,11,5,29,29,3,0,,,,,,
"Dec 9, 2021 5:00 PM",111,39,72,27,18,9,54,31,23,40,23,17,15,1,14,9,19,14,5,0,0,0,14,29,22,7,53,39,2,0,,,,,,
"Dec 9, 2021 6:00 PM",92,28,64,17,11,6,45,30,15,27,14,13,2,0,2,5,23,21,2,0,0,0,20,14,11,3,40,32,2,0,,,,,,
"Dec 9, 2021 7:00 PM",59,12,47,14,12,2,31,22,9,26,22,4,6,2,4,6,19,17,2,0,0,0,17,12,8,4,19,13,1,0,,,,,,
"Dec 9, 2021 8:00 PM",42,17,25,7,6,1,14,10,4,11,6,5,5,1,4,7,10,9,1,0,0,0,12,3,2,1,16,18,1,0,,,,,,
"Dec 9, 2021 9:00 PM",29,7,22,5,2,3,10,5,5,5,3,2,3,2,1,6,12,11,1,0,0,0,10,5,3,2,8,6,2,1,,,,,,
"Dec 9, 2021 10:00 PM",23,6,17,5,5,0,7,6,1,4,3,1,2,2,0,2,4,2,2,0,0,0,1,4,4,0,10,5,2,2,,,,,,
"Dec 9, 2021 11:00 PM",18,2,16,3,0,3,8,3,5,4,0,4,1,0,1,1,5,4,1,0,0,0,4,1,1,0,11,2,0,0,,,,,,
"Dec 10, 2021 12:00 AM",11,3,8,0,0,0,0,0,0,0,0,0,0,0,0,1,2,2,0,0,0,0,3,1,1,0,2,1,0,0,,,,,,
"Dec 10, 2021 1:00 AM",6,2,4,0,0,0,0,0,0,0,0,0,0,0,0,0,1,1,0,0,0,0,0,0,0,0,1,1,0,0,,,,,,
"Dec 10, 2021 2:00 AM",3,2,1,0,0,0,0,0,0,0,0,0,0,0,0,0,0,0,0,0,0,0,0,1,1,0,0,1,0,0,,,,,,
"Dec 10, 2021 3:00 AM",0,0,0,0,0,0,0,0,0,0,0,0,0,0,0,0,0,0,0,0,0,0,0,0,0,0,0,0,0,0,,,,,,
"Dec 10, 2021 4:00 AM",2,0,2,0,0,0,2,1,1,2,1,1,0,0,0,0,0,0,0,0,0,0,0,0,0,0,0,1,0,0,,,,,,
"Dec 10, 2021 5:00 AM",5,3,2,1,1,0,3,2,1,4,3,1,0,0,0,3,3,3,0,0,0,0,2,2,2,0,3,5,0,0,,,,,,
"Dec 10, 2021 6:00 AM",21,12,9,15,5,10,15,7,8,15,8,7,3,3,0,2,14,14,0,0,0,0,13,1,0,1,10,14,0,3,,,,,,
"Dec 10, 2021 7:00 AM",62,37,25,34,14,20,35,14,21,35,17,18,7,7,0,4,27,27,0,0,0,0,29,12,6,6,20,42,1,6,,,,,,
"Dec 10, 2021 8:00 AM",142,106,36,63,21,42,84,35,49,70,32,38,21,12,9,14,72,72,0,0,0,0,74,34,13,21,25,91,5,2,,,,,,
"Dec 10, 2021 9:00 AM",77,56,21,40,14,26,46,20,26,47,27,20,11,7,4,4,31,30,1,0,0,0,30,26,10,16,11,27,1,1,,,,,,
"Dec 10, 2021 10:00 AM",50,34,16,25,10,15,28,13,15,23,11,12,8,4,4,10,26,25,1,0,0,0,23,15,8,7,11,20,4,2,,,,,,
"Dec 10, 2021 11:00 AM",29,14,15,32,16,16,30,16,14,28,16,12,7,5,2,10,24,24,0,0,0,0,26,20,14,6,7,21,5,5,,,,,,
"Dec 10, 2021 12:00 PM",59,29,30,55,28,27,67,38,29,38,21,17,18,13,5,8,18,16,2,0,0,0,12,30,18,12,15,15,2,4,,,,,,
"Dec 10, 2021 1:00 PM",91,46,45,41,24,17,66,33,33,47,23,24,17,8,9,13,22,21,1,0,0,0,19,21,15,6,19,29,3,3,,,,,,
"Dec 10, 2021 2:00 PM",59,31,28,37,22,15,49,28,21,42,25,17,11,6,5,16,15,13,2,0,0,0,13,29,17,12,18,20,3,3,,,,,,
"Dec 10, 2021 3:00 PM",78,34,44,47,18,29,75,38,37,65,32,33,1,0,1,21,25,24,1,0,0,0,23,22,15,7,32,36,3,1,,,,,,
"Dec 10, 2021 4:00 PM",92,25,67,34,22,12,63,39,24,50,35,15,14,3,11,13,17,16,1,0,0,0,17,27,19,8,30,28,5,1,,,,,,
"Dec 10, 2021 5:00 PM",104,27,77,21,14,7,47,24,23,36,14,22,6,0,6,13,17,13,4,0,0,0,15,13,6,7,38,39,1,1,,,,,,
"Dec 10, 2021 6:00 PM",73,23,50,22,18,4,32,27,5,23,19,4,3,1,2,11,16,14,2,0,0,0,14,21,20,1,35,21,1,1,,,,,,
"Dec 10, 2021 7:00 PM",80,30,50,23,15,8,28,20,8,29,18,11,3,1,2,8,12,8,4,0,0,0,11,11,7,4,17,19,7,1,,,,,,
"Dec 10, 2021 8:00 PM",28,8,20,9,4,5,17,10,7,15,7,8,5,2,3,7,11,8,3,0,0,0,6,6,2,4,17,13,1,2,,,,,,
"Dec 10, 2021 9:00 PM",18,5,13,3,2,1,12,5,7,12,5,7,1,0,1,8,7,6,1,0,0,0,7,8,6,2,10,15,2,2,,,,,,
"Dec 10, 2021 10:00 PM",16,5,11,3,1,2,5,3,2,4,3,1,0,0,0,6,2,1,1,0,0,0,2,4,1,3,6,9,0,1,,,,,,
"Dec 10, 2021 11:00 PM",13,1,12,4,3,1,9,4,5,7,3,4,0,0,0,1,1,1,0,0,0,0,1,3,1,2,7,7,1,2,,,,,,
"Dec 11, 2021 12:00 AM",19,1,18,0,0,0,4,1,3,4,1,3,0,0,0,0,2,1,1,0,0,0,1,2,2,0,9,2,0,1,,,,,,
"Dec 11, 2021 1:00 AM",8,3,5,2,2,0,4,3,1,3,2,1,2,2,0,0,0,0,0,0,0,0,0,0,0,0,5,2,0,0,,,,,,
"Dec 11, 2021 2:00 AM",6,3,3,0,0,0,1,0,1,0,0,0,0,0,0,0,1,1,0,0,0,0,1,0,0,0,1,0,0,1,,,,,,
"Dec 11, 2021 3:00 AM",2,1,1,0,0,0,0,0,0,0,0,0,0,0,0,0,0,0,0,0,0,0,0,0,0,0,1,0,0,0,,,,,,
"Dec 11, 2021 4:00 AM",2,0,2,0,0,0,2,2,0,0,0,0,0,0,0,1,0,0,0,0,0,0,0,0,0,0,3,0,0,0,,,,,,
"Dec 11, 2021 5:00 AM",0,0,0,0,0,0,1,0,1,1,0,1,0,0,0,0,2,2,0,0,0,0,1,0,0,0,1,4,0,0,0,0,0,,,
"Dec 11, 2021 6:00 AM",11,6,5,2,1,1,3,3,0,3,2,1,1,0,1,0,6,6,0,0,0,0,6,1,1,0,6,9,1,0,0,0,0,,,
"Dec 11, 2021 7:00 AM",21,12,9,20,10,10,17,12,5,16,12,4,5,2,3,3,6,6,0,0,0,0,6,4,4,0,8,9,2,1,0,0,0,,,
"Dec 11, 2021 8:00 AM",50,34,16,16,5,11,30,14,16,19,12,7,3,2,1,6,25,25,0,0,0,0,28,7,4,3,10,22,2,0,0,0,0,,,
"Dec 11, 2021 9:00 AM",59,26,33,26,15,11,46,30,16,40,28,12,6,6,0,7,14,14,0,0,0,0,14,18,9,9,17,17,1,3,0,0,0,,,
"Dec 11, 2021 10:00 AM",46,25,21,49,21,28,48,27,21,43,22,21,10,6,4,13,15,12,3,0,0,0,13,15,7,8,17,14,5,0,0,0,0,,,
"Dec 11, 2021 11:00 AM",40,26,14,56,29,27,57,33,24,58,31,27,17,12,5,5,14,14,0,0,0,0,14,22,8,14,18,22,5,1,0,0,0,,,
"Dec 11, 2021 12:00 PM",58,39,19,64,26,38,52,28,24,55,25,30,14,9,5,19,17,15,2,0,0,0,14,18,12,6,18,24,6,2,0,0,0,,,
"Dec 11, 2021 1:00 PM",44,23,21,56,35,21,58,28,30,60,31,29,17,4,13,14,15,15,0,0,0,0,15,24,10,14,16,29,5,2,0,0,0,,,
"Dec 11, 2021 2:00 PM",44,35,9,50,26,24,70,34,36,62,32,30,15,7,8,16,26,25,1,0,0,0,22,19,9,10,20,51,1,2,0,0,0,,,
"Dec 11, 2021 3:00 PM",48,26,22,70,34,36,81,46,35,60,29,31,23,15,8,24,23,21,2,0,0,0,22,32,17,15,22,14,2,0,0,0,0,,,
"Dec 11, 2021 4:00 PM",42,23,19,52,22,30,49,16,33,38,14,24,25,15,10,12,16,14,2,0,0,0,16,17,9,8,13,22,4,1,0,0,0,,,
"Dec 11, 2021 5:00 PM",44,9,35,31,14,17,39,22,17,30,13,17,8,2,6,14,11,10,1,0,0,0,12,17,12,5,16,19,0,0,0,0,0,,,
"Dec 11, 2021 6:00 PM",65,19,46,17,14,3,19,11,8,19,10,9,3,0,3,4,11,10,1,0,0,0,9,7,2,5,14,18,1,0,0,0,0,,,
"Dec 11, 2021 7:00 PM",35,14,21,4,4,0,12,5,7,12,4,8,3,1,2,3,9,7,2,0,0,0,5,4,2,2,6,9,0,0,0,0,0,,,
"Dec 11, 2021 8:00 PM",29,11,18,4,3,1,7,5,2,3,2,1,4,0,4,4,8,5,3,0,0,0,4,2,0,2,10,6,1,1,0,0,0,,,
"Dec 11, 2021 9:00 PM",13,3,10,4,0,4,6,1,5,3,2,1,0,0,0,6,2,2,0,0,0,0,2,1,1,0,4,3,1,1,0,0,0,,,
"Dec 11, 2021 10:00 PM",8,2,6,1,1,0,5,1,4,1,0,1,1,0,1,0,2,2,0,0,0,0,2,1,1,0,2,6,1,1,0,0,0,,,
"Dec 11, 2021 11:00 PM",6,4,2,0,0,0,7,3,4,5,2,3,0,0,0,2,5,5,0,0,0,0,4,1,0,1,2,2,1,0,0,0,0,,,
"Dec 12, 2021 12:00 AM",7,2,5,0,0,0,0,0,0,3,1,2,2,2,0,0,3,3,0,0,0,0,2,2,0,2,7,1,0,1,,,,,,
"Dec 12, 2021 1:00 AM",8,3,5,0,0,0,8,3,5,4,2,2,0,0,0,0,0,0,0,0,0,0,0,2,2,0,3,3,0,0,,,,,,
"Dec 12, 2021 2:00 AM",5,2,3,0,0,0,1,1,0,0,0,0,0,0,0,0,2,1,1,0,0,0,1,2,2,0,1,1,0,0,,,,,,
"Dec 12, 2021 3:00 AM",4,2,2,0,0,0,0,0,0,0,0,0,2,1,1,0,0,0,0,0,0,0,0,2,2,0,2,0,0,0,,,,,,
"Dec 12, 2021 4:00 AM",3,0,3,0,0,0,1,1,0,0,0,0,0,0,0,0,0,0,0,0,0,0,1,0,0,0,2,1,0,0,,,,,,
"Dec 12, 2021 5:00 AM",2,1,1,0,0,0,0,0,0,0,0,0,1,0,1,1,2,1,1,0,0,0,1,0,0,0,1,1,0,0,,,,,,
"Dec 12, 2021 6:00 AM",8,5,3,0,0,0,3,2,1,2,0,2,0,0,0,3,4,4,0,0,0,0,3,0,0,0,2,5,1,1,,,,,,
"Dec 12, 2021 7:00 AM",8,7,1,7,3,4,9,4,5,10,6,4,0,0,0,2,6,6,0,0,0,0,8,4,4,0,11,13,0,0,,,,,,
"Dec 12, 2021 8:00 AM",28,11,17,30,11,19,41,27,14,32,23,9,3,2,1,3,7,6,1,0,0,0,4,16,14,2,13,13,1,5,,,,,,
"Dec 12, 2021 9:00 AM",30,15,15,110,78,32,143,98,45,104,83,21,12,7,5,7,12,12,0,0,0,0,11,32,22,10,38,37,7,18,,,,,,
"Dec 12, 2021 10:00 AM",49,30,19,112,64,48,114,60,54,106,68,38,15,6,9,6,26,26,0,0,0,0,23,41,22,19,14,26,5,6,,,,,,
"Dec 12, 2021 11:00 AM",46,30,16,150,69,81,110,47,63,121,54,67,32,19,13,16,18,16,2,0,0,0,16,52,30,22,39,39,7,6,,,,,,
"Dec 12, 2021 12:00 PM",70,35,35,177,78,99,149,76,73,148,70,78,38,24,14,11,20,20,0,0,0,0,16,53,22,31,27,37,12,3,,,,,,
"Dec 12, 2021 1:00 PM",51,27,24,126,59,67,125,71,54,114,61,53,46,24,22,20,18,16,2,0,0,0,15,49,25,24,28,50,7,2,,,,,,
"Dec 12, 2021 2:00 PM",60,33,27,104,52,52,113,53,60,99,46,53,25,10,15,27,16,15,1,0,0,0,15,45,27,18,30,42,1,8,,,,,,
"Dec 12, 2021 3:00 PM",46,28,18,114,66,48,113,57,56,89,46,43,14,5,9,17,15,13,2,0,0,0,12,45,17,28,31,34,1,1,,,,,,
"Dec 12, 2021 4:00 PM",51,23,28,60,29,31,89,28,61,69,27,42,16,8,8,13,21,20,1,0,0,0,16,37,17,20,11,23,2,2,,,,,,
"Dec 12, 2021 5:00 PM",43,18,25,18,12,6,36,16,20,33,13,20,5,1,4,5,11,10,1,0,0,0,10,19,9,10,16,19,1,0,,,,,,
"Dec 12, 2021 6:00 PM",33,11,22,8,4,4,25,13,12,13,6,7,3,2,1,4,5,5,0,0,0,0,5,5,2,3,10,10,1,0,,,,,,
"Dec 12, 2021 7:00 PM",31,9,22,3,3,0,5,0,5,2,0,2,4,0,4,4,9,9,0,0,0,0,9,6,3,3,6,8,0,0,,,,,,
"Dec 12, 2021 8:00 PM",29,9,20,8,3,5,11,2,9,8,1,7,3,0,3,3,9,7,2,0,0,0,10,8,3,5,4,8,0,1,,,,,,
"Dec 12, 2021 9:00 PM",16,4,12,3,3,0,8,4,4,5,2,3,3,1,2,6,6,5,1,0,0,0,5,5,4,1,2,7,0,1,,,,,,
"Dec 12, 2021 10:00 PM",12,3,9,0,0,0,6,5,1,4,2,2,0,0,0,1,0,0,0,0,0,0,1,0,0,0,11,7,1,1,,,,,,
"Dec 12, 2021 11:00 PM",6,1,5,0,0,0,2,0,2,5,3,2,2,0,2,0,1,1,0,0,0,0,1,1,0,1,6,2,0,0,,,,,,
"Dec 13, 2021 12:00 AM",3,0,3,0,0,0,0,0,0,1,0,1,2,2,0,0,1,0,1,0,0,0,1,0,0,0,0,0,0,1,,,,,,
"Dec 13, 2021 1:00 AM",1,0,1,0,0,0,1,0,1,0,0,0,0,0,0,0,0,0,0,0,0,0,0,0,0,0,0,1,0,0,,,,,,
"Dec 13, 2021 2:00 AM",1,1,0,0,0,0,0,0,0,0,0,0,0,0,0,0,0,0,0,0,0,0,0,0,0,0,1,0,0,0,,,,,,
"Dec 13, 2021 3:00 AM",2,0,2,0,0,0,0,0,0,0,0,0,0,0,0,0,0,0,0,0,0,0,1,0,0,0,0,1,0,0,,,,,,
"Dec 13, 2021 4:00 AM",1,0,1,0,0,0,1,1,0,0,0,0,1,0,1,0,1,1,0,0,0,0,1,0,0,0,1,0,0,0,,,,,,
"Dec 13, 2021 5:00 AM",8,7,1,1,1,0,4,3,1,4,3,1,0,0,0,1,5,5,0,0,0,0,5,1,1,0,3,9,0,0,,,,,,
"Dec 13, 2021 6:00 AM",36,25,11,11,3,8,16,4,12,10,4,6,1,1,0,3,14,13,1,0,0,0,13,5,1,4,13,22,1,2,,,,,,
"Dec 13, 2021 7:00 AM",61,38,23,36,14,22,68,25,43,40,21,19,6,6,0,6,47,47,0,0,0,0,50,16,6,10,33,63,2,2,,,,,,
"Dec 13, 2021 8:00 AM",165,108,57,75,22,53,110,40,70,85,37,48,30,19,11,21,99,99,0,0,0,0,101,48,15,33,46,121,4,3,,,,,,
"Dec 13, 2021 9:00 AM",89,74,15,43,17,26,79,43,36,59,37,22,13,9,4,3,58,57,1,0,0,0,55,31,20,11,30,33,1,2,,,,,,
"Dec 13, 2021 10:00 AM",52,39,13,42,14,28,74,41,33,44,21,23,10,6,4,5,27,26,1,0,0,0,26,21,12,9,14,29,2,5,,,,,,
"Dec 13, 2021 11:00 AM",43,22,21,48,25,23,47,18,29,35,18,17,13,4,9,7,28,27,1,0,0,0,23,16,6,10,11,27,2,3,,,,,,
"Dec 13, 2021 12:00 PM",56,29,27,51,26,25,58,27,31,49,23,26,8,5,3,8,16,16,0,0,0,0,17,13,8,5,12,25,3,2,,,,,,
"Dec 13, 2021 1:00 PM",70,36,34,47,18,29,60,31,29,50,22,28,19,11,8,10,20,18,2,0,0,0,19,25,17,8,23,19,2,2,,,,,,
"Dec 13, 2021 2:00 PM",58,34,24,46,24,22,31,19,12,28,17,11,15,9,6,15,17,14,3,0,0,0,12,23,16,7,19,19,4,2,,,,,,
"Dec 13, 2021 3:00 PM",53,27,26,29,16,13,41,22,19,37,21,16,11,5,6,14,26,25,1,0,0,0,21,24,14,10,29,23,1,1,,,,,,
"Dec 13, 2021 4:00 PM",112,46,66,27,19,8,47,31,16,38,21,17,5,1,4,18,19,18,1,0,0,0,18,22,18,4,31,32,4,0,,,,,,
"Dec 13, 2021 5:00 PM",127,38,89,25,17,8,57,33,24,37,20,17,11,3,8,16,19,16,3,0,0,0,15,22,19,3,66,41,0,0,,,,,,
"Dec 13, 2021 6:00 PM",101,30,71,43,27,16,66,45,21,51,30,21,7,2,5,10,21,17,4,0,0,0,20,25,21,4,61,43,2,0,,,,,,
"Dec 13, 2021 7:00 PM",70,18,52,16,11,5,29,20,9,24,16,8,2,0,2,12,16,14,2,0,0,0,14,17,12,5,39,16,0,2,,,,,,
"Dec 13, 2021 8:00 PM",57,16,41,16,13,3,23,14,9,20,12,8,6,3,3,9,10,9,1,0,0,0,11,12,9,3,22,21,0,1,,,,,,
"Dec 13, 2021 9:00 PM",28,7,21,4,1,3,12,4,8,11,4,7,0,0,0,9,6,6,0,0,0,0,5,6,5,1,6,10,2,2,,,,,,
"Dec 13, 2021 10:00 PM",17,5,12,7,6,1,6,3,3,7,3,4,1,0,1,6,2,2,0,0,0,0,2,3,2,1,7,4,1,1,,,,,,
"Dec 13, 2021 11:00 PM",9,3,6,2,1,1,2,2,0,1,1,0,1,0,1,0,4,2,2,0,0,0,2,1,0,1,6,5,0,0,,,,,,
"Dec 14, 2021 12:00 AM",8,0,8,0,0,0,0,0,0,2,0,2,1,0,1,0,0,0,0,0,0,0,0,0,0,0,3,1,0,0,,,,,,
"Dec 14, 2021 1:00 AM",4,0,4,1,1,0,2,2,0,2,1,1,0,0,0,0,0,0,0,0,0,0,0,0,0,0,0,0,1,0,,,,,,
"Dec 14, 2021 2:00 AM",3,2,1,0,0,0,2,0,2,0,0,0,0,0,0,0,0,0,0,0,0,0,0,0,0,0,0,3,0,1,,,,,,
"Dec 14, 2021 3:00 AM",0,0,0,0,0,0,0,0,0,0,0,0,0,0,0,1,0,0,0,0,0,0,1,0,0,0,1,0,0,0,,,,,,
"Dec 14, 2021 4:00 AM",1,1,0,0,0,0,0,0,0,0,0,0,0,0,0,0,0,0,0,0,0,0,0,0,0,0,0,2,0,0,,,,,,
"Dec 14, 2021 5:00 AM",8,6,2,1,1,0,3,3,0,5,4,1,0,0,0,2,7,7,0,0,0,0,8,1,1,0,3,10,0,0,,,,,,
"Dec 14, 2021 6:00 AM",33,24,9,15,7,8,18,7,11,17,9,8,0,0,0,4,9,8,1,0,0,0,10,2,1,1,13,22,1,2,,,,,,
"Dec 14, 2021 7:00 AM",81,52,29,30,11,19,48,15,33,34,16,18,8,8,0,8,52,52,0,0,0,0,48,26,9,17,31,49,1,4,,,,,,
"Dec 14, 2021 8:00 AM",165,109,56,81,28,53,123,36,87,80,29,51,29,15,14,21,92,91,1,0,0,0,91,44,11,33,38,109,5,6,,,,,,
"Dec 14, 2021 9:00 AM",107,85,22,47,17,30,87,44,43,68,38,30,17,13,4,12,64,63,1,0,0,0,52,37,15,22,23,48,3,0,,,,,,
"Dec 14, 2021 10:00 AM",55,39,16,45,24,21,68,44,24,46,32,14,15,9,6,16,22,22,0,0,0,0,23,18,11,7,23,20,3,2,,,,,,
"Dec 14, 2021 11:00 AM",59,38,21,55,23,32,67,27,40,55,26,29,8,2,6,5,18,17,1,0,0,0,14,37,20,17,15,27,3,2,,,,,,
"Dec 14, 2021 12:00 PM",65,34,31,49,29,20,63,37,26,49,29,20,13,8,5,16,20,20,0,0,0,0,17,21,13,8,20,34,1,4,,,,,,
"Dec 14, 2021 1:00 PM",68,31,37,55,28,27,66,35,31,49,23,26,17,8,9,16,17,16,1,0,0,0,15,27,15,12,21,30,5,2,,,,,,
"Dec 14, 2021 2:00 PM",62,35,27,67,34,33,64,33,31,52,31,21,13,4,9,13,12,11,1,0,0,0,13,29,20,9,17,25,6,4,,,,,,
"Dec 14, 2021 3:00 PM",82,42,40,47,21,26,71,40,31,55,33,22,15,9,6,24,23,21,2,0,0,0,18,27,19,8,30,25,2,2,,,,,,
"Dec 14, 2021 4:00 PM",105,47,58,61,41,20,82,49,33,62,33,29,13,5,8,16,25,25,0,0,0,0,26,38,30,8,31,43,1,5,,,,,,
"Dec 14, 2021 5:00 PM",148,35,113,38,26,12,67,37,30,48,29,19,12,5,7,17,20,19,1,0,0,0,22,28,19,9,57,40,2,1,,,,,,
"Dec 14, 2021 6:00 PM",119,30,89,33,26,7,63,43,20,49,30,19,4,3,1,13,30,25,5,0,0,0,26,27,20,7,65,41,4,0,,,,,,
"Dec 14, 2021 7:00 PM",86,22,64,19,11,8,30,16,14,22,11,11,4,0,4,11,15,12,3,0,0,0,13,19,12,7,27,21,2,0,,,,,,
"Dec 14, 2021 8:00 PM",63,19,44,11,9,2,21,18,3,17,13,4,7,1,6,9,12,10,2,0,0,0,12,12,10,2,28,17,1,2,,,,,,
"Dec 14, 2021 9:00 PM",45,11,34,17,10,7,20,9,11,20,11,9,1,0,1,5,12,10,2,0,0,0,8,3,2,1,13,10,0,0,,,,,,
"Dec 14, 2021 10:00 PM",28,11,17,2,2,0,9,5,4,7,4,3,2,2,0,4,3,3,0,0,0,0,3,3,2,1,10,6,3,2,,,,,,
"Dec 14, 2021 11:00 PM",14,1,13,5,4,1,4,3,1,2,1,1,0,0,0,0,5,2,3,0,0,0,2,3,1,2,4,5,2,0,,,,,,
"Dec 15, 2021 12:00 AM",9,2,7,1,1,0,2,1,1,3,3,0,0,0,0,0,1,1,0,0,0,0,0,1,1,0,6,1,0,0,,,,,,
"Dec 15, 2021 1:00 AM",3,1,2,1,1,0,1,1,0,0,0,0,0,0,0,0,0,0,0,0,0,0,0,0,0,0,0,1,0,0,,,,,,
"Dec 15, 2021 2:00 AM",4,3,1,0,0,0,2,0,2,1,0,1,0,0,0,0,0,0,0,0,0,0,0,0,0,0,0,1,0,0,,,,,,
"Dec 15, 2021 3:00 AM",0,0,0,1,1,0,0,0,0,1,1,0,0,0,0,0,0,0,0,0,0,0,1,0,0,0,0,1,0,0,,,,,,
"Dec 15, 2021 4:00 AM",1,1,0,0,0,0,1,1,0,0,0,0,0,0,0,0,0,0,0,0,0,0,0,0,0,0,1,1,0,0,,,,,,
"Dec 15, 2021 5:00 AM",6,4,2,0,0,0,3,2,1,4,3,1,0,0,0,2,4,4,0,0,0,0,5,1,1,0,3,8,0,0,,,,,,
"Dec 15, 2021 6:00 AM",31,23,8,14,7,7,13,8,5,15,9,6,1,1,0,4,18,18,0,0,0,0,16,3,2,1,13,20,0,3,,,,,,
"Dec 15, 2021 7:00 AM",78,51,27,26,12,14,58,20,38,40,19,21,6,5,1,17,48,48,0,0,0,0,51,19,8,11,37,68,0,2,,,,,,
"Dec 15, 2021 8:00 AM",176,111,65,74,25,49,131,47,84,97,36,61,41,27,14,20,91,90,1,0,0,0,88,57,19,38,35,133,5,2,,,,,,
"Dec 15, 2021 9:00 AM",116,85,31,74,27,47,79,44,35,75,34,41,13,8,5,8,55,53,2,0,0,0,49,33,14,19,15,53,0,6,,,,,,
"Dec 15, 2021 10:00 AM",50,38,12,40,15,25,66,34,32,34,16,18,14,4,10,6,17,16,1,0,0,0,19,17,11,6,18,20,1,2,,,,,,
"Dec 15, 2021 11:00 AM",52,32,20,48,22,26,84,43,41,50,26,24,10,6,4,12,16,15,1,0,0,0,13,18,13,5,22,24,6,3,,,,,,
"Dec 15, 2021 12:00 PM",68,28,40,67,33,34,75,39,36,65,35,30,27,8,19,8,22,21,1,0,0,0,20,23,15,8,29,31,6,0,,,,,,
"Dec 15, 2021 1:00 PM",69,35,34,85,43,42,93,50,43,84,45,39,20,10,10,12,28,27,1,0,0,0,21,28,16,12,42,23,1,8,,,,,,
"Dec 15, 2021 2:00 PM",48,30,18,57,30,27,48,23,25,50,28,22,27,12,15,11,24,23,1,0,0,0,21,20,10,10,24,32,3,1,,,,,,
"Dec 15, 2021 3:00 PM",74,33,41,42,19,23,55,36,19,43,28,15,11,7,4,12,25,23,2,0,0,0,22,35,20,15,25,30,3,1,,,,,,
"Dec 15, 2021 4:00 PM",97,31,66,42,25,17,65,35,30,48,22,26,23,11,12,18,23,22,1,0,0,0,15,27,16,11,43,28,5,2,,,,,,
"Dec 15, 2021 5:00 PM",118,38,80,34,20,14,71,37,34,56,32,24,14,2,12,16,23,23,0,0,0,0,22,19,14,5,67,41,5,2,,,,,,
"Dec 15, 2021 6:00 PM",118,36,82,29,19,10,47,30,17,28,15,13,17,10,7,17,18,18,0,0,0,0,21,24,20,4,55,38,1,2,,,,,,
"Dec 15, 2021 7:00 PM",80,24,56,20,19,1,36,25,11,34,23,11,11,7,4,8,11,9,2,0,0,0,9,16,12,4,18,20,3,1,,,,,,
"Dec 15, 2021 8:00 PM",44,13,31,11,9,2,28,20,8,29,21,8,5,2,3,8,15,14,1,0,0,0,15,12,10,2,20,16,2,0,,,,,,
"Dec 15, 2021 9:00 PM",36,12,24,6,5,1,12,9,3,11,6,5,3,1,2,6,7,6,1,0,0,0,7,6,6,0,14,5,4,1,,,,,,
"Dec 15, 2021 10:00 PM",23,5,18,6,4,2,12,5,7,12,6,6,1,1,0,6,5,5,0,0,0,0,5,4,2,2,11,5,1,2,,,,,,
"Dec 15, 2021 11:00 PM",14,2,12,0,0,0,1,1,0,1,1,0,1,1,0,3,2,2,0,0,0,0,2,4,3,1,5,5,0,0,,,,,,
"Dec 16, 2021 12:00 AM",11,3,8,1,1,0,1,1,0,2,2,0,0,0,0,0,5,2,3,0,0,0,2,2,2,0,2,1,0,0,,,,,,
"Dec 16, 2021 1:00 AM",8,2,6,1,1,0,2,2,0,0,0,0,1,0,1,5,1,0,1,0,0,0,0,0,0,0,1,1,0,0,,,,,,
"Dec 16, 2021 2:00 AM",3,1,2,1,1,0,1,1,0,1,1,0,0,0,0,0,0,0,0,0,0,0,0,0,0,0,0,0,0,0,,,,,,
"Dec 16, 2021 3:00 AM",0,0,0,0,0,0,0,0,0,0,0,0,0,0,0,0,0,0,0,0,0,0,1,0,0,0,0,0,0,0,,,,,,
"Dec 16, 2021 4:00 AM",1,1,0,1,0,1,1,1,0,1,0,1,0,0,0,1,0,0,0,0,0,0,0,0,0,0,0,2,0,0,,,,,,
"Dec 16, 2021 5:00 AM",9,8,1,2,1,1,4,2,2,4,3,1,0,0,0,1,7,7,0,0,0,0,7,3,1,2,1,10,0,0,,,,,,
"Dec 16, 2021 6:00 AM",29,20,9,14,4,10,15,4,11,13,6,7,3,1,2,7,14,14,0,0,0,0,15,0,0,0,10,22,0,4,,,,,,
"Dec 16, 2021 7:00 AM",77,49,28,23,11,12,53,19,34,37,16,21,4,3,1,11,41,41,0,0,0,0,43,31,11,20,28,57,1,4,,,,,,
"Dec 16, 2021 8:00 AM",154,106,48,90,27,63,111,37,74,89,38,51,30,16,14,20,84,83,1,0,0,0,83,47,13,34,39,102,6,5,,,,,,
"Dec 16, 2021 9:00 AM",94,73,21,45,14,31,59,32,27,53,29,24,17,8,9,12,42,41,1,0,0,0,37,28,18,10,24,51,3,4,,,,,,
"Dec 16, 2021 10:00 AM",42,25,17,34,19,15,63,45,18,31,18,13,8,6,2,14,30,29,1,0,0,0,22,25,15,10,23,23,6,3,,,,,,
"Dec 16, 2021 11:00 AM",43,24,19,44,16,28,80,34,46,45,20,25,8,2,6,8,23,23,0,0,0,0,23,19,10,9,13,21,3,2,,,,,,
"Dec 16, 2021 12:00 PM",77,50,27,37,20,17,59,33,26,40,23,17,15,3,12,15,27,25,2,0,0,0,21,29,17,12,23,32,2,2,,,,,,
"Dec 16, 2021 1:00 PM",78,39,39,33,16,17,53,29,24,34,16,18,17,6,11,13,19,16,3,0,0,0,12,25,15,10,23,25,5,5,,,,,,
"Dec 16, 2021 2:00 PM",57,28,29,40,26,14,59,26,33,53,28,25,22,8,14,14,20,19,1,0,0,0,17,27,13,14,28,25,1,3,,,,,,
"Dec 16, 2021 3:00 PM",89,43,46,28,19,9,52,38,14,39,24,15,4,4,0,17,18,16,2,0,0,0,16,23,16,7,27,31,4,1,,,,,,
"Dec 16, 2021 4:00 PM",106,41,65,41,27,14,64,44,20,50,27,23,25,13,12,30,24,24,0,0,0,0,26,30,24,6,29,37,5,0,,,,,,
"Dec 16, 2021 5:00 PM",135,29,106,39,26,13,51,31,20,44,29,15,10,4,6,16,18,18,0,0,0,0,20,27,20,7,47,42,0,3,,,,,,
"Dec 16, 2021 6:00 PM",92,40,52,34,23,11,49,30,19,40,23,17,17,4,13,18,23,20,3,0,0,0,26,23,15,8,48,32,5,3,,,,,,
"Dec 16, 2021 7:00 PM",84,24,60,18,12,6,43,25,18,28,14,14,4,0,4,14,18,16,2,0,0,0,17,17,15,2,28,16,1,0,,,,,,
"Dec 16, 2021 8:00 PM",53,17,36,10,8,2,20,13,7,16,11,5,3,2,1,5,11,9,2,0,0,0,9,6,3,3,17,15,4,0,,,,,,
"Dec 16, 2021 9:00 PM",38,7,31,15,12,3,16,10,6,15,11,4,5,1,4,4,7,7,0,0,0,0,9,6,5,1,12,9,0,1,,,,,,
"Dec 16, 2021 10:00 PM",19,3,16,6,4,2,15,4,11,8,3,5,3,2,1,3,10,10,0,0,0,0,10,6,5,1,8,5,4,1,,,,,,
"Dec 16, 2021 11:00 PM",19,4,15,9,5,4,12,6,6,11,6,5,1,0,1,1,3,3,0,0,0,0,4,3,1,2,8,6,1,0,,,,,,
"Dec 17, 2021 12:00 AM",9,1,8,0,0,0,1,1,0,3,2,1,1,1,0,1,4,2,2,0,0,0,3,1,1,0,10,2,0,0,,,,,,
"Dec 17, 2021 1:00 AM",11,2,9,0,0,0,1,0,1,1,0,1,0,0,0,0,0,0,0,0,0,0,0,1,1,0,0,3,0,0,,,,,,
"Dec 17, 2021 2:00 AM",3,2,1,0,0,0,0,0,0,1,1,0,0,0,0,1,0,0,0,0,0,0,0,0,0,0,0,0,0,0,,,,,,
"Dec 17, 2021 3:00 AM",1,0,1,0,0,0,0,0,0,0,0,0,0,0,0,0,0,0,0,0,0,0,0,0,0,0,1,0,0,0,,,,,,
"Dec 17, 2021 4:00 AM",1,1,0,0,0,0,1,0,1,2,0,2,0,0,0,0,1,1,0,0,0,0,1,1,1,0,1,2,0,0,,,,,,
"Dec 17, 2021 5:00 AM",8,5,3,2,2,0,5,4,1,4,4,0,0,0,0,1,6,6,0,0,0,0,6,1,1,0,2,9,0,0,,,,,,
"Dec 17, 2021 6:00 AM",24,17,7,18,8,10,16,6,10,15,8,7,2,2,0,4,12,12,0,0,0,0,12,5,5,0,7,18,1,1,,,,,,
"Dec 17, 2021 7:00 AM",76,55,21,35,15,20,55,22,33,40,18,22,5,4,1,7,33,32,1,0,0,0,31,24,13,11,24,50,1,4,,,,,,
"Dec 17, 2021 8:00 AM",120,85,35,58,19,39,95,32,63,71,32,39,19,13,6,15,69,69,0,0,0,0,74,43,14,29,30,80,4,2,,,,,,
"Dec 17, 2021 9:00 AM",87,63,24,68,32,36,88,47,41,55,32,23,8,6,2,11,34,33,1,0,0,0,32,30,14,16,16,45,1,0,,,,,,
"Dec 17, 2021 10:00 AM",47,31,16,49,28,21,58,23,35,48,27,21,7,5,2,5,21,21,0,0,0,0,21,22,11,11,20,26,0,2,,,,,,
"Dec 17, 2021 11:00 AM",49,25,24,65,29,36,88,50,38,64,32,32,14,8,6,11,23,22,1,0,0,0,23,47,35,12,16,17,6,1,,,,,,
"Dec 17, 2021 12:00 PM",84,49,35,70,41,29,93,48,45,74,48,26,24,14,10,11,26,25,1,0,0,0,22,33,21,12,20,35,1,5,,,,,,
"Dec 17, 2021 1:00 PM",89,38,51,47,21,26,57,30,27,55,32,23,24,13,11,19,17,16,1,0,0,0,15,24,14,10,21,19,4,4,,,,,,
"Dec 17, 2021 2:00 PM",78,37,41,29,16,13,59,38,21,50,34,16,14,5,9,14,19,18,1,0,0,0,19,24,12,12,32,20,3,3,,,,,,
"Dec 17, 2021 3:00 PM",69,33,36,39,22,17,47,27,20,43,22,21,16,6,10,22,19,17,2,0,0,0,18,21,12,9,29,34,3,3,,,,,,
"Dec 17, 2021 4:00 PM",84,26,58,46,30,16,56,33,23,42,26,16,15,8,7,30,33,31,2,0,0,0,30,19,12,7,33,37,6,1,,,,,,
"Dec 17, 2021 5:00 PM",98,28,70,28,19,9,37,29,8,31,23,8,8,0,8,19,16,14,2,0,0,0,14,20,17,3,43,29,3,0,,,,,,
"Dec 17, 2021 6:00 PM",92,36,56,22,17,5,42,30,12,26,17,9,12,5,7,17,14,10,4,0,0,0,17,17,15,2,31,27,2,0,,,,,,
"Dec 17, 2021 7:00 PM",73,24,49,13,9,4,33,16,17,23,10,13,1,0,1,5,18,16,2,0,0,0,14,16,11,5,14,24,5,1,,,,,,
"Dec 17, 2021 8:00 PM",42,19,23,8,6,2,16,9,7,15,8,7,3,0,3,9,14,13,1,0,0,0,15,12,9,3,14,14,0,2,,,,,,
"Dec 17, 2021 9:00 PM",31,13,18,4,1,3,10,4,6,7,2,5,2,0,2,9,4,3,1,0,0,0,3,2,2,0,5,9,1,0,,,,,,
"Dec 17, 2021 10:00 PM",20,5,15,4,3,1,10,3,7,10,3,7,0,0,0,7,3,2,1,0,0,0,4,5,3,2,4,6,0,1,,,,,,
"Dec 17, 2021 11:00 PM",11,3,8,1,1,0,6,3,3,6,1,5,1,0,1,2,2,1,1,0,0,0,1,6,2,4,10,7,0,0,,,,,,
"Dec 18, 2021 12:00 AM",24,8,16,0,0,0,4,3,1,5,2,3,1,1,0,3,9,8,1,0,0,0,7,4,1,3,13,7,0,2,,,,,,
"Dec 18, 2021 1:00 AM",12,2,10,5,5,0,5,3,2,5,3,2,2,0,2,3,1,0,1,0,0,0,0,3,2,1,5,6,0,0,,,,,,
"Dec 18, 2021 2:00 AM",7,4,3,1,0,1,2,2,0,3,2,1,0,0,0,0,0,0,0,0,0,0,0,1,1,0,2,0,0,0,,,,,,
"Dec 18, 2021 3:00 AM",3,1,2,0,0,0,1,0,1,1,0,1,0,0,0,0,0,0,0,0,0,0,0,2,2,0,1,3,0,0,,,,,,
"Dec 18, 2021 4:00 AM",2,1,1,0,0,0,1,0,1,1,0,1,0,0,0,0,1,0,1,0,0,0,0,0,0,0,0,1,0,0,,,,,,
"Dec 18, 2021 5:00 AM",0,0,0,0,0,0,1,1,0,0,0,0,0,0,0,1,2,2,0,0,0,0,2,0,0,0,3,3,0,0,,,,,,
"Dec 18, 2021 6:00 AM",7,4,3,1,1,0,2,1,1,1,1,0,1,0,1,0,6,6,0,0,0,0,4,1,1,0,2,6,2,0,,,,,,
"Dec 18, 2021 7:00 AM",16,3,13,13,7,6,15,10,5,17,12,5,2,0,2,2,6,6,0,0,0,0,7,8,4,4,9,12,0,1,,,,,,
"Dec 18, 2021 8:00 AM",35,16,19,35,26,9,38,29,9,34,28,6,7,4,3,4,13,12,1,0,0,0,13,11,5,6,9,22,0,1,,,,,,
"Dec 18, 2021 9:00 AM",35,25,10,66,37,29,75,49,26,71,45,26,5,5,0,11,21,20,1,0,0,0,22,19,8,11,25,12,3,11,,,,,,
"Dec 18, 2021 10:00 AM",51,27,24,63,32,31,122,80,42,78,53,25,19,12,7,7,23,23,0,0,0,0,25,34,28,6,24,35,9,2,,,,,,
"Dec 18, 2021 11:00 AM",60,30,30,114,69,45,151,75,76,134,68,66,13,8,5,8,19,19,0,0,0,0,20,37,21,16,31,22,10,4,,,,,,
"Dec 18, 2021 12:00 PM",45,19,26,103,52,51,130,60,70,107,51,56,28,13,15,16,26,24,2,0,0,0,27,67,21,46,25,42,3,4,,,,,,
"Dec 18, 2021 1:00 PM",76,33,43,81,38,43,107,55,52,97,52,45,35,22,13,27,21,19,2,0,0,0,22,36,15,21,35,37,6,3,,,,,,
"Dec 18, 2021 2:00 PM",59,32,27,88,48,40,103,46,57,75,38,37,26,16,10,5,21,21,0,0,0,0,19,35,15,20,28,45,7,6,,,,,,
"Dec 18, 2021 3:00 PM",56,23,33,81,43,38,81,43,38,66,36,30,26,14,12,25,17,17,0,0,0,0,21,42,22,20,23,23,5,5,,,,,,
"Dec 18, 2021 4:00 PM",39,18,21,58,30,28,63,26,37,58,19,39,24,11,13,22,19,19,0,0,0,0,19,21,11,10,19,27,6,3,,,,,,
"Dec 18, 2021 5:00 PM",45,20,25,32,14,18,44,15,29,41,10,31,12,7,5,9,13,11,2,0,0,0,12,14,8,6,11,14,0,0,,,,,,
"Dec 18, 2021 6:00 PM",50,16,34,25,17,8,37,23,14,24,13,11,7,2,5,10,10,10,0,0,0,0,10,6,1,5,13,13,1,2,,,,,,
"Dec 18, 2021 7:00 PM",46,20,26,8,3,5,15,3,12,11,4,7,3,2,1,6,7,7,0,0,0,0,8,4,1,3,7,17,0,0,,,,,,
"Dec 18, 2021 8:00 PM",38,16,22,5,3,2,14,13,1,8,6,2,10,0,10,7,5,4,1,0,0,0,4,1,0,1,8,8,1,1,,,,,,
"Dec 18, 2021 9:00 PM",17,5,12,5,2,3,9,4,5,5,3,2,8,0,8,3,6,6,0,0,0,0,7,1,0,1,7,4,0,2,,,,,,
"Dec 18, 2021 10:00 PM",11,4,7,7,4,3,8,2,6,8,1,7,0,0,0,0,3,3,0,0,0,0,3,7,6,1,5,11,0,1,,,,,,
"Dec 18, 2021 11:00 PM",12,2,10,3,1,2,9,4,5,5,1,4,4,0,4,2,2,2,0,0,0,0,2,3,2,1,6,4,1,0,,,,,,
"Dec 19, 2021 12:00 AM",6,1,5,1,0,1,2,1,1,5,3,2,8,7,1,5,2,2,0,0,0,0,2,4,3,1,6,3,0,1,,,,,,
"Dec 19, 2021 1:00 AM",8,1,7,3,3,0,5,3,2,3,2,1,0,0,0,0,3,2,1,0,0,0,2,0,0,0,2,2,0,0,,,,,,
"Dec 19, 2021 2:00 AM",15,7,8,0,0,0,1,1,0,1,1,0,0,0,0,1,1,0,1,0,0,0,0,0,0,0,5,1,0,0,,,,,,
"Dec 19, 2021 3:00 AM",2,1,1,0,0,0,1,0,1,1,0,1,1,0,1,0,0,0,0,0,0,0,0,2,2,0,0,0,0,0,,,,,,
"Dec 19, 2021 4:00 AM",0,0,0,0,0,0,0,0,0,0,0,0,0,0,0,1,0,0,0,0,0,0,0,0,0,0,0,0,0,0,,,,,,
"Dec 19, 2021 5:00 AM",1,0,1,1,1,0,1,1,0,1,1,0,0,0,0,0,0,0,0,0,0,0,0,0,0,0,2,4,0,0,,,,,,
"Dec 19, 2021 6:00 AM",10,6,4,2,1,1,3,1,2,1,0,1,0,0,0,0,4,4,0,0,0,0,4,0,0,0,2,5,0,0,,,,,,
"Dec 19, 2021 7:00 AM",7,4,3,6,2,4,9,5,4,11,7,4,0,0,0,1,11,10,1,0,0,0,11,4,2,2,4,9,0,0,,,,,,
"Dec 19, 2021 8:00 AM",17,12,5,50,31,19,45,34,11,49,35,14,2,2,0,2,5,4,1,0,0,0,5,10,7,3,9,24,0,4,,,,,,
"Dec 19, 2021 9:00 AM",34,14,20,84,46,38,84,54,30,68,47,21,6,5,1,8,16,15,1,0,0,0,14,24,15,9,30,47,0,10,,,,,,
"Dec 19, 2021 10:00 AM",41,17,24,159,82,77,138,86,52,119,70,49,13,10,3,19,29,27,2,0,0,0,27,31,24,7,23,25,6,4,,,,,,
"Dec 19, 2021 11:00 AM",53,35,18,158,66,92,153,66,87,112,55,57,22,21,1,22,18,17,1,0,0,0,17,58,30,28,40,24,5,4,,,,,,
"Dec 19, 2021 12:00 PM",56,30,26,138,62,76,148,75,73,131,64,67,23,16,7,18,18,17,1,0,0,0,17,59,26,33,33,38,6,4,,,,,,
"Dec 19, 2021 1:00 PM",62,36,26,113,58,55,122,63,59,112,56,56,29,11,18,29,20,20,0,0,0,0,19,49,24,25,33,44,4,3,,,,,,
"Dec 19, 2021 2:00 PM",69,31,38,92,45,47,100,45,55,97,48,49,12,7,5,37,17,16,1,0,0,0,16,30,16,14,20,31,6,3,,,,,,
"Dec 19, 2021 3:00 PM",37,22,15,86,42,44,92,42,50,73,34,39,16,10,6,22,16,15,1,0,0,0,11,27,14,13,19,31,9,1,,,,,,
"Dec 19, 2021 4:00 PM",41,18,23,68,36,32,47,16,31,50,15,35,14,7,7,13,14,14,0,0,0,0,12,24,10,14,18,27,5,3,,,,,,
"Dec 19, 2021 5:00 PM",46,15,31,21,13,8,29,12,17,24,8,16,7,2,5,9,10,9,1,0,0,0,6,10,3,7,14,18,0,4,,,,,,
"Dec 19, 2021 6:00 PM",42,16,26,8,5,3,22,13,9,10,6,4,5,1,4,7,10,10,0,0,0,0,8,7,4,3,12,11,0,2,,,,,,
"Dec 19, 2021 7:00 PM",34,17,17,6,2,4,8,6,2,15,6,9,0,0,0,5,8,7,1,0,0,0,7,10,7,3,11,8,0,0,,,,,,
"Dec 19, 2021 8:00 PM",27,9,18,6,4,2,9,6,3,4,4,0,4,4,0,3,9,7,2,0,0,0,6,2,1,1,10,7,0,0,,,,,,
"Dec 19, 2021 9:00 PM",18,7,11,4,1,3,6,2,4,4,2,2,1,0,1,7,7,6,1,0,0,0,6,1,0,1,7,11,0,0,,,,,,
"Dec 19, 2021 10:00 PM",9,4,5,1,1,0,2,0,2,3,0,3,1,0,1,5,3,3,0,0,0,0,4,1,1,0,4,7,1,2,,,,,,
"Dec 19, 2021 11:00 PM",10,4,6,1,0,1,5,0,5,5,1,4,5,2,3,0,4,4,0,0,0,0,4,4,2,2,1,4,0,1,,,,,,
"Dec 20, 2021 12:00 AM",6,1,5,0,0,0,0,0,0,1,1,0,0,0,0,0,2,1,1,0,0,0,2,1,1,0,7,3,0,1,,,,,,
"Dec 20, 2021 1:00 AM",7,2,5,5,4,1,3,3,0,4,4,0,1,0,1,0,2,1,1,0,0,0,1,2,2,0,2,3,0,0,,,,,,
"Dec 20, 2021 2:00 AM",3,2,1,3,0,3,1,0,1,4,0,4,0,0,0,0,0,0,0,0,0,0,0,0,0,0,1,2,0,0,,,,,,
"Dec 20, 2021 3:00 AM",2,0,2,0,0,0,3,1,2,0,0,0,0,0,0,0,0,0,0,0,0,0,0,0,0,0,1,1,0,0,,,,,,
"Dec 20, 2021 4:00 AM",0,0,0,0,0,0,0,0,0,0,0,0,0,0,0,0,0,0,0,0,0,0,0,0,0,0,0,1,0,0,,,,,,
"Dec 20, 2021 5:00 AM",6,4,2,0,0,0,5,4,1,6,5,1,0,0,0,1,2,2,0,0,0,0,3,1,1,0,2,6,1,0,,,,,,
"Dec 20, 2021 6:00 AM",20,14,6,11,5,6,16,5,11,12,5,7,1,1,0,2,13,13,0,0,0,0,12,3,1,2,7,18,1,4,,,,,,
"Dec 20, 2021 7:00 AM",59,32,27,32,17,15,42,14,28,30,14,16,4,4,0,10,37,37,0,0,0,0,37,17,8,9,30,58,2,2,,,,,,
"Dec 20, 2021 8:00 AM",128,76,52,82,22,60,109,41,68,81,33,48,27,17,10,30,60,59,1,0,0,0,62,45,18,27,30,94,3,2,,,,,,
"Dec 20, 2021 9:00 AM",68,57,11,49,22,27,65,40,25,58,35,23,13,8,5,8,31,30,1,0,0,0,33,22,12,10,16,37,3,4,,,,,,
"Dec 20, 2021 10:00 AM",54,29,25,36,14,22,54,27,27,33,20,13,4,2,2,5,22,22,0,0,0,0,19,28,20,8,10,19,2,2,,,,,,
"Dec 20, 2021 11:00 AM",48,32,16,35,21,14,43,24,19,31,20,11,12,7,5,8,13,12,1,0,0,0,11,14,10,4,7,29,1,2,,,,,,
"Dec 20, 2021 12:00 PM",47,26,21,62,28,34,76,45,31,42,26,16,21,9,12,8,22,21,1,0,0,0,18,17,13,4,10,18,2,6,,,,,,
"Dec 20, 2021 1:00 PM",92,43,49,50,22,28,74,37,37,53,23,30,13,5,8,19,16,14,2,0,0,0,13,24,14,10,32,17,2,3,,,,,,
"Dec 20, 2021 2:00 PM",53,24,29,56,34,22,43,25,18,46,29,17,11,9,2,19,21,20,1,0,0,0,19,29,14,15,18,24,2,0,,,,,,
"Dec 20, 2021 3:00 PM",71,26,45,38,18,20,77,44,33,56,27,29,10,6,4,17,17,17,0,0,0,0,15,25,18,7,26,35,1,1,,,,,,
"Dec 20, 2021 4:00 PM",92,48,44,49,27,22,66,39,27,55,27,28,11,3,8,21,22,21,1,0,0,0,19,25,16,9,35,33,3,1,,,,,,
"Dec 20, 2021 5:00 PM",123,34,89,40,31,9,48,24,24,46,29,17,13,8,5,15,13,13,0,0,0,0,16,24,14,10,59,36,6,2,,,,,,
"Dec 20, 2021 6:00 PM",72,16,56,35,24,11,53,34,19,39,22,17,5,1,4,8,22,18,4,0,0,0,21,15,11,4,42,30,2,3,,,,,,
"Dec 20, 2021 7:00 PM",60,26,34,9,8,1,28,16,12,14,8,6,3,0,3,8,13,11,2,0,0,0,14,12,9,3,14,16,1,1,,,,,,
"Dec 20, 2021 8:00 PM",37,10,27,10,9,1,15,12,3,13,8,5,4,1,3,5,7,7,0,0,0,0,8,9,6,3,14,14,4,3,,,,,,
"Dec 20, 2021 9:00 PM",33,9,24,12,9,3,15,10,5,14,8,6,1,0,1,6,3,2,1,0,0,0,2,7,6,1,15,5,0,1,,,,,,
"Dec 20, 2021 10:00 PM",20,3,17,1,0,1,3,0,3,3,1,2,3,2,1,3,9,9,0,0,0,0,9,2,1,1,4,5,1,1,,,,,,
"Dec 20, 2021 11:00 PM",3,2,1,2,1,1,5,3,2,0,0,0,0,0,0,2,3,3,0,0,0,0,3,4,3,1,4,2,0,0,,,,,,
"Dec 21, 2021 12:00 AM",3,0,3,0,0,0,0,0,0,1,0,1,0,0,0,0,2,1,1,0,0,0,1,1,0,1,0,2,0,0,,,,,,
"Dec 21, 2021 1:00 AM",2,1,1,1,1,0,0,0,0,1,1,0,2,0,2,0,1,1,0,0,0,0,1,0,0,0,0,0,1,1,,,,,,
"Dec 21, 2021 2:00 AM",4,3,1,0,0,0,0,0,0,0,0,0,0,0,0,0,1,1,0,0,0,0,1,0,0,0,0,0,0,0,,,,,,
"Dec 21, 2021 3:00 AM",1,1,0,0,0,0,0,0,0,0,0,0,0,0,0,0,0,0,0,0,0,0,0,0,0,0,0,0,0,0,,,,,,
"Dec 21, 2021 4:00 AM",1,1,0,1,1,0,0,0,0,0,0,0,0,0,0,0,0,0,0,0,0,0,0,0,0,0,0,0,0,0,,,,,,
"Dec 21, 2021 5:00 AM",6,4,2,7,2,5,3,2,1,3,2,1,0,0,0,2,5,5,0,0,0,0,4,1,1,0,2,6,1,0,,,,,,
"Dec 21, 2021 6:00 AM",25,16,9,16,5,11,21,10,11,17,7,10,1,0,1,3,14,14,0,0,0,0,13,3,1,2,13,23,0,3,,,,,,
"Dec 21, 2021 7:00 AM",62,41,21,33,14,19,45,16,29,38,21,17,6,5,1,10,36,36,0,0,0,0,41,20,8,12,26,49,1,2,,,,,,
"Dec 21, 2021 8:00 AM",112,68,44,99,43,56,118,57,61,114,58,56,18,10,8,18,58,58,0,0,0,0,58,56,23,33,34,83,5,7,,,,,,
"Dec 21, 2021 9:00 AM",64,47,17,56,18,38,71,33,38,58,27,31,12,5,7,9,33,31,2,0,0,0,31,19,13,6,22,36,1,3,,,,,,
"Dec 21, 2021 10:00 AM",44,29,15,57,29,28,67,39,28,62,36,26,12,9,3,6,19,17,2,0,0,0,15,18,8,10,21,21,1,4,,,,,,
"Dec 21, 2021 11:00 AM",51,28,23,60,28,32,68,33,35,52,25,27,10,5,5,5,19,17,2,0,0,0,15,12,6,6,12,24,2,2,,,,,,
"Dec 21, 2021 12:00 PM",49,20,29,42,17,25,70,38,32,41,18,23,18,8,10,22,16,16,0,0,0,0,18,34,22,12,16,33,4,2,,,,,,
"Dec 21, 2021 1:00 PM",60,32,28,51,29,22,57,30,27,48,25,23,15,8,7,26,24,22,2,0,0,0,17,21,12,9,22,35,4,6,,,,,,
"Dec 21, 2021 2:00 PM",59,33,26,32,19,13,63,31,32,50,25,25,12,5,7,19,31,29,2,0,0,0,23,24,14,10,22,22,1,1,,,,,,
"Dec 21, 2021 3:00 PM",87,37,50,49,23,26,60,39,21,50,32,18,13,6,7,20,21,20,1,0,0,0,15,29,21,8,23,34,2,1,,,,,,
"Dec 21, 2021 4:00 PM",87,27,60,51,30,21,61,38,23,58,37,21,15,6,9,25,26,25,1,0,0,0,27,27,19,8,31,35,4,3,,,,,,
"Dec 21, 2021 5:00 PM",92,30,62,34,26,8,64,39,25,46,30,16,5,1,4,11,22,21,1,0,0,0,22,26,21,5,44,33,0,1,,,,,,
"Dec 21, 2021 6:00 PM",78,29,49,25,15,10,51,34,17,38,18,20,5,1,4,8,23,22,1,0,0,0,22,23,16,7,30,26,4,1,,,,,,
"Dec 21, 2021 7:00 PM",50,22,28,13,9,4,20,14,6,19,9,10,7,1,6,11,10,9,1,0,0,0,11,4,3,1,19,15,1,1,,,,,,
"Dec 21, 2021 8:00 PM",43,17,26,14,12,2,27,15,12,16,9,7,5,2,3,10,15,14,1,0,0,0,14,7,4,3,22,12,1,4,,,,,,
"Dec 21, 2021 9:00 PM",22,5,17,11,5,6,13,9,4,9,5,4,0,0,0,5,6,6,0,0,0,0,5,6,6,0,10,9,0,1,,,,,,
"Dec 21, 2021 10:00 PM",9,4,5,7,6,1,8,4,4,14,12,2,0,0,0,5,4,4,0,0,0,0,4,2,1,1,3,12,1,1,,,,,,
"Dec 21, 2021 11:00 PM",9,2,7,2,1,1,2,1,1,1,1,0,0,0,0,0,5,5,0,0,0,0,3,3,2,1,5,3,0,0,,,,,,
"Dec 22, 2021 12:00 AM",3,0,3,0,0,0,0,0,0,0,0,0,0,0,0,1,2,0,2,0,0,0,0,0,0,0,2,2,1,1,,,,,,
"Dec 22, 2021 1:00 AM",3,3,0,2,1,1,5,2,3,6,4,2,0,0,0,0,2,2,0,0,0,0,2,0,0,0,2,1,0,0,,,,,,
"Dec 22, 2021 2:00 AM",3,3,0,0,0,0,0,0,0,0,0,0,0,0,0,0,0,0,0,0,0,0,0,0,0,0,1,1,0,0,,,,,,
"Dec 22, 2021 3:00 AM",2,1,1,1,0,1,2,0,2,0,0,0,0,0,0,0,0,0,0,0,0,0,0,0,0,0,0,1,0,0,,,,,,
"Dec 22, 2021 4:00 AM",1,1,0,0,0,0,0,0,0,0,0,0,0,0,0,0,0,0,0,0,0,0,0,0,0,0,3,1,0,0,,,,,,
"Dec 22, 2021 5:00 AM",4,2,2,0,0,0,3,1,2,0,0,0,0,0,0,1,9,9,0,0,0,0,8,0,0,0,1,6,0,0,,,,,,
"Dec 22, 2021 6:00 AM",25,15,10,7,1,6,10,5,5,7,3,4,1,1,0,2,11,11,0,0,0,0,11,1,0,1,7,12,0,2,,,,,,
"Dec 22, 2021 7:00 AM",29,14,15,12,4,8,21,9,12,17,7,10,3,3,0,7,19,19,0,0,0,0,20,7,4,3,8,37,1,2,,,,,,
"Dec 22, 2021 8:00 AM",53,29,24,15,6,9,32,10,22,24,10,14,7,4,3,8,29,28,1,0,0,0,28,20,6,14,16,33,4,2,,,,,,
"Dec 22, 2021 9:00 AM",45,34,11,8,2,6,19,8,11,21,10,11,4,2,2,8,11,11,0,0,0,0,11,7,5,2,8,21,1,0,,,,,,
"Dec 22, 2021 10:00 AM",30,19,11,7,4,3,9,6,3,12,7,5,5,5,0,4,18,17,1,0,0,0,15,5,3,2,7,8,0,1,,,,,,
"Dec 22, 2021 11:00 AM",28,13,15,15,9,6,16,7,9,11,7,4,9,5,4,6,7,7,0,0,0,0,8,8,5,3,9,4,2,0,,,,,,
"Dec 22, 2021 12:00 PM",35,19,16,16,8,8,25,17,8,24,16,8,7,2,5,15,10,9,1,0,0,0,10,14,8,6,14,12,1,0,,,,,,
"Dec 22, 2021 1:00 PM",66,40,26,16,11,5,30,19,11,24,15,9,9,3,6,11,16,15,1,0,0,0,15,9,7,2,17,15,1,2,,,,,,
"Dec 22, 2021 2:00 PM",63,31,32,16,7,9,42,21,21,23,13,10,1,1,0,14,19,18,1,0,0,0,16,19,11,8,12,19,1,2,,,,,,
"Dec 22, 2021 3:00 PM",51,24,27,19,11,8,38,19,19,32,13,19,11,6,5,18,13,12,1,0,0,0,10,9,4,5,14,15,3,0,,,,,,
"Dec 22, 2021 4:00 PM",52,15,37,18,11,7,33,23,10,25,15,10,4,1,3,20,19,19,0,0,0,0,18,16,8,8,20,22,1,1,,,,,,
"Dec 22, 2021 5:00 PM",91,28,63,19,17,2,26,16,10,21,12,9,9,0,9,5,8,7,1,0,0,0,8,12,7,5,30,22,1,2,,,,,,
"Dec 22, 2021 6:00 PM",68,29,39,13,8,5,25,18,7,22,10,12,5,2,3,12,10,9,1,0,0,0,8,11,8,3,21,17,1,2,,,,,,
"Dec 22, 2021 7:00 PM",35,14,21,10,10,0,11,9,2,13,10,3,4,1,3,7,6,6,0,0,0,0,7,8,4,4,9,6,2,1,,,,,,
"Dec 22, 2021 8:00 PM",29,14,15,3,1,2,7,3,4,7,2,5,3,0,3,8,11,11,0,0,0,0,10,3,2,1,9,10,0,0,,,,,,
"Dec 22, 2021 9:00 PM",21,6,15,1,1,0,7,5,2,4,3,1,3,3,0,7,4,4,0,0,0,0,4,2,2,0,4,6,1,1,,,,,,
"Dec 22, 2021 10:00 PM",9,1,8,4,2,2,7,4,3,5,2,3,2,2,0,4,6,5,1,0,0,0,6,0,0,0,4,2,1,0,,,,,,
"Dec 22, 2021 11:00 PM",9,4,5,1,0,1,5,1,4,5,1,4,0,0,0,1,5,5,0,0,0,0,5,1,0,1,2,3,0,0,,,,,,
"Dec 23, 2021 12:00 AM",5,1,4,0,0,0,0,0,0,0,0,0,1,0,1,1,1,1,0,0,0,0,1,0,0,0,3,1,1,1,,,,,,
"Dec 23, 2021 1:00 AM",4,2,2,0,0,0,0,0,0,0,0,0,0,0,0,1,1,1,0,0,0,0,1,0,0,0,1,0,0,0,,,,,,
"Dec 23, 2021 2:00 AM",7,6,1,0,0,0,0,0,0,0,0,0,0,0,0,0,1,0,1,0,0,0,0,0,0,0,0,0,0,0,,,,,,
"Dec 23, 2021 3:00 AM",0,0,0,0,0,0,0,0,0,0,0,0,0,0,0,0,0,0,0,0,0,0,0,0,0,0,0,0,0,0,,,,,,
"Dec 23, 2021 4:00 AM",1,1,0,0,0,0,1,0,1,0,0,0,0,0,0,0,0,0,0,0,0,0,0,0,0,0,1,1,0,0,,,,,,
"Dec 23, 2021 5:00 AM",0,0,0,2,1,1,4,2,2,1,1,0,0,0,0,0,2,2,0,0,0,0,2,2,1,1,2,4,0,0,,,,,,
"Dec 23, 2021 6:00 AM",17,11,6,6,2,4,10,3,7,8,4,4,1,1,0,3,8,8,0,0,0,0,8,3,2,1,5,14,0,1,,,,,,
"Dec 23, 2021 7:00 AM",26,12,14,11,4,7,14,4,10,18,8,10,1,0,1,7,12,12,0,0,0,0,13,5,1,4,13,32,1,4,,,,,,
"Dec 23, 2021 8:00 AM",49,25,24,35,21,14,40,21,19,37,24,13,7,4,3,4,28,28,0,0,0,0,29,14,8,6,19,33,1,0,,,,,,
"Dec 23, 2021 9:00 AM",38,28,10,39,17,22,40,25,15,39,23,16,5,4,1,9,15,15,0,0,0,0,15,14,9,5,13,14,2,1,,,,,,
"Dec 23, 2021 10:00 AM",43,22,21,50,26,24,40,22,18,40,23,17,6,3,3,6,17,16,1,0,0,0,16,27,18,9,15,12,4,3,,,,,,
"Dec 23, 2021 11:00 AM",41,17,24,67,33,34,75,46,29,66,39,27,13,7,6,13,17,13,4,0,0,0,11,23,19,4,18,26,1,2,,,,,,
"Dec 23, 2021 12:00 PM",49,26,23,62,27,35,90,49,41,70,32,38,15,7,8,18,28,27,1,0,0,0,22,33,20,13,26,32,5,3,,,,,,
"Dec 23, 2021 1:00 PM",49,34,15,69,34,35,99,51,48,80,37,43,30,19,11,26,26,23,3,0,0,0,24,42,24,18,26,27,5,2,,,,,,
"Dec 23, 2021 2:00 PM",61,33,28,142,77,65,145,70,75,107,62,45,34,21,13,24,21,20,1,0,0,0,22,63,38,25,26,26,1,2,,,,,,
"Dec 23, 2021 3:00 PM",60,27,33,100,51,49,111,67,44,88,54,34,23,8,15,32,16,16,0,0,0,0,12,48,28,20,16,34,4,1,,,,,,
"Dec 23, 2021 4:00 PM",65,25,40,69,31,38,81,34,47,65,30,35,26,16,10,19,19,18,1,0,0,0,18,30,18,12,22,26,3,2,,,,,,
"Dec 23, 2021 5:00 PM",53,18,35,20,9,11,39,20,19,37,22,15,14,6,8,17,13,12,1,0,0,0,11,21,13,8,21,19,4,0,,,,,,
"Dec 23, 2021 6:00 PM",35,10,25,16,9,7,23,13,10,25,11,14,4,1,3,17,4,4,0,0,0,0,3,14,9,5,24,12,1,1,,,,,,
"Dec 23, 2021 7:00 PM",27,11,16,19,14,5,19,12,7,21,12,9,1,0,1,6,6,6,0,0,0,0,7,5,3,2,7,11,2,1,,,,,,
"Dec 23, 2021 8:00 PM",25,10,15,13,9,4,16,8,8,20,7,13,11,3,8,15,9,8,1,0,0,0,8,8,6,2,6,12,2,2,,,,,,
"Dec 23, 2021 9:00 PM",14,4,10,6,2,4,11,4,7,9,3,6,1,0,1,8,3,3,0,0,0,0,3,1,0,1,9,12,1,0,,,,,,
"Dec 23, 2021 10:00 PM",14,7,7,1,1,0,7,2,5,3,1,2,1,1,0,3,6,5,1,0,0,0,5,1,1,0,7,4,0,0,,,,,,
"Dec 23, 2021 11:00 PM",7,1,6,2,0,2,3,0,3,1,0,1,2,1,1,3,3,3,0,0,0,0,2,2,1,1,3,7,1,0,,,,,,
"Dec 24, 2021 12:00 AM",5,4,1,0,0,0,1,0,1,3,1,2,0,0,0,0,2,2,0,0,0,0,2,0,0,0,1,4,0,1,,,,,,
"Dec 24, 2021 1:00 AM",3,0,3,1,1,0,0,0,0,0,0,0,0,0,0,1,0,0,0,0,0,0,0,1,1,0,1,1,0,0,,,,,,
"Dec 24, 2021 2:00 AM",5,4,1,0,0,0,0,0,0,0,0,0,0,0,0,0,0,0,0,0,0,0,0,0,0,0,0,1,0,0,,,,,,
"Dec 24, 2021 3:00 AM",0,0,0,1,1,0,2,1,1,1,1,0,0,0,0,0,0,0,0,0,0,0,1,0,0,0,1,1,0,0,,,,,,
"Dec 24, 2021 4:00 AM",1,1,0,1,1,0,2,1,1,1,1,0,0,0,0,0,0,0,0,0,0,0,0,0,0,0,0,0,0,0,,,,,,
"Dec 24, 2021 5:00 AM",2,1,1,0,0,0,0,0,0,0,0,0,0,0,0,0,1,1,0,0,0,0,2,0,0,0,1,3,1,0,,,,,,
"Dec 24, 2021 6:00 AM",9,6,3,7,3,4,10,4,6,8,2,6,1,0,1,2,4,4,0,0,0,0,4,1,0,1,3,7,2,0,,,,,,
"Dec 24, 2021 7:00 AM",17,10,7,31,17,14,27,16,11,28,16,12,0,0,0,6,4,4,0,0,0,0,4,2,1,1,8,17,0,1,,,,,,
"Dec 24, 2021 8:00 AM",26,9,17,34,20,14,27,16,11,32,22,10,5,3,2,11,13,13,0,0,0,0,12,11,7,4,11,17,3,0,,,,,,
"Dec 24, 2021 9:00 AM",20,14,6,52,34,18,49,35,14,51,36,15,2,2,0,4,9,9,0,0,0,0,7,13,11,2,13,15,2,3,,,,,,
"Dec 24, 2021 10:00 AM",32,14,18,90,32,58,59,26,33,56,25,31,10,4,6,7,9,8,1,0,0,0,15,14,5,9,15,19,1,3,,,,,,
"Dec 24, 2021 11:00 AM",38,19,19,54,24,30,55,27,28,44,20,24,6,4,2,10,10,9,1,0,0,0,8,14,8,6,10,24,4,2,,,,,,
"Dec 24, 2021 12:00 PM",22,6,16,43,23,20,61,31,30,41,20,21,13,6,7,13,11,11,0,0,0,0,10,17,10,7,13,11,3,2,,,,,,
"Dec 24, 2021 1:00 PM",31,11,20,28,15,13,34,20,14,25,15,10,5,3,2,14,5,5,0,0,0,0,9,11,8,3,15,18,2,1,,,,,,
"Dec 24, 2021 2:00 PM",32,15,17,21,8,13,42,18,24,25,9,16,15,5,10,10,14,12,2,0,0,0,12,18,11,7,12,12,3,4,,,,,,
"Dec 24, 2021 3:00 PM",25,12,13,24,16,8,31,15,16,14,8,6,6,1,5,6,9,9,0,0,0,0,8,10,4,6,13,11,0,0,,,,,,
"Dec 24, 2021 4:00 PM",21,8,13,4,1,3,16,6,10,9,4,5,3,2,1,10,7,7,0,0,0,0,6,5,2,3,9,11,2,1,,,,,,
"Dec 24, 2021 5:00 PM",16,10,6,9,8,1,17,7,10,5,4,1,4,2,2,5,5,4,1,0,0,0,4,6,3,3,5,4,0,0,,,,,,
"Dec 24, 2021 6:00 PM",14,5,9,2,2,0,10,8,2,5,4,1,2,2,0,6,0,0,0,0,0,0,0,4,2,2,3,4,0,0,,,,,,
"Dec 24, 2021 7:00 PM",10,4,6,2,1,1,10,4,6,10,6,4,0,0,0,3,2,2,0,0,0,0,2,0,0,0,4,2,1,2,,,,,,
"Dec 24, 2021 8:00 PM",8,4,4,4,2,2,4,1,3,4,2,2,1,1,0,3,3,3,0,0,0,0,3,2,2,0,2,5,0,1,,,,,,
"Dec 24, 2021 9:00 PM",5,2,3,6,4,2,4,3,1,1,0,1,0,0,0,3,6,5,1,0,0,0,5,2,2,0,2,3,1,1,,,,,,
"Dec 24, 2021 10:00 PM",4,2,2,1,0,1,4,0,4,6,1,5,0,0,0,1,1,1,0,0,0,0,1,2,0,2,1,2,0,0,,,,,,
"Dec 24, 2021 11:00 PM",3,1,2,1,0,1,1,1,0,3,2,1,1,1,0,0,2,2,0,0,0,0,1,2,1,1,0,0,0,0,,,,,,
"Dec 25, 2021 12:00 AM",3,2,1,0,0,0,0,0,0,0,0,0,0,0,0,1,2,2,0,0,0,0,3,0,0,0,3,3,0,1,,,,,,
"Dec 25, 2021 1:00 AM",2,0,2,1,1,0,3,1,2,0,0,0,2,1,1,0,0,0,0,0,0,0,0,0,0,0,0,2,0,0,,,,,,
"Dec 25, 2021 2:00 AM",4,3,1,0,0,0,2,1,1,0,0,0,0,0,0,0,0,0,0,0,0,0,0,0,0,0,0,0,0,0,,,,,,
"Dec 25, 2021 3:00 AM",2,0,2,0,0,0,0,0,0,0,0,0,0,0,0,0,0,0,0,0,0,0,0,0,0,0,0,1,0,0,,,,,,
"Dec 25, 2021 4:00 AM",0,0,0,0,0,0,0,0,0,0,0,0,0,0,0,0,0,0,0,0,0,0,0,0,0,0,0,0,0,0,,,,,,
"Dec 25, 2021 5:00 AM",0,0,0,0,0,0,0,0,0,0,0,0,0,0,0,0,0,0,0,0,0,0,0,0,0,0,0,0,0,0,,,,,,
"Dec 25, 2021 6:00 AM",1,0,1,0,0,0,0,0,0,0,0,0,0,0,0,0,0,0,0,0,0,0,0,0,0,0,1,1,0,0,,,,,,
"Dec 25, 2021 7:00 AM",3,0,3,0,0,0,2,1,1,1,0,1,0,0,0,0,1,1,0,0,0,0,1,0,0,0,0,3,1,2,,,,,,
"Dec 25, 2021 8:00 AM",1,0,1,7,5,2,6,5,1,5,5,0,2,2,0,1,1,1,0,0,0,0,2,3,3,0,2,1,0,0,,,,,,
"Dec 25, 2021 9:00 AM",5,3,2,6,4,2,3,0,3,1,0,1,0,0,0,0,2,1,1,0,0,0,1,0,0,0,1,2,0,1,,,,,,
"Dec 25, 2021 10:00 AM",6,1,5,7,3,4,10,6,4,8,5,3,1,1,0,0,1,1,0,0,0,0,1,3,2,1,2,0,0,0,,,,,,
"Dec 25, 2021 11:00 AM",6,4,2,6,3,3,8,4,4,5,3,2,2,0,2,1,2,2,0,0,0,0,2,4,1,3,2,5,0,1,,,,,,
"Dec 25, 2021 12:00 PM",3,1,2,7,4,3,12,5,7,4,1,3,5,3,2,2,1,1,0,0,0,0,2,3,0,3,2,3,0,0,,,,,,
"Dec 25, 2021 1:00 PM",2,1,1,2,0,2,3,1,2,3,0,3,0,0,0,2,1,1,0,0,0,0,1,0,0,0,1,4,1,0,,,,,,
"Dec 25, 2021 2:00 PM",5,1,4,0,0,0,2,0,2,5,2,3,5,3,2,1,2,2,0,0,0,0,1,1,0,1,3,2,1,0,,,,,,
"Dec 25, 2021 3:00 PM",3,1,2,1,0,1,4,3,1,2,1,1,0,0,0,0,3,3,0,0,0,0,3,3,2,1,0,1,0,0,,,,,,
"Dec 25, 2021 4:00 PM",1,0,1,0,0,0,3,0,3,0,0,0,2,0,2,0,0,0,0,0,0,0,0,3,0,3,0,1,0,0,,,,,,
"Dec 25, 2021 5:00 PM",3,2,1,0,0,0,1,1,0,1,1,0,0,0,0,0,1,1,0,0,0,0,0,0,0,0,1,0,0,0,,,,,,
"Dec 25, 2021 6:00 PM",3,2,1,0,0,0,0,0,0,0,0,0,0,0,0,0,0,0,0,0,0,0,0,0,0,0,0,2,0,0,,,,,,
"Dec 25, 2021 7:00 PM",3,2,1,0,0,0,0,0,0,0,0,0,0,0,0,0,3,2,1,0,0,0,1,0,0,0,2,1,1,0,,,,,,
"Dec 25, 2021 8:00 PM",4,2,2,0,0,0,0,0,0,0,0,0,1,0,1,0,1,1,0,0,0,0,1,0,0,0,1,0,0,0,,,,,,
"Dec 25, 2021 9:00 PM",2,2,0,1,0,1,2,1,1,3,1,2,0,0,0,0,1,1,0,0,0,0,1,1,1,0,2,0,0,0,,,,,,
"Dec 25, 2021 10:00 PM",1,1,0,4,2,2,1,1,0,2,2,0,2,0,2,6,4,4,0,0,0,0,4,2,2,0,1,1,0,0,,,,,,
"Dec 25, 2021 11:00 PM",1,0,1,0,0,0,2,1,1,1,1,0,0,0,0,0,3,3,0,0,0,0,3,2,1,1,0,0,0,0,,,,,,
"Dec 26, 2021 12:00 AM",1,1,0,0,0,0,0,0,0,2,1,1,0,0,0,0,2,0,2,0,0,0,0,0,0,0,0,0,0,1,,,,,,
"Dec 26, 2021 1:00 AM",0,0,0,2,0,2,0,0,0,0,0,0,0,0,0,0,0,0,0,0,0,0,0,1,0,1,0,0,0,0,,,,,,
"Dec 26, 2021 2:00 AM",1,1,0,0,0,0,0,0,0,0,0,0,0,0,0,0,0,0,0,0,0,0,0,0,0,0,0,0,0,0,,,,,,
"Dec 26, 2021 3:00 AM",0,0,0,0,0,0,0,0,0,0,0,0,0,0,0,0,0,0,0,0,0,0,0,0,0,0,0,0,0,0,,,,,,
"Dec 26, 2021 4:00 AM",0,0,0,0,0,0,0,0,0,0,0,0,0,0,0,0,0,0,0,0,0,0,0,0,0,0,0,0,0,0,,,,,,
"Dec 26, 2021 5:00 AM",0,0,0,0,0,0,4,1,3,1,0,1,0,0,0,0,2,2,0,0,0,0,2,0,0,0,0,0,0,0,0,0,0,,,
"Dec 26, 2021 6:00 AM",4,1,3,2,1,1,2,1,1,2,1,1,0,0,0,0,0,0,0,0,0,0,0,0,0,0,0,0,0,0,0,0,0,,,
"Dec 26, 2021 7:00 AM",9,1,8,1,1,0,4,4,0,2,1,1,0,0,0,1,1,1,0,0,0,0,1,3,1,2,1,0,0,0,0,0,0,,,
"Dec 26, 2021 8:00 AM",6,2,4,14,8,6,16,10,6,14,9,5,2,0,2,0,1,1,0,0,0,0,1,4,2,2,7,0,2,2,0,0,0,,,
"Dec 26, 2021 9:00 AM",17,10,7,33,20,13,36,24,12,36,22,14,2,1,1,1,6,5,1,0,0,0,7,7,2,5,10,1,1,3,0,0,0,,,
"Dec 26, 2021 10:00 AM",10,4,6,93,48,45,64,33,31,73,43,30,2,0,2,11,15,15,0,0,0,0,16,26,16,10,15,0,0,1,0,0,0,,,
"Dec 26, 2021 11:00 AM",35,18,17,117,74,43,111,76,35,108,73,35,10,5,5,54,15,12,3,0,0,0,9,37,31,6,30,13,8,3,0,0,0,,,
"Dec 26, 2021 12:00 PM",30,15,15,167,80,87,156,85,71,154,80,74,21,14,7,30,20,20,0,0,0,0,22,49,26,23,28,36,4,8,0,0,0,,,
"Dec 26, 2021 1:00 PM",48,25,23,149,79,70,177,91,86,139,77,62,27,16,11,12,12,8,4,0,0,0,9,72,35,37,23,35,6,5,0,0,0,,,
"Dec 26, 2021 2:00 PM",36,17,19,147,59,88,136,71,65,117,54,63,28,12,16,34,14,13,1,0,0,0,11,43,26,17,30,23,3,4,0,0,0,,,
"Dec 26, 2021 3:00 PM",41,19,22,125,66,59,145,58,87,118,54,64,16,9,7,17,10,10,0,0,0,0,9,63,28,35,17,34,6,1,0,0,0,,,
"Dec 26, 2021 4:00 PM",28,14,14,69,27,42,95,40,55,76,32,44,15,5,10,14,17,16,1,0,0,0,14,44,13,31,11,24,2,2,0,0,0,,,
"Dec 26, 2021 5:00 PM",18,8,10,27,10,17,25,8,17,28,14,14,4,2,2,13,9,8,1,0,0,0,8,10,7,3,7,15,3,0,0,0,0,,,
"Dec 26, 2021 6:00 PM",11,6,5,13,8,5,16,9,7,17,9,8,4,1,3,2,1,1,0,0,0,0,1,8,4,4,5,5,2,1,0,0,0,,,
"Dec 26, 2021 7:00 PM",13,10,3,8,8,0,16,10,6,12,9,3,4,2,2,5,6,6,0,0,0,0,4,2,0,2,10,6,5,1,0,0,0,,,
"Dec 26, 2021 8:00 PM",10,7,3,5,2,3,10,3,7,15,3,12,3,3,0,2,4,4,0,0,0,0,4,0,0,0,8,5,0,0,0,0,0,,,
"Dec 26, 2021 9:00 PM",11,5,6,9,4,5,11,7,4,3,0,3,1,0,1,2,2,2,0,0,0,0,2,3,2,1,4,3,0,2,0,0,0,,,
"Dec 26, 2021 10:00 PM",3,2,1,4,3,1,7,0,7,2,0,2,0,0,0,2,1,1,0,0,0,0,1,1,0,1,2,4,0,1,0,0,0,,,
"Dec 26, 2021 11:00 PM",4,2,2,0,0,0,3,1,2,2,1,1,0,0,0,2,1,1,0,0,0,0,1,0,0,0,0,1,0,1,0,0,0,,,
"Dec 27, 2021 12:00 AM",1,0,1,0,0,0,0,0,0,0,0,0,2,2,0,0,0,0,0,0,0,0,0,0,0,0,0,0,0,1,,,,,,
"Dec 27, 2021 1:00 AM",0,0,0,1,0,1,0,0,0,0,0,0,0,0,0,0,0,0,0,0,0,0,0,0,0,0,1,0,0,0,,,,,,
"Dec 27, 2021 2:00 AM",0,0,0,0,0,0,0,0,0,1,0,1,0,0,0,0,0,0,0,0,0,0,0,0,0,0,1,0,0,0,,,,,,
"Dec 27, 2021 3:00 AM",1,1,0,1,1,0,1,1,0,1,1,0,0,0,0,1,0,0,0,0,0,0,1,0,0,0,0,0,0,0,,,,,,
"Dec 27, 2021 4:00 AM",0,0,0,0,0,0,0,0,0,0,0,0,0,0,0,0,0,0,0,0,0,0,0,0,0,0,0,1,0,0,,,,,,
"Dec 27, 2021 5:00 AM",1,0,1,0,0,0,2,1,1,1,0,1,0,0,0,0,2,2,0,0,0,0,2,0,0,0,0,1,0,0,,,,,,
"Dec 27, 2021 6:00 AM",4,1,3,5,3,2,6,2,4,6,2,4,1,1,0,1,1,0,1,0,0,0,0,0,0,0,1,5,1,0,,,,,,
"Dec 27, 2021 7:00 AM",12,3,9,6,2,4,10,4,6,11,5,6,0,0,0,3,4,4,0,0,0,0,4,3,2,1,4,14,0,1,,,,,,
"Dec 27, 2021 8:00 AM",10,3,7,10,4,6,21,15,6,13,10,3,8,0,8,0,5,5,0,0,0,0,5,2,2,0,12,4,1,0,,,,,,
"Dec 27, 2021 9:00 AM",21,9,12,30,17,13,28,16,12,25,17,8,1,0,1,6,4,4,0,0,0,0,4,9,5,4,9,11,1,6,,,,,,
"Dec 27, 2021 10:00 AM",12,8,4,87,41,46,62,34,28,66,33,33,19,9,10,8,9,8,1,0,0,0,8,25,17,8,13,18,3,1,,,,,,
"Dec 27, 2021 11:00 AM",37,17,20,71,44,27,88,53,35,77,49,28,10,5,5,6,21,20,1,0,0,0,17,39,20,19,15,23,0,4,,,,,,
"Dec 27, 2021 12:00 PM",36,20,16,119,47,72,81,41,40,79,35,44,18,10,8,13,13,13,0,0,0,0,13,34,23,11,10,26,2,5,,,,,,
"Dec 27, 2021 1:00 PM",33,16,17,98,55,43,56,28,28,66,42,24,18,12,6,19,14,13,1,0,0,0,11,33,19,14,12,26,3,4,,,,,,
"Dec 27, 2021 2:00 PM",38,13,25,69,38,31,91,52,39,76,48,28,6,5,1,79,17,15,2,0,0,0,16,44,30,14,24,21,4,4,,,,,,
"Dec 27, 2021 3:00 PM",55,32,23,106,54,52,102,49,53,85,37,48,8,3,5,21,27,25,2,0,0,0,26,51,26,25,29,34,7,2,,,,,,
"Dec 27, 2021 4:00 PM",27,12,15,54,29,25,71,37,34,43,21,22,9,5,4,11,14,13,1,0,0,0,9,24,8,16,17,17,2,3,,,,,,
"Dec 27, 2021 5:00 PM",28,11,17,13,8,5,18,11,7,14,8,6,10,3,7,12,6,6,0,0,0,0,7,14,6,8,16,11,0,0,,,,,,
"Dec 27, 2021 6:00 PM",21,8,13,13,7,6,15,6,9,15,6,9,2,1,1,5,3,3,0,0,0,0,3,7,5,2,6,11,0,0,,,,,,
"Dec 27, 2021 7:00 PM",8,3,5,6,2,4,16,9,7,11,7,4,9,4,5,10,6,6,0,0,0,0,6,0,0,0,5,6,1,1,,,,,,
"Dec 27, 2021 8:00 PM",22,7,15,6,6,0,7,5,2,8,7,1,8,4,4,6,5,5,0,0,0,0,5,5,3,2,2,4,1,1,,,,,,
"Dec 27, 2021 9:00 PM",10,4,6,3,0,3,3,0,3,4,0,4,0,0,0,1,2,2,0,0,0,0,2,1,1,0,5,4,0,0,,,,,,
"Dec 27, 2021 10:00 PM",12,5,7,3,2,1,5,3,2,9,4,5,0,0,0,4,1,1,0,0,0,0,0,1,0,1,2,7,0,0,,,,,,
"Dec 27, 2021 11:00 PM",1,1,0,1,1,0,2,1,1,1,1,0,1,0,1,2,1,1,0,0,0,0,1,1,1,0,0,1,0,0,,,,,,
"Dec 28, 2021 12:00 AM",1,1,0,0,0,0,0,0,0,0,0,0,1,1,0,2,0,0,0,0,0,0,0,1,0,1,1,0,1,0,,,,,,
"Dec 28, 2021 1:00 AM",3,3,0,1,1,0,2,1,1,1,1,0,0,0,0,0,0,0,0,0,0,0,0,0,0,0,3,0,0,0,,,,,,
"Dec 28, 2021 2:00 AM",5,5,0,0,0,0,0,0,0,0,0,0,0,0,0,0,0,0,0,0,0,0,0,0,0,0,0,0,0,0,,,,,,
"Dec 28, 2021 3:00 AM",0,0,0,0,0,0,0,0,0,0,0,0,0,0,0,0,1,1,0,0,0,0,1,0,0,0,0,0,0,0,,,,,,
"Dec 28, 2021 4:00 AM",1,1,0,0,0,0,0,0,0,0,0,0,0,0,0,0,1,1,0,0,0,0,0,0,0,0,0,0,0,0,,,,,,
"Dec 28, 2021 5:00 AM",2,0,2,0,0,0,1,0,1,1,0,1,0,0,0,0,2,2,0,0,0,0,2,0,0,0,0,0,0,0,,,,,,
"Dec 28, 2021 6:00 AM",1,0,1,0,0,0,2,1,1,1,1,0,0,0,0,0,0,0,0,0,0,0,0,0,0,0,2,2,1,0,,,,,,
"Dec 28, 2021 7:00 AM",8,4,4,9,4,5,9,6,3,7,3,4,0,0,0,2,4,4,0,0,0,0,4,1,0,1,3,12,0,1,,,,,,
"Dec 28, 2021 8:00 AM",4,1,3,8,4,4,11,8,3,10,5,5,4,0,4,2,5,5,0,0,0,0,5,1,1,0,7,8,0,1,,,,,,
"Dec 28, 2021 9:00 AM",27,10,17,25,17,8,37,27,10,27,21,6,10,7,3,2,6,6,0,0,0,0,8,14,8,6,11,19,1,7,,,,,,
"Dec 28, 2021 10:00 AM",21,10,11,60,35,25,69,34,35,62,30,32,7,5,2,10,19,19,0,0,0,0,18,24,10,14,15,14,1,4,,,,,,
"Dec 28, 2021 11:00 AM",37,23,14,112,52,60,65,30,35,78,43,35,7,6,1,8,15,14,1,0,0,0,14,33,17,16,13,26,3,5,,,,,,
"Dec 28, 2021 12:00 PM",52,29,23,107,68,39,91,61,30,98,64,34,14,7,7,16,19,18,1,0,0,0,22,35,22,13,25,25,5,6,,,,,,
"Dec 28, 2021 1:00 PM",41,22,19,128,63,65,103,56,47,109,58,51,25,12,13,14,16,16,0,0,0,0,17,67,41,26,22,27,6,2,,,,,,
"Dec 28, 2021 2:00 PM",42,18,24,124,69,55,126,68,58,114,65,49,31,18,13,33,24,19,5,0,0,0,19,40,24,16,22,25,7,4,,,,,,
"Dec 28, 2021 3:00 PM",56,27,29,112,53,59,123,47,76,93,44,49,28,19,9,27,14,14,0,0,0,0,13,42,12,30,25,36,4,0,,,,,,
"Dec 28, 2021 4:00 PM",45,18,27,50,25,25,71,25,46,62,28,34,20,11,9,14,9,9,0,0,0,0,8,29,17,12,16,27,3,1,,,,,,
"Dec 28, 2021 5:00 PM",42,16,26,29,13,16,39,19,20,32,15,17,21,6,15,9,7,7,0,0,0,0,8,16,8,8,11,13,0,0,,,,,,
"Dec 28, 2021 6:00 PM",26,10,16,10,7,3,17,9,8,8,3,5,1,1,0,5,11,10,1,0,0,0,11,5,2,3,8,6,6,2,,,,,,
"Dec 28, 2021 7:00 PM",18,9,9,3,1,2,3,1,2,3,1,2,4,0,4,11,6,6,0,0,0,0,5,1,0,1,11,5,1,1,,,,,,
"Dec 28, 2021 8:00 PM",19,8,11,11,9,2,11,5,6,10,6,4,8,4,4,1,5,5,0,0,0,0,5,4,3,1,3,3,1,0,,,,,,
"Dec 28, 2021 9:00 PM",13,5,8,5,3,2,10,4,6,10,3,7,1,0,1,3,5,5,0,0,0,0,5,3,3,0,1,7,3,0,,,,,,
"Dec 28, 2021 10:00 PM",9,3,6,6,4,2,9,7,2,2,1,1,0,0,0,5,2,1,1,0,0,0,1,2,0,2,2,5,0,0,,,,,,
"Dec 28, 2021 11:00 PM",2,1,1,3,0,3,9,0,9,4,0,4,0,0,0,4,0,0,0,0,0,0,0,0,0,0,1,2,0,0,,,,,,
"Dec 29, 2021 12:00 AM",0,0,0,0,0,0,0,0,0,2,1,1,0,0,0,0,1,0,1,0,0,0,0,7,0,7,3,1,0,0,,,,,,
"Dec 29, 2021 1:00 AM",1,0,1,1,0,1,0,0,0,1,0,1,0,0,0,1,0,0,0,0,0,0,0,0,0,0,0,2,1,0,,,,,,
"Dec 29, 2021 2:00 AM",5,5,0,2,2,0,0,0,0,2,2,0,0,0,0,0,0,0,0,0,0,0,0,0,0,0,0,0,0,1,,,,,,
"Dec 29, 2021 3:00 AM",1,0,1,0,0,0,0,0,0,0,0,0,0,0,0,0,0,0,0,0,0,0,0,0,0,0,0,0,0,0,,,,,,
"Dec 29, 2021 4:00 AM",2,1,1,0,0,0,0,0,0,0,0,0,0,0,0,0,1,1,0,0,0,0,1,0,0,0,0,0,0,0,,,,,,
"Dec 29, 2021 5:00 AM",2,0,2,0,0,0,1,0,1,0,0,0,0,0,0,0,3,3,0,0,0,0,3,0,0,0,1,2,0,0,,,,,,
"Dec 29, 2021 6:00 AM",5,3,2,1,0,1,6,2,4,3,1,2,2,2,0,2,4,4,0,0,0,0,3,2,2,0,2,9,0,1,,,,,,
"Dec 29, 2021 7:00 AM",20,13,7,7,4,3,13,5,8,14,8,6,4,1,3,4,2,2,0,0,0,0,3,6,4,2,5,18,0,0,,,,,,
"Dec 29, 2021 8:00 AM",17,11,6,12,7,5,12,9,3,13,7,6,7,6,1,3,13,12,1,0,0,0,12,3,2,1,9,8,1,2,,,,,,
"Dec 29, 2021 9:00 AM",19,8,11,19,11,8,29,17,12,25,10,15,9,5,4,2,9,9,0,0,0,0,8,12,7,5,5,17,2,3,,,,,,
"Dec 29, 2021 10:00 AM",24,15,9,28,16,12,45,25,20,27,15,12,13,8,5,4,11,11,0,0,0,0,10,10,7,3,3,3,2,2,,,,,,
"Dec 29, 2021 11:00 AM",19,10,9,30,16,14,28,15,13,32,17,15,13,5,8,8,15,13,2,0,0,0,11,16,11,5,7,19,1,2,,,,,,
"Dec 29, 2021 12:00 PM",29,15,14,42,25,17,41,30,11,35,22,13,10,3,7,13,4,4,0,0,0,0,3,23,15,8,14,18,0,0,,,,,,
"Dec 29, 2021 1:00 PM",24,10,14,42,17,25,38,21,17,30,16,14,10,6,4,11,9,8,1,0,0,0,8,18,9,9,13,15,1,1,,,,,,
"Dec 29, 2021 2:00 PM",31,19,12,63,37,26,58,40,18,61,43,18,12,6,6,15,10,10,0,0,0,0,11,29,21,8,18,15,3,3,,,,,,
"Dec 29, 2021 3:00 PM",29,17,12,69,33,36,55,26,29,46,23,23,19,15,4,20,16,15,1,0,0,0,14,28,15,13,19,19,1,2,,,,,,
"Dec 29, 2021 4:00 PM",27,14,13,55,19,36,56,21,35,43,13,30,20,12,8,20,21,17,4,0,0,0,14,27,12,15,10,21,4,1,,,,,,
"Dec 29, 2021 5:00 PM",45,14,31,25,17,8,43,24,19,28,20,8,13,1,12,9,10,9,1,0,0,0,11,18,11,7,22,29,2,0,,,,,,
"Dec 29, 2021 6:00 PM",30,14,16,14,5,9,26,14,12,17,6,11,13,4,9,3,6,6,0,0,0,0,7,7,4,3,15,7,5,6,,,,,,
"Dec 29, 2021 7:00 PM",17,8,9,11,9,2,17,9,8,14,6,8,3,3,0,6,6,6,0,0,0,0,6,7,3,4,13,10,1,3,,,,,,
"Dec 29, 2021 8:00 PM",25,11,14,3,2,1,13,4,9,8,4,4,2,0,2,2,8,7,1,0,0,0,10,3,3,0,8,8,0,0,,,,,,
"Dec 29, 2021 9:00 PM",18,6,12,8,4,4,11,8,3,9,4,5,3,1,2,4,4,4,0,0,0,0,5,0,0,0,5,7,1,0,,,,,,
"Dec 29, 2021 10:00 PM",12,3,9,4,3,1,5,2,3,4,2,2,1,0,1,4,4,4,0,0,0,0,3,5,1,4,5,4,2,0,,,,,,
"Dec 29, 2021 11:00 PM",5,0,5,5,1,4,3,2,1,2,1,1,1,0,1,0,3,3,0,0,0,0,3,2,0,2,2,1,1,1,,,,,,
"Dec 30, 2021 12:00 AM",2,1,1,0,0,0,0,0,0,3,1,2,2,0,2,0,0,0,0,0,0,0,0,0,0,0,1,0,0,1,,,,,,
"Dec 30, 2021 1:00 AM",3,2,1,1,0,1,0,0,0,1,0,1,1,1,0,2,0,0,0,0,0,0,0,0,0,0,0,0,0,0,,,,,,
"Dec 30, 2021 2:00 AM",8,5,3,3,2,1,1,1,0,3,2,1,0,0,0,0,0,0,0,0,0,0,0,0,0,0,0,1,1,0,,,,,,
"Dec 30, 2021 3:00 AM",2,1,1,0,0,0,0,0,0,0,0,0,1,1,0,0,0,0,0,0,0,0,0,0,0,0,1,0,0,0,,,,,,
"Dec 30, 2021 4:00 AM",0,0,0,0,0,0,0,0,0,0,0,0,0,0,0,0,0,0,0,0,0,0,0,0,0,0,0,0,0,0,,,,,,
"Dec 30, 2021 5:00 AM",2,2,0,0,0,0,1,0,1,0,0,0,0,0,0,0,2,2,0,0,0,0,2,0,0,0,1,4,0,0,,,,,,
"Dec 30, 2021 6:00 AM",8,3,5,2,0,2,5,2,3,4,1,3,0,0,0,2,1,1,0,0,0,0,1,0,0,0,5,3,0,0,,,,,,
"Dec 30, 2021 7:00 AM",13,11,2,8,3,5,15,7,8,15,8,7,2,2,0,4,13,12,1,0,0,0,13,4,2,2,9,9,2,1,,,,,,
"Dec 30, 2021 8:00 AM",21,6,15,29,23,6,31,23,8,23,19,4,5,2,3,6,8,8,0,0,0,0,7,6,3,3,15,10,1,2,,,,,,
"Dec 30, 2021 9:00 AM",21,8,13,61,38,23,55,35,20,42,27,15,9,8,1,11,13,13,0,0,0,0,11,21,13,8,14,18,2,5,,,,,,
"Dec 30, 2021 10:00 AM",34,11,23,85,41,44,105,62,43,78,49,29,14,9,5,8,14,12,2,0,0,0,11,37,22,15,21,17,1,4,,,,,,
"Dec 30, 2021 11:00 AM",41,21,20,99,52,47,105,56,49,93,50,43,21,15,6,4,20,19,1,0,0,0,12,29,20,9,23,27,3,5,,,,,,
"Dec 30, 2021 12:00 PM",32,18,14,88,40,48,84,36,48,75,36,39,13,4,9,20,11,9,2,0,0,0,9,33,13,20,14,36,7,4,,,,,,
"Dec 30, 2021 1:00 PM",31,18,13,61,31,30,52,15,37,55,20,35,15,6,9,14,10,8,2,0,0,0,5,28,8,20,14,17,2,1,,,,,,
"Dec 30, 2021 2:00 PM",31,13,18,8,5,3,23,12,11,16,7,9,3,0,3,7,6,6,0,0,0,0,8,8,3,5,13,6,1,1,,,,,,
"Dec 30, 2021 3:00 PM",31,18,13,14,8,6,13,7,6,8,5,3,5,5,0,8,8,8,0,0,0,0,7,3,3,0,9,14,0,3,,,,,,
"Dec 30, 2021 4:00 PM",25,8,17,15,6,9,13,4,9,8,2,6,6,1,5,10,7,7,0,0,0,0,7,11,4,7,11,4,1,0,,,,,,
"Dec 30, 2021 5:00 PM",28,7,21,5,5,0,9,4,5,8,3,5,1,0,1,5,5,4,1,0,0,0,3,3,3,0,7,9,3,0,,,,,,
"Dec 30, 2021 6:00 PM",22,7,15,10,7,3,10,6,4,12,8,4,1,0,1,5,5,5,0,0,0,0,5,1,1,0,6,6,2,1,,,,,,
"Dec 30, 2021 7:00 PM",13,7,6,1,1,0,5,3,2,7,4,3,1,1,0,0,2,1,1,0,0,0,1,6,4,2,4,5,1,0,,,,,,
"Dec 30, 2021 8:00 PM",9,5,4,0,0,0,6,3,3,2,1,1,1,0,1,0,5,4,1,0,0,0,3,1,1,0,6,9,0,0,,,,,,
"Dec 30, 2021 9:00 PM",10,5,5,5,4,1,7,5,2,2,2,0,2,0,2,1,7,6,1,0,0,0,5,2,1,1,4,4,1,0,,,,,,
"Dec 30, 2021 10:00 PM",7,3,4,1,1,0,2,0,2,5,1,4,0,0,0,3,4,3,1,0,0,0,5,1,0,1,1,4,0,0,,,,,,
"Dec 30, 2021 11:00 PM",4,1,3,1,1,0,0,0,0,0,0,0,1,0,1,1,2,2,0,0,0,0,2,0,0,0,1,0,0,0,,,,,,
"Dec 31, 2021 12:00 AM",4,2,2,0,0,0,0,0,0,0,0,0,0,0,0,1,0,0,0,0,0,0,0,0,0,0,1,0,0,0,,,,,,
"Dec 31, 2021 1:00 AM",2,2,0,0,0,0,0,0,0,1,0,1,0,0,0,0,0,0,0,0,0,0,0,2,0,2,0,1,0,1,,,,,,
"Dec 31, 2021 2:00 AM",5,4,1,0,0,0,1,0,1,0,0,0,0,0,0,0,0,0,0,0,0,0,0,0,0,0,0,1,0,0,,,,,,
"Dec 31, 2021 3:00 AM",2,0,2,0,0,0,0,0,0,0,0,0,0,0,0,0,0,0,0,0,0,0,1,0,0,0,0,0,0,0,,,,,,
"Dec 31, 2021 4:00 AM",1,1,0,0,0,0,0,0,0,0,0,0,0,0,0,0,0,0,0,0,0,0,0,0,0,0,0,0,0,0,,,,,,
"Dec 31, 2021 5:00 AM",1,1,0,0,0,0,2,0,2,1,0,1,0,0,0,0,1,1,0,0,0,0,1,0,0,0,2,4,0,0,,,,,,
"Dec 31, 2021 6:00 AM",8,4,4,2,0,2,7,3,4,5,3,2,0,0,0,3,3,2,1,0,0,0,2,0,0,0,2,7,2,1,,,,,,
"Dec 31, 2021 7:00 AM",16,10,6,11,5,6,7,4,3,8,5,3,0,0,0,2,10,10,0,0,0,0,10,5,4,1,7,12,0,2,,,,,,
"Dec 31, 2021 8:00 AM",28,16,12,19,13,6,21,14,7,26,18,8,10,5,5,8,11,11,0,0,0,0,11,9,6,3,11,8,1,0,,,,,,
"Dec 31, 2021 9:00 AM",25,14,11,48,28,20,66,44,22,37,26,11,3,3,0,5,15,15,0,0,0,0,15,26,13,13,16,19,4,4,,,,,,
"Dec 31, 2021 10:00 AM",28,6,22,86,47,39,106,67,39,74,39,35,12,8,4,6,16,16,0,0,0,0,11,38,22,16,25,14,3,2,,,,,,
"Dec 31, 2021 11:00 AM",36,16,20,117,53,64,106,52,54,106,47,59,19,11,8,16,17,16,1,0,0,0,22,38,19,19,25,32,3,5,,,,,,
"Dec 31, 2021 12:00 PM",45,25,20,137,74,63,162,78,84,129,62,67,26,16,10,24,22,22,0,0,0,0,23,37,23,14,25,31,7,5,,,,,,
"Dec 31, 2021 1:00 PM",63,35,28,159,84,75,136,78,58,150,95,55,14,11,3,20,14,13,1,0,0,0,11,53,26,27,37,28,7,6,,,,,,
"Dec 31, 2021 2:00 PM",59,36,23,150,83,67,130,68,62,131,77,54,30,15,15,33,25,22,3,0,0,0,25,64,30,34,21,23,3,7,,,,,,
"Dec 31, 2021 3:00 PM",42,14,28,123,59,64,120,53,67,104,41,63,23,10,13,40,21,18,3,0,0,0,17,58,29,29,20,38,10,3,,,,,,
"Dec 31, 2021 4:00 PM",51,15,36,76,33,43,80,31,49,59,24,35,34,13,21,18,8,8,0,0,0,0,13,36,13,23,21,38,4,2,,,,,,
"Dec 31, 2021 5:00 PM",39,14,25,36,20,16,55,23,32,37,15,22,7,3,4,7,12,12,0,0,0,0,12,19,13,6,11,19,1,0,,,,,,
"Dec 31, 2021 6:00 PM",42,13,29,13,8,5,19,11,8,21,8,13,0,0,0,8,4,4,0,0,0,0,4,10,6,4,5,16,2,1,,,,,,
"Dec 31, 2021 7:00 PM",25,12,13,14,10,4,24,14,10,22,11,11,13,3,10,6,5,4,1,0,0,0,5,7,5,2,15,11,1,0,,,,,,
"Dec 31, 2021 8:00 PM",21,5,16,8,5,3,14,8,6,13,6,7,7,5,2,7,3,3,0,0,0,0,4,2,1,1,9,10,0,1,,,,,,
"Dec 31, 2021 9:00 PM",17,9,8,26,7,19,17,5,12,15,5,10,7,6,1,4,8,8,0,0,0,0,10,9,2,7,2,9,0,2,,,,,,
"Dec 31, 2021 10:00 PM",13,6,7,9,5,4,7,2,5,4,2,2,0,0,0,0,1,1,0,0,0,0,1,2,1,1,4,4,0,0,,,,,,
"Dec 31, 2021 11:00 PM",5,0,5,4,1,3,5,3,2,7,2,5,1,1,0,1,2,2,0,0,0,0,2,2,2,0,1,3,0,1,,,,,,
