Time,Charleville Mall,Charleville Mall Cyclist IN,Charleville Mall Cyclist OUT,Clontarf - James Larkin Rd,Clontarf - James Larkin Rd Cyclist IN,Clontarf - James Larkin Rd Cyclist OUT,Clontarf - Pebble Beach Carpark,Clontarf - Pebble Beach Carpark Cyclist IN,Clontarf - Pebble Beach Carpark Cyclist OUT,Drumcondra Cyclists 1,Drumcondra Cyclists 1 Cyclist IN,Drumcondra Cyclists 1 Cyclist OUT,Drumcondra Cyclists 2,Drumcondra Cyclists 2 Cyclist IN,Drumcondra Cyclists 2 Cyclist OUT,Griffith Avenue (Clare Rd Side),Griffith Avenue (Clare Rd Side) Cyclist IN,Griffith Avenue (Clare Rd Side) Cyclist OUT,Griffith Avenue (Lane Side),Griffith Avenue (Lane Side) Cyclist IN,Griffith Avenue (Lane Side) Cyclist OUT,Grove Road Totem,Grove Road Totem OUT,Grove Road Totem IN,North Strand Rd N/B,North Strand Rd S/B,Richmond Street Cyclists 1,Richmond Street Cyclists 1 Cyclist IN,Richmond Street Cyclists 1 Cyclist OUT,Richmond Street Cyclists 2 ,Richmond Street Cyclists 2  Cyclist IN,Richmond Street Cyclists 2  Cyclist OUT
01/01/2022 00:00,0,0,0,0,0,0,6,4,2,0,0,0,2,2,0,1,1,0,0,0,0,4,3,1,3,1,9,1,8,4,0,4
01/01/2022 01:00,2,0,2,2,1,1,1,0,1,0,0,0,0,0,0,0,0,0,0,0,0,17,9,8,7,5,6,0,6,1,0,1
01/01/2022 02:00,0,0,0,2,1,1,4,0,4,0,0,0,1,1,0,1,1,0,0,0,0,7,7,0,2,3,9,0,9,6,0,6
01/01/2022 03:00,1,1,0,1,1,0,2,0,2,0,0,0,1,1,0,0,0,0,0,0,0,9,5,4,5,0,6,0,6,2,0,2
01/01/2022 04:00,1,0,1,1,1,0,1,0,1,0,0,0,1,1,0,0,0,0,0,0,0,9,4,5,2,1,2,0,2,0,0,0
01/01/2022 05:00,1,1,0,1,1,0,1,1,0,0,0,0,1,1,0,1,1,0,0,0,0,3,1,2,1,2,1,0,1,2,0,2
01/01/2022 06:00,2,1,1,0,0,0,1,0,1,0,0,0,1,1,0,1,1,0,1,1,0,10,4,6,6,6,6,0,6,3,0,3
01/01/2022 07:00,3,2,1,4,3,1,6,2,4,0,0,0,3,3,0,0,0,0,0,0,0,12,1,11,3,4,4,0,4,7,0,7
01/01/2022 08:00,1,1,0,11,3,8,12,2,10,0,0,0,2,2,0,0,0,0,0,0,0,14,4,10,8,3,4,0,4,9,0,9
01/01/2022 09:00,3,3,0,21,9,12,30,12,18,0,0,0,4,4,0,0,0,0,0,0,0,23,6,17,10,11,8,0,8,9,0,9
01/01/2022 10:00,4,3,1,47,19,28,83,24,59,0,0,0,2,2,0,8,8,0,1,1,0,39,15,24,8,14,14,0,14,17,0,17
01/01/2022 11:00,4,2,2,86,32,54,108,39,69,0,0,0,2,2,0,10,10,0,1,1,0,37,16,21,14,22,13,0,13,30,0,30
01/01/2022 12:00,6,5,1,98,44,54,116,42,74,0,0,0,2,2,0,7,7,0,2,2,0,57,31,26,23,23,28,0,28,37,0,37
01/01/2022 13:00,7,3,4,116,45,71,158,64,94,0,0,0,5,5,0,12,12,0,1,1,0,65,24,41,26,32,38,0,38,39,0,39
01/01/2022 14:00,3,1,2,109,55,54,132,50,82,0,0,0,10,10,0,10,10,0,0,0,0,79,24,55,34,23,57,0,57,53,1,52
01/01/2022 15:00,4,0,4,104,51,53,153,77,76,0,0,0,6,6,0,8,8,0,0,0,0,54,30,24,28,27,53,0,53,46,0,46
01/01/2022 16:00,7,6,1,45,30,15,87,51,36,0,0,0,4,4,0,12,12,0,0,0,0,62,30,32,32,26,49,0,49,44,0,44
01/01/2022 17:00,5,3,2,15,12,3,27,15,12,0,0,0,3,3,0,5,5,0,1,1,0,51,30,21,22,14,59,0,59,45,0,45
01/01/2022 18:00,1,1,0,13,7,6,8,4,4,0,0,0,6,6,0,4,4,0,4,4,0,53,30,23,21,16,45,1,44,45,1,44
01/01/2022 19:00,2,0,2,7,3,4,21,10,11,0,0,0,3,3,0,1,1,0,2,2,0,63,34,29,24,8,4,0,4,49,0,49
01/01/2022 20:00,6,3,3,5,3,2,7,4,3,0,0,0,4,3,1,2,2,0,1,1,0,48,34,14,22,10,41,0,41,40,0,40
01/01/2022 21:00,4,1,3,5,2,3,8,3,5,0,0,0,5,5,0,3,3,0,3,3,0,33,15,18,21,9,30,1,29,35,1,34
01/01/2022 22:00,4,2,2,3,2,1,3,2,1,0,0,0,4,3,1,0,0,0,0,0,0,20,12,8,10,6,18,0,18,21,1,20
01/01/2022 23:00,0,0,0,2,1,1,3,2,1,0,0,0,1,0,1,3,3,0,1,1,0,8,5,3,6,4,13,0,13,12,0,12
02/01/2022 00:00,0,0,0,3,2,1,2,1,1,0,0,0,0,0,0,0,0,0,0,0,0,7,3,4,5,1,6,0,6,4,0,4
02/01/2022 01:00,0,0,0,0,0,0,1,0,1,0,0,0,0,0,0,0,0,0,0,0,0,4,3,1,4,2,0,0,0,0,0,0
02/01/2022 02:00,0,0,0,0,0,0,1,0,1,0,0,0,0,0,0,0,0,0,0,0,0,1,1,0,1,1,1,0,1,2,0,2
02/01/2022 03:00,0,0,0,1,1,0,0,0,0,0,0,0,0,0,0,0,0,0,0,0,0,2,2,0,0,0,2,0,2,0,0,0
02/01/2022 04:00,0,0,0,0,0,0,0,0,0,0,0,0,1,1,0,0,0,0,1,1,0,2,1,1,1,2,0,0,0,0,0,0
02/01/2022 05:00,0,0,0,1,1,0,1,0,1,0,0,0,0,0,0,0,0,0,0,0,0,5,2,3,1,2,0,0,0,2,0,2
02/01/2022 06:00,2,1,1,9,4,5,9,2,7,0,0,0,2,2,0,0,0,0,0,0,0,18,1,17,5,9,2,0,2,5,0,5
02/01/2022 07:00,1,0,1,13,6,7,20,11,9,0,0,0,4,4,0,0,0,0,0,0,0,22,4,18,5,8,5,0,5,2,0,2
02/01/2022 08:00,2,2,0,61,26,35,50,18,32,0,0,0,3,3,0,5,5,0,0,0,0,21,6,15,11,15,8,0,8,20,0,20
02/01/2022 09:00,2,2,0,70,30,40,73,28,45,0,0,0,6,6,0,2,2,0,0,0,0,43,11,32,8,15,14,0,14,18,0,18
02/01/2022 10:00,2,2,0,96,41,55,118,45,73,0,0,0,4,4,0,11,11,0,1,1,0,36,14,22,15,24,10,0,10,22,0,22
02/01/2022 11:00,6,6,0,115,52,63,130,66,64,0,0,0,5,5,0,9,9,0,0,0,0,57,23,34,15,36,29,0,29,44,0,44
02/01/2022 12:00,6,5,1,106,54,52,128,48,80,0,0,0,3,3,0,9,9,0,6,6,0,73,31,42,44,41,40,1,39,55,0,55
02/01/2022 13:00,13,8,5,99,39,60,133,59,74,0,0,0,5,5,0,18,18,0,1,1,0,69,23,46,34,24,48,0,48,73,0,73
02/01/2022 14:00,12,7,5,88,40,48,112,46,66,0,0,0,4,4,0,12,12,0,0,0,0,62,27,35,48,32,56,0,56,86,2,84
02/01/2022 15:00,9,5,4,72,41,31,77,42,35,0,0,0,4,4,0,5,5,0,0,0,0,60,34,26,21,28,45,3,42,56,0,56
02/01/2022 16:00,11,5,6,59,33,26,63,30,33,0,0,0,6,6,0,9,9,0,0,0,0,80,29,51,25,30,55,0,55,59,0,59
02/01/2022 17:00,6,2,4,19,12,7,18,10,8,0,0,0,2,2,0,7,7,0,0,0,0,71,41,30,32,14,70,0,70,49,0,49
02/01/2022 18:00,4,2,2,19,9,10,12,4,8,0,0,0,6,6,0,6,6,0,0,0,0,62,39,23,33,6,62,1,61,47,0,47
02/01/2022 19:00,4,2,2,11,4,7,14,3,11,0,0,0,8,8,0,5,5,0,0,0,0,56,27,29,25,11,63,0,63,54,0,54
02/01/2022 20:00,7,7,0,11,5,6,13,4,9,0,0,0,3,3,0,7,7,0,0,0,0,58,36,22,34,9,52,0,52,38,0,38
02/01/2022 21:00,7,1,6,10,3,7,9,1,8,0,0,0,2,2,0,2,2,0,0,0,0,42,25,17,12,9,36,0,36,37,0,37
02/01/2022 22:00,5,1,4,3,2,1,4,3,1,0,0,0,1,1,0,0,0,0,0,0,0,19,12,7,11,11,18,0,18,22,1,21
02/01/2022 23:00,1,1,0,3,1,2,2,0,2,0,0,0,0,0,0,0,0,0,0,0,0,17,10,7,11,1,5,0,5,7,0,7
03/01/2022 00:00,0,0,0,2,2,0,3,1,2,0,0,0,0,0,0,2,2,0,0,0,0,6,5,1,5,1,5,0,5,1,0,1
03/01/2022 01:00,2,0,2,1,1,0,1,0,1,0,0,0,0,0,0,1,1,0,0,0,0,3,2,1,1,0,1,0,1,0,0,0
03/01/2022 02:00,0,0,0,1,1,0,1,1,0,0,0,0,0,0,0,0,0,0,1,1,0,0,0,0,1,2,1,0,1,0,0,0
03/01/2022 03:00,1,1,0,0,0,0,0,0,0,0,0,0,0,0,0,0,0,0,0,0,0,0,0,0,0,1,3,0,3,0,0,0
03/01/2022 04:00,0,0,0,0,0,0,0,0,0,0,0,0,1,1,0,0,0,0,0,0,0,3,1,2,0,1,0,0,0,0,0,0
03/01/2022 05:00,0,0,0,4,2,2,3,1,2,0,0,0,0,0,0,0,0,0,0,0,0,5,0,5,3,8,2,0,2,3,0,3
03/01/2022 06:00,3,2,1,1,1,0,5,2,3,0,0,0,3,3,0,0,0,0,0,0,0,22,3,19,8,9,6,0,6,6,0,6
03/01/2022 07:00,2,1,1,6,4,2,13,5,8,0,0,0,5,5,0,0,0,0,0,0,0,28,6,22,8,14,1,0,1,10,0,10
03/01/2022 08:00,7,7,0,13,7,6,27,10,17,0,0,0,6,6,0,2,2,0,0,0,0,33,8,25,8,17,12,0,12,16,0,16
03/01/2022 09:00,4,2,2,52,19,33,42,16,26,0,0,0,3,3,0,9,9,0,0,0,0,39,13,26,15,17,16,1,15,19,0,19
03/01/2022 10:00,8,4,4,104,37,67,116,35,81,0,0,0,3,3,0,5,5,0,0,0,0,50,12,38,11,16,24,0,24,38,0,38
03/01/2022 11:00,14,13,1,121,47,74,144,49,95,0,0,0,13,13,0,8,8,0,0,0,0,67,27,40,32,22,34,1,33,48,1,47
03/01/2022 12:00,8,5,3,118,61,57,161,70,91,0,0,0,9,9,0,13,13,0,0,0,0,55,17,38,27,39,60,0,60,71,0,71
03/01/2022 13:00,17,10,7,127,67,60,132,73,59,0,0,0,2,2,0,11,11,0,0,0,0,95,41,54,55,45,50,0,50,76,0,76
03/01/2022 14:00,17,10,7,121,63,58,131,61,70,0,0,0,4,4,0,8,8,0,0,0,0,88,42,46,46,37,55,0,55,79,0,79
03/01/2022 15:00,19,10,9,103,56,47,100,49,51,0,0,0,1,1,0,12,12,0,0,0,0,79,40,39,45,29,69,0,69,78,1,77
03/01/2022 16:00,11,9,2,69,46,23,97,61,36,0,0,0,4,4,0,10,10,0,0,0,0,73,34,39,38,26,54,0,54,55,0,55
03/01/2022 17:00,15,10,5,17,9,8,30,12,18,0,0,0,1,1,0,5,5,0,0,0,0,81,42,39,40,30,93,1,92,82,0,82
03/01/2022 18:00,4,4,0,15,6,9,22,11,11,0,0,0,6,6,0,7,7,0,0,0,0,81,43,38,39,26,92,0,92,76,0,76
03/01/2022 19:00,3,2,1,9,5,4,27,10,17,0,0,0,4,4,0,3,3,0,0,0,0,62,37,25,39,20,76,0,76,51,0,51
03/01/2022 20:00,6,4,2,2,0,2,13,6,7,0,0,0,3,3,0,4,4,0,0,0,0,66,41,25,24,17,57,0,57,38,1,37
03/01/2022 21:00,1,1,0,2,2,0,1,0,1,0,0,0,2,2,0,0,0,0,0,0,0,37,24,13,18,5,32,0,32,20,0,20
03/01/2022 22:00,3,0,3,2,2,0,2,2,0,0,0,0,0,0,0,2,2,0,0,0,0,23,10,13,8,3,15,1,14,16,0,16
03/01/2022 23:00,1,1,0,2,0,2,2,1,1,0,0,0,1,1,0,0,0,0,0,0,0,12,11,1,5,3,4,1,3,5,0,5
04/01/2022 00:00,2,1,1,0,0,0,0,0,0,0,0,0,1,1,0,0,0,0,0,0,0,2,0,2,0,0,1,0,1,1,0,1
04/01/2022 01:00,1,0,1,0,0,0,0,0,0,0,0,0,0,0,0,0,0,0,0,0,0,2,1,1,0,1,1,0,1,0,0,0
04/01/2022 02:00,0,0,0,0,0,0,1,1,0,0,0,0,0,0,0,0,0,0,0,0,0,1,1,0,3,0,0,0,0,1,0,1
04/01/2022 03:00,0,0,0,0,0,0,0,0,0,0,0,0,0,0,0,0,0,0,0,0,0,1,1,0,0,2,2,0,2,0,0,0
04/01/2022 04:00,0,0,0,1,1,0,2,2,0,0,0,0,0,0,0,2,2,0,1,1,0,3,0,3,0,3,0,0,0,0,0,0
04/01/2022 05:00,0,0,0,5,2,3,9,4,5,0,0,0,1,1,0,0,0,0,1,1,0,17,2,15,2,12,2,0,2,3,0,3
04/01/2022 06:00,7,7,0,7,7,0,6,5,1,0,0,0,13,13,0,9,9,0,2,2,0,83,11,72,9,39,11,0,11,23,0,23
04/01/2022 07:00,6,5,1,34,23,11,37,24,13,0,0,0,14,14,0,7,7,0,7,7,0,144,43,101,18,57,27,0,27,43,0,43
04/01/2022 08:00,27,24,3,45,32,13,49,32,17,0,0,0,32,32,0,14,14,0,7,7,0,175,50,125,14,108,30,0,30,60,1,59
04/01/2022 09:00,12,9,3,40,20,20,45,26,19,0,0,0,9,9,0,8,8,0,4,4,0,95,27,68,12,58,18,0,18,67,0,67
04/01/2022 10:00,5,3,2,73,34,39,86,43,43,0,0,0,7,7,0,8,8,0,1,1,0,52,21,31,16,26,21,0,21,37,0,37
04/01/2022 11:00,10,6,4,68,25,43,83,32,51,0,0,0,16,16,0,8,8,0,0,0,0,57,18,39,41,14,41,1,40,67,0,67
04/01/2022 12:00,18,9,9,96,44,52,111,55,56,0,0,0,11,10,1,4,4,0,0,0,0,59,29,30,35,33,61,2,59,84,0,84
04/01/2022 13:00,7,2,5,36,19,17,69,39,30,0,0,0,11,11,0,7,7,0,5,5,0,94,43,51,45,31,73,1,72,95,1,94
04/01/2022 14:00,17,7,10,63,41,22,79,41,38,0,0,0,3,3,0,14,14,0,1,1,0,72,37,35,66,33,49,0,49,74,0,74
04/01/2022 15:00,15,9,6,65,27,38,72,28,44,0,0,0,5,5,0,6,6,0,5,5,0,105,60,45,55,32,75,0,75,68,0,68
04/01/2022 16:00,21,13,8,46,23,23,71,34,37,0,0,0,4,4,0,15,15,0,5,5,0,152,75,77,86,29,98,1,97,68,0,68
04/01/2022 17:00,16,7,9,48,14,34,64,20,44,0,0,0,0,0,0,14,14,0,3,3,0,187,107,80,132,15,131,0,131,94,0,94
04/01/2022 18:00,10,5,5,34,11,23,45,15,30,0,0,0,4,4,0,12,12,0,2,2,0,144,77,67,82,21,85,1,84,93,1,92
04/01/2022 19:00,8,7,1,21,10,11,19,8,11,0,0,0,7,7,0,10,10,0,1,1,0,90,55,35,68,23,91,0,91,80,0,80
04/01/2022 20:00,7,3,4,20,8,12,16,5,11,0,0,0,7,6,1,8,8,0,1,1,0,69,49,20,44,17,72,0,72,55,1,54
04/01/2022 21:00,4,2,2,5,2,3,16,7,9,0,0,0,4,4,0,5,5,0,0,0,0,47,30,17,24,22,48,1,47,36,1,35
04/01/2022 22:00,3,1,2,4,2,2,8,3,5,0,0,0,4,4,0,0,0,0,3,3,0,28,17,11,25,14,16,1,15,14,0,14
04/01/2022 23:00,4,0,4,0,0,0,0,0,0,0,0,0,0,0,0,1,1,0,0,0,0,16,12,4,7,3,8,0,8,6,0,6
05/01/2022 00:00,1,1,0,2,1,1,0,0,0,0,0,0,0,0,0,2,2,0,1,1,0,9,7,2,1,1,7,0,7,1,0,1
05/01/2022 01:00,2,2,0,0,0,0,0,0,0,0,0,0,0,0,0,0,0,0,0,0,0,2,2,0,0,0,2,0,2,0,0,0
05/01/2022 02:00,0,0,0,0,0,0,2,1,1,0,0,0,0,0,0,0,0,0,0,0,0,3,2,1,2,1,0,0,0,0,0,0
05/01/2022 03:00,0,0,0,0,0,0,0,0,0,0,0,0,0,0,0,0,0,0,0,0,0,0,0,0,0,1,3,0,3,0,0,0
05/01/2022 04:00,0,0,0,0,0,0,1,1,0,0,0,0,2,2,0,0,0,0,1,1,0,6,1,5,2,3,0,0,0,0,0,0
05/01/2022 05:00,1,1,0,4,3,1,5,2,3,0,0,0,3,3,0,0,0,0,2,2,0,19,1,18,2,10,0,0,0,4,0,4
05/01/2022 06:00,12,11,1,17,14,3,14,10,4,0,0,0,6,5,1,4,4,0,3,3,0,75,9,66,10,42,10,0,10,22,0,22
05/01/2022 07:00,4,3,1,24,14,10,27,15,12,0,0,0,27,27,0,11,11,0,3,3,0,135,39,96,28,55,15,0,15,44,1,43
05/01/2022 08:00,22,19,3,34,23,11,50,36,14,0,0,0,18,18,0,9,9,0,1,1,0,170,47,123,25,87,20,0,20,47,0,47
05/01/2022 09:00,15,12,3,30,14,16,48,26,22,0,0,0,12,12,0,4,4,0,2,2,0,106,30,76,10,60,30,0,30,44,1,43
05/01/2022 10:00,8,6,2,58,23,35,67,28,39,0,0,0,14,14,0,9,9,0,4,4,0,53,14,39,24,15,20,0,20,36,0,36
05/01/2022 11:00,9,6,3,69,28,41,72,31,41,0,0,0,6,6,0,9,9,0,12,12,0,76,25,51,27,31,38,0,38,49,0,49
05/01/2022 12:00,12,10,2,110,52,58,88,42,46,0,0,0,6,6,0,10,10,0,18,18,0,94,44,50,42,39,70,0,70,72,0,72
05/01/2022 13:00,14,8,6,98,56,42,119,67,52,0,0,0,2,2,0,10,10,0,10,10,0,91,42,49,51,26,73,1,72,80,1,79
05/01/2022 14:00,16,7,9,69,34,35,73,35,38,0,0,0,2,2,0,12,12,0,9,9,0,93,37,56,42,42,64,0,64,62,1,61
05/01/2022 15:00,10,4,6,64,32,32,99,43,56,0,0,0,3,3,0,10,10,0,5,5,0,112,54,58,58,27,66,0,66,52,0,52
05/01/2022 16:00,21,11,10,61,23,38,68,30,38,0,0,0,0,0,0,9,9,0,4,4,0,162,94,68,84,27,91,0,91,67,0,67
05/01/2022 17:00,14,10,4,48,20,28,70,26,44,0,0,0,1,1,0,18,18,0,10,10,0,211,111,100,133,31,124,2,122,117,1,116
05/01/2022 18:00,9,5,4,44,13,31,58,15,43,0,0,0,2,2,0,11,11,0,11,11,0,161,81,80,90,26,104,0,104,93,0,93
05/01/2022 19:00,8,6,2,27,10,17,33,16,17,0,0,0,0,0,0,11,11,0,7,7,0,105,56,49,57,15,72,2,70,75,1,74
05/01/2022 20:00,10,6,4,17,6,11,22,6,16,0,0,0,3,3,0,5,5,0,2,2,0,66,43,23,35,12,66,0,66,64,0,64
05/01/2022 21:00,3,1,2,11,6,5,5,1,4,0,0,0,4,4,0,6,6,0,2,2,0,48,37,11,27,11,53,0,53,31,0,31
05/01/2022 22:00,1,0,1,4,2,2,4,0,4,0,0,0,3,3,0,2,2,0,0,0,0,39,19,20,13,6,17,0,17,17,0,17
05/01/2022 23:00,1,1,0,0,0,0,0,0,0,0,0,0,0,0,0,0,0,0,0,0,0,15,9,6,20,7,7,0,7,7,0,7
06/01/2022 00:00,0,0,0,0,0,0,0,0,0,0,0,0,0,0,0,0,0,0,0,0,0,9,8,1,4,2,6,0,6,1,0,1
06/01/2022 01:00,1,1,0,0,0,0,0,0,0,0,0,0,0,0,0,1,1,0,0,0,0,1,1,0,0,0,0,0,0,0,0,0
06/01/2022 02:00,0,0,0,0,0,0,2,2,0,0,0,0,0,0,0,0,0,0,0,0,0,4,3,1,2,0,0,0,0,0,0,0
06/01/2022 03:00,0,0,0,0,0,0,1,1,0,0,0,0,0,0,0,0,0,0,0,0,0,3,1,2,0,0,0,0,0,0,0,0
06/01/2022 04:00,0,0,0,0,0,0,1,1,0,0,0,0,1,1,0,0,0,0,0,0,0,5,0,5,2,4,0,0,0,0,0,0
06/01/2022 05:00,1,1,0,3,2,1,4,3,1,0,0,0,1,1,0,1,1,0,0,0,0,15,0,15,2,12,5,0,5,3,0,3
06/01/2022 06:00,5,4,1,10,10,0,13,10,3,0,0,0,13,13,0,6,6,0,0,0,0,77,11,66,12,39,8,0,8,16,0,16
06/01/2022 07:00,7,6,1,20,12,8,24,14,10,0,0,0,17,17,0,4,4,0,0,0,0,131,38,93,18,85,15,0,15,27,0,27
06/01/2022 08:00,27,24,3,18,15,3,25,15,10,0,0,0,19,18,1,18,18,0,0,0,0,206,46,160,17,88,23,1,22,47,0,47
06/01/2022 09:00,16,14,2,17,11,6,25,13,12,0,0,0,6,6,0,5,5,0,0,0,0,92,27,65,13,48,14,0,14,39,0,39
06/01/2022 10:00,8,7,1,12,7,5,12,4,8,0,0,0,6,6,0,6,6,0,0,0,0,58,26,32,13,17,20,1,19,45,1,44
06/01/2022 11:00,6,2,4,12,5,7,15,6,9,0,0,0,6,6,0,4,4,0,0,0,0,53,22,31,21,12,33,0,33,33,0,33
06/01/2022 12:00,7,3,4,18,7,11,21,10,11,0,0,0,4,3,1,3,3,0,0,0,0,64,30,34,31,16,55,0,55,38,0,38
06/01/2022 13:00,2,1,1,19,9,10,19,10,9,0,0,0,6,6,0,6,6,0,0,0,0,72,35,37,39,27,61,0,61,67,0,67
06/01/2022 14:00,13,10,3,22,10,12,34,13,21,0,0,0,2,2,0,9,9,0,0,0,0,88,43,45,41,18,58,0,58,51,0,51
06/01/2022 15:00,13,6,7,24,7,17,24,9,15,0,0,0,2,2,0,19,19,0,0,0,0,101,59,42,47,20,57,1,56,54,0,54
06/01/2022 16:00,20,10,10,16,7,9,25,7,18,0,0,0,1,1,0,9,9,0,0,0,0,146,73,73,85,16,74,1,73,81,0,81
06/01/2022 17:00,18,8,10,21,6,15,34,7,27,0,0,0,1,1,0,6,6,0,0,0,0,163,89,74,111,32,99,0,99,69,0,69
06/01/2022 18:00,14,6,8,33,11,22,35,7,28,0,0,0,2,2,0,5,5,0,0,0,0,152,92,60,91,28,101,2,99,76,0,76
06/01/2022 19:00,4,0,4,21,5,16,19,3,16,0,0,0,1,1,0,5,5,0,0,0,0,96,57,39,51,19,77,0,77,61,0,61
06/01/2022 20:00,2,2,0,9,6,3,7,5,2,0,0,0,1,1,0,3,3,0,0,0,0,75,44,31,35,18,58,0,58,34,0,34
06/01/2022 21:00,3,2,1,8,5,3,8,3,5,0,0,0,1,1,0,2,2,0,0,0,0,29,23,6,17,4,36,1,35,36,0,36
06/01/2022 22:00,2,1,1,4,2,2,3,1,2,0,0,0,0,0,0,1,1,0,0,0,0,24,16,8,17,8,19,0,19,13,0,13
06/01/2022 23:00,1,0,1,1,1,0,0,0,0,0,0,0,0,0,0,1,1,0,0,0,0,14,5,9,6,4,7,0,7,4,0,4
07/01/2022 00:00,0,0,0,0,0,0,0,0,0,0,0,0,0,0,0,1,1,0,0,0,0,5,4,1,5,2,2,0,2,4,0,4
07/01/2022 01:00,1,1,0,1,0,1,0,0,0,0,0,0,0,0,0,0,0,0,0,0,0,1,1,0,1,0,0,0,0,0,0,0
07/01/2022 02:00,0,0,0,0,0,0,0,0,0,0,0,0,0,0,0,0,0,0,0,0,0,0,0,0,0,0,2,0,2,0,0,0
07/01/2022 03:00,0,0,0,0,0,0,0,0,0,0,0,0,0,0,0,0,0,0,0,0,0,2,2,0,0,1,0,0,0,0,0,0
07/01/2022 04:00,0,0,0,2,1,1,4,3,1,0,0,0,0,0,0,0,0,0,0,0,0,2,1,1,0,5,0,0,0,0,0,0
07/01/2022 05:00,0,0,0,3,1,2,2,1,1,0,0,0,1,1,0,0,0,0,0,0,0,17,3,14,4,13,2,0,2,5,0,5
07/01/2022 06:00,9,8,1,10,8,2,14,11,3,0,0,0,8,8,0,4,4,0,0,0,0,78,14,64,11,35,7,0,7,16,0,16
07/01/2022 07:00,9,7,2,10,7,3,14,9,5,0,0,0,14,14,0,4,4,0,0,0,0,148,43,105,20,65,21,1,20,36,0,36
07/01/2022 08:00,34,29,5,30,20,10,37,23,14,0,0,0,12,12,0,13,13,0,0,0,0,185,56,129,14,105,34,1,33,58,0,58
07/01/2022 09:00,13,10,3,20,8,12,30,16,14,0,0,0,2,2,0,3,3,0,0,0,0,89,27,62,11,61,21,0,21,61,0,61
07/01/2022 10:00,6,2,4,34,16,18,38,14,24,0,0,0,5,5,0,5,5,0,0,0,0,59,20,39,23,36,22,0,22,50,1,49
07/01/2022 11:00,9,3,6,25,14,11,23,12,11,0,0,0,7,7,0,3,3,0,0,0,0,45,18,27,22,17,32,1,31,29,0,29
07/01/2022 12:00,6,5,1,17,8,9,16,9,7,0,0,0,4,4,0,9,9,0,0,0,0,54,27,27,19,18,36,0,36,36,0,36
07/01/2022 13:00,6,4,2,20,9,11,15,3,12,0,0,0,4,4,0,8,8,0,0,0,0,77,39,38,39,26,51,0,51,53,1,52
07/01/2022 14:00,4,2,2,32,15,17,25,9,16,0,0,0,1,1,0,8,8,0,0,0,0,87,42,45,52,11,70,0,70,69,0,69
07/01/2022 15:00,11,5,6,35,14,21,40,16,24,0,0,0,1,1,0,25,25,0,3,3,0,120,72,48,62,22,62,2,60,63,1,62
07/01/2022 16:00,12,4,8,40,19,21,52,15,37,0,0,0,2,2,0,6,6,0,1,1,0,143,67,76,74,23,87,0,87,71,0,71
07/01/2022 17:00,11,6,5,22,10,12,38,10,28,0,0,0,6,6,0,14,14,0,0,0,0,189,92,97,93,27,125,1,124,78,1,77
07/01/2022 18:00,8,2,6,27,10,17,38,11,27,0,0,0,2,2,0,5,5,0,0,0,0,132,72,60,70,16,113,0,113,101,0,101
07/01/2022 19:00,3,1,2,15,5,10,20,10,10,0,0,0,2,2,0,2,2,0,0,0,0,88,51,37,52,14,107,0,107,95,0,95
07/01/2022 20:00,7,5,2,7,2,5,21,8,13,0,0,0,2,2,0,6,6,0,0,0,0,95,52,43,51,14,104,1,103,73,3,70
07/01/2022 21:00,5,1,4,6,2,4,10,3,7,0,0,0,4,4,0,5,5,0,0,0,0,65,42,23,29,17,65,0,65,30,0,30
07/01/2022 22:00,5,3,2,4,2,2,4,2,2,0,0,0,1,1,0,0,0,0,0,0,0,32,22,10,26,10,29,2,27,19,0,19
07/01/2022 23:00,4,1,3,3,2,1,1,0,1,0,0,0,1,1,0,2,2,0,0,0,0,28,16,12,9,3,17,0,17,8,0,8
08/01/2022 00:00,1,1,0,1,1,0,1,0,1,0,0,0,0,0,0,0,0,0,0,0,0,10,4,6,4,3,4,0,4,1,0,1
08/01/2022 01:00,0,0,0,0,0,0,2,1,1,0,0,0,0,0,0,0,0,0,0,0,0,4,1,3,3,1,2,0,2,0,0,0
08/01/2022 02:00,0,0,0,2,0,2,1,0,1,0,0,0,1,1,0,0,0,0,0,0,0,5,5,0,2,2,3,0,3,4,0,4
08/01/2022 03:00,0,0,0,0,0,0,0,0,0,0,0,0,0,0,0,0,0,0,0,0,0,2,0,2,1,1,4,0,4,2,0,2
08/01/2022 04:00,0,0,0,0,0,0,0,0,0,0,0,0,1,1,0,0,0,0,0,0,0,5,2,3,1,2,1,0,1,2,0,2
08/01/2022 05:00,1,1,0,0,0,0,0,0,0,0,0,0,0,0,0,1,1,0,0,0,0,8,2,6,2,3,1,0,1,1,0,1
08/01/2022 06:00,3,3,0,0,0,0,4,2,2,0,0,0,3,3,0,1,1,0,0,0,0,25,6,19,6,4,8,0,8,3,0,3
08/01/2022 07:00,1,1,0,7,2,5,11,4,7,0,0,0,7,7,0,2,2,0,0,0,0,31,11,20,7,12,11,0,11,16,0,16
08/01/2022 08:00,0,0,0,21,12,9,22,11,11,0,0,0,10,10,0,2,2,0,0,0,0,24,6,18,3,14,13,0,13,18,0,18
08/01/2022 09:00,4,3,1,37,17,20,48,18,30,0,0,0,3,3,0,4,4,0,0,0,0,43,12,31,19,17,9,0,9,41,0,41
08/01/2022 10:00,3,0,3,64,23,41,54,16,38,0,0,0,5,5,0,5,5,0,0,0,0,57,17,40,21,20,18,0,18,54,0,54
08/01/2022 11:00,8,7,1,75,33,42,91,40,51,0,0,0,2,2,0,6,6,0,0,0,0,64,26,38,20,23,35,1,34,57,0,57
08/01/2022 12:00,16,12,4,105,49,56,107,49,58,0,0,0,7,7,0,10,10,0,0,0,0,82,32,50,41,48,58,1,57,71,0,71
08/01/2022 13:00,12,10,2,125,60,65,117,49,68,0,0,0,4,4,0,9,9,0,0,0,0,109,44,65,52,37,64,0,64,75,0,75
08/01/2022 14:00,10,3,7,102,48,54,141,69,72,0,0,0,5,5,0,9,9,0,0,0,0,88,27,61,41,47,62,1,61,80,0,80
08/01/2022 15:00,12,6,6,76,33,43,91,46,45,0,0,0,6,6,0,8,8,0,1,1,0,105,51,54,60,32,80,0,80,86,1,85
08/01/2022 16:00,13,8,5,57,36,21,75,41,34,0,0,0,3,3,0,15,15,0,0,0,0,97,43,54,51,35,80,0,80,64,1,63
08/01/2022 17:00,4,1,3,31,20,11,38,22,16,0,0,0,1,1,0,3,3,0,0,0,0,90,28,62,44,17,99,1,98,88,0,88
08/01/2022 18:00,8,6,2,14,7,7,21,9,12,0,0,0,1,1,0,5,5,0,0,0,0,75,36,39,48,22,83,0,83,83,1,82
08/01/2022 19:00,4,2,2,9,3,6,13,4,9,0,0,0,2,2,0,9,9,0,0,0,0,78,40,38,52,15,79,0,79,77,0,77
08/01/2022 20:00,7,4,3,7,4,3,12,7,5,0,0,0,3,3,0,3,3,0,0,0,0,93,44,49,35,14,83,0,83,74,4,70
08/01/2022 21:00,7,4,3,8,2,6,6,3,3,0,0,0,2,2,0,1,1,0,0,0,0,53,36,17,24,11,48,0,48,52,0,52
08/01/2022 22:00,2,1,1,3,2,1,5,1,4,0,0,0,2,2,0,1,1,0,1,1,0,36,21,15,18,6,31,0,31,27,0,27
08/01/2022 23:00,5,1,4,2,1,1,2,0,2,0,0,0,0,0,0,1,1,0,0,0,0,17,14,3,9,6,17,0,17,8,0,8
09/01/2022 00:00,1,0,1,0,0,0,1,0,1,0,0,0,1,1,0,0,0,0,0,0,0,7,4,3,11,3,4,0,4,2,0,2
09/01/2022 01:00,0,0,0,3,0,3,1,0,1,0,0,0,0,0,0,0,0,0,0,0,0,7,5,2,4,2,5,0,5,0,0,0
09/01/2022 02:00,0,0,0,1,1,0,1,0,1,0,0,0,0,0,0,0,0,0,0,0,0,2,1,1,2,1,3,0,3,1,0,1
09/01/2022 03:00,0,0,0,0,0,0,0,0,0,0,0,0,1,1,0,0,0,0,0,0,0,5,2,3,2,1,1,0,1,0,0,0
09/01/2022 04:00,0,0,0,0,0,0,0,0,0,0,0,0,1,1,0,0,0,0,0,0,0,4,3,1,0,0,2,0,2,0,0,0
09/01/2022 05:00,2,2,0,0,0,0,0,0,0,0,0,0,0,0,0,0,0,0,0,0,0,8,1,7,1,0,0,0,0,2,0,2
09/01/2022 06:00,1,1,0,5,2,3,7,1,6,0,0,0,1,1,0,1,1,0,0,0,0,18,1,17,10,5,2,0,2,4,0,4
09/01/2022 07:00,2,2,0,16,7,9,13,3,10,0,0,0,6,6,0,2,2,0,0,0,0,19,8,11,9,12,6,0,6,12,0,12
09/01/2022 08:00,4,2,2,86,32,54,88,27,61,0,0,0,2,2,0,3,3,0,0,0,0,21,4,17,11,13,11,0,11,16,0,16
09/01/2022 09:00,5,5,0,102,40,62,113,45,68,0,0,0,1,1,0,1,1,0,0,0,0,44,9,35,18,27,12,0,12,26,0,26
09/01/2022 10:00,12,5,7,177,71,106,175,76,99,0,0,0,2,2,0,10,10,0,0,0,0,56,19,37,29,29,22,0,22,39,0,39
09/01/2022 11:00,4,3,1,164,75,89,160,85,75,0,0,0,3,3,0,8,8,0,0,0,0,84,28,56,27,19,32,0,32,61,0,61
09/01/2022 12:00,16,11,5,178,80,98,198,83,115,0,0,0,3,3,0,13,13,0,0,0,0,106,38,68,33,25,60,0,60,57,2,55
09/01/2022 13:00,15,11,4,145,69,76,166,85,81,0,0,0,1,1,0,12,12,0,0,0,0,85,44,41,39,60,0,0,0,61,0,61
09/01/2022 14:00,13,8,5,117,60,57,126,55,71,0,0,0,7,7,0,18,18,0,4,4,0,97,42,55,47,46,0,0,0,73,0,73
09/01/2022 15:00,15,10,5,95,49,46,105,55,50,0,0,0,4,4,0,12,12,0,6,6,0,75,32,43,29,48,44,0,44,69,0,69
09/01/2022 16:00,16,9,7,53,35,18,76,46,30,0,0,0,1,1,0,10,10,0,16,16,0,86,35,51,41,43,71,0,71,59,0,59
09/01/2022 17:00,6,1,5,18,9,9,33,16,17,0,0,0,1,1,0,6,6,0,2,2,0,109,45,64,32,31,72,0,72,74,0,74
09/01/2022 18:00,5,4,1,16,6,10,17,8,9,0,0,0,1,1,0,2,2,0,2,2,0,79,35,44,57,27,96,0,96,76,0,76
09/01/2022 19:00,2,1,1,14,6,8,24,9,15,0,0,0,1,1,0,6,6,0,0,0,0,65,43,22,37,17,84,0,84,74,1,73
09/01/2022 20:00,4,4,0,10,4,6,16,7,9,0,0,0,2,2,0,2,2,0,0,0,0,79,45,34,35,12,62,1,61,68,0,68
09/01/2022 21:00,5,1,4,9,2,7,9,4,5,0,0,0,1,1,0,5,5,0,0,0,0,39,21,18,35,17,32,0,32,40,0,40
09/01/2022 22:00,2,1,1,4,4,0,8,4,4,0,0,0,3,3,0,0,0,0,0,0,0,20,13,7,17,12,20,1,19,20,0,20
09/01/2022 23:00,0,0,0,0,0,0,0,0,0,0,0,0,1,1,0,0,0,0,0,0,0,13,12,1,8,4,14,0,14,8,0,8
10/01/2022 00:00,0,0,0,2,1,1,3,0,3,0,0,0,0,0,0,0,0,0,0,0,0,7,5,2,4,0,6,0,6,5,0,5
10/01/2022 01:00,0,0,0,1,0,1,0,0,0,0,0,0,0,0,0,0,0,0,0,0,0,3,1,2,1,0,0,0,0,0,0,0
10/01/2022 02:00,0,0,0,1,0,1,0,0,0,0,0,0,0,0,0,0,0,0,0,0,0,1,1,0,0,0,1,0,1,0,0,0
10/01/2022 03:00,0,0,0,0,0,0,0,0,0,0,0,0,0,0,0,0,0,0,0,0,0,1,0,1,1,1,0,0,0,0,0,0
10/01/2022 04:00,0,0,0,3,2,1,3,3,0,0,0,0,1,1,0,0,0,0,1,1,0,3,0,3,2,9,1,0,1,0,0,0
10/01/2022 05:00,0,0,0,2,1,1,4,2,2,0,0,0,6,6,0,2,2,0,0,0,0,20,2,18,1,15,2,0,2,5,0,5
10/01/2022 06:00,7,6,1,16,12,4,16,9,7,0,0,0,10,10,0,7,7,0,0,0,0,102,18,84,8,49,10,0,10,25,0,25
10/01/2022 07:00,15,14,1,25,17,8,36,24,12,0,0,0,31,31,0,9,9,0,0,0,0,168,46,122,31,102,29,0,29,53,0,53
10/01/2022 08:00,38,31,7,49,32,17,62,48,14,0,0,0,19,19,0,20,20,0,0,0,0,294,79,215,23,144,39,0,39,54,0,54
10/01/2022 09:00,13,9,4,37,19,18,46,25,21,0,0,0,8,8,0,7,7,0,0,0,0,113,25,88,17,76,26,0,26,62,0,62
10/01/2022 10:00,8,2,6,50,27,23,43,22,21,0,0,0,2,2,0,7,7,0,1,1,0,54,26,28,12,27,13,0,13,39,0,39
10/01/2022 11:00,10,6,4,48,19,29,53,21,32,0,0,0,7,7,0,8,8,0,0,0,0,70,19,51,27,34,38,0,38,52,0,52
10/01/2022 12:00,13,9,4,44,19,25,50,19,31,0,0,0,2,2,0,9,9,0,1,1,0,99,44,55,27,34,67,0,67,62,0,62
10/01/2022 13:00,20,12,8,74,32,42,72,36,36,0,0,0,2,2,0,8,8,0,0,0,0,93,43,50,55,37,75,0,75,84,0,84
10/01/2022 14:00,9,4,5,60,31,29,52,24,28,0,0,0,2,2,0,20,20,0,0,0,0,92,44,48,55,23,70,2,68,66,0,66
10/01/2022 15:00,19,8,11,64,29,35,65,27,38,0,0,0,4,4,0,24,24,0,7,7,0,150,79,71,68,29,63,1,62,81,0,81
10/01/2022 16:00,28,15,13,55,25,30,85,38,47,0,0,0,5,5,0,23,23,0,4,4,0,200,114,86,104,35,109,0,109,74,0,74
10/01/2022 17:00,22,7,15,75,26,49,84,23,61,0,0,0,2,2,0,27,27,0,17,17,0,247,142,105,171,45,159,3,156,93,3,90
10/01/2022 18:00,12,7,5,48,15,33,58,15,43,0,0,0,0,0,0,9,9,0,17,17,0,224,113,111,106,32,125,0,125,91,0,91
10/01/2022 19:00,9,4,5,37,16,21,44,21,23,0,0,0,2,2,0,5,5,0,3,3,0,117,64,53,66,14,113,2,111,72,0,72
10/01/2022 20:00,8,3,5,29,11,18,31,15,16,0,0,0,0,0,0,12,12,0,4,4,0,93,56,37,45,21,98,0,98,80,0,80
10/01/2022 21:00,4,1,3,16,7,9,22,7,15,0,0,0,1,1,0,12,12,0,1,1,0,66,44,22,37,15,33,1,32,40,0,40
10/01/2022 22:00,2,0,2,6,3,3,7,2,5,0,0,0,1,1,0,1,1,0,6,6,0,26,15,11,25,11,17,0,17,23,0,23
10/01/2022 23:00,3,2,1,3,1,2,6,3,3,0,0,0,0,0,0,1,1,0,0,0,0,15,6,9,7,4,13,0,13,5,0,5
11/01/2022 00:00,1,1,0,3,2,1,2,0,2,0,0,0,1,1,0,2,2,0,0,0,0,8,3,5,2,8,5,0,5,3,0,3
11/01/2022 01:00,0,0,0,0,0,0,0,0,0,0,0,0,0,0,0,0,0,0,0,0,0,4,4,0,2,0,0,0,0,0,0,0
11/01/2022 02:00,0,0,0,1,1,0,3,2,1,0,0,0,0,0,0,0,0,0,0,0,0,2,2,0,1,0,0,0,0,0,0,0
11/01/2022 03:00,0,0,0,0,0,0,2,1,1,0,0,0,0,0,0,1,1,0,0,0,0,2,0,2,0,1,0,0,0,0,0,0
11/01/2022 04:00,0,0,0,1,1,0,0,0,0,0,0,0,1,1,0,0,0,0,0,0,0,5,1,4,0,2,1,0,1,0,0,0
11/01/2022 05:00,0,0,0,1,0,1,4,1,3,0,0,0,2,2,0,1,1,0,0,0,0,26,2,24,2,16,2,0,2,5,0,5
11/01/2022 06:00,12,10,2,10,7,3,15,9,6,0,0,0,7,7,0,7,7,0,0,0,0,97,14,83,13,64,6,0,6,29,0,29
11/01/2022 07:00,17,14,3,52,32,20,60,33,27,0,0,0,21,21,0,15,15,0,3,3,0,179,48,131,27,96,24,0,24,51,0,51
11/01/2022 08:00,60,51,9,62,42,20,82,60,22,0,0,0,27,27,0,32,32,0,77,77,0,328,76,252,39,162,32,0,32,80,0,80
11/01/2022 09:00,13,9,4,64,31,33,58,31,27,0,0,0,13,13,0,11,11,0,7,7,0,142,38,104,16,102,26,0,26,75,0,75
11/01/2022 10:00,9,7,2,69,27,42,92,37,55,0,0,0,8,8,0,9,9,0,6,6,0,57,16,41,20,44,30,0,30,41,0,41
11/01/2022 11:00,5,5,0,98,48,50,115,56,59,0,0,0,5,5,0,11,11,0,2,2,0,56,26,30,18,29,30,2,28,53,0,53
11/01/2022 12:00,13,6,7,91,38,53,97,40,57,0,0,0,5,5,0,12,12,0,5,5,0,93,37,56,43,37,56,1,55,71,0,71
11/01/2022 13:00,20,7,13,91,46,45,95,42,53,0,0,0,3,3,0,13,13,0,11,11,0,102,36,66,49,29,69,1,68,94,0,94
11/01/2022 14:00,10,6,4,77,45,32,89,48,41,0,0,0,2,2,0,20,20,0,9,9,0,108,50,58,50,37,72,0,72,62,0,62
11/01/2022 15:00,13,6,7,74,36,38,85,33,52,0,0,0,5,5,0,38,38,0,19,19,0,140,73,67,63,29,60,0,60,80,0,80
11/01/2022 16:00,34,17,17,78,37,41,90,40,50,0,0,0,2,2,0,21,21,0,17,17,0,200,106,94,113,33,114,2,112,68,0,68
11/01/2022 17:00,21,7,14,59,14,45,81,20,61,0,0,0,2,2,0,20,20,0,9,9,0,283,155,128,180,36,139,3,136,89,1,88
11/01/2022 18:00,25,9,16,61,21,40,84,26,58,0,0,0,1,1,0,12,12,0,6,6,0,244,119,125,141,51,158,0,158,112,0,112
11/01/2022 19:00,13,5,8,30,12,18,53,17,36,0,0,0,3,3,0,14,14,0,4,4,0,131,76,55,60,20,107,1,106,77,0,77
11/01/2022 20:00,12,5,7,19,7,12,28,10,18,0,0,0,1,1,0,8,8,0,1,1,0,116,76,40,50,15,70,2,68,59,0,59
11/01/2022 21:00,9,3,6,13,10,3,15,5,10,0,0,0,2,2,0,4,4,0,3,3,0,56,32,24,44,20,55,1,54,48,0,48
11/01/2022 22:00,2,2,0,4,2,2,9,4,5,0,0,0,3,3,0,2,2,0,4,4,0,44,25,19,19,5,19,1,18,16,0,16
11/01/2022 23:00,1,1,0,3,1,2,5,4,1,0,0,0,0,0,0,1,1,0,1,1,0,18,12,6,10,4,14,0,14,11,0,11
12/01/2022 00:00,0,0,0,3,1,2,4,1,3,0,0,0,0,0,0,0,0,0,0,0,0,6,5,1,7,4,8,0,8,5,0,5
12/01/2022 01:00,1,1,0,2,1,1,0,0,0,0,0,0,0,0,0,0,0,0,0,0,0,5,5,0,1,1,1,0,1,0,0,0
12/01/2022 02:00,0,0,0,1,1,0,0,0,0,0,0,0,0,0,0,0,0,0,0,0,0,2,1,1,2,0,0,0,0,2,0,2
12/01/2022 03:00,1,0,1,0,0,0,0,0,0,0,0,0,0,0,0,0,0,0,0,0,0,1,0,1,0,0,2,0,2,0,0,0
12/01/2022 04:00,0,0,0,0,0,0,1,0,1,0,0,0,0,0,0,0,0,0,0,0,0,8,2,6,0,5,0,0,0,0,0,0
12/01/2022 05:00,1,1,0,3,2,1,3,2,1,0,0,0,2,2,0,1,1,0,0,0,0,25,3,22,2,15,2,0,2,6,0,6
12/01/2022 06:00,8,5,3,17,12,5,26,11,15,0,0,0,6,6,0,7,7,0,0,0,0,103,16,87,16,58,9,0,9,24,0,24
12/01/2022 07:00,23,19,4,38,20,18,40,21,19,0,0,0,46,46,0,14,14,0,0,0,0,207,54,153,28,116,17,0,17,61,1,60
12/01/2022 08:00,46,41,5,71,47,24,89,69,20,0,0,0,38,38,0,20,20,0,0,0,0,306,78,228,32,120,51,2,49,76,0,76
12/01/2022 09:00,23,14,9,51,29,22,68,32,36,0,0,0,15,15,0,7,7,0,0,0,0,156,46,110,29,97,24,0,24,70,0,70
12/01/2022 10:00,11,6,5,62,26,36,80,35,45,0,0,0,10,10,0,4,4,0,0,0,0,60,24,36,21,37,17,0,17,55,0,55
12/01/2022 11:00,12,9,3,68,29,39,88,37,51,0,0,0,11,11,0,8,8,0,0,0,0,61,19,42,25,36,40,1,39,62,0,62
12/01/2022 12:00,18,8,10,92,41,51,104,45,59,0,0,0,12,12,0,10,10,0,0,0,0,107,46,61,56,29,65,0,65,93,0,93
12/01/2022 13:00,23,13,10,89,43,46,106,50,56,0,0,0,11,11,0,25,25,0,0,0,0,118,46,72,60,50,73,1,72,106,0,106
12/01/2022 14:00,10,6,4,74,31,43,109,48,61,0,0,0,8,8,0,19,19,0,0,0,0,99,49,50,56,36,67,0,67,75,1,74
12/01/2022 15:00,17,10,7,90,46,44,86,41,45,0,0,0,9,9,0,22,22,0,0,0,0,174,89,85,61,47,71,1,70,83,0,83
12/01/2022 16:00,25,14,11,78,33,45,98,42,56,0,0,0,1,1,0,19,19,0,2,2,0,170,100,70,138,64,107,0,107,57,0,57
12/01/2022 17:00,26,11,15,67,19,48,111,40,71,0,0,0,5,5,0,10,10,0,0,0,0,246,140,106,178,45,166,2,164,107,0,107
12/01/2022 18:00,17,8,9,72,26,46,75,23,52,0,0,0,2,2,0,15,15,0,0,0,0,240,125,115,141,40,137,1,136,103,0,103
12/01/2022 19:00,16,6,10,44,19,25,54,25,29,0,0,0,0,0,0,7,7,0,0,0,0,161,92,69,70,29,103,0,103,86,0,86
12/01/2022 20:00,10,8,2,25,12,13,32,12,20,0,0,0,2,2,0,11,11,0,0,0,0,124,76,48,61,11,116,0,116,77,0,77
12/01/2022 21:00,7,4,3,17,5,12,16,5,11,0,0,0,0,0,0,4,4,0,0,0,0,62,45,17,35,19,70,1,69,45,0,45
12/01/2022 22:00,4,4,0,8,4,4,6,2,4,0,0,0,1,1,0,3,3,0,0,0,0,47,26,21,24,15,18,0,18,16,0,16
12/01/2022 23:00,1,0,1,3,2,1,2,0,2,0,0,0,0,0,0,2,2,0,0,0,0,16,8,8,12,4,18,0,18,8,0,8
13/01/2022 00:00,2,1,1,3,1,2,0,0,0,0,0,0,0,0,0,0,0,0,0,0,0,11,8,3,6,1,8,1,7,4,0,4
13/01/2022 01:00,1,1,0,1,1,0,0,0,0,0,0,0,0,0,0,1,1,0,0,0,0,4,4,0,1,3,1,0,1,0,0,0
13/01/2022 02:00,0,0,0,1,0,1,2,1,1,0,0,0,0,0,0,0,0,0,0,0,0,0,0,0,1,0,0,0,0,1,0,1
13/01/2022 03:00,0,0,0,1,1,0,0,0,0,0,0,0,0,0,0,0,0,0,0,0,0,2,0,2,1,0,2,0,2,1,0,1
13/01/2022 04:00,0,0,0,1,1,0,0,0,0,0,0,0,0,0,0,0,0,0,1,1,0,7,2,5,2,4,0,0,0,0,0,0
13/01/2022 05:00,1,1,0,4,2,2,5,2,3,0,0,0,2,2,0,2,2,0,0,0,0,24,1,23,1,13,0,0,0,4,0,4
13/01/2022 06:00,16,14,2,12,9,3,13,8,5,0,0,0,11,11,0,6,6,0,2,2,0,102,20,82,12,48,10,0,10,28,0,28
13/01/2022 07:00,18,16,2,50,29,21,51,32,19,0,0,0,26,25,1,12,12,0,4,4,0,200,53,147,32,108,19,0,19,54,0,54
13/01/2022 08:00,38,34,4,71,45,26,90,65,25,0,0,0,28,28,0,33,33,0,71,71,0,307,72,235,38,154,41,1,40,73,0,73
13/01/2022 09:00,20,14,6,47,26,21,62,32,30,0,0,0,19,19,0,8,8,0,13,13,0,144,39,105,19,78,39,1,38,52,0,52
13/01/2022 10:00,9,3,6,61,33,28,79,41,38,0,0,0,8,8,0,12,12,0,8,8,0,68,21,47,26,38,21,0,21,51,0,51
13/01/2022 11:00,5,2,3,58,25,33,88,47,41,0,0,0,7,7,0,16,16,0,6,6,0,82,36,46,30,28,43,0,43,63,0,63
13/01/2022 12:00,10,6,4,71,34,37,78,36,42,0,0,0,7,7,0,17,17,0,11,11,0,122,38,84,43,44,57,0,57,90,0,90
13/01/2022 13:00,19,13,6,84,35,49,88,37,51,0,0,0,4,4,0,9,9,0,8,8,0,104,45,59,54,40,94,0,94,113,2,111
13/01/2022 14:00,11,4,7,47,21,26,52,15,37,0,0,0,5,5,0,17,17,0,16,16,0,111,56,55,60,33,78,0,78,64,0,64
13/01/2022 15:00,22,12,10,55,29,26,74,35,39,0,0,0,4,4,0,32,32,0,21,21,0,161,69,92,67,35,67,0,67,74,0,74
13/01/2022 16:00,24,13,11,44,21,23,51,23,28,0,0,0,1,1,0,26,26,0,10,10,0,187,105,82,105,40,105,0,105,66,0,66
13/01/2022 17:00,31,12,19,49,10,39,75,13,62,0,0,0,5,5,0,17,17,0,7,7,0,218,115,103,174,33,157,1,156,119,1,118
13/01/2022 18:00,12,8,4,91,35,56,99,30,69,0,0,0,1,1,0,10,10,0,4,4,0,237,131,106,126,29,142,0,142,105,0,105
13/01/2022 19:00,14,6,8,34,16,18,44,21,23,0,0,0,2,2,0,14,14,0,1,1,0,154,86,68,89,24,96,0,96,117,1,116
13/01/2022 20:00,9,3,6,38,20,18,46,21,25,0,0,0,6,6,0,8,8,0,1,1,0,116,80,36,54,7,94,0,94,81,0,81
13/01/2022 21:00,5,1,4,13,6,7,19,5,14,0,0,0,1,0,1,9,9,0,0,0,0,75,52,23,34,5,60,0,60,55,0,55
13/01/2022 22:00,1,1,0,6,2,4,10,4,6,0,0,0,3,3,0,3,3,0,3,3,0,46,25,21,29,11,31,0,31,26,0,26
13/01/2022 23:00,3,1,2,1,0,1,4,1,3,0,0,0,0,0,0,2,2,0,0,0,0,24,12,12,12,4,10,0,10,11,0,11
14/01/2022 00:00,1,0,1,0,0,0,0,0,0,0,0,0,1,1,0,0,0,0,0,0,0,8,6,2,7,4,3,0,3,5,0,5
14/01/2022 01:00,0,0,0,0,0,0,0,0,0,0,0,0,0,0,0,1,1,0,0,0,0,3,2,1,4,1,2,0,2,0,0,0
14/01/2022 02:00,1,1,0,0,0,0,2,1,1,0,0,0,0,0,0,0,0,0,0,0,0,0,0,0,1,1,1,0,1,1,0,1
14/01/2022 03:00,0,0,0,0,0,0,0,0,0,0,0,0,0,0,0,0,0,0,0,0,0,1,0,1,1,0,1,0,1,0,0,0
14/01/2022 04:00,0,0,0,2,1,1,3,0,3,0,0,0,1,1,0,1,1,0,0,0,0,4,2,2,3,5,0,0,0,0,0,0
14/01/2022 05:00,0,0,0,5,3,2,6,3,3,0,0,0,4,4,0,0,0,0,0,0,0,20,1,19,1,16,1,0,1,2,0,2
14/01/2022 06:00,10,9,1,11,6,5,11,7,4,0,0,0,10,10,0,7,7,0,0,0,0,84,13,71,10,41,12,0,12,22,0,22
14/01/2022 07:00,12,11,1,37,19,18,39,17,22,0,0,0,18,18,0,10,10,0,0,0,0,195,63,132,27,68,20,0,20,67,0,67
14/01/2022 08:00,30,28,2,58,37,21,85,56,29,0,0,0,26,25,1,28,28,0,1,1,0,286,81,205,36,108,43,1,42,81,0,81
14/01/2022 09:00,22,14,8,38,22,16,53,27,26,0,0,0,20,19,1,4,4,0,0,0,0,134,33,101,30,89,26,0,26,64,0,64
14/01/2022 10:00,11,9,2,58,24,34,86,40,46,0,0,0,7,7,0,9,9,0,1,1,0,80,24,56,22,23,21,0,21,55,0,55
14/01/2022 11:00,15,8,7,57,29,28,66,35,31,0,0,0,12,11,1,8,8,0,0,0,0,88,32,56,18,17,12,0,12,75,0,75
14/01/2022 12:00,13,6,7,71,32,39,78,36,42,0,0,0,7,7,0,17,17,0,0,0,0,121,55,66,49,39,56,0,56,89,0,89
14/01/2022 13:00,13,7,6,73,38,35,89,45,44,0,0,0,4,4,0,15,15,0,1,1,0,137,60,77,73,58,77,0,77,96,1,95
14/01/2022 14:00,19,14,5,50,14,36,61,25,36,0,0,0,6,6,0,13,13,0,0,0,0,147,72,75,69,35,99,0,99,104,1,103
14/01/2022 15:00,21,15,6,84,46,38,98,47,51,0,0,0,4,4,0,21,21,0,0,0,0,145,75,70,81,38,85,0,85,108,0,108
14/01/2022 16:00,25,17,8,63,32,31,93,36,57,0,0,0,2,2,0,20,20,0,0,0,0,196,88,108,102,48,123,0,123,109,0,109
14/01/2022 17:00,18,11,7,35,10,25,53,16,37,0,0,0,7,7,0,23,23,0,0,0,0,237,129,108,150,36,189,0,189,111,1,110
14/01/2022 18:00,15,7,8,30,10,20,49,15,34,0,0,0,2,2,0,12,12,0,0,0,0,192,88,104,119,30,153,0,153,129,0,129
14/01/2022 19:00,6,1,5,16,6,10,29,12,17,0,0,0,4,4,0,8,8,0,0,0,0,148,87,61,82,27,112,1,111,113,0,113
14/01/2022 20:00,17,9,8,21,12,9,26,13,13,0,0,0,3,3,0,11,11,0,0,0,0,117,80,37,76,13,122,0,122,104,0,104
14/01/2022 21:00,7,5,2,8,1,7,12,0,12,0,0,0,1,1,0,4,4,0,2,2,0,89,60,29,70,23,68,0,68,72,0,72
14/01/2022 22:00,4,1,3,6,1,5,11,7,4,0,0,0,0,0,0,1,1,0,0,0,0,54,37,17,19,15,34,1,33,46,0,46
14/01/2022 23:00,0,0,0,6,3,3,4,0,4,0,0,0,0,0,0,0,0,0,2,2,0,38,29,9,34,6,16,0,16,21,0,21
15/01/2022 00:00,0,0,0,6,3,3,1,0,1,0,0,0,0,0,0,1,1,0,1,1,0,21,13,8,5,12,15,0,15,3,0,3
15/01/2022 01:00,0,0,0,0,0,0,1,0,1,0,0,0,0,0,0,1,1,0,0,0,0,11,6,5,3,2,2,0,2,1,0,1
15/01/2022 02:00,0,0,0,0,0,0,1,0,1,0,0,0,2,2,0,1,1,0,0,0,0,8,4,4,3,0,3,0,3,4,0,4
15/01/2022 03:00,0,0,0,2,0,2,2,1,1,0,0,0,0,0,0,2,2,0,0,0,0,7,3,4,3,4,4,1,3,1,0,1
15/01/2022 04:00,0,0,0,2,0,2,1,0,1,0,0,0,2,2,0,0,0,0,1,1,0,4,1,3,2,3,0,0,0,3,1,2
15/01/2022 05:00,1,1,0,1,0,1,1,0,1,0,0,0,0,0,0,0,0,0,1,1,0,16,1,15,3,5,1,0,1,1,0,1
15/01/2022 06:00,2,1,1,9,4,5,11,3,8,0,0,0,1,1,0,0,0,0,0,0,0,20,3,17,7,9,6,0,6,7,0,7
15/01/2022 07:00,3,1,2,22,10,12,27,11,16,0,0,0,7,7,0,6,6,0,4,4,0,43,8,35,10,24,18,0,18,9,0,9
15/01/2022 08:00,3,3,0,58,22,36,81,26,55,0,0,0,10,10,0,5,5,0,4,4,0,57,21,36,25,28,19,1,18,25,0,25
15/01/2022 09:00,18,11,7,123,47,76,145,56,89,0,0,0,9,9,0,9,9,0,5,5,0,73,26,47,13,41,25,0,25,55,0,55
15/01/2022 10:00,10,3,7,139,63,76,158,65,93,0,0,0,3,3,0,6,6,0,12,12,0,82,23,59,34,34,30,0,30,86,0,86
15/01/2022 11:00,11,7,4,168,89,79,171,75,96,0,0,0,3,3,0,15,15,0,13,13,0,79,29,50,30,52,62,0,62,71,1,70
15/01/2022 12:00,11,5,6,123,65,58,160,75,85,0,0,0,0,0,0,12,12,0,14,14,0,107,46,61,73,38,69,0,69,82,0,82
15/01/2022 13:00,7,3,4,111,58,53,148,61,87,0,0,0,3,3,0,12,12,0,13,13,0,149,63,86,72,56,72,0,72,114,0,114
15/01/2022 14:00,14,12,2,120,57,63,128,64,64,0,0,0,3,3,0,8,8,0,8,8,0,105,43,62,54,56,76,0,76,106,0,106
15/01/2022 15:00,9,4,5,109,49,60,122,56,66,0,0,0,4,4,0,6,6,0,8,8,0,114,45,69,45,48,67,0,67,103,2,101
15/01/2022 16:00,9,6,3,70,47,23,92,53,39,0,0,0,3,3,0,11,11,0,10,10,0,110,52,58,44,48,99,0,99,93,0,93
15/01/2022 17:00,10,5,5,55,20,35,54,22,32,0,0,0,3,3,0,9,9,0,3,3,0,95,50,45,52,22,108,0,108,73,0,73
15/01/2022 18:00,8,3,5,27,14,13,33,17,16,0,0,0,8,7,1,5,5,0,0,0,0,111,52,59,54,17,79,0,79,73,0,73
15/01/2022 19:00,4,2,2,26,13,13,33,14,19,0,0,0,6,6,0,5,5,0,4,4,0,79,44,35,55,24,72,1,71,64,0,64
15/01/2022 20:00,5,4,1,4,0,4,9,3,6,0,0,0,2,2,0,3,3,0,2,2,0,114,68,46,45,14,73,0,73,89,1,88
15/01/2022 21:00,9,4,5,4,1,3,9,3,6,0,0,0,1,1,0,0,0,0,6,6,0,79,45,34,28,12,4,0,4,63,0,63
15/01/2022 22:00,5,3,2,4,1,3,8,4,4,0,0,0,2,2,0,3,3,0,1,1,0,50,28,22,23,9,5,0,5,39,0,39
15/01/2022 23:00,3,1,2,1,1,0,2,1,1,0,0,0,0,0,0,2,2,0,0,0,0,27,19,8,16,6,2,0,2,10,0,10
16/01/2022 00:00,0,0,0,4,3,1,2,2,0,0,0,0,0,0,0,1,1,0,0,0,0,17,10,7,13,9,5,0,5,10,0,10
16/01/2022 01:00,0,0,0,1,0,1,0,0,0,0,0,0,2,2,0,1,1,0,0,0,0,5,2,3,10,2,0,0,0,0,0,0
16/01/2022 02:00,1,1,0,2,1,1,2,1,1,0,0,0,1,1,0,0,0,0,1,1,0,7,5,2,9,2,0,0,0,1,0,1
16/01/2022 03:00,0,0,0,2,1,1,3,2,1,0,0,0,0,0,0,1,1,0,0,0,0,3,1,2,3,3,1,0,1,1,0,1
16/01/2022 04:00,0,0,0,2,1,1,2,1,1,0,0,0,2,2,0,1,1,0,1,1,0,3,0,3,0,3,1,0,1,1,0,1
16/01/2022 05:00,2,2,0,0,0,0,0,0,0,0,0,0,1,1,0,0,0,0,0,0,0,6,1,5,1,3,0,0,0,0,0,0
16/01/2022 06:00,2,2,0,7,3,4,6,2,4,0,0,0,0,0,0,1,1,0,0,0,0,19,3,16,8,10,0,0,0,7,0,7
16/01/2022 07:00,3,2,1,23,7,16,25,6,19,0,0,0,7,7,0,1,1,0,0,0,0,20,6,14,12,8,1,0,1,5,0,5
16/01/2022 08:00,2,1,1,71,29,42,82,31,51,0,0,0,4,4,0,4,4,0,0,0,0,42,12,30,11,18,4,0,4,22,0,22
16/01/2022 09:00,9,6,3,148,49,99,137,45,92,0,0,0,8,8,0,4,4,0,0,0,0,58,19,39,25,28,0,0,0,31,0,31
16/01/2022 10:00,8,5,3,204,91,113,226,81,145,0,0,0,9,9,0,12,12,0,1,1,0,76,29,47,24,35,30,1,29,52,0,52
16/01/2022 11:00,15,8,7,223,109,114,247,107,140,0,0,0,2,2,0,13,13,0,4,4,0,112,38,74,41,37,41,0,41,39,0,39
16/01/2022 12:00,21,13,8,260,133,127,285,142,143,0,0,0,7,7,0,9,9,0,5,5,0,115,41,74,48,45,56,0,56,58,0,58
16/01/2022 13:00,19,11,8,202,99,103,244,107,137,0,0,0,7,7,0,11,11,0,9,9,0,125,60,65,54,49,56,1,55,91,0,91
16/01/2022 14:00,21,10,11,191,100,91,252,123,129,0,0,0,5,5,0,17,17,0,6,6,0,121,47,74,57,43,71,0,71,90,0,90
16/01/2022 15:00,18,8,10,219,124,95,250,146,104,0,0,0,5,5,0,17,17,0,1,1,0,120,55,65,57,50,59,1,58,66,0,66
16/01/2022 16:00,19,12,7,117,72,45,135,85,50,0,0,0,4,4,0,18,18,0,6,6,0,118,57,61,50,36,54,0,54,55,0,55
16/01/2022 17:00,7,5,2,53,23,30,53,22,31,0,0,0,6,6,0,5,5,0,0,0,0,92,44,48,45,13,93,1,92,55,0,55
16/01/2022 18:00,7,3,4,17,7,10,22,12,10,0,0,0,9,9,0,8,8,0,4,4,0,133,62,71,48,16,93,0,93,63,2,61
16/01/2022 19:00,5,2,3,12,6,6,11,5,6,0,0,0,4,4,0,7,7,0,4,4,0,94,49,45,54,20,77,0,77,65,1,64
16/01/2022 20:00,2,2,0,11,6,5,22,11,11,0,0,0,2,2,0,3,3,0,1,1,0,73,45,28,47,13,79,0,79,57,1,56
16/01/2022 21:00,7,6,1,10,3,7,21,9,12,0,0,0,4,4,0,2,2,0,1,1,0,50,33,17,29,15,50,1,49,40,0,40
16/01/2022 22:00,7,3,4,2,1,1,8,4,4,0,0,0,1,1,0,2,2,0,0,0,0,30,14,16,19,11,34,0,34,25,1,24
16/01/2022 23:00,1,0,1,3,0,3,2,0,2,0,0,0,0,0,0,0,0,0,1,1,0,22,15,7,13,5,15,0,15,9,0,9
17/01/2022 00:00,0,0,0,2,2,0,3,2,1,0,0,0,0,0,0,0,0,0,0,0,0,7,4,3,6,2,4,0,4,3,0,3
17/01/2022 01:00,0,0,0,0,0,0,0,0,0,0,0,0,0,0,0,0,0,0,1,1,0,4,2,2,0,1,0,0,0,0,0,0
17/01/2022 02:00,0,0,0,0,0,0,0,0,0,0,0,0,0,0,0,0,0,0,0,0,0,0,0,0,0,0,0,0,0,2,0,2
17/01/2022 03:00,0,0,0,0,0,0,0,0,0,0,0,0,0,0,0,0,0,0,1,1,0,1,0,1,0,0,1,0,1,0,0,0
17/01/2022 04:00,0,0,0,0,0,0,3,1,2,0,0,0,0,0,0,0,0,0,1,1,0,8,4,4,0,4,3,0,3,1,0,1
17/01/2022 05:00,0,0,0,5,3,2,6,3,3,0,0,0,3,3,0,1,1,0,0,0,0,19,2,17,2,17,1,0,1,7,0,7
17/01/2022 06:00,13,12,1,5,5,0,10,8,2,0,0,0,12,12,0,8,8,0,1,1,0,93,14,79,13,53,9,0,9,25,0,25
17/01/2022 07:00,10,7,3,43,28,15,54,38,16,0,0,0,21,19,2,14,14,0,0,0,0,167,46,121,27,100,18,0,18,51,0,51
17/01/2022 08:00,41,36,5,55,34,21,59,44,15,0,0,0,22,22,0,36,36,0,26,26,0,322,84,238,46,143,37,0,37,64,0,64
17/01/2022 09:00,26,20,6,37,19,18,46,24,22,0,0,0,10,10,0,5,5,0,13,13,0,144,31,113,18,96,22,0,22,84,1,83
17/01/2022 10:00,18,11,7,52,30,22,58,30,28,0,0,0,7,7,0,8,8,0,6,6,0,64,18,46,16,52,22,0,22,53,0,53
17/01/2022 11:00,8,4,4,65,18,47,84,27,57,0,0,0,4,4,0,4,4,0,6,6,0,80,30,50,33,32,42,2,40,51,0,51
17/01/2022 12:00,12,6,6,80,41,39,99,45,54,0,0,0,1,1,0,13,13,0,11,11,0,107,45,62,48,37,61,0,61,79,0,79
17/01/2022 13:00,10,6,4,98,49,49,105,49,56,0,0,0,4,4,0,16,16,0,12,12,0,118,55,63,57,44,70,0,70,105,0,105
17/01/2022 14:00,21,11,10,83,42,41,98,46,52,0,0,0,3,3,0,16,16,0,9,9,0,118,55,63,52,38,80,0,80,76,0,76
17/01/2022 15:00,26,12,14,96,46,50,106,51,55,0,0,0,9,9,0,31,31,0,2,2,0,137,70,67,86,31,88,4,84,86,0,86
17/01/2022 16:00,24,12,12,93,48,45,101,48,53,0,0,0,2,2,0,20,20,0,0,0,0,194,110,84,106,54,118,0,118,58,0,58
17/01/2022 17:00,20,8,12,77,32,45,89,35,54,0,0,0,7,7,0,21,21,0,0,0,0,269,143,126,158,50,164,1,163,88,0,88
17/01/2022 18:00,16,9,7,48,15,33,65,21,44,0,0,0,1,1,0,16,16,0,0,0,0,287,166,121,145,11,138,1,137,99,0,99
17/01/2022 19:00,10,6,4,26,8,18,36,9,27,0,0,0,3,3,0,8,8,0,0,0,0,149,79,70,76,13,122,1,121,65,0,65
17/01/2022 20:00,8,4,4,27,9,18,30,10,20,0,0,0,1,1,0,6,6,0,0,0,0,108,69,39,61,17,87,0,87,52,0,52
17/01/2022 21:00,11,8,3,8,2,6,14,8,6,0,0,0,1,1,0,11,11,0,0,0,0,60,43,17,57,10,55,0,55,30,1,29
17/01/2022 22:00,3,2,1,5,3,2,7,2,5,0,0,0,1,1,0,2,2,0,0,0,0,40,21,19,18,12,28,0,28,9,0,9
17/01/2022 23:00,1,0,1,2,0,2,4,0,4,0,0,0,0,0,0,0,0,0,0,0,0,13,11,2,12,5,10,0,10,5,0,5
18/01/2022 00:00,0,0,0,0,0,0,0,0,0,0,0,0,0,0,0,0,0,0,0,0,0,7,4,3,6,0,7,0,7,2,0,2
18/01/2022 01:00,0,0,0,0,0,0,0,0,0,0,0,0,0,0,0,0,0,0,0,0,0,3,3,0,1,2,1,0,1,0,0,0
18/01/2022 02:00,0,0,0,0,0,0,1,1,0,0,0,0,0,0,0,0,0,0,0,0,0,1,1,0,2,0,1,0,1,4,0,4
18/01/2022 03:00,0,0,0,0,0,0,1,0,1,0,0,0,0,0,0,0,0,0,0,0,0,1,0,1,1,2,0,0,0,3,0,3
18/01/2022 04:00,0,0,0,0,0,0,1,0,1,0,0,0,0,0,0,0,0,0,0,0,0,5,1,4,1,5,0,0,0,1,0,1
18/01/2022 05:00,1,1,0,6,3,3,7,4,3,0,0,0,2,2,0,1,1,0,0,0,0,24,0,24,0,18,2,0,2,6,0,6
18/01/2022 06:00,15,15,0,15,11,4,11,8,3,0,0,0,10,10,0,8,8,0,1,1,0,105,18,87,18,63,8,0,8,29,1,28
18/01/2022 07:00,14,12,2,53,37,16,67,46,21,0,0,0,25,25,0,11,11,0,0,0,0,209,68,141,25,97,20,0,20,46,0,46
18/01/2022 08:00,53,43,10,54,37,17,66,44,22,0,0,0,21,21,0,34,34,0,8,8,0,334,76,258,39,146,43,0,43,45,0,45
18/01/2022 09:00,21,14,7,45,27,18,59,34,25,0,0,0,18,18,0,8,8,0,9,9,0,165,45,120,18,88,19,0,19,65,0,65
18/01/2022 10:00,10,7,3,54,31,23,64,30,34,0,0,0,8,7,1,11,11,0,2,2,0,69,16,53,20,48,21,0,21,39,0,39
18/01/2022 11:00,5,3,2,55,23,32,60,28,32,0,0,0,10,10,0,6,6,0,2,2,0,80,32,48,21,27,33,0,33,50,0,50
18/01/2022 12:00,14,10,4,63,29,34,75,35,40,0,0,0,1,1,0,11,11,0,5,5,0,83,37,46,49,49,49,0,49,66,1,65
18/01/2022 13:00,9,4,5,57,32,25,60,33,27,0,0,0,3,3,0,7,7,0,5,5,0,104,43,61,59,44,68,0,68,90,1,89
18/01/2022 14:00,9,6,3,72,37,35,78,33,45,0,0,0,0,0,0,16,16,0,8,8,0,94,39,55,53,46,68,0,68,54,0,54
18/01/2022 15:00,19,15,4,64,28,36,58,26,32,0,0,0,2,2,0,48,48,0,15,15,0,137,74,63,68,42,67,2,65,62,0,62
18/01/2022 16:00,37,21,16,68,26,42,92,38,54,0,0,0,2,2,0,14,14,0,1,1,0,205,120,85,112,46,90,1,89,71,1,70
18/01/2022 17:00,32,12,20,61,14,47,62,9,53,0,0,0,0,0,0,16,16,0,0,0,0,274,147,127,186,38,149,0,149,95,1,94
18/01/2022 18:00,19,9,10,49,15,34,60,12,48,0,0,0,4,4,0,18,18,0,0,0,0,287,159,128,155,50,163,0,163,120,0,120
18/01/2022 19:00,12,2,10,40,12,28,52,21,31,0,0,0,0,0,0,14,14,0,0,0,0,120,62,58,73,14,117,0,117,80,0,80
18/01/2022 20:00,7,4,3,22,7,15,28,9,19,0,0,0,1,1,0,8,8,0,2,2,0,109,64,45,54,30,84,0,84,71,0,71
18/01/2022 21:00,11,5,6,12,6,6,18,5,13,0,0,0,1,0,1,10,10,0,1,1,0,63,48,15,28,16,60,0,60,34,0,34
18/01/2022 22:00,9,7,2,12,5,7,12,2,10,0,0,0,1,1,0,2,2,0,0,0,0,43,17,26,25,14,24,0,24,18,0,18
18/01/2022 23:00,5,2,3,1,0,1,1,0,1,0,0,0,0,0,0,2,2,0,0,0,0,17,11,6,9,5,14,1,13,5,0,5
19/01/2022 00:00,0,0,0,0,0,0,2,0,2,0,0,0,0,0,0,0,0,0,0,0,0,11,6,5,5,0,7,0,7,5,0,5
19/01/2022 01:00,0,0,0,1,1,0,0,0,0,0,0,0,0,0,0,0,0,0,0,0,0,5,4,1,2,0,3,0,3,0,0,0
19/01/2022 02:00,0,0,0,2,1,1,1,0,1,0,0,0,0,0,0,0,0,0,0,0,0,2,1,1,2,0,2,1,1,1,0,1
19/01/2022 03:00,1,0,1,0,0,0,0,0,0,0,0,0,0,0,0,0,0,0,0,0,0,0,0,0,1,0,2,0,2,0,0,0
19/01/2022 04:00,0,0,0,1,1,0,2,2,0,0,0,0,0,0,0,0,0,0,0,0,0,9,1,8,3,4,0,0,0,1,0,1
19/01/2022 05:00,1,1,0,3,1,2,5,2,3,0,0,0,3,3,0,1,1,0,0,0,0,28,3,25,0,20,2,0,2,3,0,3
19/01/2022 06:00,12,10,2,17,15,2,22,18,4,0,0,0,5,4,1,6,6,0,1,1,0,97,12,85,15,52,7,0,7,36,0,36
19/01/2022 07:00,20,19,1,50,35,15,51,34,17,0,0,0,21,21,0,17,17,0,0,0,0,238,77,161,34,99,27,0,27,59,0,59
19/01/2022 08:00,49,41,8,67,42,25,72,51,21,0,0,0,23,23,0,36,36,0,0,0,0,343,79,264,44,162,51,0,51,105,0,105
19/01/2022 09:00,29,22,7,40,23,17,48,26,22,0,0,0,6,6,0,7,7,0,0,0,0,158,35,123,22,88,29,0,29,97,1,96
19/01/2022 10:00,17,10,7,54,30,24,69,29,40,0,0,0,8,8,0,11,11,0,3,3,0,75,17,58,13,39,21,0,21,66,0,66
19/01/2022 11:00,7,4,3,65,29,36,73,28,45,0,0,0,5,4,1,4,4,0,8,8,0,75,19,56,24,42,33,0,33,60,0,60
19/01/2022 12:00,16,9,7,74,30,44,79,33,46,0,0,0,7,7,0,12,12,0,10,10,0,108,44,64,52,44,51,0,51,95,0,95
19/01/2022 13:00,13,8,5,75,37,38,102,53,49,0,0,0,12,11,1,32,32,0,12,12,0,146,70,76,70,52,85,0,85,86,1,85
19/01/2022 14:00,11,6,5,61,31,30,80,36,44,0,0,0,9,9,0,20,20,0,4,4,0,121,60,61,54,49,82,0,82,56,0,56
19/01/2022 15:00,18,8,10,57,28,29,61,31,30,0,0,0,6,6,0,27,27,0,9,9,0,154,62,92,60,40,82,0,82,68,0,68
19/01/2022 16:00,21,9,12,64,22,42,81,32,49,0,0,0,5,5,0,17,17,0,0,0,0,185,109,76,114,42,112,0,112,81,0,81
19/01/2022 17:00,29,13,16,64,21,43,78,21,57,0,0,0,5,5,0,21,21,0,2,2,0,263,139,124,172,49,167,1,166,89,0,89
19/01/2022 18:00,16,6,10,57,12,45,71,19,52,0,0,0,1,1,0,14,14,0,0,0,0,263,152,111,160,47,159,1,158,105,0,105
19/01/2022 19:00,15,6,9,39,16,23,49,19,30,0,0,0,1,1,0,7,7,0,0,0,0,151,83,68,72,24,117,1,116,93,1,92
19/01/2022 20:00,11,7,4,33,15,18,44,19,25,0,0,0,1,1,0,13,13,0,0,0,0,140,87,53,73,33,141,1,140,81,0,81
19/01/2022 21:00,9,5,4,17,9,8,9,4,5,0,0,0,0,0,0,7,7,0,0,0,0,73,53,20,44,23,69,0,69,47,1,46
19/01/2022 22:00,1,0,1,4,2,2,6,2,4,0,0,0,2,2,0,1,1,0,1,1,0,40,23,17,17,3,30,0,30,27,0,27
19/01/2022 23:00,1,0,1,3,1,2,1,1,0,0,0,0,0,0,0,3,3,0,0,0,0,19,14,5,12,3,10,0,10,12,0,12
20/01/2022 00:00,1,0,1,0,0,0,2,1,1,0,0,0,1,1,0,1,1,0,0,0,0,15,10,5,4,0,5,0,5,5,0,5
20/01/2022 01:00,1,1,0,0,0,0,0,0,0,0,0,0,0,0,0,1,1,0,0,0,0,3,2,1,3,2,0,0,0,2,0,2
20/01/2022 02:00,0,0,0,0,0,0,1,1,0,0,0,0,1,1,0,0,0,0,0,0,0,3,2,1,3,0,1,0,1,1,0,1
20/01/2022 03:00,0,0,0,0,0,0,1,0,1,0,0,0,0,0,0,1,1,0,0,0,0,0,0,0,0,2,1,0,1,1,0,1
20/01/2022 04:00,0,0,0,2,2,0,1,1,0,0,0,0,0,0,0,0,0,0,0,0,0,6,2,4,1,0,0,0,0,0,0,0
20/01/2022 05:00,0,0,0,4,2,2,6,2,4,0,0,0,4,4,0,1,1,0,1,1,0,25,2,23,1,19,0,0,0,2,0,2
20/01/2022 06:00,14,12,2,19,14,5,20,16,4,0,0,0,6,6,0,5,5,0,2,2,0,101,23,78,17,60,7,0,7,27,0,27
20/01/2022 07:00,21,17,4,50,32,18,62,42,20,0,0,0,18,18,0,11,11,0,1,1,0,222,77,145,34,96,28,0,28,54,0,54
20/01/2022 08:00,53,41,12,72,52,20,83,56,27,0,0,0,34,34,0,34,34,0,33,33,0,334,78,256,41,163,36,0,36,82,0,82
20/01/2022 09:00,18,15,3,46,23,23,68,36,32,0,0,0,12,12,0,7,7,0,8,8,0,153,36,117,24,78,21,0,21,85,0,85
20/01/2022 10:00,14,8,6,60,28,32,71,33,38,0,0,0,9,9,0,10,10,0,10,10,0,82,21,61,20,28,19,0,19,53,0,53
20/01/2022 11:00,10,7,3,61,29,32,68,34,34,0,0,0,4,4,0,8,8,0,10,10,0,77,28,49,26,36,40,0,40,64,0,64
20/01/2022 12:00,15,8,7,85,44,41,92,46,46,0,0,0,5,5,0,17,17,0,14,14,0,114,41,73,50,53,76,0,76,78,0,78
20/01/2022 13:00,12,6,6,58,26,32,81,41,40,0,0,0,5,5,0,16,16,0,12,12,0,125,63,62,59,51,79,0,79,108,0,108
20/01/2022 14:00,16,10,6,45,20,25,80,34,46,0,0,0,3,3,0,17,17,0,6,6,0,115,53,62,60,19,71,1,70,69,0,69
20/01/2022 15:00,22,10,12,40,17,23,56,26,30,0,0,0,5,5,0,24,24,0,19,19,0,160,71,89,64,29,71,0,71,68,1,67
20/01/2022 16:00,28,15,13,49,22,27,63,21,42,0,0,0,1,1,0,16,16,0,7,7,0,199,101,98,133,44,77,0,77,74,1,73
20/01/2022 17:00,31,17,14,58,19,39,75,23,52,0,0,0,5,5,0,16,16,0,2,2,0,283,150,133,169,34,162,0,162,130,1,129
20/01/2022 18:00,22,9,13,71,26,45,83,24,59,0,0,0,2,2,0,14,14,0,1,1,0,265,137,128,146,50,163,1,162,113,0,113
20/01/2022 19:00,17,3,14,41,16,25,45,18,27,0,0,0,0,0,0,11,11,0,1,1,0,152,92,60,80,25,120,2,118,109,1,108
20/01/2022 20:00,7,4,3,33,17,16,45,19,26,0,0,0,0,0,0,10,10,0,1,1,0,149,96,53,67,24,115,2,113,121,2,119
20/01/2022 21:00,13,7,6,17,8,9,25,7,18,0,0,0,0,0,0,7,7,0,1,1,0,89,58,31,56,11,77,1,76,55,0,55
20/01/2022 22:00,6,3,3,4,1,3,6,3,3,0,0,0,0,0,0,4,4,0,1,1,0,58,35,23,22,4,37,0,37,25,0,25
20/01/2022 23:00,5,1,4,1,0,1,4,1,3,0,0,0,0,0,0,2,2,0,0,0,0,20,11,9,13,3,7,0,7,10,0,10
21/01/2022 00:00,1,1,0,0,0,0,2,1,1,0,0,0,0,0,0,0,0,0,0,0,0,10,6,4,3,6,12,0,12,3,0,3
21/01/2022 01:00,0,0,0,0,0,0,0,0,0,0,0,0,0,0,0,2,2,0,0,0,0,4,2,2,3,4,0,0,0,0,0,0
21/01/2022 02:00,0,0,0,0,0,0,0,0,0,0,0,0,0,0,0,0,0,0,0,0,0,2,1,1,2,1,1,0,1,2,0,2
21/01/2022 03:00,0,0,0,0,0,0,0,0,0,0,0,0,0,0,0,0,0,0,0,0,0,4,3,1,0,1,1,0,1,0,0,0
21/01/2022 04:00,0,0,0,2,1,1,2,1,1,0,0,0,0,0,0,1,1,0,0,0,0,5,1,4,0,4,0,0,0,1,0,1
21/01/2022 05:00,2,2,0,6,3,3,8,5,3,0,0,0,3,3,0,0,0,0,0,0,0,21,1,20,2,13,1,0,1,5,0,5
21/01/2022 06:00,13,11,2,12,10,2,16,12,4,0,0,0,11,10,1,5,5,0,4,4,0,90,16,74,13,51,8,0,8,26,0,26
21/01/2022 07:00,19,18,1,26,17,9,39,27,12,0,0,0,28,28,0,10,10,0,2,2,0,189,47,142,33,82,23,0,23,58,0,58
21/01/2022 08:00,36,30,6,54,31,23,75,48,27,0,0,0,27,27,0,27,27,0,53,53,0,297,72,225,43,126,34,1,33,79,1,78
21/01/2022 09:00,25,18,7,35,18,17,35,17,18,0,0,0,13,13,0,9,9,0,6,6,0,155,31,124,28,82,42,0,42,80,1,79
21/01/2022 10:00,11,4,7,78,32,46,85,35,50,0,0,0,5,5,0,10,10,0,4,4,0,91,28,63,22,47,16,0,16,72,0,72
21/01/2022 11:00,7,3,4,60,23,37,76,29,47,0,0,0,5,5,0,14,14,0,8,8,0,99,27,72,35,36,44,0,44,52,0,52
21/01/2022 12:00,14,5,9,83,48,35,90,54,36,0,0,0,3,3,0,13,13,0,7,7,0,121,48,73,33,46,68,0,68,74,0,74
21/01/2022 13:00,18,6,12,50,23,27,82,41,41,0,0,0,4,4,0,17,17,0,5,5,0,156,66,90,55,56,86,1,85,90,0,90
21/01/2022 14:00,22,14,8,48,23,25,66,28,38,0,0,0,3,3,0,15,15,0,6,6,0,142,81,61,55,42,93,0,93,83,0,83
21/01/2022 15:00,16,7,9,57,25,32,74,32,42,0,0,0,5,5,0,32,32,0,16,16,0,165,78,87,87,39,85,0,85,84,0,84
21/01/2022 16:00,20,13,7,69,28,41,88,33,55,0,0,0,2,2,0,17,17,0,5,5,0,191,86,105,109,51,120,0,120,71,0,71
21/01/2022 17:00,28,16,12,53,16,37,64,15,49,0,0,0,8,8,0,20,20,0,6,6,0,245,134,111,148,53,155,0,155,125,0,125
21/01/2022 18:00,16,8,8,38,6,32,57,15,42,0,0,0,2,2,0,15,15,0,3,3,0,212,114,98,94,31,168,1,167,135,0,135
21/01/2022 19:00,10,6,4,17,5,12,19,5,14,0,0,0,2,2,0,6,6,0,2,2,0,121,69,52,70,14,93,0,93,99,0,99
21/01/2022 20:00,18,11,7,17,8,9,40,17,23,0,0,0,4,4,0,10,10,0,4,4,0,143,88,55,74,30,107,1,106,95,2,93
21/01/2022 21:00,7,4,3,13,5,8,23,9,14,0,0,0,4,4,0,6,6,0,5,5,0,108,76,32,56,17,84,0,84,63,1,62
21/01/2022 22:00,3,3,0,6,2,4,14,3,11,0,0,0,0,0,0,1,1,0,6,6,0,58,34,24,29,10,44,0,44,37,0,37
21/01/2022 23:00,0,0,0,1,1,0,10,6,4,0,0,0,0,0,0,1,1,0,0,0,0,28,20,8,24,6,22,0,22,21,0,21
22/01/2022 00:00,4,2,2,1,1,0,5,2,3,0,0,0,3,3,0,1,1,0,1,1,0,20,8,12,9,4,12,1,11,7,0,7
22/01/2022 01:00,1,1,0,2,1,1,2,0,2,0,0,0,0,0,0,0,0,0,0,0,0,10,7,3,11,3,5,0,5,0,0,0
22/01/2022 02:00,0,0,0,0,0,0,1,0,1,0,0,0,1,1,0,0,0,0,0,0,0,1,1,0,6,0,5,0,5,1,0,1
22/01/2022 03:00,2,1,1,0,0,0,0,0,0,0,0,0,0,0,0,0,0,0,0,0,0,3,1,2,3,3,1,0,1,2,0,2
22/01/2022 04:00,0,0,0,0,0,0,1,1,0,0,0,0,0,0,0,0,0,0,1,1,0,6,0,6,3,2,0,0,0,0,0,0
22/01/2022 05:00,2,2,0,5,3,2,4,2,2,0,0,0,3,3,0,1,1,0,2,2,0,11,4,7,2,6,5,0,5,3,0,3
22/01/2022 06:00,3,2,1,5,2,3,5,2,3,0,0,0,4,4,0,0,0,0,0,0,0,32,8,24,11,7,7,0,7,6,0,6
22/01/2022 07:00,3,3,0,21,8,13,21,8,13,0,0,0,6,6,0,4,4,0,2,2,0,55,13,42,18,24,13,0,13,9,0,9
22/01/2022 08:00,11,7,4,63,23,40,64,24,40,0,0,0,10,9,1,5,5,0,7,7,0,54,20,34,13,35,21,0,21,26,1,25
22/01/2022 09:00,9,3,6,115,49,66,134,52,82,0,0,0,7,7,0,17,17,0,7,7,0,86,35,51,27,38,27,0,27,59,0,59
22/01/2022 10:00,13,9,4,118,51,67,139,59,80,0,0,0,5,5,0,14,14,0,13,13,0,87,30,57,29,29,41,1,40,60,0,60
22/01/2022 11:00,15,7,8,145,66,79,187,76,111,0,0,0,1,1,0,16,16,0,18,18,0,107,35,72,52,58,44,0,44,86,0,86
22/01/2022 12:00,13,9,4,176,102,74,192,101,91,0,0,0,4,4,0,9,9,0,7,7,0,138,60,78,54,55,74,0,74,87,0,87
22/01/2022 13:00,11,7,4,149,79,70,172,86,86,0,0,0,11,11,0,11,11,0,4,4,0,142,63,79,68,43,76,0,76,107,0,107
22/01/2022 14:00,12,4,8,112,55,57,139,73,66,0,0,0,8,8,0,6,6,0,1,1,0,130,53,77,63,44,84,3,81,107,1,106
22/01/2022 15:00,23,11,12,93,49,44,127,66,61,0,0,0,11,11,0,8,8,0,1,1,0,113,50,63,60,53,81,0,81,95,0,95
22/01/2022 16:00,15,10,5,81,49,32,76,44,32,0,0,0,6,6,0,12,12,0,2,2,0,115,55,60,60,38,82,0,82,70,0,70
22/01/2022 17:00,8,3,5,40,20,20,43,23,20,0,0,0,1,1,0,6,6,0,3,3,0,126,51,75,65,21,122,1,121,52,0,52
22/01/2022 18:00,6,1,5,32,17,15,36,20,16,0,0,0,2,2,0,10,10,0,2,2,0,102,49,53,45,18,80,0,80,97,1,96
22/01/2022 19:00,9,5,4,15,9,6,19,9,10,0,0,0,3,3,0,3,3,0,1,1,0,109,51,58,48,21,84,0,84,80,0,80
22/01/2022 20:00,8,4,4,13,8,5,17,8,9,0,0,0,3,3,0,8,8,0,4,4,0,81,48,33,43,25,63,3,60,89,1,88
22/01/2022 21:00,6,3,3,6,4,2,7,3,4,0,0,0,4,4,0,3,3,0,1,1,0,56,28,28,30,23,57,1,56,73,0,73
22/01/2022 22:00,4,4,0,6,2,4,11,4,7,0,0,0,3,3,0,2,2,0,0,0,0,36,27,9,14,7,37,0,37,41,0,41
22/01/2022 23:00,1,0,1,3,0,3,3,0,3,0,0,0,0,0,0,1,1,0,0,0,0,37,28,9,14,3,29,0,29,9,1,8
23/01/2022 00:00,2,2,0,1,0,1,1,1,0,0,0,0,0,0,0,3,3,0,0,0,0,29,17,12,15,5,30,0,30,12,2,10
23/01/2022 01:00,0,0,0,0,0,0,1,0,1,0,0,0,0,0,0,1,1,0,0,0,0,22,10,12,20,1,0,0,0,2,0,2
23/01/2022 02:00,0,0,0,1,1,0,1,0,1,0,0,0,0,0,0,0,0,0,0,0,0,10,4,6,12,3,15,0,15,4,0,4
23/01/2022 03:00,0,0,0,3,2,1,0,0,0,0,0,0,0,0,0,1,1,0,0,0,0,8,5,3,5,0,10,0,10,3,0,3
23/01/2022 04:00,1,1,0,1,0,1,2,0,2,0,0,0,0,0,0,0,0,0,1,1,0,7,4,3,4,2,5,0,5,2,0,2
23/01/2022 05:00,0,0,0,2,1,1,2,1,1,0,0,0,2,2,0,0,0,0,1,1,0,5,2,3,4,4,5,0,5,3,0,3
23/01/2022 06:00,2,2,0,7,3,4,8,3,5,0,0,0,2,2,0,0,0,0,1,1,0,20,3,17,9,16,7,0,7,6,1,5
23/01/2022 07:00,6,4,2,26,10,16,27,11,16,0,0,0,3,3,0,2,2,0,0,0,0,34,12,22,8,15,11,0,11,11,0,11
23/01/2022 08:00,2,2,0,99,41,58,95,44,51,0,0,0,5,5,0,1,1,0,0,0,0,38,13,25,10,16,9,0,9,25,0,25
23/01/2022 09:00,10,9,1,141,48,93,154,50,104,0,0,0,17,17,0,4,4,0,0,0,0,49,19,30,22,25,21,0,21,36,0,36
23/01/2022 10:00,13,6,7,188,76,112,186,77,109,0,0,0,6,5,1,6,6,0,0,0,0,67,33,34,39,37,32,0,32,36,0,36
23/01/2022 11:00,10,6,4,191,96,95,204,86,118,0,0,0,11,11,0,20,20,0,0,0,0,138,40,98,34,29,39,1,38,49,0,49
23/01/2022 12:00,20,10,10,228,115,113,255,131,124,0,0,0,8,8,0,23,23,0,3,3,0,96,36,60,46,21,54,1,53,60,1,59
23/01/2022 13:00,9,6,3,141,83,58,165,89,76,0,0,0,3,3,0,15,15,0,13,13,0,132,62,70,57,42,60,0,60,71,0,71
23/01/2022 14:00,16,9,7,143,75,68,162,81,81,0,0,0,6,5,1,9,9,0,6,6,0,124,46,78,48,47,69,0,69,110,1,109
23/01/2022 15:00,7,5,2,108,54,54,131,66,65,0,0,0,5,5,0,14,14,0,10,10,0,109,41,68,39,32,76,0,76,97,0,97
23/01/2022 16:00,8,3,5,76,52,24,90,60,30,0,0,0,3,3,0,10,10,0,0,0,0,121,63,58,55,20,84,1,83,81,1,80
23/01/2022 17:00,12,8,4,29,15,14,36,18,18,0,0,0,1,1,0,3,3,0,0,0,0,124,52,72,37,24,84,0,84,71,0,71
23/01/2022 18:00,11,4,7,19,13,6,26,14,12,0,0,0,1,1,0,10,10,0,0,0,0,111,61,50,40,11,97,0,97,61,1,60
23/01/2022 19:00,9,5,4,17,7,10,20,8,12,0,0,0,1,1,0,5,5,0,0,0,0,81,45,36,35,12,77,0,77,58,1,57
23/01/2022 20:00,5,3,2,6,4,2,21,10,11,0,0,0,0,0,0,3,3,0,1,1,0,57,35,22,42,14,64,0,64,58,1,57
23/01/2022 21:00,2,1,1,7,3,4,5,1,4,0,0,0,2,2,0,2,2,0,0,0,0,57,34,23,22,13,49,1,48,52,0,52
23/01/2022 22:00,5,2,3,4,0,4,5,1,4,0,0,0,1,1,0,2,2,0,1,1,0,40,23,17,20,12,28,1,27,34,0,34
23/01/2022 23:00,1,0,1,2,1,1,5,2,3,0,0,0,0,0,0,2,2,0,2,2,0,27,16,11,22,6,38,1,37,19,0,19
24/01/2022 00:00,0,0,0,4,2,2,2,1,1,0,0,0,1,1,0,0,0,0,1,1,0,9,3,6,7,2,16,0,16,7,1,6
24/01/2022 01:00,0,0,0,0,0,0,0,0,0,0,0,0,0,0,0,0,0,0,0,0,0,7,3,4,4,1,1,0,1,1,0,1
24/01/2022 02:00,0,0,0,0,0,0,0,0,0,0,0,0,0,0,0,0,0,0,1,1,0,6,1,5,2,0,5,1,4,1,0,1
24/01/2022 03:00,0,0,0,1,0,1,1,0,1,0,0,0,1,0,1,0,0,0,0,0,0,1,1,0,2,0,2,0,2,1,0,1
24/01/2022 04:00,0,0,0,1,0,1,1,0,1,0,0,0,1,1,0,0,0,0,1,1,0,2,0,2,2,3,1,0,1,1,0,1
24/01/2022 05:00,0,0,0,5,2,3,7,2,5,0,0,0,2,2,0,1,1,0,0,0,0,26,2,24,0,18,1,0,1,6,0,6
24/01/2022 06:00,15,13,2,13,11,2,18,15,3,0,0,0,9,9,0,4,4,0,0,0,0,107,20,87,10,54,12,0,12,31,0,31
24/01/2022 07:00,16,15,1,35,25,10,46,33,13,0,0,0,21,21,0,12,12,0,0,0,0,206,54,152,27,87,22,0,22,59,0,59
24/01/2022 08:00,46,41,5,58,43,15,69,48,21,0,0,0,33,33,0,23,23,0,0,0,0,329,80,249,30,182,51,1,50,82,0,82
24/01/2022 09:00,23,18,5,47,29,18,53,37,16,0,0,0,23,23,0,4,4,0,0,0,0,158,32,126,19,72,26,1,25,88,0,88
24/01/2022 10:00,7,4,3,77,33,44,84,33,51,0,0,0,9,9,0,6,6,0,0,0,0,80,25,55,15,51,19,0,19,69,0,69
24/01/2022 11:00,12,10,2,67,29,38,67,30,37,0,0,0,4,4,0,10,10,0,0,0,0,66,18,48,26,34,33,0,33,83,0,83
24/01/2022 12:00,15,7,8,73,35,38,79,38,41,0,0,0,6,6,0,12,12,0,0,0,0,122,52,70,48,30,39,0,39,84,0,84
24/01/2022 13:00,14,9,5,88,46,42,98,43,55,0,0,0,6,6,0,18,18,0,0,0,0,111,48,63,67,40,65,1,64,91,0,91
24/01/2022 14:00,13,11,2,67,36,31,95,48,47,0,0,0,1,1,0,10,10,0,0,0,0,110,63,47,55,28,77,0,77,73,0,73
24/01/2022 15:00,18,10,8,54,25,29,73,37,36,0,0,0,2,2,0,29,29,0,0,0,0,145,64,81,76,44,87,1,86,70,0,70
24/01/2022 16:00,28,16,12,69,30,39,83,38,45,0,0,0,1,1,0,14,14,0,0,0,0,227,132,95,116,44,119,1,118,88,0,88
24/01/2022 17:00,32,21,11,63,18,45,79,22,57,0,0,0,4,4,0,24,24,0,0,0,0,290,167,123,202,36,174,0,174,102,1,101
24/01/2022 18:00,18,6,12,64,20,44,76,20,56,0,0,0,2,2,0,26,26,0,0,0,0,261,163,98,148,26,170,0,170,99,0,99
24/01/2022 19:00,11,3,8,35,13,22,43,15,28,0,0,0,1,0,1,5,5,0,0,0,0,148,86,62,94,23,127,0,127,94,0,94
24/01/2022 20:00,6,3,3,25,12,13,28,9,19,0,0,0,7,7,0,11,11,0,0,0,0,99,55,44,61,20,84,0,84,79,0,79
24/01/2022 21:00,3,0,3,14,5,9,16,4,12,0,0,0,0,0,0,9,9,0,0,0,0,74,45,29,42,12,64,1,63,52,0,52
24/01/2022 22:00,6,4,2,11,7,4,10,6,4,0,0,0,0,0,0,1,1,0,0,0,0,45,27,18,28,13,31,1,30,22,0,22
24/01/2022 23:00,1,0,1,3,1,2,3,1,2,0,0,0,0,0,0,1,1,0,1,1,0,16,11,5,11,6,18,0,18,7,0,7
25/01/2022 00:00,3,0,3,0,0,0,4,1,3,0,0,0,0,0,0,0,0,0,0,0,0,8,4,4,9,3,14,1,13,2,0,2
25/01/2022 01:00,1,1,0,0,0,0,0,0,0,0,0,0,0,0,0,0,0,0,0,0,0,3,2,1,1,2,3,0,3,2,0,2
25/01/2022 02:00,0,0,0,0,0,0,1,0,1,0,0,0,0,0,0,0,0,0,0,0,0,2,1,1,4,1,4,0,4,1,0,1
25/01/2022 03:00,1,0,1,0,0,0,0,0,0,0,0,0,0,0,0,0,0,0,1,1,0,3,1,2,0,0,3,0,3,0,0,0
25/01/2022 04:00,0,0,0,1,0,1,1,0,1,0,0,0,1,1,0,0,0,0,1,1,0,7,2,5,6,6,0,0,0,2,0,2
25/01/2022 05:00,2,2,0,4,3,1,5,4,1,0,0,0,2,2,0,1,1,0,0,0,0,29,4,25,1,18,5,0,5,8,0,8
25/01/2022 06:00,12,11,1,20,17,3,19,14,5,0,0,0,9,9,0,8,8,0,0,0,0,119,27,92,16,53,13,0,13,33,0,33
25/01/2022 07:00,21,17,4,56,27,29,57,32,25,0,0,0,14,14,0,16,16,0,0,0,0,250,67,183,30,124,23,0,23,55,0,55
25/01/2022 08:00,50,41,9,78,53,25,91,66,25,0,0,0,42,42,0,35,35,0,0,0,0,382,93,289,39,215,43,1,42,102,0,102
25/01/2022 09:00,26,20,6,57,37,20,74,44,30,0,0,0,20,20,0,10,10,0,0,0,0,163,30,133,19,96,30,0,30,106,0,106
25/01/2022 10:00,11,7,4,61,31,30,68,31,37,0,0,0,8,8,0,7,7,0,0,0,0,84,28,56,28,56,22,0,22,70,1,69
25/01/2022 11:00,14,8,6,74,36,38,79,42,37,0,0,0,8,8,0,15,15,0,0,0,0,73,24,49,27,31,24,0,24,50,0,50
25/01/2022 12:00,9,5,4,60,27,33,62,24,38,0,0,0,5,5,0,8,8,0,0,0,0,78,30,48,45,31,28,1,27,81,0,81
25/01/2022 13:00,8,4,4,62,32,30,60,30,30,0,0,0,0,0,0,19,19,0,0,0,0,111,44,67,51,38,83,0,83,107,1,106
25/01/2022 14:00,18,12,6,41,15,26,53,20,33,0,0,0,2,2,0,15,15,0,0,0,0,109,53,56,51,15,70,0,70,63,0,63
25/01/2022 15:00,15,9,6,55,27,28,56,18,38,0,0,0,1,1,0,38,38,0,0,0,0,167,99,68,85,21,90,0,90,66,0,66
25/01/2022 16:00,22,11,11,60,27,33,80,36,44,0,0,0,2,2,0,37,37,0,1,1,0,221,133,88,135,40,118,0,118,80,0,80
25/01/2022 17:00,40,20,20,88,21,67,101,29,72,0,0,0,0,0,0,34,34,0,0,0,0,296,168,128,187,35,211,0,211,122,2,120
25/01/2022 18:00,14,7,7,90,31,59,93,28,65,0,0,0,2,2,0,22,22,0,0,0,0,284,149,135,154,40,201,2,199,133,0,133
25/01/2022 19:00,16,7,9,43,14,29,52,19,33,0,0,0,1,1,0,10,10,0,0,0,0,152,80,72,90,22,129,2,127,106,1,105
25/01/2022 20:00,13,6,7,33,12,21,44,19,25,0,0,0,2,2,0,7,7,0,0,0,0,115,73,42,57,15,103,0,103,89,0,89
25/01/2022 21:00,9,4,5,13,6,7,17,8,9,0,0,0,1,1,0,16,16,0,0,0,0,70,47,23,30,12,85,0,85,57,1,56
25/01/2022 22:00,1,1,0,8,4,4,12,3,9,0,0,0,1,1,0,1,1,0,0,0,0,48,25,23,30,5,47,3,44,30,1,29
25/01/2022 23:00,0,0,0,2,1,1,5,4,1,0,0,0,0,0,0,2,2,0,0,0,0,36,25,11,15,5,23,0,23,11,0,11
26/01/2022 00:00,1,0,1,3,1,2,3,1,2,0,0,0,0,0,0,0,0,0,0,0,0,22,19,3,8,4,22,1,21,5,0,5
26/01/2022 01:00,1,0,1,1,1,0,1,0,1,0,0,0,0,0,0,0,0,0,0,0,0,4,4,0,8,1,2,0,2,1,0,1
26/01/2022 02:00,0,0,0,2,1,1,0,0,0,0,0,0,0,0,0,0,0,0,0,0,0,3,3,0,3,1,4,0,4,3,0,3
26/01/2022 03:00,0,0,0,0,0,0,0,0,0,0,0,0,0,0,0,0,0,0,0,0,0,5,2,3,0,1,2,0,2,1,0,1
26/01/2022 04:00,0,0,0,3,2,1,3,1,2,0,0,0,1,1,0,0,0,0,0,0,0,7,0,7,1,4,1,0,1,1,0,1
26/01/2022 05:00,2,2,0,4,3,1,5,2,3,0,0,0,1,1,0,0,0,0,0,0,0,27,4,23,1,14,6,1,5,8,0,8
26/01/2022 06:00,18,16,2,20,15,5,18,10,8,0,0,0,7,7,0,9,9,0,2,2,0,124,32,92,14,49,11,0,11,43,0,43
26/01/2022 07:00,19,16,3,49,33,16,62,35,27,0,0,0,25,25,0,19,19,0,14,14,0,209,55,154,27,120,22,0,22,66,0,66
26/01/2022 08:00,66,58,8,78,50,28,98,71,27,0,0,0,45,45,0,36,36,0,45,45,0,409,98,311,42,215,47,0,47,116,0,116
26/01/2022 09:00,24,22,2,52,22,30,70,37,33,0,0,0,9,9,0,9,9,0,13,13,0,182,31,151,24,112,27,0,27,124,0,124
26/01/2022 10:00,12,6,6,71,37,34,79,38,41,0,0,0,9,9,0,8,8,0,6,6,0,83,34,49,17,49,24,0,24,82,0,82
26/01/2022 11:00,5,3,2,58,28,30,60,27,33,0,0,0,1,1,0,17,17,0,6,6,0,104,23,81,30,37,26,0,26,78,0,78
26/01/2022 12:00,17,8,9,79,40,39,87,43,44,0,0,0,1,1,0,15,15,0,5,5,0,128,47,81,45,43,36,0,36,93,0,93
26/01/2022 13:00,11,5,6,67,27,40,85,39,46,0,0,0,4,4,0,31,31,0,4,4,0,137,70,67,62,58,59,0,59,120,0,120
26/01/2022 14:00,17,7,10,57,24,33,58,27,31,0,0,0,11,11,0,17,17,0,1,1,0,125,66,59,61,26,95,1,94,94,0,94
26/01/2022 15:00,17,8,9,52,24,28,78,29,49,0,0,0,3,3,0,28,28,0,0,0,0,157,74,83,68,34,81,0,81,78,0,78
26/01/2022 16:00,26,17,9,53,21,32,77,22,55,0,0,0,3,3,0,21,21,0,0,0,0,216,116,100,129,48,120,0,120,76,0,76
26/01/2022 17:00,39,11,28,64,18,46,89,23,66,0,0,0,3,3,0,20,20,0,0,0,0,289,174,115,192,41,183,1,182,102,1,101
26/01/2022 18:00,21,6,15,63,20,43,61,13,48,0,0,0,4,4,0,16,16,0,1,1,0,297,159,138,152,33,172,1,171,115,0,115
26/01/2022 19:00,13,3,10,42,19,23,53,25,28,0,0,0,1,1,0,11,11,0,1,1,0,166,89,77,88,25,125,1,124,80,0,80
26/01/2022 20:00,13,4,9,21,9,12,23,4,19,0,0,0,3,3,0,7,7,0,1,1,0,117,69,48,59,13,84,0,84,80,0,80
26/01/2022 21:00,6,5,1,14,5,9,19,11,8,0,0,0,5,5,0,12,12,0,0,0,0,84,60,24,52,18,87,0,87,49,0,49
26/01/2022 22:00,9,3,6,7,4,3,10,3,7,0,0,0,1,1,0,6,6,0,0,0,0,50,36,14,30,9,38,1,37,32,0,32
26/01/2022 23:00,2,1,1,8,5,3,12,4,8,0,0,0,0,0,0,2,2,0,0,0,0,43,29,14,23,5,29,0,29,15,0,15
27/01/2022 00:00,0,0,0,0,0,0,0,0,0,0,0,0,3,3,0,2,2,0,0,0,0,21,14,7,12,2,13,0,13,9,0,9
27/01/2022 01:00,3,0,3,0,0,0,0,0,0,0,0,0,0,0,0,1,1,0,0,0,0,5,4,1,4,1,0,0,0,0,0,0
27/01/2022 02:00,0,0,0,0,0,0,0,0,0,0,0,0,0,0,0,0,0,0,0,0,0,4,2,2,4,0,6,0,6,1,0,1
27/01/2022 03:00,0,0,0,0,0,0,0,0,0,0,0,0,0,0,0,0,0,0,0,0,0,2,1,1,2,1,3,0,3,0,0,0
27/01/2022 04:00,0,0,0,3,2,1,6,2,4,0,0,0,1,1,0,0,0,0,0,0,0,7,0,7,2,3,1,0,1,0,0,0
27/01/2022 05:00,1,1,0,4,1,3,5,3,2,0,0,0,1,1,0,1,1,0,0,0,0,22,2,20,0,9,2,0,2,4,0,4
27/01/2022 06:00,19,17,2,23,18,5,24,17,7,0,0,0,7,7,0,6,6,0,0,0,0,116,22,94,10,58,10,0,10,24,0,24
27/01/2022 07:00,21,19,2,44,24,20,63,36,27,0,0,0,25,25,0,10,10,0,0,0,0,228,56,172,27,95,34,0,34,60,0,60
27/01/2022 08:00,49,44,5,68,49,19,86,59,27,0,0,0,36,35,1,29,29,0,0,0,0,362,91,271,32,196,49,0,49,107,1,106
27/01/2022 09:00,30,20,10,48,26,22,58,30,28,0,0,0,15,15,0,8,8,0,0,0,0,173,37,136,22,122,33,0,33,84,0,84
27/01/2022 10:00,20,10,10,72,32,40,59,27,32,0,0,0,10,10,0,5,5,0,0,0,0,103,20,83,26,36,29,0,29,70,1,69
27/01/2022 11:00,18,9,9,58,25,33,73,27,46,0,0,0,12,12,0,10,10,0,0,0,0,105,38,67,24,40,43,1,42,76,1,75
27/01/2022 12:00,18,8,10,48,21,27,56,29,27,0,0,0,12,12,0,13,13,0,2,2,0,112,47,65,46,48,56,0,56,87,0,87
27/01/2022 13:00,24,10,14,66,29,37,82,32,50,0,0,0,4,4,0,19,19,0,1,1,0,149,50,99,66,47,76,0,76,120,1,119
27/01/2022 14:00,30,18,12,78,41,37,80,38,42,0,0,0,1,1,0,14,14,0,2,2,0,144,65,79,61,29,108,1,107,100,0,100
27/01/2022 15:00,32,17,15,53,25,28,62,29,33,0,0,0,7,7,0,37,37,0,4,4,0,170,87,83,69,39,97,0,97,88,1,87
27/01/2022 16:00,27,12,15,51,21,30,72,27,45,0,0,0,6,6,0,25,25,0,1,1,0,216,130,86,107,57,131,0,131,99,0,99
27/01/2022 17:00,42,15,27,73,29,44,93,35,58,0,0,0,9,8,1,23,23,0,12,12,0,298,177,121,177,41,191,3,188,123,1,122
27/01/2022 18:00,24,10,14,89,29,60,106,29,77,0,0,0,6,6,0,26,26,0,14,14,0,288,160,128,144,55,193,0,193,137,0,137
27/01/2022 19:00,15,5,10,55,25,30,69,26,43,0,0,0,2,1,1,13,13,0,10,10,0,146,85,61,63,15,155,1,154,113,1,112
27/01/2022 20:00,10,3,7,32,21,11,41,18,23,0,0,0,6,6,0,13,13,0,7,7,0,131,82,49,66,22,122,0,122,102,0,102
27/01/2022 21:00,7,2,5,17,9,8,17,9,8,0,0,0,6,6,0,13,13,0,1,1,0,77,57,20,51,21,90,0,90,77,1,76
27/01/2022 22:00,8,4,4,12,5,7,13,5,8,0,0,0,1,1,0,6,6,0,0,0,0,68,48,20,35,12,49,0,49,29,0,29
27/01/2022 23:00,0,0,0,2,0,2,9,3,6,0,0,0,0,0,0,3,3,0,0,0,0,43,28,15,28,4,38,0,38,20,0,20
28/01/2022 00:00,2,2,0,2,1,1,1,1,0,0,0,0,0,0,0,1,1,0,0,0,0,23,17,6,16,6,20,0,20,10,1,9
28/01/2022 01:00,0,0,0,1,1,0,0,0,0,0,0,0,0,0,0,0,0,0,0,0,0,8,3,5,9,1,2,0,2,0,0,0
28/01/2022 02:00,0,0,0,1,1,0,0,0,0,0,0,0,0,0,0,0,0,0,0,0,0,2,2,0,6,2,5,0,5,2,0,2
28/01/2022 03:00,0,0,0,2,2,0,4,2,2,0,0,0,0,0,0,1,1,0,0,0,0,4,2,2,3,2,4,0,4,1,0,1
28/01/2022 04:00,0,0,0,4,2,2,4,0,4,0,0,0,1,1,0,0,0,0,0,0,0,8,4,4,6,7,2,0,2,1,0,1
28/01/2022 05:00,0,0,0,7,5,2,13,5,8,0,0,0,3,3,0,0,0,0,0,0,0,22,7,15,7,17,0,0,0,7,0,7
28/01/2022 06:00,10,9,1,13,9,4,20,13,7,0,0,0,3,3,0,7,7,0,1,1,0,101,24,77,16,50,21,0,21,28,0,28
28/01/2022 07:00,18,17,1,44,24,20,48,33,15,0,0,0,24,23,1,10,10,0,1,1,0,183,47,136,31,84,24,0,24,59,0,59
28/01/2022 08:00,47,40,7,62,37,25,81,51,30,0,0,0,23,23,0,30,30,0,40,40,0,335,91,244,38,163,45,0,45,93,0,93
28/01/2022 09:00,15,7,8,50,29,21,68,38,30,0,0,0,19,19,0,5,5,0,1,1,0,132,30,102,32,106,24,0,24,108,0,108
28/01/2022 10:00,23,12,11,64,26,38,76,33,43,0,0,0,12,12,0,10,10,0,0,0,0,79,23,56,25,64,8,0,8,72,0,72
28/01/2022 11:00,9,4,5,56,29,27,71,29,42,0,0,0,10,10,0,6,6,0,1,1,0,105,31,74,28,55,42,0,42,64,0,64
28/01/2022 12:00,27,13,14,54,27,27,68,37,31,0,0,0,7,7,0,25,25,0,1,1,0,116,43,73,56,47,62,0,62,67,0,67
28/01/2022 13:00,25,10,15,61,30,31,65,28,37,0,0,0,5,5,0,20,20,0,0,0,0,156,70,86,75,53,94,0,94,97,0,97
28/01/2022 14:00,21,7,14,45,17,28,59,26,33,0,0,0,2,2,0,16,16,0,0,0,0,153,66,87,66,31,113,1,112,119,1,118
28/01/2022 15:00,15,8,7,45,18,27,41,11,30,0,0,0,4,4,0,20,20,0,0,0,0,171,79,92,111,64,99,0,99,99,1,98
28/01/2022 16:00,19,11,8,40,15,25,57,19,38,0,0,0,7,6,1,14,14,0,0,0,0,172,96,76,118,56,142,0,142,64,0,64
28/01/2022 17:00,25,10,15,38,14,24,59,15,44,0,0,0,6,6,0,22,22,0,1,1,0,238,129,109,156,44,161,0,161,110,0,110
28/01/2022 18:00,20,8,12,35,16,19,62,25,37,0,0,0,17,17,0,19,19,0,2,2,0,223,119,104,138,57,144,1,143,121,0,121
28/01/2022 19:00,5,3,2,24,12,12,34,15,19,0,0,0,13,13,0,9,9,0,0,0,0,145,64,81,81,53,135,1,134,97,1,96
28/01/2022 20:00,13,6,7,13,6,7,21,4,17,0,0,0,8,7,1,5,5,0,1,1,0,123,69,54,76,42,96,0,96,122,1,121
28/01/2022 21:00,5,1,4,8,2,6,11,3,8,0,0,0,4,4,0,6,6,0,1,1,0,69,41,28,36,9,60,1,59,77,0,77
28/01/2022 22:00,6,4,2,6,2,4,9,4,5,0,0,0,1,1,0,3,3,0,0,0,0,59,31,28,35,18,51,1,50,49,0,49
28/01/2022 23:00,3,2,1,4,1,3,9,4,5,0,0,0,1,1,0,0,0,0,1,1,0,34,24,10,30,17,53,0,53,17,0,17
29/01/2022 00:00,1,0,1,1,1,0,5,2,3,0,0,0,0,0,0,1,1,0,0,0,0,31,21,10,27,4,44,1,43,5,0,5
29/01/2022 01:00,1,0,1,2,1,1,4,1,3,0,0,0,0,0,0,1,1,0,0,0,0,12,9,3,15,1,6,0,6,2,0,2
29/01/2022 02:00,4,4,0,0,0,0,1,0,1,0,0,0,0,0,0,0,0,0,0,0,0,9,8,1,12,2,23,0,23,5,0,5
29/01/2022 03:00,0,0,0,2,1,1,1,0,1,0,0,0,0,0,0,1,1,0,0,0,0,4,4,0,12,0,17,0,17,5,1,4
29/01/2022 04:00,0,0,0,3,1,2,1,0,1,0,0,0,1,1,0,0,0,0,0,0,0,7,4,3,7,1,10,0,10,1,0,1
29/01/2022 05:00,1,1,0,3,3,0,3,1,2,0,0,0,1,1,0,0,0,0,0,0,0,11,2,9,5,1,5,0,5,2,0,2
29/01/2022 06:00,5,4,1,10,5,5,12,5,7,0,0,0,3,3,0,0,0,0,0,0,0,36,6,30,9,16,9,0,9,7,0,7
29/01/2022 07:00,2,1,1,12,6,6,11,4,7,0,0,0,10,10,0,5,5,0,0,0,0,52,17,35,15,29,13,0,13,12,1,11
29/01/2022 08:00,4,4,0,37,14,23,39,17,22,0,0,0,14,14,0,6,6,0,0,0,0,44,15,29,18,18,21,0,21,16,0,16
29/01/2022 09:00,10,7,3,59,28,31,68,24,44,0,0,0,7,7,0,5,5,0,0,0,0,53,22,31,14,23,20,0,20,49,0,49
29/01/2022 10:00,9,6,3,53,28,25,64,29,35,0,0,0,2,2,0,8,8,0,1,1,0,63,22,41,16,31,32,1,31,72,0,72
29/01/2022 11:00,19,10,9,84,33,51,103,46,57,0,0,0,4,4,0,10,10,0,0,0,0,87,29,58,31,32,41,0,41,62,1,61
29/01/2022 12:00,18,7,11,82,40,42,102,45,57,0,0,0,4,4,0,12,12,0,11,11,0,112,37,75,49,38,81,0,81,76,0,76
29/01/2022 13:00,16,10,6,67,38,29,80,43,37,0,0,0,6,6,0,9,9,0,11,11,0,134,46,88,56,37,86,0,86,121,1,120
29/01/2022 14:00,20,9,11,66,28,38,94,43,51,0,0,0,9,9,0,10,10,0,11,11,0,107,48,59,74,48,62,1,61,93,0,93
29/01/2022 15:00,15,5,10,82,45,37,95,51,44,0,0,0,3,3,0,11,11,0,13,13,0,101,45,56,47,51,77,1,76,92,0,92
29/01/2022 16:00,8,4,4,55,31,24,71,38,33,0,0,0,3,3,0,11,11,0,2,2,0,114,43,71,53,42,109,2,107,83,1,82
29/01/2022 17:00,7,5,2,31,21,10,55,31,24,0,0,0,3,3,0,10,10,0,9,9,0,120,60,60,46,28,106,0,106,75,0,75
29/01/2022 18:00,9,5,4,18,10,8,26,13,13,0,0,0,16,16,0,5,5,0,8,8,0,119,47,72,63,37,99,0,99,90,0,90
29/01/2022 19:00,11,8,3,12,3,9,25,10,15,0,0,0,2,2,0,7,7,0,4,4,0,97,48,49,55,43,98,1,97,69,0,69
29/01/2022 20:00,8,6,2,9,4,5,12,7,5,0,0,0,4,4,0,5,5,0,3,3,0,71,39,32,46,32,65,1,64,66,1,65
29/01/2022 21:00,7,5,2,7,4,3,8,3,5,0,0,0,2,2,0,3,3,0,2,2,0,62,29,33,39,20,44,1,43,59,0,59
29/01/2022 22:00,4,3,1,4,2,2,8,3,5,0,0,0,4,4,0,3,3,0,1,1,0,46,29,17,30,8,43,0,43,46,0,46
29/01/2022 23:00,4,3,1,2,0,2,4,1,3,0,0,0,0,0,0,1,1,0,3,3,0,35,27,8,24,9,39,0,39,23,2,21
30/01/2022 00:00,1,0,1,0,0,0,1,1,0,0,0,0,0,0,0,3,3,0,2,2,0,28,22,6,14,5,26,0,26,14,0,14
30/01/2022 01:00,1,0,1,2,1,1,2,0,2,0,0,0,0,0,0,2,2,0,1,1,0,11,5,6,7,3,4,0,4,1,0,1
30/01/2022 02:00,0,0,0,0,0,0,0,0,0,0,0,0,0,0,0,1,1,0,0,0,0,10,7,3,8,3,21,0,21,1,0,1
30/01/2022 03:00,1,0,1,2,2,0,0,0,0,0,0,0,0,0,0,0,0,0,0,0,0,5,4,1,7,1,16,0,16,3,0,3
30/01/2022 04:00,0,0,0,4,1,3,5,1,4,0,0,0,1,1,0,0,0,0,0,0,0,3,0,3,7,3,6,0,6,0,0,0
30/01/2022 05:00,2,2,0,0,0,0,0,0,0,0,0,0,1,1,0,0,0,0,0,0,0,9,3,6,2,0,8,0,8,0,0,0
30/01/2022 06:00,0,0,0,7,4,3,10,6,4,0,0,0,0,0,0,0,0,0,0,0,0,26,5,21,8,5,11,0,11,4,0,4
30/01/2022 07:00,2,2,0,20,11,9,22,10,12,0,0,0,7,7,0,1,1,0,0,0,0,27,10,17,12,14,9,0,9,11,0,11
30/01/2022 08:00,7,5,2,83,37,46,77,32,45,0,0,0,2,2,0,4,4,0,0,0,0,59,28,31,10,12,11,0,11,16,0,16
30/01/2022 09:00,9,8,1,138,55,83,143,55,88,0,0,0,11,11,0,10,10,0,1,1,0,58,15,43,18,39,13,1,12,41,0,41
30/01/2022 10:00,7,4,3,161,52,109,242,88,154,0,0,0,5,5,0,5,5,0,0,0,0,84,33,51,25,33,46,0,46,41,0,41
30/01/2022 11:00,9,5,4,216,102,114,220,102,118,0,0,0,5,5,0,13,13,0,1,1,0,87,35,52,35,32,37,0,37,53,0,53
30/01/2022 12:00,17,8,9,184,99,85,218,117,101,0,0,0,0,0,0,11,11,0,1,1,0,94,33,61,44,41,66,1,65,74,1,73
30/01/2022 13:00,16,10,6,133,78,55,178,100,78,0,0,0,0,0,0,15,15,0,4,4,0,112,48,64,46,41,85,1,84,59,0,59
30/01/2022 14:00,12,8,4,82,46,36,105,57,48,0,0,0,8,8,0,8,8,0,3,3,0,106,45,61,28,36,83,0,83,79,0,79
30/01/2022 15:00,14,9,5,65,33,32,84,41,43,0,0,0,9,9,0,7,7,0,2,2,0,103,40,63,44,46,71,3,68,111,1,110
30/01/2022 16:00,12,5,7,26,15,11,45,29,16,0,0,0,4,4,0,7,7,0,0,0,0,97,42,55,34,33,93,0,93,59,0,59
30/01/2022 17:00,10,4,6,18,6,12,16,5,11,0,0,0,1,1,0,10,10,0,0,0,0,101,41,60,39,25,91,0,91,56,0,56
30/01/2022 18:00,5,3,2,8,2,6,7,2,5,0,0,0,5,5,0,3,3,0,0,0,0,116,46,70,36,12,69,0,69,51,0,51
30/01/2022 19:00,8,5,3,5,1,4,5,2,3,0,0,0,0,0,0,4,4,0,0,0,0,69,33,36,30,18,63,1,62,55,1,54
30/01/2022 20:00,8,4,4,10,4,6,9,3,6,0,0,0,4,4,0,4,4,0,2,2,0,57,33,24,29,14,58,0,58,49,0,49
30/01/2022 21:00,6,4,2,3,3,0,4,1,3,0,0,0,1,1,0,1,1,0,0,0,0,41,28,13,31,11,43,1,42,35,0,35
30/01/2022 22:00,3,1,2,1,1,0,2,0,2,0,0,0,0,0,0,0,0,0,0,0,0,28,22,6,30,6,26,1,25,27,1,26
30/01/2022 23:00,2,2,0,3,1,2,0,0,0,0,0,0,0,0,0,3,3,0,2,2,0,15,10,5,13,2,20,0,20,10,0,10
31/01/2022 00:00,0,0,0,2,1,1,4,1,3,0,0,0,0,0,0,3,3,0,0,0,0,10,8,2,6,1,11,0,11,5,0,5
31/01/2022 01:00,1,1,0,1,1,0,0,0,0,0,0,0,1,1,0,0,0,0,0,0,0,5,4,1,5,2,0,0,0,0,0,0
31/01/2022 02:00,0,0,0,0,0,0,0,0,0,0,0,0,0,0,0,0,0,0,1,1,0,2,0,2,3,0,3,0,3,1,0,1
31/01/2022 03:00,1,0,1,0,0,0,2,1,1,0,0,0,0,0,0,0,0,0,0,0,0,3,2,1,0,2,3,0,3,1,0,1
31/01/2022 04:00,0,0,0,1,1,0,2,1,1,0,0,0,1,1,0,0,0,0,1,1,0,8,1,7,1,2,1,0,1,0,0,0
31/01/2022 05:00,0,0,0,3,2,1,5,2,3,0,0,0,2,2,0,1,1,0,0,0,0,20,1,19,0,10,1,0,1,5,0,5
31/01/2022 06:00,18,14,4,12,9,3,14,10,4,0,0,0,7,7,0,7,7,0,6,6,0,121,22,99,15,66,14,0,14,27,0,27
31/01/2022 07:00,28,22,6,24,20,4,41,32,9,0,0,0,11,11,0,13,13,0,9,9,0,206,50,156,29,95,25,0,25,59,0,59
31/01/2022 08:00,51,42,9,62,44,18,80,62,18,0,0,0,22,22,0,32,32,0,11,11,0,337,85,252,32,205,39,1,38,109,0,109
31/01/2022 09:00,31,22,9,40,21,19,52,28,24,0,0,0,13,13,0,10,10,0,0,0,0,160,36,124,20,122,27,1,26,98,0,98
31/01/2022 10:00,15,8,7,41,17,24,51,19,32,0,0,0,11,11,0,9,9,0,7,7,0,77,21,56,14,30,14,0,14,60,0,60
31/01/2022 11:00,13,7,6,58,29,29,66,30,36,0,0,0,4,4,0,5,5,0,8,8,0,76,24,52,26,58,29,0,29,81,0,81
31/01/2022 12:00,17,9,8,61,31,30,62,34,28,0,0,0,5,5,0,9,9,0,1,1,0,103,44,59,47,35,70,0,70,83,0,83
31/01/2022 13:00,22,8,14,47,17,30,46,15,31,0,0,0,1,1,0,6,6,0,0,0,0,103,49,54,47,41,87,0,87,90,0,90
31/01/2022 14:00,21,9,12,45,20,25,51,20,31,0,0,0,2,2,0,16,16,0,0,0,0,120,59,61,42,39,66,0,66,71,0,71
31/01/2022 15:00,18,9,9,36,17,19,35,14,21,0,0,0,1,1,0,39,39,0,0,0,0,151,90,61,77,39,67,0,67,70,0,70
31/01/2022 16:00,30,14,16,32,13,19,57,17,40,0,0,0,1,1,0,17,17,0,0,0,0,180,103,77,114,51,103,0,103,76,0,76
31/01/2022 17:00,31,10,21,54,17,37,66,12,54,0,0,0,1,1,0,21,21,0,0,0,0,298,175,123,175,48,162,0,162,98,0,98
31/01/2022 18:00,29,9,20,41,11,30,73,17,56,0,0,0,2,2,0,18,18,0,0,0,0,257,147,110,131,41,168,0,168,98,0,98
31/01/2022 19:00,11,3,8,25,7,18,33,10,23,0,0,0,1,1,0,16,16,0,0,0,0,141,81,60,83,15,134,2,132,78,0,78
31/01/2022 20:00,7,2,5,21,9,12,30,11,19,0,0,0,1,1,0,11,11,0,0,0,0,100,60,40,57,18,92,0,92,67,0,67
31/01/2022 21:00,6,4,2,10,5,5,14,4,10,0,0,0,1,1,0,7,7,0,0,0,0,75,47,28,35,7,74,1,73,40,1,39
31/01/2022 22:00,6,1,5,9,2,7,6,1,5,0,0,0,2,2,0,3,3,0,0,0,0,52,32,20,22,9,47,0,47,22,0,22
31/01/2022 23:00,2,1,1,1,1,0,4,1,3,0,0,0,0,0,0,2,2,0,0,0,0,22,10,12,13,4,21,0,21,16,0,16
01/02/2022 00:00,1,1,0,2,1,1,1,0,1,0,0,0,0,0,0,2,2,0,0,0,0,13,6,7,9,2,13,0,13,7,0,7
01/02/2022 01:00,0,0,0,0,0,0,0,0,0,0,0,0,0,0,0,0,0,0,0,0,0,4,4,0,3,1,5,0,5,0,0,0
01/02/2022 02:00,0,0,0,0,0,0,1,0,1,0,0,0,0,0,0,0,0,0,0,0,0,4,3,1,4,0,3,0,3,1,0,1
01/02/2022 03:00,0,0,0,0,0,0,0,0,0,0,0,0,1,1,0,0,0,0,0,0,0,0,0,0,1,1,3,0,3,1,0,1
01/02/2022 04:00,0,0,0,0,0,0,2,1,1,0,0,0,0,0,0,0,0,0,0,0,0,5,1,4,2,3,1,0,1,1,0,1
01/02/2022 05:00,1,0,1,2,2,0,3,3,0,0,0,0,1,1,0,1,1,0,1,1,0,24,2,22,0,12,0,0,0,5,0,5
01/02/2022 06:00,14,14,0,16,12,4,15,11,4,0,0,0,5,5,0,4,4,0,0,0,0,108,25,83,16,67,15,0,15,27,0,27
01/02/2022 07:00,25,21,4,43,30,13,41,27,14,0,0,0,11,11,0,8,8,0,0,0,0,238,69,169,32,130,33,1,32,63,0,63
01/02/2022 08:00,61,49,12,58,47,11,78,58,20,0,0,0,39,38,1,22,22,0,0,0,0,376,81,295,33,226,30,0,30,115,0,115
01/02/2022 09:00,26,19,7,40,22,18,51,28,23,0,0,0,14,13,1,5,5,0,0,0,0,183,42,141,12,127,17,0,17,91,0,91
01/02/2022 10:00,15,8,7,36,14,22,53,21,32,0,0,0,11,11,0,5,5,0,0,0,0,70,17,53,17,36,20,0,20,54,0,54
01/02/2022 11:00,7,2,5,22,12,10,18,10,8,0,0,0,4,4,0,12,12,0,0,0,0,90,31,59,21,36,30,0,30,48,0,48
01/02/2022 12:00,16,8,8,32,18,14,40,27,13,0,0,0,1,1,0,10,10,0,0,0,0,95,36,59,36,43,58,0,58,85,0,85
01/02/2022 13:00,12,3,9,22,12,10,24,8,16,0,0,0,0,0,0,8,8,0,1,1,0,118,49,69,46,51,67,0,67,79,1,78
01/02/2022 14:00,26,14,12,24,8,16,22,6,16,0,0,0,1,1,0,11,11,0,8,8,0,93,44,49,38,25,59,0,59,73,0,73
01/02/2022 15:00,21,13,8,26,8,18,37,11,26,0,0,0,1,1,0,38,38,0,6,6,0,144,80,64,66,35,75,1,74,85,0,85
01/02/2022 16:00,23,2,21,42,21,21,53,19,34,0,0,0,0,0,0,19,19,0,0,0,0,173,94,79,97,46,101,0,101,71,1,70
01/02/2022 17:00,35,12,23,55,13,42,72,16,56,0,0,0,0,0,0,22,22,0,1,1,0,281,165,116,205,41,177,0,177,103,1,102
01/02/2022 18:00,43,15,28,55,11,44,66,15,51,0,0,0,5,5,0,20,20,0,0,0,0,292,180,112,195,41,173,0,173,105,0,105
01/02/2022 19:00,16,6,10,27,7,20,35,8,27,0,0,0,2,1,1,7,7,0,0,0,0,151,70,81,99,30,118,0,118,108,3,105
01/02/2022 20:00,11,3,8,14,4,10,19,7,12,0,0,0,2,2,0,10,10,0,0,0,0,102,67,35,53,21,92,2,90,72,0,72
01/02/2022 21:00,8,5,3,9,4,5,15,5,10,0,0,0,2,2,0,8,8,0,0,0,0,52,36,16,40,15,68,0,68,40,1,39
01/02/2022 22:00,6,4,2,4,2,2,8,3,5,0,0,0,4,4,0,5,5,0,0,0,0,48,31,17,30,6,39,0,39,26,1,25
01/02/2022 23:00,4,2,2,0,0,0,7,4,3,0,0,0,0,0,0,0,0,0,0,0,0,23,13,10,13,8,21,0,21,15,0,15
02/02/2022 00:00,0,0,0,1,0,1,1,0,1,0,0,0,0,0,0,1,1,0,1,1,0,15,13,2,16,4,22,0,22,4,0,4
02/02/2022 01:00,1,0,1,1,0,1,0,0,0,0,0,0,1,1,0,0,0,0,0,0,0,6,5,1,2,2,3,0,3,1,0,1
02/02/2022 02:00,0,0,0,1,0,1,3,1,2,0,0,0,0,0,0,0,0,0,0,0,0,4,2,2,2,1,5,0,5,0,0,0
02/02/2022 03:00,0,0,0,1,0,1,1,0,1,0,0,0,0,0,0,1,1,0,0,0,0,1,1,0,3,2,3,0,3,0,0,0
02/02/2022 04:00,1,1,0,0,0,0,3,2,1,0,0,0,1,1,0,0,0,0,0,0,0,5,1,4,2,2,2,0,2,0,0,0
02/02/2022 05:00,1,1,0,3,3,0,4,3,1,0,0,0,0,0,0,1,1,0,0,0,0,30,3,27,0,16,1,0,1,4,0,4
02/02/2022 06:00,24,18,6,23,14,9,23,13,10,0,0,0,1,1,0,7,7,0,7,7,0,113,23,90,14,59,12,0,12,27,0,27
02/02/2022 07:00,29,27,2,45,31,14,47,27,20,0,0,0,16,16,0,13,13,0,21,21,0,225,58,167,36,103,30,1,29,57,0,57
02/02/2022 08:00,69,62,7,84,61,23,102,74,28,0,0,0,67,67,0,29,29,0,47,47,0,389,77,312,37,219,50,0,50,141,0,141
02/02/2022 09:00,28,21,7,48,24,24,49,23,26,0,0,0,15,15,0,10,10,0,4,4,0,203,42,161,16,112,35,0,35,119,0,119
02/02/2022 10:00,16,6,10,50,21,29,56,24,32,0,0,0,13,13,0,7,7,0,1,1,0,86,19,67,14,60,28,0,28,73,0,73
02/02/2022 11:00,15,8,7,51,24,27,50,26,24,0,0,0,9,9,0,6,6,0,4,4,0,85,29,56,21,43,30,0,30,77,0,77
02/02/2022 12:00,13,9,4,52,27,25,63,27,36,0,0,0,7,7,0,16,16,0,5,5,0,103,45,58,46,45,60,0,60,100,1,99
02/02/2022 13:00,23,12,11,42,17,25,55,24,31,0,0,0,4,4,0,26,26,0,3,3,0,145,66,79,57,46,78,0,78,95,1,94
02/02/2022 14:00,34,15,19,44,21,23,43,20,23,0,0,0,1,1,0,19,19,0,5,5,0,126,62,64,66,42,74,0,74,84,0,84
02/02/2022 15:00,20,14,6,36,17,19,57,28,29,0,0,0,2,2,0,32,32,0,12,12,0,130,64,66,83,40,84,1,83,55,2,53
02/02/2022 16:00,27,12,15,56,21,35,64,21,43,0,0,0,3,3,0,30,30,0,1,1,0,197,111,86,141,44,109,1,108,82,0,82
02/02/2022 17:00,36,11,25,73,23,50,92,27,65,0,0,0,2,2,0,28,28,0,7,7,0,326,195,131,228,36,182,1,181,109,0,109
02/02/2022 18:00,19,9,10,65,20,45,80,28,52,0,0,0,9,9,0,19,19,0,0,0,0,292,181,111,154,35,200,0,200,142,1,141
02/02/2022 19:00,15,9,6,45,17,28,50,18,32,0,0,0,6,6,0,14,14,0,3,3,0,192,106,86,90,17,146,1,145,112,0,112
02/02/2022 20:00,7,5,2,22,11,11,28,8,20,0,0,0,4,4,0,16,16,0,6,6,0,130,69,61,62,13,98,0,98,64,0,64
02/02/2022 21:00,9,3,6,15,3,12,26,10,16,0,0,0,3,3,0,9,9,0,10,10,0,87,61,26,48,10,68,1,67,51,0,51
02/02/2022 22:00,2,1,1,7,5,2,9,4,5,0,0,0,1,1,0,4,4,0,4,4,0,60,38,22,35,17,57,0,57,40,0,40
02/02/2022 23:00,3,0,3,4,1,3,2,1,1,0,0,0,1,1,0,1,1,0,0,0,0,39,20,19,20,7,29,1,28,18,0,18
03/02/2022 00:00,4,0,4,0,0,0,2,0,2,0,0,0,0,0,0,1,1,0,1,1,0,16,10,6,17,3,25,1,24,3,0,3
03/02/2022 01:00,1,1,0,1,1,0,0,0,0,0,0,0,0,0,0,1,1,0,0,0,0,9,7,2,8,1,4,0,4,0,0,0
03/02/2022 02:00,0,0,0,0,0,0,1,1,0,0,0,0,0,0,0,0,0,0,0,0,0,4,3,1,5,0,3,0,3,0,0,0
03/02/2022 03:00,0,0,0,2,0,2,2,1,1,0,0,0,0,0,0,0,0,0,1,1,0,1,1,0,4,0,3,0,3,1,0,1
03/02/2022 04:00,1,1,0,2,2,0,2,2,0,0,0,0,1,1,0,0,0,0,0,0,0,5,0,5,3,1,1,0,1,0,0,0
03/02/2022 05:00,1,0,1,2,0,2,3,2,1,0,0,0,1,1,0,1,1,0,0,0,0,22,1,21,3,11,2,0,2,8,0,8
03/02/2022 06:00,14,13,1,17,13,4,17,10,7,0,0,0,6,6,0,6,6,0,3,3,0,114,28,86,14,58,15,0,15,29,0,29
03/02/2022 07:00,20,18,2,49,30,19,57,39,18,0,0,0,15,15,0,13,13,0,0,0,0,240,64,176,24,123,33,1,32,43,0,43
03/02/2022 08:00,56,48,8,84,61,23,88,66,22,0,0,0,45,45,0,31,31,0,1,1,0,393,88,305,33,238,40,0,40,112,0,112
03/02/2022 09:00,25,20,5,44,26,18,52,30,22,0,0,0,14,14,0,13,13,0,0,0,0,177,42,135,23,114,33,0,33,118,0,118
03/02/2022 10:00,17,9,8,70,34,36,67,25,42,0,0,0,13,13,0,10,10,0,1,1,0,90,24,66,16,60,20,0,20,81,0,81
03/02/2022 11:00,12,4,8,47,24,23,56,24,32,0,0,0,10,10,0,12,12,0,3,3,0,77,21,56,30,45,35,0,35,69,1,68
03/02/2022 12:00,9,3,6,64,26,38,63,26,37,0,0,0,9,9,0,11,11,0,9,9,0,124,48,76,44,48,65,1,64,91,0,91
03/02/2022 13:00,18,6,12,49,28,21,54,24,30,0,0,0,3,3,0,11,11,0,1,1,0,123,42,81,58,53,64,0,64,96,1,95
03/02/2022 14:00,23,8,15,45,11,34,51,17,34,0,0,0,10,10,0,18,18,0,1,1,0,117,57,60,59,36,82,0,82,87,0,87
03/02/2022 15:00,18,11,7,39,15,24,49,22,27,0,0,0,6,6,0,30,30,0,2,2,0,158,88,70,94,41,79,1,78,82,0,82
03/02/2022 16:00,26,10,16,48,15,33,58,15,43,0,0,0,10,10,0,19,19,0,0,0,0,164,91,73,130,51,92,1,91,71,0,71
03/02/2022 17:00,38,15,23,46,13,33,77,20,57,0,0,0,3,3,0,24,24,0,1,1,0,317,195,122,195,42,170,0,170,123,1,122
03/02/2022 18:00,25,9,16,69,16,53,88,20,68,0,0,0,7,7,0,22,22,0,0,0,0,285,177,108,158,51,172,0,172,134,2,132
03/02/2022 19:00,19,9,10,24,10,14,29,7,22,0,0,0,5,5,0,6,6,0,0,0,0,146,71,75,106,24,152,1,151,100,1,99
03/02/2022 20:00,10,2,8,22,10,12,22,8,14,0,0,0,4,4,0,6,6,0,0,0,0,100,65,35,69,23,89,0,89,56,1,55
03/02/2022 21:00,8,4,4,7,1,6,4,1,3,0,0,0,0,0,0,8,8,0,0,0,0,77,52,25,44,11,62,0,62,40,0,40
03/02/2022 22:00,3,2,1,2,0,2,4,0,4,0,0,0,2,2,0,3,3,0,0,0,0,44,29,15,30,8,50,1,49,26,1,25
03/02/2022 23:00,2,2,0,2,0,2,5,1,4,0,0,0,0,0,0,2,2,0,0,0,0,28,18,10,26,1,36,0,36,15,0,15
04/02/2022 00:00,1,0,1,0,0,0,2,1,1,0,0,0,0,0,0,2,2,0,0,0,0,22,19,3,17,7,27,0,27,5,0,5
04/02/2022 01:00,0,0,0,1,0,1,0,0,0,0,0,0,0,0,0,1,1,0,0,0,0,9,7,2,7,1,3,0,3,0,0,0
04/02/2022 02:00,0,0,0,1,1,0,0,0,0,0,0,0,0,0,0,0,0,0,1,1,0,5,2,3,10,2,7,0,7,1,0,1
04/02/2022 03:00,0,0,0,1,0,1,1,0,1,0,0,0,0,0,0,0,0,0,0,0,0,2,2,0,1,0,4,0,4,2,0,2
04/02/2022 04:00,1,1,0,3,1,2,2,1,1,0,0,0,0,0,0,0,0,0,0,0,0,6,1,5,4,4,1,0,1,1,0,1
04/02/2022 05:00,1,1,0,2,2,0,6,2,4,0,0,0,3,3,0,0,0,0,0,0,0,24,4,20,1,7,2,0,2,6,0,6
04/02/2022 06:00,17,15,2,4,4,0,5,5,0,0,0,0,14,14,0,6,6,0,0,0,0,96,19,77,13,59,9,0,9,30,0,30
04/02/2022 07:00,13,12,1,41,25,16,44,28,16,0,0,0,13,12,1,11,11,0,3,3,0,185,51,134,24,96,18,0,18,55,0,55
04/02/2022 08:00,40,34,6,42,21,21,41,26,15,0,0,0,31,31,0,25,25,0,54,54,0,318,71,247,45,183,34,0,34,83,0,83
04/02/2022 09:00,29,22,7,43,26,17,51,26,25,0,0,0,19,19,0,5,5,0,5,5,0,175,43,132,24,108,28,0,28,88,0,88
04/02/2022 10:00,12,6,6,35,13,22,46,17,29,0,0,0,11,11,0,9,9,0,4,4,0,76,19,57,22,52,21,0,21,50,0,50
04/02/2022 11:00,17,8,9,62,32,30,55,24,31,0,0,0,6,6,0,10,10,0,0,0,0,97,33,64,18,41,35,0,35,70,0,70
04/02/2022 12:00,23,18,5,42,19,23,56,23,33,0,0,0,3,3,0,18,18,0,0,0,0,130,51,79,50,49,66,0,66,71,0,71
04/02/2022 13:00,22,10,12,39,23,16,52,28,24,0,0,0,6,6,0,26,26,0,1,1,0,142,66,76,55,35,92,0,92,129,0,129
04/02/2022 14:00,20,9,11,30,13,17,39,18,21,0,0,0,4,4,0,7,7,0,0,0,0,126,65,61,78,29,71,0,71,87,0,87
04/02/2022 15:00,21,12,9,29,8,21,42,13,29,0,0,0,4,4,0,15,15,0,0,0,0,141,69,72,90,41,69,2,67,62,1,61
04/02/2022 16:00,17,4,13,29,8,21,45,15,30,0,0,0,4,3,1,8,8,0,7,7,0,182,97,85,112,43,112,0,112,102,1,101
04/02/2022 17:00,30,10,20,36,10,26,68,22,46,0,0,0,2,2,0,21,21,0,17,17,0,251,137,114,133,29,148,2,146,93,0,93
04/02/2022 18:00,24,14,10,31,11,20,44,13,31,0,0,0,3,2,1,11,11,0,3,3,0,230,110,120,123,41,181,1,180,140,0,140
04/02/2022 19:00,9,3,6,20,7,13,27,10,17,0,0,0,8,8,0,10,10,0,6,6,0,168,88,80,67,26,151,0,151,120,0,120
04/02/2022 20:00,13,8,5,15,9,6,19,7,12,0,0,0,3,3,0,9,9,0,2,2,0,90,47,43,56,33,118,1,117,104,1,103
04/02/2022 21:00,8,5,3,12,6,6,15,9,6,0,0,0,3,3,0,4,4,0,4,4,0,79,52,27,40,22,78,1,77,69,0,69
04/02/2022 22:00,7,2,5,9,5,4,12,4,8,0,0,0,2,2,0,4,4,0,1,1,0,39,24,15,32,23,34,0,34,45,0,45
04/02/2022 23:00,0,0,0,2,1,1,4,2,2,0,0,0,0,0,0,3,3,0,1,1,0,32,18,14,26,12,39,0,39,30,0,30
05/02/2022 00:00,4,1,3,0,0,0,3,2,1,0,0,0,0,0,0,2,2,0,2,2,0,33,26,7,19,7,27,0,27,11,0,11
05/02/2022 01:00,0,0,0,0,0,0,1,0,1,0,0,0,1,1,0,2,2,0,0,0,0,17,13,4,8,5,7,1,6,3,0,3
05/02/2022 02:00,1,0,1,0,0,0,1,0,1,0,0,0,0,0,0,0,0,0,0,0,0,9,6,3,10,3,22,0,22,1,1,0
05/02/2022 03:00,0,0,0,1,1,0,2,1,1,0,0,0,0,0,0,0,0,0,0,0,0,7,3,4,12,0,15,0,15,1,0,1
05/02/2022 04:00,0,0,0,2,1,1,2,1,1,0,0,0,0,0,0,0,0,0,0,0,0,9,4,5,8,2,9,0,9,0,0,0
05/02/2022 05:00,2,2,0,1,1,0,1,1,0,0,0,0,1,1,0,0,0,0,0,0,0,11,5,6,3,3,4,0,4,0,0,0
05/02/2022 06:00,4,4,0,2,1,1,3,1,2,0,0,0,2,2,0,1,1,0,1,1,0,25,3,22,9,6,6,0,6,10,0,10
05/02/2022 07:00,8,8,0,19,5,14,20,4,16,0,0,0,4,4,0,3,3,0,0,0,0,43,15,28,12,21,12,0,12,11,0,11
05/02/2022 08:00,4,3,1,40,13,27,40,16,24,0,0,0,6,6,0,4,4,0,0,0,0,54,12,42,13,24,15,0,15,23,0,23
05/02/2022 09:00,7,5,2,49,22,27,47,19,28,0,0,0,3,3,0,9,9,0,0,0,0,70,22,48,24,20,22,0,22,60,0,60
05/02/2022 10:00,14,9,5,53,25,28,55,23,32,0,0,0,1,1,0,5,5,0,0,0,0,70,26,44,22,50,37,1,36,64,0,64
05/02/2022 11:00,6,4,2,48,31,17,47,24,23,0,0,0,2,2,0,6,6,0,0,0,0,91,32,59,26,42,38,0,38,67,2,65
05/02/2022 12:00,10,5,5,32,20,12,49,22,27,0,0,0,2,2,0,7,7,0,0,0,0,108,41,67,40,42,64,0,64,74,0,74
05/02/2022 13:00,11,5,6,16,8,8,23,13,10,0,0,0,3,3,0,4,4,0,0,0,0,112,50,62,30,38,60,0,60,90,0,90
05/02/2022 14:00,4,3,1,20,10,10,23,13,10,0,0,0,6,6,0,7,7,0,0,0,0,96,40,56,43,34,47,0,47,82,0,82
05/02/2022 15:00,8,6,2,10,6,4,8,2,6,0,0,0,3,3,0,4,4,0,0,0,0,65,27,38,28,12,46,1,45,56,0,56
05/02/2022 16:00,6,3,3,17,7,10,17,9,8,0,0,0,3,3,0,4,4,0,0,0,0,95,37,58,29,35,55,1,54,62,0,62
05/02/2022 17:00,8,2,6,8,3,5,13,7,6,0,0,0,4,4,0,3,3,0,0,0,0,115,50,65,31,18,75,0,75,55,0,55
05/02/2022 18:00,9,5,4,5,3,2,4,0,4,0,0,0,3,3,0,3,3,0,0,0,0,101,33,68,27,15,60,0,60,47,0,47
05/02/2022 19:00,3,0,3,3,1,2,5,2,3,0,0,0,2,2,0,0,0,0,0,0,0,67,33,34,22,8,55,1,54,55,1,54
05/02/2022 20:00,4,2,2,6,2,4,7,3,4,0,0,0,0,0,0,2,2,0,0,0,0,53,32,21,20,8,51,0,51,42,0,42
05/02/2022 21:00,5,3,2,1,0,1,4,0,4,0,0,0,1,1,0,1,1,0,1,1,0,51,30,21,22,15,32,1,31,38,1,37
05/02/2022 22:00,3,2,1,1,1,0,2,0,2,0,0,0,6,6,0,1,1,0,0,0,0,27,15,12,11,11,34,0,34,43,0,43
05/02/2022 23:00,4,4,0,2,0,2,1,0,1,0,0,0,1,1,0,1,1,0,0,0,0,29,20,9,16,6,28,0,28,16,0,16
06/02/2022 00:00,1,0,1,1,1,0,3,1,2,0,0,0,0,0,0,2,2,0,0,0,0,18,13,5,8,3,15,0,15,5,0,5
06/02/2022 01:00,1,0,1,2,0,2,1,0,1,0,0,0,0,0,0,0,0,0,0,0,0,14,7,7,5,2,1,0,1,0,0,0
06/02/2022 02:00,1,0,1,0,0,0,0,0,0,0,0,0,0,0,0,0,0,0,0,0,0,8,5,3,8,2,7,0,7,5,0,5
06/02/2022 03:00,0,0,0,1,1,0,1,0,1,0,0,0,0,0,0,1,1,0,0,0,0,5,2,3,9,1,5,0,5,1,0,1
06/02/2022 04:00,0,0,0,0,0,0,2,1,1,0,0,0,0,0,0,0,0,0,0,0,0,4,2,2,7,0,7,0,7,1,0,1
06/02/2022 05:00,1,1,0,2,1,1,1,0,1,0,0,0,1,1,0,0,0,0,0,0,0,2,0,2,3,1,9,0,9,1,0,1
06/02/2022 06:00,1,1,0,3,1,2,4,1,3,0,0,0,3,3,0,1,1,0,0,0,0,18,2,16,10,3,4,0,4,8,0,8
06/02/2022 07:00,4,4,0,13,6,7,25,7,18,0,0,0,9,9,0,1,1,0,0,0,0,31,10,21,10,11,8,0,8,4,0,4
06/02/2022 08:00,5,2,3,49,16,33,46,13,33,0,0,0,5,5,0,4,4,0,0,0,0,26,9,17,10,12,13,0,13,17,0,17
06/02/2022 09:00,3,2,1,54,17,37,56,20,36,0,0,0,4,4,0,7,7,0,0,0,0,36,7,29,12,23,11,0,11,28,0,28
06/02/2022 10:00,6,5,1,88,31,57,79,24,55,0,0,0,1,1,0,6,6,0,0,0,0,64,22,42,14,25,18,0,18,38,0,38
06/02/2022 11:00,13,9,4,78,46,32,87,45,42,0,0,0,5,5,0,5,5,0,0,0,0,64,29,35,18,23,33,0,33,53,0,53
06/02/2022 12:00,16,11,5,65,29,36,77,33,44,0,0,0,4,4,0,7,7,0,1,1,0,85,28,57,31,20,53,1,52,74,0,74
06/02/2022 13:00,15,6,9,67,36,31,57,28,29,0,0,0,8,7,1,8,8,0,0,0,0,93,42,51,30,32,59,0,59,83,1,82
06/02/2022 14:00,14,6,8,51,31,20,69,38,31,0,0,0,3,2,1,8,8,0,0,0,0,69,36,33,28,35,74,0,74,70,1,69
06/02/2022 15:00,11,7,4,34,15,19,35,15,20,0,0,0,5,5,0,3,3,0,0,0,0,87,34,53,31,25,64,0,64,75,2,73
06/02/2022 16:00,14,8,6,38,21,17,42,20,22,0,0,0,2,2,0,6,6,0,0,0,0,84,41,43,37,22,60,0,60,56,0,56
06/02/2022 17:00,11,7,4,31,19,12,35,19,16,0,0,0,2,2,0,9,9,0,0,0,0,97,43,54,37,42,100,1,99,78,0,78
06/02/2022 18:00,9,6,3,16,6,10,21,13,8,0,0,0,1,1,0,4,4,0,0,0,0,109,45,64,56,42,74,1,73,71,0,71
06/02/2022 19:00,14,8,6,11,6,5,16,8,8,0,0,0,3,3,0,8,8,0,0,0,0,77,42,35,43,11,72,0,72,60,1,59
06/02/2022 20:00,7,3,4,10,5,5,9,5,4,0,0,0,1,1,0,4,4,0,3,3,0,72,37,35,19,19,74,1,73,64,1,63
06/02/2022 21:00,6,6,0,6,2,4,10,3,7,0,0,0,1,1,0,1,1,0,3,3,0,41,25,16,23,7,49,0,49,53,0,53
06/02/2022 22:00,6,2,4,4,2,2,5,3,2,0,0,0,3,3,0,1,1,0,1,1,0,39,28,11,15,6,39,0,39,22,0,22
06/02/2022 23:00,0,0,0,1,1,0,0,0,0,0,0,0,1,0,1,2,2,0,0,0,0,13,11,2,15,7,19,1,18,17,0,17
07/02/2022 00:00,1,1,0,2,1,1,3,1,2,0,0,0,1,1,0,2,2,0,0,0,0,5,3,2,9,3,11,0,11,13,0,13
07/02/2022 01:00,3,3,0,2,1,1,0,0,0,0,0,0,1,1,0,0,0,0,0,0,0,5,5,0,4,1,1,0,1,0,0,0
07/02/2022 02:00,0,0,0,1,1,0,1,1,0,0,0,0,0,0,0,0,0,0,0,0,0,5,1,4,6,1,2,0,2,0,0,0
07/02/2022 03:00,0,0,0,2,1,1,2,1,1,0,0,0,0,0,0,0,0,0,0,0,0,3,3,0,2,0,2,0,2,1,1,0
07/02/2022 04:00,1,1,0,1,1,0,2,0,2,0,0,0,2,2,0,0,0,0,0,0,0,4,0,4,2,4,0,0,0,0,0,0
07/02/2022 05:00,0,0,0,4,4,0,4,3,1,0,0,0,3,3,0,0,0,0,0,0,0,26,3,23,5,17,3,0,3,3,0,3
07/02/2022 06:00,20,19,1,16,15,1,18,13,5,0,0,0,4,4,0,6,6,0,0,0,0,117,23,94,13,61,6,0,6,28,0,28
07/02/2022 07:00,24,20,4,43,29,14,53,38,15,0,0,0,8,8,0,13,13,0,0,0,0,219,57,162,28,124,30,0,30,69,0,69
07/02/2022 08:00,61,54,7,67,44,23,76,58,18,0,0,0,40,40,0,20,20,0,0,0,0,340,69,271,29,205,37,0,37,127,0,127
07/02/2022 09:00,28,20,8,40,24,16,46,25,21,0,0,0,21,21,0,10,10,0,0,0,0,188,40,148,15,105,26,0,26,131,0,131
07/02/2022 10:00,13,9,4,51,20,31,43,19,24,0,0,0,14,14,0,10,10,0,0,0,0,82,20,62,6,41,19,0,19,78,0,78
07/02/2022 11:00,11,5,6,49,20,29,57,25,32,0,0,0,8,8,0,9,9,0,0,0,0,82,23,59,17,38,41,0,41,78,0,78
07/02/2022 12:00,12,6,6,37,19,18,52,21,31,0,0,0,4,4,0,12,12,0,0,0,0,109,43,66,36,25,41,0,41,75,0,75
07/02/2022 13:00,28,14,14,34,17,17,35,16,19,0,0,0,1,1,0,5,5,0,0,0,0,119,56,63,42,32,56,0,56,83,0,83
07/02/2022 14:00,16,8,8,26,11,15,29,14,15,0,0,0,0,0,0,13,13,0,0,0,0,113,70,43,46,32,61,0,61,65,0,65
07/02/2022 15:00,25,12,13,35,13,22,42,11,31,0,0,0,6,6,0,29,29,0,0,0,0,170,88,82,86,34,66,0,66,75,1,74
07/02/2022 16:00,28,9,19,50,16,34,63,21,42,0,0,0,3,3,0,17,17,0,0,0,0,201,108,93,122,42,107,0,107,66,2,64
07/02/2022 17:00,33,10,23,61,18,43,80,22,58,0,0,0,0,0,0,27,27,0,0,0,0,315,183,132,198,52,186,0,186,107,0,107
07/02/2022 18:00,30,14,16,51,16,35,80,21,59,0,0,0,0,0,0,18,18,0,0,0,0,268,160,108,154,16,158,0,158,107,0,107
07/02/2022 19:00,16,4,12,27,11,16,41,12,29,0,0,0,2,2,0,10,10,0,0,0,0,157,86,71,93,20,136,0,136,78,0,78
07/02/2022 20:00,14,3,11,18,4,14,16,3,13,0,0,0,0,0,0,13,13,0,0,0,0,94,55,39,43,11,97,0,97,57,0,57
07/02/2022 21:00,8,1,7,22,10,12,25,7,18,0,0,0,4,4,0,10,10,0,1,1,0,73,48,25,43,13,54,0,54,49,1,48
07/02/2022 22:00,1,0,1,5,3,2,6,2,4,0,0,0,1,1,0,6,6,0,1,1,0,42,24,18,25,17,32,0,32,18,0,18
07/02/2022 23:00,5,1,4,3,1,2,1,0,1,0,0,0,0,0,0,3,3,0,0,0,0,20,10,10,11,2,18,0,18,6,1,5
08/02/2022 00:00,2,0,2,2,1,1,7,3,4,0,0,0,0,0,0,1,1,0,0,0,0,11,7,4,8,4,15,0,15,5,0,5
08/02/2022 01:00,2,1,1,1,1,0,0,0,0,0,0,0,0,0,0,0,0,0,0,0,0,5,5,0,3,0,1,0,1,1,0,1
08/02/2022 02:00,0,0,0,0,0,0,1,0,1,0,0,0,0,0,0,0,0,0,0,0,0,1,1,0,2,0,4,0,4,0,0,0
08/02/2022 03:00,0,0,0,0,0,0,1,0,1,0,0,0,0,0,0,0,0,0,0,0,0,4,3,1,1,0,0,0,0,0,0,0
08/02/2022 04:00,1,1,0,0,0,0,0,0,0,0,0,0,1,1,0,0,0,0,0,0,0,6,1,5,2,3,0,0,0,0,0,0
08/02/2022 05:00,1,1,0,6,5,1,6,4,2,0,0,0,2,2,0,0,0,0,0,0,0,22,3,19,1,17,2,0,2,7,0,7
08/02/2022 06:00,13,13,0,12,9,3,15,11,4,0,0,0,3,3,0,3,3,0,0,0,0,113,18,95,14,76,12,1,11,26,0,26
08/02/2022 07:00,20,20,0,36,23,13,42,29,13,0,0,0,30,30,0,15,15,0,0,0,0,224,52,172,27,122,27,0,27,62,0,62
08/02/2022 08:00,59,50,9,58,42,16,90,67,23,0,0,0,52,52,0,33,33,0,0,0,0,407,92,315,28,246,34,0,34,101,0,101
08/02/2022 09:00,22,15,7,38,20,18,45,24,21,0,0,0,17,17,0,8,8,0,0,0,0,184,43,141,22,119,23,0,23,103,1,102
08/02/2022 10:00,17,7,10,18,7,11,28,16,12,0,0,0,4,4,0,8,8,0,0,0,0,57,15,42,26,37,12,0,12,61,1,60
08/02/2022 11:00,11,4,7,43,21,22,47,20,27,0,0,0,7,7,0,7,7,0,0,0,0,73,24,49,21,36,38,0,38,43,0,43
08/02/2022 12:00,15,9,6,33,16,17,43,21,22,0,0,0,10,10,0,7,7,0,0,0,0,86,38,48,33,46,46,0,46,67,1,66
08/02/2022 13:00,19,12,7,17,12,5,24,9,15,0,0,0,5,5,0,12,12,0,0,0,0,103,40,63,40,38,73,0,73,79,2,77
08/02/2022 14:00,17,8,9,20,5,15,33,13,20,0,0,0,4,4,0,13,13,0,0,0,0,91,50,41,64,37,63,0,63,60,0,60
08/02/2022 15:00,19,8,11,28,11,17,32,10,22,0,0,0,2,2,0,20,20,0,0,0,0,157,80,77,75,41,71,0,71,61,0,61
08/02/2022 16:00,22,12,10,39,12,27,46,14,32,0,0,0,8,8,0,14,14,0,0,0,0,196,112,84,114,45,102,0,102,65,2,63
08/02/2022 17:00,46,16,30,53,13,40,69,14,55,0,0,0,3,3,0,20,20,0,0,0,0,279,177,102,204,42,163,1,162,70,0,70
08/02/2022 18:00,21,9,12,44,5,39,60,10,50,0,0,0,2,2,0,19,19,0,0,0,0,250,168,82,175,29,167,1,166,84,1,83
08/02/2022 19:00,13,7,6,15,4,11,25,4,21,0,0,0,0,0,0,10,10,0,0,0,0,133,79,54,75,15,98,1,97,57,1,56
08/02/2022 20:00,8,1,7,10,4,6,15,4,11,0,0,0,1,1,0,7,7,0,0,0,0,91,55,36,46,23,74,0,74,45,0,45
08/02/2022 21:00,4,3,1,4,3,1,4,1,3,0,0,0,0,0,0,2,2,0,0,0,0,70,53,17,27,12,49,1,48,40,1,39
08/02/2022 22:00,6,4,2,2,0,2,4,1,3,0,0,0,1,1,0,4,4,0,0,0,0,33,21,12,31,7,26,0,26,25,0,25
08/02/2022 23:00,2,1,1,1,1,0,1,1,0,0,0,0,0,0,0,1,1,0,0,0,0,13,9,4,15,4,18,0,18,10,0,10
09/02/2022 00:00,1,0,1,1,0,1,2,0,2,0,0,0,0,0,0,2,2,0,2,2,0,12,10,2,10,1,12,0,12,8,0,8
09/02/2022 01:00,0,0,0,1,0,1,0,0,0,0,0,0,0,0,0,0,0,0,1,1,0,4,4,0,4,3,1,0,1,0,0,0
09/02/2022 02:00,0,0,0,0,0,0,0,0,0,0,0,0,0,0,0,0,0,0,0,0,0,3,3,0,3,0,2,0,2,0,0,0
09/02/2022 03:00,1,0,1,2,0,2,3,1,2,0,0,0,0,0,0,0,0,0,0,0,0,3,1,2,4,0,4,0,4,1,0,1
09/02/2022 04:00,1,1,0,0,0,0,0,0,0,0,0,0,2,2,0,0,0,0,2,2,0,7,0,7,1,3,2,0,2,0,0,0
09/02/2022 05:00,0,0,0,3,3,0,4,2,2,0,0,0,1,1,0,1,1,0,0,0,0,26,3,23,1,15,1,0,1,5,0,5
09/02/2022 06:00,20,20,0,17,11,6,20,11,9,0,0,0,12,12,0,7,7,0,0,0,0,113,20,93,12,70,10,0,10,31,0,31
09/02/2022 07:00,23,19,4,61,46,15,71,42,29,0,0,0,18,17,1,14,14,0,0,0,0,246,66,180,34,139,32,0,32,75,0,75
09/02/2022 08:00,66,58,8,92,68,24,105,78,27,0,0,0,69,68,1,34,34,0,21,21,0,386,76,310,34,248,51,0,51,130,0,130
09/02/2022 09:00,33,26,7,63,32,31,81,45,36,0,0,0,16,15,1,12,12,0,2,2,0,195,40,155,24,108,32,2,30,122,0,122
09/02/2022 10:00,20,11,9,71,32,39,70,33,37,0,0,0,6,6,0,11,11,0,0,0,0,77,25,52,19,61,31,0,31,77,0,77
09/02/2022 11:00,14,7,7,66,35,31,71,36,35,0,0,0,3,3,0,9,9,0,0,0,0,91,37,54,23,49,33,0,33,66,0,66
09/02/2022 12:00,27,16,11,53,24,29,68,31,37,0,0,0,13,13,0,13,13,0,0,0,0,126,46,80,49,60,73,0,73,70,0,70
09/02/2022 13:00,27,11,16,67,35,32,73,34,39,0,0,0,11,11,0,18,18,0,0,0,0,138,56,82,49,57,100,0,100,120,0,120
09/02/2022 14:00,29,14,15,50,23,27,56,26,30,0,0,0,6,6,0,22,22,0,0,0,0,119,60,59,53,44,80,1,79,85,1,84
09/02/2022 15:00,23,12,11,57,27,30,63,28,35,0,0,0,2,2,0,21,21,0,0,0,0,152,78,74,74,39,88,0,88,74,1,73
09/02/2022 16:00,29,10,19,50,14,36,77,28,49,0,0,0,0,0,0,20,20,0,1,1,0,214,125,89,133,44,120,1,119,79,2,77
09/02/2022 17:00,34,10,24,81,20,61,111,34,77,0,0,0,3,3,0,24,24,0,1,1,0,316,195,121,210,46,183,0,183,109,0,109
09/02/2022 18:00,17,8,9,64,17,47,74,10,64,0,0,0,2,2,0,17,17,0,0,0,0,245,144,101,190,33,203,0,203,118,0,118
09/02/2022 19:00,18,11,7,53,15,38,47,17,30,0,0,0,0,0,0,13,13,0,0,0,0,159,89,70,91,32,147,1,146,88,0,88
09/02/2022 20:00,13,7,6,25,11,14,33,10,23,0,0,0,1,1,0,12,12,0,0,0,0,140,80,60,65,19,120,1,119,65,0,65
09/02/2022 21:00,13,8,5,24,11,13,30,10,20,0,0,0,3,3,0,5,5,0,0,0,0,96,42,54,49,6,83,1,82,52,0,52
09/02/2022 22:00,5,2,3,10,7,3,9,4,5,0,0,0,1,1,0,5,5,0,0,0,0,58,30,28,33,10,44,0,44,41,1,40
09/02/2022 23:00,2,2,0,1,1,0,1,1,0,0,0,0,0,0,0,4,4,0,0,0,0,31,25,6,31,5,37,0,37,18,0,18
10/02/2022 00:00,0,0,0,1,0,1,1,0,1,0,0,0,0,0,0,3,3,0,0,0,0,17,13,4,10,6,20,0,20,8,0,8
10/02/2022 01:00,0,0,0,1,0,1,0,0,0,0,0,0,1,1,0,0,0,0,0,0,0,8,8,0,5,0,3,0,3,0,0,0
10/02/2022 02:00,0,0,0,0,0,0,2,0,2,0,0,0,0,0,0,0,0,0,0,0,0,2,2,0,2,0,2,0,2,1,0,1
10/02/2022 03:00,0,0,0,2,1,1,2,1,1,0,0,0,0,0,0,0,0,0,0,0,0,1,1,0,8,0,2,0,2,2,0,2
10/02/2022 04:00,0,0,0,1,1,0,0,0,0,0,0,0,1,1,0,1,1,0,0,0,0,6,0,6,1,4,4,0,4,0,0,0
10/02/2022 05:00,1,1,0,4,4,0,5,4,1,0,0,0,2,2,0,0,0,0,0,0,0,25,0,25,3,10,1,0,1,8,0,8
10/02/2022 06:00,21,19,2,16,12,4,19,13,6,0,0,0,6,6,0,7,7,0,0,0,0,103,20,83,12,60,7,0,7,25,0,25
10/02/2022 07:00,22,19,3,36,23,13,49,28,21,0,0,0,16,16,0,8,8,0,0,0,0,230,59,171,28,102,22,1,21,49,0,49
10/02/2022 08:00,69,57,12,60,46,14,82,66,16,0,0,0,40,40,0,29,29,0,0,0,0,403,78,325,46,219,41,0,41,142,1,141
10/02/2022 09:00,23,19,4,39,20,19,41,25,16,0,0,0,23,22,1,16,16,0,0,0,0,211,43,168,29,123,25,2,23,123,1,122
10/02/2022 10:00,16,11,5,47,20,27,54,20,34,0,0,0,6,5,1,11,11,0,0,0,0,90,24,66,25,49,15,0,15,60,0,60
10/02/2022 11:00,15,7,8,52,21,31,59,27,32,0,0,0,7,7,0,8,8,0,0,0,0,90,30,60,15,47,29,0,29,66,0,66
10/02/2022 12:00,15,8,7,81,41,40,67,36,31,0,0,0,15,15,0,6,6,0,0,0,0,94,35,59,47,52,41,0,41,90,0,90
10/02/2022 13:00,24,13,11,51,24,27,53,28,25,0,0,0,6,6,0,15,15,0,0,0,0,134,50,84,79,45,95,2,93,88,0,88
10/02/2022 14:00,22,14,8,46,21,25,47,14,33,0,0,0,3,3,0,16,16,0,0,0,0,127,65,62,64,39,54,0,54,81,0,81
10/02/2022 15:00,22,6,16,41,16,25,46,11,35,0,0,0,4,4,0,22,22,0,0,0,0,148,70,78,73,44,80,0,80,64,1,63
10/02/2022 16:00,41,17,24,53,16,37,64,19,45,0,0,0,4,4,0,17,17,0,0,0,0,196,112,84,138,51,114,0,114,79,0,79
10/02/2022 17:00,38,3,35,65,17,48,87,24,63,0,0,0,4,3,1,26,26,0,1,1,0,298,180,118,211,51,196,1,195,105,0,105
10/02/2022 18:00,29,12,17,72,24,48,93,27,66,0,0,0,1,1,0,25,25,0,0,0,0,287,169,118,188,36,184,3,181,146,0,146
10/02/2022 19:00,14,4,10,38,15,23,45,11,34,0,0,0,1,1,0,10,10,0,0,0,0,170,86,84,63,44,137,0,137,98,2,96
10/02/2022 20:00,12,4,8,27,14,13,31,12,19,0,0,0,1,0,1,15,15,0,1,1,0,119,80,39,48,15,124,1,123,82,0,82
10/02/2022 21:00,6,1,5,5,4,1,4,2,2,0,0,0,0,0,0,7,7,0,1,1,0,83,59,24,53,17,85,0,85,51,0,51
10/02/2022 22:00,5,4,1,11,5,6,13,5,8,0,0,0,2,2,0,4,4,0,1,1,0,62,43,19,43,7,57,0,57,31,2,29
10/02/2022 23:00,6,2,4,2,1,1,4,1,3,0,0,0,0,0,0,2,2,0,0,0,0,35,25,10,19,0,44,0,44,20,0,20
11/02/2022 00:00,1,0,1,1,0,1,3,1,2,0,0,0,1,1,0,2,2,0,0,0,0,28,24,4,13,3,25,0,25,8,0,8
11/02/2022 01:00,0,0,0,0,0,0,0,0,0,0,0,0,0,0,0,1,1,0,0,0,0,5,4,1,8,1,2,0,2,0,0,0
11/02/2022 02:00,0,0,0,0,0,0,0,0,0,0,0,0,0,0,0,0,0,0,0,0,0,3,2,1,3,0,5,0,5,2,0,2
11/02/2022 03:00,0,0,0,3,1,2,6,2,4,0,0,0,0,0,0,0,0,0,0,0,0,2,1,1,4,0,5,0,5,0,0,0
11/02/2022 04:00,0,0,0,1,1,0,0,0,0,0,0,0,1,1,0,0,0,0,0,0,0,7,2,5,4,4,1,0,1,1,0,1
11/02/2022 05:00,3,2,1,1,1,0,3,2,1,0,0,0,2,2,0,2,2,0,0,0,0,16,2,14,0,14,1,0,1,6,0,6
11/02/2022 06:00,14,13,1,8,7,1,9,7,2,0,0,0,4,4,0,8,8,0,0,0,0,113,26,87,14,46,10,0,10,29,0,29
11/02/2022 07:00,27,25,2,36,23,13,41,25,16,0,0,0,25,25,0,11,11,0,0,0,0,199,50,149,27,101,31,1,30,64,0,64
11/02/2022 08:00,34,27,7,59,40,19,85,63,22,0,0,0,18,18,0,25,25,0,0,0,0,332,83,249,29,155,48,1,47,107,0,107
11/02/2022 09:00,26,16,10,37,20,17,49,30,19,0,0,0,8,8,0,8,8,0,0,0,0,190,50,140,21,99,36,0,36,108,1,107
11/02/2022 10:00,22,14,8,57,20,37,59,26,33,0,0,0,9,9,0,10,10,0,1,1,0,84,24,60,19,50,29,0,29,70,0,70
11/02/2022 11:00,13,9,4,53,26,27,60,31,29,0,0,0,10,10,0,13,13,0,0,0,0,89,24,65,41,58,30,0,30,83,0,83
11/02/2022 12:00,23,15,8,49,24,25,64,32,32,0,0,0,6,6,0,15,15,0,0,0,0,119,48,71,54,54,77,1,76,98,0,98
11/02/2022 13:00,17,6,11,46,19,27,57,21,36,0,0,0,6,6,0,14,14,0,0,0,0,142,68,74,68,48,89,0,89,121,0,121
11/02/2022 14:00,26,12,14,51,27,24,44,15,29,0,0,0,3,3,0,15,15,0,0,0,0,133,54,79,73,33,80,0,80,113,1,112
11/02/2022 15:00,21,8,13,50,21,29,58,23,35,0,0,0,6,6,0,15,15,0,0,0,0,155,76,79,82,38,78,0,78,80,1,79
11/02/2022 16:00,24,11,13,36,9,27,58,15,43,0,0,0,5,4,1,17,17,0,0,0,0,194,98,96,111,47,133,0,133,90,0,90
11/02/2022 17:00,38,11,27,46,13,33,67,17,50,0,0,0,3,3,0,18,18,0,0,0,0,254,140,114,146,41,179,0,179,135,0,135
11/02/2022 18:00,12,5,7,30,9,21,44,11,33,0,0,0,8,8,0,8,8,0,0,0,0,210,125,85,119,45,176,2,174,143,0,143
11/02/2022 19:00,4,3,1,22,10,12,23,6,17,0,0,0,4,4,0,7,7,0,0,0,0,151,71,80,60,33,133,0,133,125,0,125
11/02/2022 20:00,10,2,8,5,2,3,15,4,11,0,0,0,1,1,0,6,6,0,0,0,0,114,57,57,59,29,87,0,87,107,0,107
11/02/2022 21:00,7,4,3,7,3,4,10,4,6,0,0,0,5,5,0,4,4,0,0,0,0,71,45,26,51,11,90,1,89,76,0,76
11/02/2022 22:00,5,4,1,3,0,3,4,1,3,0,0,0,1,1,0,1,1,0,0,0,0,63,46,17,30,7,40,0,40,48,0,48
11/02/2022 23:00,1,0,1,1,0,1,2,0,2,0,0,0,1,1,0,5,5,0,0,0,0,35,31,4,28,5,37,0,37,20,0,20
12/02/2022 00:00,3,2,1,4,1,3,5,2,3,0,0,0,0,0,0,4,4,0,0,0,0,28,17,11,17,3,24,0,24,14,0,14
12/02/2022 01:00,0,0,0,1,0,1,0,0,0,0,0,0,0,0,0,0,0,0,0,0,0,15,9,6,10,5,8,1,7,2,0,2
12/02/2022 02:00,0,0,0,1,0,1,1,0,1,0,0,0,0,0,0,0,0,0,0,0,0,7,4,3,8,1,16,0,16,4,0,4
12/02/2022 03:00,0,0,0,1,0,1,1,0,1,0,0,0,0,0,0,1,1,0,0,0,0,4,1,3,8,2,17,0,17,0,0,0
12/02/2022 04:00,0,0,0,1,0,1,1,0,1,0,0,0,0,0,0,0,0,0,0,0,0,9,5,4,5,1,9,0,9,0,0,0
12/02/2022 05:00,2,2,0,3,2,1,4,2,2,0,0,0,1,1,0,0,0,0,0,0,0,15,3,12,4,4,4,0,4,2,0,2
12/02/2022 06:00,3,3,0,0,0,0,1,0,1,0,0,0,2,2,0,1,1,0,0,0,0,33,8,25,11,5,7,0,7,11,0,11
12/02/2022 07:00,6,3,3,16,6,10,26,10,16,0,0,0,9,9,0,3,3,0,0,0,0,50,18,32,11,22,10,0,10,15,0,15
12/02/2022 08:00,6,6,0,29,11,18,41,18,23,0,0,0,6,6,0,5,5,0,0,0,0,55,15,40,18,23,12,0,12,24,0,24
12/02/2022 09:00,4,4,0,62,29,33,72,28,44,0,0,0,2,2,0,10,10,0,1,1,0,57,18,39,8,36,21,0,21,48,0,48
12/02/2022 10:00,8,4,4,45,19,26,57,19,38,0,0,0,1,1,0,8,8,0,0,0,0,79,26,53,20,31,33,0,33,59,0,59
12/02/2022 11:00,5,3,2,61,29,32,70,28,42,0,0,0,2,2,0,5,5,0,3,3,0,78,31,47,35,28,47,0,47,70,1,69
12/02/2022 12:00,11,4,7,48,25,23,64,39,25,0,0,0,4,4,0,12,12,0,0,0,0,103,43,60,40,47,76,0,76,92,0,92
12/02/2022 13:00,13,7,6,58,28,30,65,32,33,0,0,0,6,6,0,9,9,0,0,0,0,122,50,72,57,27,87,1,86,108,1,107
12/02/2022 14:00,13,7,6,44,23,21,56,21,35,0,0,0,3,3,0,5,5,0,6,6,0,109,48,61,45,27,78,1,77,118,4,114
12/02/2022 15:00,12,5,7,48,26,22,66,32,34,0,0,0,6,5,1,4,4,0,3,3,0,117,46,71,46,49,88,0,88,72,1,71
12/02/2022 16:00,9,8,1,56,28,28,54,28,26,0,0,0,7,6,1,5,5,0,2,2,0,110,48,62,53,37,104,0,104,68,1,67
12/02/2022 17:00,12,6,6,31,20,11,46,26,20,0,0,0,6,6,0,9,9,0,4,4,0,103,38,65,55,20,70,0,70,72,0,72
12/02/2022 18:00,8,5,3,17,10,7,19,11,8,0,0,0,6,6,0,2,2,0,4,4,0,102,45,57,52,28,86,0,86,100,1,99
12/02/2022 19:00,11,6,5,13,5,8,15,7,8,0,0,0,0,0,0,1,1,0,5,5,0,95,45,50,42,27,84,0,84,96,0,96
12/02/2022 20:00,8,4,4,13,7,6,22,10,12,0,0,0,6,6,0,3,3,0,2,2,0,71,38,33,43,32,83,1,82,103,1,102
12/02/2022 21:00,7,4,3,5,2,3,6,2,4,0,0,0,1,1,0,2,2,0,2,2,0,68,34,34,29,23,43,2,41,59,0,59
12/02/2022 22:00,8,7,1,2,1,1,9,3,6,0,0,0,3,3,0,0,0,0,2,2,0,38,17,21,24,15,36,0,36,53,0,53
12/02/2022 23:00,1,0,1,2,0,2,4,1,3,0,0,0,2,2,0,3,3,0,3,3,0,37,18,19,17,7,33,0,33,26,0,26
13/02/2022 00:00,2,1,1,3,1,2,3,1,2,0,0,0,0,0,0,0,0,0,0,0,0,21,15,6,21,9,26,0,26,18,0,18
13/02/2022 01:00,1,0,1,3,1,2,2,1,1,0,0,0,0,0,0,2,2,0,2,2,0,19,13,6,9,2,14,0,14,1,0,1
13/02/2022 02:00,2,1,1,0,0,0,0,0,0,0,0,0,1,1,0,1,1,0,0,0,0,14,8,6,5,2,22,1,21,3,0,3
13/02/2022 03:00,2,0,2,2,2,0,3,1,2,0,0,0,0,0,0,0,0,0,1,1,0,6,2,4,11,2,11,0,11,5,0,5
13/02/2022 04:00,0,0,0,1,0,1,1,0,1,0,0,0,0,0,0,0,0,0,0,0,0,4,1,3,8,2,10,0,10,2,0,2
13/02/2022 05:00,0,0,0,1,1,0,1,1,0,0,0,0,1,1,0,0,0,0,0,0,0,6,0,6,0,1,5,0,5,3,0,3
13/02/2022 06:00,2,2,0,1,0,1,3,0,3,0,0,0,1,1,0,0,0,0,2,2,0,13,2,11,5,1,2,0,2,5,0,5
13/02/2022 07:00,2,1,1,6,3,3,6,2,4,0,0,0,4,3,1,0,0,0,1,1,0,25,8,17,9,3,8,0,8,9,0,9
13/02/2022 08:00,2,2,0,22,11,11,27,13,14,0,0,0,6,6,0,3,3,0,6,6,0,41,14,27,13,13,6,0,6,8,0,8
13/02/2022 09:00,7,7,0,41,18,23,41,15,26,0,0,0,4,4,0,5,5,0,2,2,0,39,16,23,11,15,12,0,12,31,0,31
13/02/2022 10:00,4,1,3,46,21,25,64,32,32,0,0,0,2,2,0,5,5,0,2,2,0,57,20,37,13,25,26,0,26,40,0,40
13/02/2022 11:00,7,5,2,64,22,42,60,25,35,0,0,0,5,5,0,4,4,0,2,2,0,81,29,52,13,19,40,1,39,55,0,55
13/02/2022 12:00,10,6,4,85,37,48,84,33,51,0,0,0,2,2,0,3,3,0,1,1,0,100,33,67,33,24,53,0,53,81,0,81
13/02/2022 13:00,10,7,3,85,39,46,100,43,57,0,0,0,1,1,0,6,6,0,0,0,0,99,34,65,32,28,63,0,63,67,0,67
13/02/2022 14:00,20,13,7,74,39,35,84,42,42,0,0,0,4,4,0,4,4,0,0,0,0,102,41,61,34,38,59,0,59,96,0,96
13/02/2022 15:00,10,6,4,53,31,22,89,43,46,0,0,0,5,5,0,7,7,0,1,1,0,100,39,61,24,25,69,0,69,68,0,68
13/02/2022 16:00,6,3,3,65,32,33,71,40,31,0,0,0,4,4,0,7,7,0,1,1,0,93,35,58,40,36,74,2,72,63,0,63
13/02/2022 17:00,8,6,2,33,20,13,42,26,16,0,0,0,2,2,0,4,4,0,3,3,0,96,45,51,40,27,83,0,83,61,0,61
13/02/2022 18:00,10,7,3,24,15,9,37,24,13,0,0,0,0,0,0,5,5,0,1,1,0,95,45,50,48,31,77,2,75,78,0,78
13/02/2022 19:00,3,3,0,17,11,6,16,10,6,0,0,0,0,0,0,3,3,0,4,4,0,71,39,32,38,25,74,0,74,63,0,63
13/02/2022 20:00,5,3,2,10,4,6,9,3,6,0,0,0,3,3,0,2,2,0,4,4,0,62,32,30,31,18,58,1,57,69,0,69
13/02/2022 21:00,5,3,2,6,2,4,7,1,6,0,0,0,3,3,0,2,2,0,1,1,0,33,21,12,34,10,39,0,39,35,0,35
13/02/2022 22:00,3,2,1,5,3,2,10,7,3,0,0,0,0,0,0,1,1,0,1,1,0,29,14,15,9,7,22,0,22,26,0,26
13/02/2022 23:00,1,0,1,5,2,3,3,1,2,0,0,0,1,1,0,1,1,0,0,0,0,15,9,6,12,5,19,1,18,10,1,9
14/02/2022 00:00,0,0,0,2,1,1,1,0,1,0,0,0,0,0,0,0,0,0,0,0,0,12,8,4,7,3,11,0,11,9,0,9
14/02/2022 01:00,0,0,0,0,0,0,0,0,0,0,0,0,0,0,0,1,1,0,0,0,0,4,3,1,4,2,1,0,1,1,0,1
14/02/2022 02:00,0,0,0,0,0,0,0,0,0,0,0,0,0,0,0,1,1,0,0,0,0,2,1,1,4,0,5,0,5,2,0,2
14/02/2022 03:00,0,0,0,1,1,0,1,0,1,0,0,0,0,0,0,0,0,0,0,0,0,4,3,1,3,0,4,0,4,0,0,0
14/02/2022 04:00,1,1,0,0,0,0,2,1,1,0,0,0,1,1,0,1,1,0,0,0,0,5,2,3,0,3,3,0,3,0,0,0
14/02/2022 05:00,0,0,0,7,5,2,6,2,4,0,0,0,4,4,0,2,2,0,0,0,0,24,2,22,3,12,0,0,0,9,0,9
14/02/2022 06:00,17,16,1,16,14,2,18,14,4,0,0,0,8,8,0,5,5,0,0,0,0,110,18,92,13,70,10,0,10,29,0,29
14/02/2022 07:00,18,17,1,31,18,13,50,32,18,0,0,0,21,21,0,8,8,0,0,0,0,229,63,166,26,112,22,1,21,70,0,70
14/02/2022 08:00,50,41,9,57,43,14,74,54,20,0,0,0,35,35,0,22,22,0,0,0,0,384,88,296,34,196,45,0,45,132,0,132
14/02/2022 09:00,27,20,7,33,19,14,47,26,21,0,0,0,17,17,0,6,6,0,0,0,0,181,41,140,18,92,38,1,37,114,0,114
14/02/2022 10:00,18,13,5,29,14,15,34,12,22,0,0,0,11,11,0,4,4,0,0,0,0,74,19,55,23,44,2,0,2,60,0,60
14/02/2022 11:00,21,9,12,37,18,19,46,23,23,0,0,0,5,5,0,10,10,0,0,0,0,73,27,46,19,40,29,0,29,64,0,64
14/02/2022 12:00,18,7,11,39,21,18,63,25,38,0,0,0,6,6,0,7,7,0,0,0,0,105,39,66,34,50,47,0,47,93,2,91
14/02/2022 13:00,18,9,9,41,21,20,45,20,25,0,0,0,4,3,1,7,7,0,0,0,0,91,39,52,59,45,72,0,72,63,0,63
14/02/2022 14:00,20,9,11,56,20,36,53,22,31,0,0,0,3,3,0,17,17,0,0,0,0,119,62,57,50,31,77,0,77,67,0,67
14/02/2022 15:00,26,14,12,57,20,37,62,21,41,0,0,0,3,3,0,29,29,0,0,0,0,149,74,75,87,39,81,2,79,74,0,74
14/02/2022 16:00,27,11,16,52,23,29,66,24,42,0,0,0,4,4,0,13,13,0,5,5,0,163,93,70,129,52,123,0,123,71,1,70
14/02/2022 17:00,33,12,21,58,15,43,75,18,57,0,0,0,1,1,0,30,30,0,20,20,0,311,193,118,219,45,196,0,196,128,1,127
14/02/2022 18:00,22,9,13,54,14,40,64,19,45,0,0,0,0,0,0,15,15,0,11,11,0,279,162,117,161,38,182,0,182,123,0,123
14/02/2022 19:00,10,4,6,32,14,18,39,13,26,0,0,0,0,0,0,14,14,0,3,3,0,139,69,70,87,23,141,0,141,110,1,109
14/02/2022 20:00,8,2,6,23,7,16,32,11,21,0,0,0,2,2,0,7,7,0,0,0,0,117,68,49,43,32,126,1,125,78,0,78
14/02/2022 21:00,6,3,3,8,4,4,18,7,11,0,0,0,0,0,0,7,7,0,1,1,0,70,49,21,42,9,83,0,83,45,0,45
14/02/2022 22:00,2,2,0,10,4,6,11,3,8,0,0,0,2,2,0,3,3,0,0,0,0,47,28,19,26,5,42,0,42,28,0,28
14/02/2022 23:00,0,0,0,5,1,4,5,1,4,0,0,0,0,0,0,3,3,0,0,0,0,31,22,9,16,5,28,1,27,20,0,20
15/02/2022 00:00,3,1,2,0,0,0,3,1,2,0,0,0,0,0,0,0,0,0,0,0,0,16,12,4,9,6,20,0,20,9,0,9
15/02/2022 01:00,0,0,0,1,0,1,1,0,1,0,0,0,0,0,0,1,1,0,0,0,0,5,4,1,6,0,5,1,4,0,0,0
15/02/2022 02:00,0,0,0,0,0,0,0,0,0,0,0,0,1,0,1,0,0,0,0,0,0,1,1,0,2,0,2,0,2,1,0,1
15/02/2022 03:00,0,0,0,0,0,0,0,0,0,0,0,0,0,0,0,0,0,0,0,0,0,0,0,0,3,0,0,0,0,0,0,0
15/02/2022 04:00,2,1,1,0,0,0,3,2,1,0,0,0,0,0,0,0,0,0,0,0,0,7,4,3,3,3,0,0,0,0,0,0
15/02/2022 05:00,1,1,0,6,5,1,6,5,1,0,0,0,1,1,0,2,2,0,0,0,0,24,1,23,3,12,2,0,2,6,0,6
15/02/2022 06:00,17,13,4,17,12,5,19,10,9,0,0,0,5,5,0,3,3,0,0,0,0,102,15,87,15,46,5,0,5,34,0,34
15/02/2022 07:00,24,19,5,39,25,14,43,33,10,0,0,0,15,15,0,15,15,0,0,0,0,253,68,185,21,133,20,1,19,69,1,68
15/02/2022 08:00,53,45,8,63,45,18,72,52,20,0,0,0,38,38,0,26,26,0,0,0,0,419,84,335,25,253,47,1,46,153,1,152
15/02/2022 09:00,23,16,7,37,24,13,52,35,17,0,0,0,32,32,0,10,10,0,0,0,0,187,40,147,21,119,33,0,33,113,0,113
15/02/2022 10:00,17,14,3,38,17,21,49,19,30,0,0,0,2,2,0,7,7,0,0,0,0,80,28,52,35,52,15,0,15,72,0,72
15/02/2022 11:00,9,5,4,40,21,19,46,21,25,0,0,0,4,4,0,3,3,0,0,0,0,93,30,63,24,27,30,1,29,62,0,62
15/02/2022 12:00,26,13,13,40,19,21,44,19,25,0,0,0,3,3,0,18,18,0,0,0,0,93,41,52,36,50,47,0,47,79,0,79
15/02/2022 13:00,26,17,9,35,19,16,52,24,28,0,0,0,2,2,0,11,11,0,0,0,0,116,52,64,46,49,63,1,62,100,0,100
15/02/2022 14:00,21,8,13,27,10,17,37,18,19,0,0,0,1,1,0,11,11,0,5,5,0,94,45,49,69,21,80,1,79,79,0,79
15/02/2022 15:00,22,11,11,32,16,16,43,19,24,0,0,0,2,2,0,34,34,0,12,12,0,146,71,75,69,38,90,1,89,86,1,85
15/02/2022 16:00,21,12,9,39,15,24,43,12,31,0,0,0,3,3,0,20,20,0,7,7,0,215,130,85,153,58,130,0,130,66,0,66
15/02/2022 17:00,41,10,31,67,16,51,83,17,66,0,0,0,3,3,0,20,20,0,0,0,0,314,177,137,189,42,189,0,189,99,0,99
15/02/2022 18:00,22,11,11,62,11,51,70,7,63,0,0,0,2,2,0,24,24,0,0,0,0,262,173,89,149,36,144,0,144,110,1,109
15/02/2022 19:00,11,5,6,20,5,15,29,11,18,0,0,0,4,4,0,12,12,0,0,0,0,149,86,63,87,19,153,0,153,88,2,86
15/02/2022 20:00,13,4,9,17,6,11,13,5,8,0,0,0,3,3,0,8,8,0,0,0,0,78,48,30,53,23,80,0,80,39,0,39
15/02/2022 21:00,11,5,6,9,2,7,10,1,9,0,0,0,2,2,0,4,4,0,0,0,0,57,41,16,36,12,54,0,54,37,0,37
15/02/2022 22:00,4,3,1,4,0,4,6,1,5,0,0,0,1,1,0,4,4,0,0,0,0,46,28,18,17,5,33,0,33,18,0,18
15/02/2022 23:00,2,0,2,0,0,0,1,0,1,0,0,0,0,0,0,3,3,0,0,0,0,21,16,5,20,2,31,0,31,13,0,13
16/02/2022 00:00,0,0,0,0,0,0,4,3,1,0,0,0,0,0,0,0,0,0,0,0,0,16,12,4,10,6,14,0,14,7,0,7
16/02/2022 01:00,0,0,0,0,0,0,0,0,0,0,0,0,0,0,0,0,0,0,0,0,0,11,10,1,4,0,4,0,4,0,0,0
16/02/2022 02:00,0,0,0,0,0,0,0,0,0,0,0,0,0,0,0,0,0,0,0,0,0,4,4,0,4,0,3,0,3,0,0,0
16/02/2022 03:00,0,0,0,2,1,1,2,0,2,0,0,0,0,0,0,0,0,0,0,0,0,0,0,0,3,0,6,0,6,0,0,0
16/02/2022 04:00,1,1,0,0,0,0,1,1,0,0,0,0,0,0,0,0,0,0,0,0,0,2,0,2,1,4,1,0,1,1,0,1
16/02/2022 05:00,0,0,0,3,3,0,5,3,2,0,0,0,4,4,0,1,1,0,0,0,0,21,2,19,1,12,2,0,2,6,0,6
16/02/2022 06:00,17,15,2,8,6,2,9,5,4,0,0,0,13,13,0,7,7,0,0,0,0,110,16,94,13,48,7,0,7,31,0,31
16/02/2022 07:00,13,11,2,19,11,8,19,9,10,0,0,0,15,15,0,12,12,0,3,3,0,224,48,176,26,92,19,0,19,53,0,53
16/02/2022 08:00,51,45,6,39,30,9,52,36,16,0,0,0,33,33,0,26,26,0,12,12,0,373,64,309,26,206,49,0,49,126,0,126
16/02/2022 09:00,18,15,3,17,7,10,21,10,11,0,0,0,23,23,0,9,9,0,3,3,0,148,26,122,20,86,26,0,26,113,1,112
16/02/2022 10:00,17,12,5,9,2,7,12,2,10,0,0,0,14,14,0,6,6,0,1,1,0,65,26,39,15,44,28,0,28,69,0,69
16/02/2022 11:00,14,7,7,17,9,8,22,10,12,0,0,0,3,3,0,17,17,0,0,0,0,90,32,58,25,25,37,0,37,55,1,54
16/02/2022 12:00,14,7,7,9,6,3,16,8,8,0,0,0,2,2,0,9,9,0,0,0,0,81,38,43,36,29,67,0,67,50,2,48
16/02/2022 13:00,16,8,8,7,3,4,9,2,7,0,0,0,1,1,0,9,9,0,0,0,0,97,45,52,28,26,46,0,46,50,0,50
16/02/2022 14:00,5,3,2,2,0,2,6,1,5,0,0,0,2,2,0,11,11,0,0,0,0,86,54,32,34,17,51,0,51,50,0,50
16/02/2022 15:00,12,4,8,10,1,9,18,4,14,0,0,0,1,1,0,13,13,0,1,1,0,96,46,50,54,17,51,0,51,55,0,55
16/02/2022 16:00,26,13,13,16,4,12,16,1,15,0,0,0,0,0,0,12,12,0,1,1,0,160,96,64,122,37,85,0,85,40,0,40
16/02/2022 17:00,31,6,25,24,7,17,36,8,28,0,0,0,1,1,0,16,16,0,1,1,0,236,145,91,144,27,152,0,152,98,1,97
16/02/2022 18:00,15,7,8,22,4,18,38,2,36,0,0,0,4,4,0,10,10,0,0,0,0,236,132,104,137,20,147,1,146,106,0,106
16/02/2022 19:00,13,8,5,12,6,6,18,4,14,0,0,0,4,4,0,5,5,0,0,0,0,127,75,52,59,12,113,0,113,72,0,72
16/02/2022 20:00,11,6,5,9,4,5,11,5,6,0,0,0,1,1,0,7,7,0,0,0,0,71,47,24,45,24,69,0,69,51,0,51
16/02/2022 21:00,3,2,1,7,2,5,5,0,5,0,0,0,0,0,0,4,4,0,0,0,0,60,42,18,38,9,57,0,57,53,0,53
16/02/2022 22:00,6,3,3,3,1,2,2,1,1,0,0,0,2,2,0,5,5,0,0,0,0,49,26,23,20,3,47,0,47,38,0,38
16/02/2022 23:00,1,0,1,0,0,0,0,0,0,0,0,0,0,0,0,2,2,0,0,0,0,19,14,5,12,8,25,0,25,14,0,14
17/02/2022 00:00,0,0,0,2,1,1,2,0,2,0,0,0,0,0,0,2,2,0,0,0,0,14,8,6,11,3,14,0,14,8,0,8
17/02/2022 01:00,0,0,0,0,0,0,1,0,1,0,0,0,0,0,0,1,1,0,0,0,0,10,10,0,5,0,1,0,1,0,0,0
17/02/2022 02:00,0,0,0,0,0,0,0,0,0,0,0,0,0,0,0,0,0,0,0,0,0,1,1,0,4,0,4,0,4,0,0,0
17/02/2022 03:00,0,0,0,0,0,0,1,1,0,0,0,0,0,0,0,0,0,0,0,0,0,0,0,0,7,0,2,0,2,1,0,1
17/02/2022 04:00,1,1,0,1,0,1,3,1,2,0,0,0,2,2,0,0,0,0,0,0,0,4,1,3,2,5,1,0,1,1,0,1
17/02/2022 05:00,0,0,0,3,1,2,4,2,2,0,0,0,1,1,0,1,1,0,0,0,0,22,5,17,3,18,0,0,0,5,0,5
17/02/2022 06:00,15,13,2,11,5,6,17,9,8,0,0,0,2,2,0,6,6,0,2,2,0,100,15,85,12,54,12,0,12,28,0,28
17/02/2022 07:00,24,21,3,47,31,16,46,29,17,0,0,0,13,13,0,12,12,0,0,0,0,235,58,177,24,117,21,0,21,47,0,47
17/02/2022 08:00,52,44,8,49,36,13,67,53,14,0,0,0,59,59,0,28,28,0,2,2,0,377,80,297,26,201,37,0,37,137,1,136
17/02/2022 09:00,26,22,4,37,16,21,51,25,26,0,0,0,22,22,0,10,10,0,6,6,0,174,47,127,21,109,37,0,37,103,0,103
17/02/2022 10:00,16,8,8,20,11,9,32,13,19,0,0,0,2,2,0,7,7,0,3,3,0,82,35,47,23,37,10,0,10,49,0,49
17/02/2022 11:00,6,3,3,15,9,6,23,14,9,0,0,0,9,9,0,9,9,0,1,1,0,81,18,63,20,26,31,0,31,45,0,45
17/02/2022 12:00,11,6,5,22,14,8,31,14,17,0,0,0,3,3,0,15,15,0,0,0,0,111,42,69,41,25,51,0,51,83,1,82
17/02/2022 13:00,15,6,9,39,13,26,45,20,25,0,0,0,4,4,0,10,10,0,0,0,0,113,47,66,46,46,85,2,83,88,1,87
17/02/2022 14:00,15,8,7,9,3,6,12,4,8,0,0,0,5,5,0,9,9,0,0,0,0,111,54,57,61,20,60,0,60,64,1,63
17/02/2022 15:00,17,8,9,20,4,16,30,7,23,0,0,0,1,1,0,21,21,0,0,0,0,131,60,71,61,33,75,0,75,79,0,79
17/02/2022 16:00,30,16,14,35,9,26,45,12,33,0,0,0,2,2,0,11,11,0,8,8,0,173,98,75,116,38,107,0,107,52,0,52
17/02/2022 17:00,35,9,26,50,14,36,55,10,45,0,0,0,2,2,0,15,15,0,8,8,0,266,154,112,189,41,159,0,159,105,0,105
17/02/2022 18:00,21,6,15,43,9,34,64,13,51,0,0,0,1,1,0,19,19,0,5,5,0,263,152,111,131,40,186,0,186,116,0,116
17/02/2022 19:00,9,4,5,26,8,18,27,8,19,0,0,0,6,6,0,10,10,0,2,2,0,156,85,71,84,28,122,0,122,105,1,104
17/02/2022 20:00,7,3,4,19,10,9,21,10,11,0,0,0,5,5,0,9,9,0,1,1,0,115,78,37,62,28,96,1,95,81,1,80
17/02/2022 21:00,11,7,4,9,3,6,11,3,8,0,0,0,2,1,1,4,4,0,0,0,0,94,64,30,39,9,69,1,68,64,0,64
17/02/2022 22:00,5,1,4,3,1,2,9,4,5,0,0,0,3,3,0,5,5,0,0,0,0,47,22,25,35,10,44,1,43,23,0,23
17/02/2022 23:00,3,2,1,0,0,0,0,0,0,0,0,0,1,1,0,2,2,0,0,0,0,31,21,10,19,5,29,0,29,13,0,13
18/02/2022 00:00,1,0,1,1,0,1,0,0,0,0,0,0,0,0,0,2,2,0,0,0,0,10,9,1,10,4,21,0,21,3,0,3
18/02/2022 01:00,0,0,0,0,0,0,0,0,0,0,0,0,0,0,0,1,1,0,0,0,0,9,6,3,7,1,4,0,4,0,0,0
18/02/2022 02:00,0,0,0,0,0,0,0,0,0,0,0,0,0,0,0,0,0,0,0,0,0,3,2,1,3,0,12,1,11,1,0,1
18/02/2022 03:00,0,0,0,0,0,0,0,0,0,0,0,0,0,0,0,0,0,0,0,0,0,4,3,1,1,0,4,0,4,2,0,2
18/02/2022 04:00,1,1,0,0,0,0,3,1,2,0,0,0,1,1,0,0,0,0,0,0,0,7,4,3,3,4,2,0,2,1,0,1
18/02/2022 05:00,0,0,0,2,1,1,3,2,1,0,0,0,1,1,0,0,0,0,0,0,0,18,2,16,1,9,4,0,4,6,0,6
18/02/2022 06:00,9,7,2,3,2,1,4,2,2,0,0,0,3,3,0,4,4,0,1,1,0,82,14,68,17,42,8,0,8,21,0,21
18/02/2022 07:00,16,15,1,17,11,6,22,17,5,0,0,0,10,10,0,7,7,0,0,0,0,154,42,112,15,67,16,0,16,40,1,39
18/02/2022 08:00,37,33,4,25,14,11,26,18,8,0,0,0,26,26,0,18,18,0,0,0,0,232,65,167,26,110,30,0,30,99,0,99
18/02/2022 09:00,17,12,5,12,6,6,19,9,10,0,0,0,10,10,0,6,6,0,0,0,0,123,34,89,10,45,31,0,31,74,0,74
18/02/2022 10:00,7,4,3,3,2,1,9,4,5,0,0,0,4,4,0,6,6,0,1,1,0,56,18,38,11,25,7,0,7,53,0,53
18/02/2022 11:00,4,0,4,1,1,0,4,1,3,0,0,0,5,5,0,2,2,0,0,0,0,68,18,50,20,15,18,0,18,37,0,37
18/02/2022 12:00,10,4,6,5,2,3,5,1,4,0,0,0,2,2,0,8,8,0,1,1,0,65,27,38,22,22,44,0,44,40,0,40
18/02/2022 13:00,9,2,7,7,2,5,5,1,4,0,0,0,4,4,0,4,4,0,0,0,0,95,41,54,32,26,42,0,42,58,0,58
18/02/2022 14:00,16,6,10,6,0,6,6,1,5,0,0,0,1,1,0,5,5,0,0,0,0,92,43,49,38,26,64,0,64,62,0,62
18/02/2022 15:00,15,8,7,12,3,9,15,3,12,0,0,0,1,1,0,10,10,0,0,0,0,123,64,59,47,27,53,0,53,58,0,58
18/02/2022 16:00,23,12,11,18,4,14,22,3,19,0,0,0,1,1,0,9,9,0,0,0,0,115,48,67,61,28,78,0,78,80,0,80
18/02/2022 17:00,17,4,13,10,3,7,14,4,10,0,0,0,1,1,0,8,8,0,0,0,0,178,96,82,87,13,124,0,124,73,0,73
18/02/2022 18:00,10,5,5,10,2,8,12,2,10,0,0,0,2,2,0,7,7,0,0,0,0,151,77,74,59,15,100,0,100,76,0,76
18/02/2022 19:00,11,6,5,8,2,6,13,4,9,0,0,0,2,1,1,4,4,0,0,0,0,115,54,61,42,13,81,2,79,71,1,70
18/02/2022 20:00,8,6,2,8,4,4,6,3,3,0,0,0,0,0,0,3,3,0,0,0,0,77,43,34,26,12,70,0,70,62,1,61
18/02/2022 21:00,7,2,5,2,1,1,5,3,2,0,0,0,0,0,0,0,0,0,0,0,0,52,34,18,19,11,49,2,47,42,0,42
18/02/2022 22:00,10,4,6,3,0,3,2,0,2,0,0,0,1,1,0,3,3,0,0,0,0,44,28,16,23,6,26,0,26,35,0,35
18/02/2022 23:00,3,0,3,1,0,1,6,2,4,0,0,0,0,0,0,2,2,0,1,1,0,30,20,10,18,8,16,0,16,14,0,14
19/02/2022 00:00,1,1,0,0,0,0,1,0,1,0,0,0,0,0,0,1,1,0,0,0,0,19,13,6,13,5,23,1,22,7,0,7
19/02/2022 01:00,1,0,1,0,0,0,0,0,0,0,0,0,0,0,0,0,0,0,0,0,0,23,12,11,8,5,4,0,4,0,0,0
19/02/2022 02:00,0,0,0,0,0,0,0,0,0,0,0,0,0,0,0,0,0,0,0,0,0,11,6,5,7,2,8,0,8,3,0,3
19/02/2022 03:00,0,0,0,0,0,0,0,0,0,0,0,0,0,0,0,1,1,0,0,0,0,7,5,2,6,3,12,1,11,5,0,5
19/02/2022 04:00,1,0,1,2,1,1,2,1,1,0,0,0,0,0,0,0,0,0,0,0,0,6,4,2,7,2,11,0,11,1,0,1
19/02/2022 05:00,0,0,0,1,0,1,2,0,2,0,0,0,2,2,0,0,0,0,0,0,0,9,3,6,4,1,2,0,2,1,0,1
19/02/2022 06:00,3,3,0,0,0,0,0,0,0,0,0,0,2,2,0,2,2,0,0,0,0,22,7,15,8,5,8,0,8,7,0,7
19/02/2022 07:00,2,2,0,3,1,2,6,2,4,0,0,0,3,3,0,0,0,0,0,0,0,25,7,18,5,10,3,0,3,5,0,5
19/02/2022 08:00,5,5,0,8,4,4,13,8,5,0,0,0,4,4,0,2,2,0,0,0,0,24,6,18,10,14,11,0,11,14,0,14
19/02/2022 09:00,1,1,0,22,7,15,22,6,16,0,0,0,1,1,0,3,3,0,0,0,0,46,19,27,9,19,16,0,16,33,0,33
19/02/2022 10:00,6,3,3,22,11,11,30,17,13,0,0,0,0,0,0,2,2,0,0,0,0,60,14,46,13,12,18,0,18,50,0,50
19/02/2022 11:00,4,3,1,25,8,17,33,12,21,0,0,0,0,0,0,5,5,0,0,0,0,61,18,43,10,16,34,0,34,45,0,45
19/02/2022 12:00,9,5,4,35,17,18,31,20,11,0,0,0,4,4,0,3,3,0,0,0,0,88,28,60,30,23,46,0,46,80,0,80
19/02/2022 13:00,13,11,2,30,13,17,43,21,22,0,0,0,3,3,0,6,6,0,0,0,0,87,43,44,38,31,62,1,61,105,0,105
19/02/2022 14:00,22,14,8,60,25,35,53,25,28,0,0,0,2,2,0,1,1,0,0,0,0,96,43,53,34,20,63,0,63,72,0,72
19/02/2022 15:00,11,4,7,57,22,35,61,22,39,0,0,0,7,7,0,4,4,0,1,1,0,93,34,59,36,32,64,0,64,98,0,98
19/02/2022 16:00,13,8,5,47,22,25,57,26,31,0,0,0,4,4,0,5,5,0,0,0,0,107,42,65,24,27,78,3,75,65,0,65
19/02/2022 17:00,8,2,6,40,24,16,39,21,18,0,0,0,1,1,0,4,4,0,0,0,0,110,50,60,48,21,103,0,103,86,0,86
19/02/2022 18:00,6,2,4,7,6,1,18,11,7,0,0,0,1,1,0,4,4,0,0,0,0,113,43,70,45,26,111,1,110,87,0,87
19/02/2022 19:00,9,6,3,7,3,4,11,3,8,0,0,0,0,0,0,2,2,0,0,0,0,107,38,69,43,22,79,0,79,89,0,89
19/02/2022 20:00,8,3,5,1,0,1,7,3,4,0,0,0,3,3,0,2,2,0,0,0,0,61,35,26,27,20,77,3,74,64,0,64
19/02/2022 21:00,3,2,1,2,0,2,5,2,3,0,0,0,2,2,0,0,0,0,0,0,0,46,29,17,20,17,52,1,51,57,0,57
19/02/2022 22:00,4,2,2,0,0,0,4,1,3,0,0,0,1,1,0,2,2,0,0,0,0,24,16,8,20,14,33,0,33,27,0,27
19/02/2022 23:00,2,1,1,3,0,3,3,1,2,0,0,0,0,0,0,3,3,0,0,0,0,30,19,11,15,5,25,0,25,16,0,16
20/02/2022 00:00,0,0,0,0,0,0,0,0,0,0,0,0,0,0,0,0,0,0,0,0,0,16,9,7,8,1,23,0,23,2,0,2
20/02/2022 01:00,0,0,0,1,1,0,2,1,1,0,0,0,1,1,0,0,0,0,0,0,0,12,8,4,12,0,4,0,4,0,0,0
20/02/2022 02:00,0,0,0,1,0,1,2,0,2,0,0,0,0,0,0,0,0,0,0,0,0,7,5,2,6,3,11,0,11,2,0,2
20/02/2022 03:00,1,1,0,2,1,1,2,0,2,0,0,0,1,1,0,0,0,0,0,0,0,11,3,8,6,0,17,0,17,0,0,0
20/02/2022 04:00,0,0,0,0,0,0,0,0,0,0,0,0,1,1,0,0,0,0,0,0,0,7,2,5,6,4,6,0,6,0,0,0
20/02/2022 05:00,1,1,0,0,0,0,1,1,0,0,0,0,0,0,0,0,0,0,0,0,0,5,2,3,1,2,4,0,4,1,0,1
20/02/2022 06:00,0,0,0,1,0,1,1,0,1,0,0,0,2,2,0,0,0,0,0,0,0,15,2,13,3,4,2,0,2,2,0,2
20/02/2022 07:00,1,1,0,1,0,1,5,1,4,0,0,0,3,3,0,1,1,0,0,0,0,16,6,10,6,4,4,0,4,4,0,4
20/02/2022 08:00,2,1,1,7,4,3,9,5,4,0,0,0,1,0,1,1,1,0,0,0,0,22,8,14,4,7,5,0,5,10,0,10
20/02/2022 09:00,9,7,2,9,4,5,7,2,5,0,0,0,2,2,0,1,1,0,0,0,0,27,9,18,7,8,7,0,7,20,0,20
20/02/2022 10:00,6,6,0,8,2,6,9,4,5,0,0,0,2,2,0,0,0,0,0,0,0,37,13,24,8,7,17,0,17,25,0,25
20/02/2022 11:00,4,2,2,5,2,3,4,1,3,0,0,0,0,0,0,2,2,0,0,0,0,44,21,23,8,6,11,0,11,22,0,22
20/02/2022 12:00,3,2,1,2,1,1,3,1,2,0,0,0,1,1,0,0,0,0,0,0,0,44,16,28,6,3,24,0,24,31,1,30
20/02/2022 13:00,2,0,2,1,0,1,2,0,2,0,0,0,0,0,0,2,2,0,0,0,0,31,12,19,10,8,24,0,24,26,0,26
20/02/2022 14:00,5,4,1,6,3,3,5,3,2,0,0,0,0,0,0,2,2,0,0,0,0,49,21,28,12,15,32,1,31,36,0,36
20/02/2022 15:00,6,4,2,14,8,6,11,7,4,0,0,0,0,0,0,1,1,0,0,0,0,72,26,46,14,6,31,0,31,31,0,31
20/02/2022 16:00,5,3,2,6,2,4,5,1,4,0,0,0,3,2,1,1,1,0,0,0,0,44,20,24,11,7,31,1,30,27,1,26
20/02/2022 17:00,6,2,4,6,1,5,9,2,7,0,0,0,1,1,0,2,2,0,0,0,0,58,33,25,17,12,47,1,46,28,0,28
20/02/2022 18:00,3,1,2,10,3,7,5,1,4,0,0,0,0,0,0,4,4,0,0,0,0,70,33,37,26,11,53,0,53,49,0,49
20/02/2022 19:00,7,6,1,2,1,1,6,3,3,0,0,0,1,1,0,1,1,0,0,0,0,59,38,21,25,13,46,1,45,49,0,49
20/02/2022 20:00,5,2,3,2,1,1,2,1,1,0,0,0,0,0,0,0,0,0,0,0,0,53,32,21,17,11,25,0,25,35,0,35
20/02/2022 21:00,2,1,1,1,0,1,1,0,1,0,0,0,1,1,0,2,2,0,0,0,0,24,10,14,8,6,24,0,24,26,0,26
20/02/2022 22:00,4,2,2,0,0,0,0,0,0,0,0,0,1,1,0,0,0,0,0,0,0,20,12,8,10,5,21,1,20,14,0,14
20/02/2022 23:00,1,1,0,0,0,0,2,0,2,0,0,0,0,0,0,0,0,0,0,0,0,15,10,5,8,2,12,1,11,5,2,3
21/02/2022 00:00,1,1,0,0,0,0,4,2,2,0,0,0,0,0,0,0,0,0,0,0,0,5,4,1,6,3,5,0,5,8,0,8
21/02/2022 01:00,0,0,0,1,0,1,0,0,0,0,0,0,0,0,0,0,0,0,0,0,0,1,0,1,1,1,1,0,1,0,0,0
21/02/2022 02:00,0,0,0,0,0,0,0,0,0,0,0,0,0,0,0,0,0,0,0,0,0,0,0,0,3,0,1,0,1,0,0,0
21/02/2022 03:00,0,0,0,0,0,0,0,0,0,0,0,0,0,0,0,0,0,0,0,0,0,2,2,0,0,0,0,0,0,1,0,1
21/02/2022 04:00,0,0,0,0,0,0,0,0,0,0,0,0,0,0,0,0,0,0,0,0,0,4,1,3,2,2,0,0,0,0,0,0
21/02/2022 05:00,0,0,0,2,1,1,4,2,2,0,0,0,1,1,0,0,0,0,0,0,0,13,0,13,2,8,0,0,0,6,0,6
21/02/2022 06:00,11,10,1,1,1,0,1,1,0,0,0,0,0,0,0,2,2,0,0,0,0,81,11,70,7,40,7,0,7,29,0,29
21/02/2022 07:00,20,16,4,11,8,3,14,9,5,0,0,0,16,16,0,4,4,0,0,0,0,131,24,107,16,62,14,1,13,40,0,40
21/02/2022 08:00,23,21,2,14,10,4,15,11,4,0,0,0,17,16,1,5,5,0,0,0,0,215,46,169,17,85,29,1,28,92,0,92
21/02/2022 09:00,12,9,3,8,4,4,9,3,6,0,0,0,13,13,0,3,3,0,0,0,0,102,28,74,10,39,18,0,18,66,0,66
21/02/2022 10:00,14,11,3,9,6,3,19,9,10,0,0,0,6,6,0,4,4,0,0,0,0,52,15,37,9,29,6,0,6,51,0,51
21/02/2022 11:00,8,3,5,17,6,11,13,3,10,0,0,0,4,4,0,7,7,0,0,0,0,68,26,42,16,19,18,0,18,56,0,56
21/02/2022 12:00,17,7,10,18,9,9,22,9,13,0,0,0,2,2,0,8,8,0,1,1,0,63,27,36,19,22,33,0,33,75,0,75
21/02/2022 13:00,17,12,5,25,14,11,25,13,12,0,0,0,2,2,0,8,8,0,3,3,0,89,34,55,33,25,46,0,46,82,0,82
21/02/2022 14:00,19,10,9,30,11,19,39,18,21,0,0,0,5,5,0,5,5,0,4,4,0,96,43,53,46,24,47,0,47,67,2,65
21/02/2022 15:00,11,5,6,32,15,17,49,19,30,0,0,0,3,3,0,5,5,0,5,5,0,93,43,50,47,21,65,0,65,92,0,92
21/02/2022 16:00,24,13,11,33,13,20,41,20,21,0,0,0,3,3,0,11,11,0,5,5,0,139,75,64,85,43,76,2,74,76,0,76
21/02/2022 17:00,24,6,18,57,20,37,71,20,51,0,0,0,2,2,0,18,18,0,6,6,0,205,121,84,106,42,154,1,153,98,0,98
21/02/2022 18:00,19,7,12,60,23,37,69,22,47,0,0,0,0,0,0,4,4,0,3,3,0,210,111,99,99,34,145,0,145,80,0,80
21/02/2022 19:00,11,3,8,35,15,20,31,14,17,0,0,0,5,5,0,11,11,0,0,0,0,108,52,56,62,23,125,0,125,88,1,87
21/02/2022 20:00,9,2,7,23,13,10,26,12,14,0,0,0,0,0,0,6,6,0,2,2,0,96,60,36,41,18,81,1,80,64,1,63
21/02/2022 21:00,5,2,3,15,4,11,24,6,18,0,0,0,0,0,0,6,6,0,0,0,0,56,39,17,37,11,47,0,47,34,0,34
21/02/2022 22:00,4,2,2,9,5,4,6,2,4,0,0,0,0,0,0,5,5,0,0,0,0,51,33,18,21,7,43,0,43,22,0,22
21/02/2022 23:00,1,1,0,5,3,2,3,1,2,0,0,0,0,0,0,3,3,0,1,1,0,20,12,8,18,8,22,0,22,13,1,12
22/02/2022 00:00,1,1,0,0,0,0,4,3,1,0,0,0,1,1,0,1,1,0,0,0,0,15,7,8,6,0,10,0,10,5,0,5
22/02/2022 01:00,0,0,0,1,1,0,0,0,0,0,0,0,0,0,0,0,0,0,0,0,0,4,3,1,2,1,1,0,1,0,0,0
22/02/2022 02:00,0,0,0,0,0,0,3,2,1,0,0,0,0,0,0,0,0,0,0,0,0,3,2,1,5,0,5,1,4,0,0,0
22/02/2022 03:00,1,0,1,0,0,0,0,0,0,0,0,0,0,0,0,0,0,0,0,0,0,2,1,1,2,0,1,0,1,0,0,0
22/02/2022 04:00,1,1,0,0,0,0,0,0,0,0,0,0,0,0,0,0,0,0,0,0,0,5,1,4,2,1,2,0,2,0,0,0
22/02/2022 05:00,0,0,0,3,2,1,3,1,2,0,0,0,1,1,0,2,2,0,0,0,0,21,2,19,1,13,0,0,0,7,0,7
22/02/2022 06:00,13,12,1,6,6,0,6,4,2,0,0,0,7,7,0,3,3,0,0,0,0,93,14,79,16,37,6,0,6,30,0,30
22/02/2022 07:00,10,8,2,10,5,5,19,14,5,0,0,0,4,4,0,4,4,0,0,0,0,147,38,109,17,70,15,0,15,42,1,41
22/02/2022 08:00,48,40,8,26,23,3,35,28,7,0,0,0,35,35,0,14,14,0,0,0,0,345,75,270,22,174,30,1,29,126,1,125
22/02/2022 09:00,20,13,7,15,9,6,22,10,12,0,0,0,14,14,0,9,9,0,0,0,0,169,39,130,19,83,28,1,27,124,0,124
22/02/2022 10:00,17,8,9,22,11,11,25,10,15,0,0,0,7,7,0,3,3,0,1,1,0,80,17,63,19,37,25,0,25,62,0,62
22/02/2022 11:00,10,6,4,21,11,10,42,21,21,0,0,0,2,2,0,5,5,0,3,3,0,72,25,47,17,36,28,0,28,60,1,59
22/02/2022 12:00,11,5,6,26,8,18,29,12,17,0,0,0,2,2,0,10,10,0,10,10,0,85,31,54,36,30,42,0,42,84,0,84
22/02/2022 13:00,24,14,10,32,15,17,31,11,20,0,0,0,1,1,0,6,6,0,10,10,0,115,46,69,46,39,70,0,70,108,0,108
22/02/2022 14:00,21,7,14,27,12,15,40,17,23,0,0,0,3,3,0,8,8,0,10,10,0,76,30,46,57,39,50,0,50,81,1,80
22/02/2022 15:00,16,6,10,29,10,19,59,23,36,0,0,0,0,0,0,8,8,0,8,8,0,108,58,50,54,23,61,0,61,72,0,72
22/02/2022 16:00,25,14,11,38,15,23,63,22,41,0,0,0,4,4,0,13,13,0,13,13,0,146,78,68,101,45,99,0,99,66,0,66
22/02/2022 17:00,39,9,30,63,32,31,76,25,51,0,0,0,0,0,0,17,17,0,22,22,0,275,167,108,169,43,176,1,175,101,2,99
22/02/2022 18:00,21,8,13,53,16,37,76,16,60,0,0,0,2,2,0,17,17,0,13,13,0,246,135,111,126,41,146,0,146,111,0,111
22/02/2022 19:00,17,7,10,33,13,20,28,10,18,0,0,0,5,5,0,7,7,0,11,11,0,162,72,90,102,30,138,1,137,101,0,101
22/02/2022 20:00,12,7,5,10,4,6,21,7,14,0,0,0,2,2,0,9,9,0,6,6,0,129,71,58,47,36,83,0,83,90,0,90
22/02/2022 21:00,3,0,3,13,7,6,16,5,11,0,0,0,0,0,0,7,7,0,4,4,0,74,48,26,44,24,70,0,70,52,0,52
22/02/2022 22:00,6,3,3,7,1,6,11,2,9,0,0,0,1,1,0,4,4,0,7,7,0,48,32,16,36,10,31,1,30,38,0,38
22/02/2022 23:00,1,0,1,3,1,2,5,2,3,0,0,0,0,0,0,1,1,0,0,0,0,29,18,11,18,4,27,2,25,17,0,17
23/02/2022 00:00,2,0,2,3,1,2,4,2,2,0,0,0,0,0,0,1,1,0,0,0,0,11,7,4,14,4,28,0,28,9,0,9
23/02/2022 01:00,1,0,1,0,0,0,0,0,0,0,0,0,0,0,0,0,0,0,0,0,0,5,5,0,4,0,1,0,1,0,0,0
23/02/2022 02:00,0,0,0,0,0,0,1,1,0,0,0,0,0,0,0,0,0,0,0,0,0,2,1,1,5,0,5,0,5,2,0,2
23/02/2022 03:00,0,0,0,1,0,1,1,1,0,0,0,0,0,0,0,0,0,0,0,0,0,2,2,0,1,0,3,0,3,0,0,0
23/02/2022 04:00,1,1,0,1,1,0,1,1,0,0,0,0,0,0,0,0,0,0,0,0,0,4,0,4,2,4,0,0,0,2,0,2
23/02/2022 05:00,1,1,0,4,3,1,4,3,1,0,0,0,2,2,0,2,2,0,0,0,0,17,3,14,2,10,1,0,1,5,0,5
23/02/2022 06:00,18,15,3,13,8,5,13,7,6,0,0,0,2,2,0,5,5,0,0,0,0,112,20,92,14,66,9,0,9,31,0,31
23/02/2022 07:00,24,21,3,27,24,3,41,28,13,0,0,0,9,9,0,13,13,0,0,0,0,226,55,171,22,118,21,1,20,72,1,71
23/02/2022 08:00,57,52,5,47,35,12,69,49,20,0,0,0,12,12,0,9,9,0,1,1,0,360,71,289,31,177,48,0,48,153,0,153
23/02/2022 09:00,24,20,4,33,12,21,38,18,20,0,0,0,11,11,0,12,12,0,13,13,0,178,37,141,23,79,34,1,33,117,0,117
23/02/2022 10:00,17,12,5,27,15,12,33,13,20,0,0,0,4,4,0,12,12,0,3,3,0,78,20,58,20,43,26,0,26,58,0,58
23/02/2022 11:00,12,5,7,20,9,11,34,17,17,0,0,0,1,1,0,4,4,0,8,8,0,88,21,67,24,40,32,0,32,51,0,51
23/02/2022 12:00,7,5,2,20,12,8,17,8,9,0,0,0,1,1,0,7,7,0,9,9,0,100,43,57,49,45,59,0,59,87,0,87
23/02/2022 13:00,17,9,8,28,9,19,36,10,26,0,0,0,0,0,0,10,10,0,6,6,0,89,46,43,39,37,76,0,76,110,1,109
23/02/2022 14:00,21,9,12,17,4,13,25,10,15,0,0,0,3,3,0,9,9,0,13,13,0,100,51,49,46,25,74,0,74,73,1,72
23/02/2022 15:00,10,5,5,13,5,8,20,10,10,0,0,0,0,0,0,14,14,0,10,10,0,93,50,43,51,14,60,0,60,56,0,56
23/02/2022 16:00,20,6,14,21,7,14,27,6,21,0,0,0,0,0,0,11,11,0,0,0,0,165,84,81,95,35,104,0,104,52,1,51
23/02/2022 17:00,31,7,24,42,11,31,59,12,47,0,0,0,0,0,0,15,15,0,0,0,0,285,184,101,161,31,165,2,163,120,1,119
23/02/2022 18:00,19,10,9,42,11,31,49,5,44,0,0,0,4,4,0,8,8,0,1,1,0,220,139,81,101,26,153,0,153,99,0,99
23/02/2022 19:00,13,5,8,22,9,13,34,8,26,0,0,0,2,2,0,8,8,0,0,0,0,129,81,48,86,23,113,0,113,54,0,54
23/02/2022 20:00,10,4,6,9,2,7,8,1,7,0,0,0,1,1,0,6,6,0,0,0,0,89,56,33,43,20,83,0,83,65,0,65
23/02/2022 21:00,1,0,1,2,1,1,2,1,1,0,0,0,1,1,0,5,5,0,0,0,0,67,42,25,31,5,61,0,61,59,0,59
23/02/2022 22:00,3,1,2,2,0,2,4,1,3,0,0,0,0,0,0,2,2,0,0,0,0,52,32,20,27,7,42,0,42,30,0,30
23/02/2022 23:00,0,0,0,5,2,3,3,1,2,0,0,0,0,0,0,0,0,0,0,0,0,27,19,8,19,6,25,0,25,11,0,11
24/02/2022 00:00,0,0,0,3,2,1,0,0,0,0,0,0,0,0,0,2,2,0,2,2,0,7,5,2,15,1,17,0,17,8,0,8
24/02/2022 01:00,1,1,0,0,0,0,1,0,1,0,0,0,0,0,0,1,1,0,0,0,0,13,10,3,8,2,3,0,3,0,0,0
24/02/2022 02:00,0,0,0,0,0,0,0,0,0,0,0,0,0,0,0,0,0,0,0,0,0,2,1,1,4,0,7,0,7,3,0,3
24/02/2022 03:00,0,0,0,0,0,0,0,0,0,0,0,0,0,0,0,0,0,0,0,0,0,3,1,2,2,0,0,0,0,1,0,1
24/02/2022 04:00,1,1,0,1,0,1,1,0,1,0,0,0,0,0,0,0,0,0,0,0,0,4,1,3,2,0,2,0,2,3,0,3
24/02/2022 05:00,0,0,0,3,1,2,6,3,3,0,0,0,0,0,0,1,1,0,0,0,0,22,1,21,2,12,1,0,1,5,0,5
24/02/2022 06:00,19,16,3,11,10,1,12,9,3,0,0,0,5,5,0,4,4,0,0,0,0,96,15,81,8,64,11,0,11,25,0,25
24/02/2022 07:00,21,19,2,27,17,10,27,17,10,0,0,0,8,8,0,12,12,0,0,0,0,204,52,152,21,96,20,0,20,50,0,50
24/02/2022 08:00,36,32,4,30,22,8,49,36,13,0,0,0,16,16,0,6,6,0,0,0,0,284,61,223,33,162,42,3,39,130,0,130
24/02/2022 09:00,25,17,8,23,14,9,26,17,9,0,0,0,6,6,0,4,4,0,0,0,0,156,35,121,12,93,16,0,16,85,0,85
24/02/2022 10:00,11,8,3,11,6,5,17,8,9,0,0,0,10,10,0,12,12,0,0,0,0,86,23,63,15,33,6,0,6,64,1,63
24/02/2022 11:00,9,6,3,21,11,10,27,12,15,0,0,0,3,3,0,3,3,0,0,0,0,75,20,55,22,28,22,0,22,79,1,78
24/02/2022 12:00,25,12,13,25,21,4,21,15,6,0,0,0,10,10,0,7,7,0,0,0,0,90,37,53,40,35,52,0,52,84,0,84
24/02/2022 13:00,20,7,13,21,9,12,25,8,17,0,0,0,2,2,0,9,9,0,0,0,0,113,47,66,40,30,63,0,63,93,0,93
24/02/2022 14:00,15,8,7,17,6,11,25,8,17,0,0,0,1,1,0,7,7,0,5,5,0,110,54,56,48,23,52,0,52,73,0,73
24/02/2022 15:00,12,1,11,29,7,22,29,9,20,0,0,0,7,7,0,6,6,0,2,2,0,117,63,54,53,30,64,1,63,51,0,51
24/02/2022 16:00,23,12,11,33,15,18,34,12,22,0,0,0,2,2,0,5,5,0,0,0,0,154,80,74,82,36,83,0,83,56,0,56
24/02/2022 17:00,33,10,23,42,9,33,53,15,38,0,0,0,2,2,0,14,14,0,0,0,0,237,148,89,167,41,162,1,161,69,0,69
24/02/2022 18:00,14,4,10,46,12,34,57,9,48,0,0,0,0,0,0,14,14,0,0,0,0,225,131,94,134,31,147,2,145,94,0,94
24/02/2022 19:00,12,7,5,32,7,25,27,7,20,0,0,0,3,3,0,7,7,0,0,0,0,145,74,71,79,28,112,0,112,81,0,81
24/02/2022 20:00,8,4,4,19,4,15,23,5,18,0,0,0,1,1,0,7,7,0,0,0,0,114,63,51,67,28,92,0,92,83,0,83
24/02/2022 21:00,7,4,3,2,0,2,8,2,6,0,0,0,0,0,0,2,2,0,0,0,0,67,49,18,29,12,67,0,67,53,0,53
24/02/2022 22:00,5,2,3,2,1,1,5,1,4,0,0,0,0,0,0,4,4,0,0,0,0,49,34,15,29,9,55,0,55,23,0,23
24/02/2022 23:00,4,1,3,1,0,1,5,1,4,0,0,0,1,1,0,2,2,0,2,2,0,39,30,9,15,5,40,0,40,13,0,13
25/02/2022 00:00,1,1,0,1,1,0,1,0,1,0,0,0,0,0,0,2,2,0,2,2,0,21,16,5,19,3,38,0,38,10,0,10
25/02/2022 01:00,1,0,1,1,1,0,1,1,0,0,0,0,0,0,0,1,1,0,0,0,0,7,6,1,7,2,4,1,3,0,0,0
25/02/2022 02:00,0,0,0,0,0,0,1,1,0,0,0,0,0,0,0,0,0,0,0,0,0,6,5,1,8,1,9,0,9,0,0,0
25/02/2022 03:00,0,0,0,1,1,0,2,0,2,0,0,0,0,0,0,0,0,0,0,0,0,3,3,0,3,2,7,0,7,3,0,3
25/02/2022 04:00,1,1,0,4,1,3,2,0,2,0,0,0,1,1,0,1,1,0,1,1,0,9,3,6,4,3,1,0,1,0,0,0
25/02/2022 05:00,1,1,0,4,4,0,6,5,1,0,0,0,0,0,0,0,0,0,0,0,0,24,5,19,3,10,4,0,4,4,0,4
25/02/2022 06:00,13,12,1,6,5,1,9,8,1,0,0,0,3,3,0,5,5,0,1,1,0,88,14,74,8,45,5,0,5,28,1,27
25/02/2022 07:00,19,18,1,38,25,13,42,30,12,0,0,0,6,6,0,9,9,0,2,2,0,167,44,123,21,78,22,0,22,47,0,47
25/02/2022 08:00,36,29,7,36,23,13,50,32,18,0,0,0,7,7,0,12,12,0,3,3,0,240,55,185,24,137,31,0,31,131,0,131
25/02/2022 09:00,17,14,3,44,23,21,47,23,24,0,0,0,6,6,0,2,2,0,2,2,0,157,33,124,29,65,30,0,30,68,0,68
25/02/2022 10:00,13,9,4,59,31,28,66,31,35,0,0,0,2,2,0,9,9,0,0,0,0,85,22,63,18,43,24,0,24,62,0,62
25/02/2022 11:00,11,7,4,59,33,26,57,31,26,0,0,0,1,1,0,11,11,0,3,3,0,108,29,79,21,42,0,0,0,73,0,73
25/02/2022 12:00,18,13,5,69,32,37,92,42,50,0,0,0,1,1,0,8,8,0,3,3,0,112,39,73,41,43,51,0,51,102,1,101
25/02/2022 13:00,15,10,5,77,40,37,62,24,38,0,0,0,0,0,0,6,6,0,1,1,0,132,59,73,53,44,88,1,87,129,1,128
25/02/2022 14:00,21,11,10,60,25,35,80,32,48,0,0,0,1,1,0,8,8,0,0,0,0,128,74,54,64,36,63,1,62,92,1,91
25/02/2022 15:00,17,10,7,67,31,36,61,23,38,0,0,0,4,4,0,11,11,0,0,0,0,131,55,76,86,63,92,0,92,99,0,99
25/02/2022 16:00,23,12,11,64,26,38,75,28,47,0,0,0,2,2,0,15,15,0,0,0,0,169,97,72,83,48,128,0,128,89,0,89
25/02/2022 17:00,32,10,22,67,29,38,91,32,59,0,0,0,2,2,0,15,15,0,0,0,0,206,117,89,139,44,142,0,142,96,1,95
25/02/2022 18:00,18,10,8,38,15,23,60,20,40,0,0,0,3,3,0,15,15,0,1,1,0,180,100,80,129,52,157,1,156,116,1,115
25/02/2022 19:00,4,2,2,27,12,15,43,20,23,0,0,0,6,6,0,7,7,0,1,1,0,113,65,48,87,44,120,0,120,133,0,133
25/02/2022 20:00,9,5,4,12,7,5,12,6,6,0,0,0,0,0,0,3,3,0,0,0,0,98,50,48,61,44,84,0,84,113,0,113
25/02/2022 21:00,11,3,8,3,3,0,4,1,3,0,0,0,1,1,0,5,5,0,0,0,0,80,45,35,32,23,80,4,76,58,0,58
25/02/2022 22:00,7,3,4,3,0,3,4,2,2,0,0,0,0,0,0,2,2,0,0,0,0,87,45,42,41,13,44,0,44,38,0,38
25/02/2022 23:00,5,3,2,4,1,3,5,1,4,0,0,0,0,0,0,1,1,0,0,0,0,43,32,11,23,6,52,0,52,25,0,25
26/02/2022 00:00,2,0,2,0,0,0,1,1,0,0,0,0,0,0,0,2,2,0,0,0,0,36,20,16,17,3,39,0,39,13,0,13
26/02/2022 01:00,2,0,2,1,1,0,1,1,0,0,0,0,0,0,0,2,2,0,0,0,0,22,20,2,21,3,11,0,11,1,0,1
26/02/2022 02:00,1,0,1,1,0,1,2,1,1,0,0,0,0,0,0,0,0,0,0,0,0,12,7,5,10,3,15,1,14,6,0,6
26/02/2022 03:00,0,0,0,0,0,0,0,0,0,0,0,0,0,0,0,0,0,0,0,0,0,9,8,1,5,3,18,0,18,3,0,3
26/02/2022 04:00,0,0,0,1,0,1,0,0,0,0,0,0,1,1,0,0,0,0,0,0,0,9,5,4,7,3,17,1,16,1,0,1
26/02/2022 05:00,1,1,0,2,0,2,2,0,2,0,0,0,1,1,0,0,0,0,0,0,0,12,3,9,8,0,7,0,7,3,0,3
26/02/2022 06:00,3,3,0,5,2,3,4,2,2,0,0,0,0,0,0,1,1,0,0,0,0,25,3,22,8,9,7,0,7,5,0,5
26/02/2022 07:00,6,5,1,12,3,9,30,8,22,0,0,0,4,4,0,1,1,0,0,0,0,59,15,44,11,25,8,0,8,14,0,14
26/02/2022 08:00,12,8,4,55,23,32,52,26,26,0,0,0,2,2,0,4,4,0,0,0,0,60,22,38,21,24,16,0,16,24,0,24
26/02/2022 09:00,10,7,3,74,36,38,75,30,45,0,0,0,2,2,0,15,15,0,0,0,0,65,14,51,14,37,23,0,23,45,0,45
26/02/2022 10:00,14,10,4,59,23,36,65,26,39,0,0,0,3,3,0,9,9,0,0,0,0,82,31,51,15,29,29,0,29,56,0,56
26/02/2022 11:00,15,8,7,58,27,31,88,30,58,0,0,0,1,1,0,9,9,0,0,0,0,99,34,65,32,34,52,0,52,73,1,72
26/02/2022 12:00,15,9,6,51,25,26,61,22,39,0,0,0,4,4,0,9,9,0,0,0,0,100,35,65,44,41,61,0,61,106,0,106
26/02/2022 13:00,6,5,1,36,19,17,48,21,27,0,0,0,0,0,0,12,12,0,0,0,0,113,50,63,46,46,81,1,80,105,0,105
26/02/2022 14:00,17,10,7,24,15,9,31,19,12,0,0,0,0,0,0,6,6,0,0,0,0,110,36,74,44,34,78,1,77,119,0,119
26/02/2022 15:00,15,10,5,28,15,13,40,22,18,0,0,0,0,0,0,3,3,0,1,1,0,110,48,62,36,25,79,1,78,91,1,90
26/02/2022 16:00,19,9,10,17,8,9,26,15,11,0,0,0,2,1,1,9,9,0,3,3,0,113,50,63,48,31,70,1,69,83,0,83
26/02/2022 17:00,10,5,5,19,8,11,21,11,10,0,0,0,2,2,0,3,3,0,3,3,0,115,54,61,52,34,93,1,92,84,0,84
26/02/2022 18:00,8,4,4,17,7,10,19,5,14,0,0,0,1,1,0,5,5,0,0,0,0,141,60,81,44,20,108,0,108,92,0,92
26/02/2022 19:00,8,5,3,6,2,4,20,7,13,0,0,0,3,3,0,1,1,0,0,0,0,104,54,50,52,35,105,1,104,88,0,88
26/02/2022 20:00,15,8,7,10,7,3,16,8,8,0,0,0,3,3,0,3,3,0,0,0,0,72,32,40,53,37,66,1,65,97,1,96
26/02/2022 21:00,4,3,1,0,0,0,5,3,2,0,0,0,0,0,0,3,3,0,1,1,0,47,19,28,35,21,54,0,54,59,0,59
26/02/2022 22:00,5,2,3,0,0,0,1,0,1,0,0,0,2,2,0,3,3,0,0,0,0,50,35,15,22,12,43,0,43,34,0,34
26/02/2022 23:00,2,0,2,2,1,1,2,0,2,0,0,0,0,0,0,1,1,0,0,0,0,28,15,13,30,6,32,0,32,16,0,16
27/02/2022 00:00,3,2,1,6,2,4,4,0,4,0,0,0,0,0,0,2,2,0,1,1,0,33,22,11,13,4,23,0,23,8,0,8
27/02/2022 01:00,1,1,0,0,0,0,0,0,0,0,0,0,1,1,0,1,1,0,0,0,0,23,16,7,8,3,5,0,5,2,0,2
27/02/2022 02:00,0,0,0,1,0,1,3,1,2,0,0,0,1,1,0,1,1,0,0,0,0,8,7,1,14,1,20,0,20,4,0,4
27/02/2022 03:00,0,0,0,0,0,0,0,0,0,0,0,0,0,0,0,0,0,0,0,0,0,14,9,5,9,5,12,0,12,4,0,4
27/02/2022 04:00,0,0,0,3,2,1,2,2,0,0,0,0,1,1,0,0,0,0,0,0,0,7,4,3,5,1,9,0,9,0,0,0
27/02/2022 05:00,1,1,0,1,1,0,1,1,0,0,0,0,0,0,0,0,0,0,0,0,0,6,2,4,3,1,2,0,2,1,0,1
27/02/2022 06:00,1,1,0,6,1,5,7,3,4,0,0,0,0,0,0,0,0,0,1,1,0,17,4,13,5,4,8,0,8,3,0,3
27/02/2022 07:00,4,2,2,17,7,10,20,9,11,0,0,0,3,3,0,1,1,0,0,0,0,47,19,28,15,23,6,0,6,10,0,10
27/02/2022 08:00,6,4,2,47,22,25,53,19,34,0,0,0,2,2,0,3,3,0,2,2,0,44,13,31,11,19,6,0,6,14,0,14
27/02/2022 09:00,6,6,0,83,35,48,101,39,62,0,0,0,3,3,0,11,11,0,1,1,0,71,20,51,20,21,21,0,21,44,0,44
27/02/2022 10:00,10,9,1,84,34,50,101,39,62,0,0,0,0,0,0,10,10,0,6,6,0,89,28,61,24,27,16,0,16,43,0,43
27/02/2022 11:00,8,7,1,81,39,42,80,37,43,0,0,0,5,5,0,9,9,0,7,7,0,101,50,51,24,39,36,0,36,80,0,80
27/02/2022 12:00,13,10,3,76,41,35,89,39,50,0,0,0,0,0,0,6,6,0,22,22,0,88,34,54,34,42,53,0,53,70,0,70
27/02/2022 13:00,10,6,4,48,23,25,66,29,37,0,0,0,2,2,0,13,13,0,6,6,0,111,35,76,42,32,62,0,62,75,0,75
27/02/2022 14:00,16,12,4,51,27,24,65,30,35,0,0,0,8,8,0,16,16,0,1,1,0,116,49,67,46,32,70,0,70,68,0,68
27/02/2022 15:00,13,9,4,24,12,12,45,20,25,0,0,0,1,1,0,5,5,0,0,0,0,105,43,62,43,35,74,0,74,69,1,68
27/02/2022 16:00,8,4,4,28,17,11,36,17,19,0,0,0,2,2,0,8,8,0,0,0,0,93,38,55,39,38,67,2,65,69,0,69
27/02/2022 17:00,7,3,4,11,6,5,23,13,10,0,0,0,1,1,0,7,7,0,0,0,0,120,71,49,48,21,83,1,82,56,0,56
27/02/2022 18:00,8,1,7,22,11,11,25,11,14,0,0,0,2,1,1,2,2,0,0,0,0,123,49,74,49,27,68,0,68,60,2,58
27/02/2022 19:00,10,9,1,12,8,4,17,8,9,0,0,0,1,1,0,6,6,0,0,0,0,116,55,61,40,24,102,0,102,65,0,65
27/02/2022 20:00,9,6,3,12,7,5,12,5,7,0,0,0,1,1,0,6,6,0,0,0,0,106,50,56,29,21,60,1,59,53,0,53
27/02/2022 21:00,9,6,3,1,0,1,4,1,3,0,0,0,1,1,0,0,0,0,0,0,0,50,35,15,28,8,61,0,61,50,0,50
27/02/2022 22:00,6,4,2,6,1,5,8,2,6,0,0,0,1,1,0,0,0,0,0,0,0,30,21,9,24,12,30,0,30,17,0,17
27/02/2022 23:00,2,1,1,2,1,1,2,0,2,0,0,0,0,0,0,2,2,0,2,2,0,14,11,3,21,9,33,0,33,16,0,16
28/02/2022 00:00,0,0,0,1,1,0,0,0,0,0,0,0,0,0,0,4,4,0,0,0,0,12,8,4,12,1,9,0,9,5,0,5
28/02/2022 01:00,0,0,0,0,0,0,0,0,0,0,0,0,0,0,0,0,0,0,0,0,0,5,3,2,5,4,2,0,2,0,0,0
28/02/2022 02:00,1,0,1,0,0,0,0,0,0,0,0,0,0,0,0,0,0,0,0,0,0,4,3,1,5,0,2,0,2,1,0,1
28/02/2022 03:00,0,0,0,0,0,0,0,0,0,0,0,0,0,0,0,0,0,0,0,0,0,0,0,0,3,0,3,0,3,0,0,0
28/02/2022 04:00,1,1,0,0,0,0,3,2,1,0,0,0,0,0,0,0,0,0,1,1,0,4,0,4,5,5,1,0,1,1,0,1
28/02/2022 05:00,,,,3,1,2,5,3,2,0,0,0,3,3,0,0,0,0,0,0,0,24,1,23,,,1,0,1,5,0,5
28/02/2022 06:00,,,,10,8,2,13,10,3,0,0,0,5,5,0,9,9,0,0,0,0,98,16,82,,,11,0,11,27,0,27
28/02/2022 07:00,,,,46,28,18,53,32,21,0,0,0,20,20,0,11,11,0,8,8,0,200,42,158,,,21,0,21,74,0,74
28/02/2022 08:00,,,,67,50,17,79,62,17,0,0,0,34,34,0,25,25,0,82,82,0,377,79,298,,,46,0,46,113,0,113
28/02/2022 09:00,,,,34,17,17,43,18,25,0,0,0,19,19,0,12,12,0,19,19,0,178,45,133,,,28,1,27,105,0,105
28/02/2022 10:00,,,,39,17,22,44,23,21,0,0,0,13,13,0,10,10,0,4,4,0,84,23,61,,,20,0,20,58,0,58
28/02/2022 11:00,,,,30,12,18,35,18,17,0,0,0,5,5,0,9,9,0,7,7,0,84,33,51,,,25,0,25,58,0,58
28/02/2022 12:00,,,,36,20,16,43,21,22,0,0,0,5,4,1,9,9,0,9,9,0,116,52,64,,,45,0,45,70,0,70
28/02/2022 13:00,17,10,7,28,16,12,31,15,16,0,0,0,1,1,0,6,6,0,6,6,0,97,40,57,14,13,83,0,83,69,1,68
28/02/2022 14:00,14,9,5,15,7,8,21,10,11,0,0,0,3,3,0,4,4,0,3,3,0,100,48,52,46,26,59,0,59,60,0,60
28/02/2022 15:00,15,6,9,27,16,11,25,12,13,0,0,0,4,4,0,39,39,0,3,3,0,120,75,45,60,23,67,0,67,71,1,70
28/02/2022 16:00,30,14,16,37,11,26,59,20,39,0,0,0,9,9,0,16,16,0,13,13,0,188,113,75,144,39,110,0,110,47,0,47
28/02/2022 17:00,37,12,25,62,18,44,88,24,64,0,0,0,10,10,0,24,24,0,6,6,0,303,195,108,188,35,180,0,180,99,0,99
28/02/2022 18:00,21,5,16,73,24,49,94,33,61,0,0,0,3,3,0,16,16,0,8,8,0,278,162,116,163,46,161,0,161,111,0,111
28/02/2022 19:00,14,7,7,33,13,20,39,12,27,0,0,0,2,2,0,8,8,0,3,3,0,171,95,76,107,30,119,0,119,78,0,78
28/02/2022 20:00,8,5,3,19,5,14,28,8,20,0,0,0,4,4,0,11,11,0,0,0,0,108,58,50,54,15,100,0,100,84,0,84
28/02/2022 21:00,8,4,4,4,3,1,11,4,7,0,0,0,6,6,0,5,5,0,0,0,0,68,41,27,35,7,76,1,75,56,0,56
28/02/2022 22:00,8,4,4,3,0,3,4,0,4,0,0,0,1,1,0,3,3,0,0,0,0,45,32,13,20,12,38,1,37,23,0,23
28/02/2022 23:00,0,0,0,2,0,2,2,0,2,0,0,0,0,0,0,2,2,0,0,0,0,23,14,9,20,5,26,0,26,17,0,17
01/03/2022 00:00,0,0,0,3,1,2,2,0,2,0,0,0,0,0,0,0,0,0,0,0,0,10,7,3,15,2,11,0,11,4,0,4
01/03/2022 01:00,0,0,0,0,0,0,1,0,1,0,0,0,0,0,0,1,1,0,0,0,0,5,3,2,3,2,1,0,1,1,0,1
01/03/2022 02:00,0,0,0,0,0,0,2,1,1,0,0,0,1,1,0,0,0,0,0,0,0,0,0,0,2,0,2,0,2,1,0,1
01/03/2022 03:00,0,0,0,0,0,0,0,0,0,0,0,0,0,0,0,0,0,0,0,0,0,2,1,1,2,0,3,0,3,1,0,1
01/03/2022 04:00,1,1,0,0,0,0,2,1,1,0,0,0,0,0,0,0,0,0,0,0,0,5,1,4,0,5,0,0,0,0,0,0
01/03/2022 05:00,0,0,0,4,2,2,8,4,4,0,0,0,1,0,1,1,1,0,0,0,0,27,5,22,3,12,2,0,2,6,0,6
01/03/2022 06:00,16,15,1,13,11,2,17,11,6,0,0,0,6,6,0,5,5,0,0,0,0,103,12,91,13,70,12,0,12,25,0,25
01/03/2022 07:00,28,25,3,44,32,12,56,41,15,0,0,0,13,13,0,12,12,0,0,0,0,264,58,206,30,140,23,0,23,73,0,73
01/03/2022 08:00,62,52,10,74,61,13,94,75,19,0,0,0,33,33,0,33,33,0,0,0,0,467,86,381,44,264,51,1,50,167,0,167
01/03/2022 09:00,29,25,4,54,28,26,70,36,34,0,0,0,25,25,0,6,6,0,0,0,0,209,43,166,25,151,22,0,22,97,0,97
01/03/2022 10:00,13,10,3,63,25,38,70,24,46,0,0,0,14,14,0,5,5,0,0,0,0,92,25,67,22,47,19,0,19,61,0,61
01/03/2022 11:00,13,10,3,72,35,37,76,35,41,0,0,0,4,4,0,11,11,0,0,0,0,77,29,48,17,32,35,0,35,55,0,55
01/03/2022 12:00,16,9,7,85,39,46,111,48,63,0,0,0,4,4,0,8,8,0,0,0,0,112,39,73,49,48,58,0,58,61,0,61
01/03/2022 13:00,15,10,5,73,41,32,87,34,53,0,0,0,8,8,0,3,3,0,0,0,0,122,46,76,54,55,74,0,74,99,1,98
01/03/2022 14:00,28,9,19,48,27,21,79,40,39,0,0,0,1,1,0,15,15,0,0,0,0,108,48,60,74,34,80,1,79,84,0,84
01/03/2022 15:00,15,6,9,67,30,37,79,31,48,0,0,0,6,6,0,36,36,0,0,0,0,160,79,81,83,41,80,1,79,98,0,98
01/03/2022 16:00,24,10,14,81,40,41,99,42,57,0,0,0,3,3,0,24,24,0,0,0,0,209,118,91,171,48,135,0,135,82,1,81
01/03/2022 17:00,46,15,31,97,32,65,123,35,88,0,0,0,1,1,0,31,31,0,0,0,0,333,224,109,256,70,236,0,236,118,0,118
01/03/2022 18:00,23,12,11,99,30,69,142,43,99,0,0,0,0,0,0,17,17,0,0,0,0,288,183,105,239,52,197,0,197,116,0,116
01/03/2022 19:00,12,3,9,44,15,29,53,23,30,0,0,0,0,0,0,6,6,0,0,0,0,195,116,79,112,32,139,2,137,96,0,96
01/03/2022 20:00,11,3,8,28,12,16,47,20,27,0,0,0,4,4,0,5,5,0,0,0,0,131,81,50,64,25,105,0,105,93,1,92
01/03/2022 21:00,3,2,1,7,2,5,16,4,12,0,0,0,4,4,0,9,9,0,0,0,0,70,47,23,43,23,76,0,76,48,0,48
01/03/2022 22:00,7,3,4,4,2,2,9,3,6,0,0,0,1,1,0,5,5,0,0,0,0,65,43,22,37,11,50,0,50,32,1,31
01/03/2022 23:00,5,0,5,1,1,0,2,1,1,0,0,0,1,1,0,1,1,0,0,0,0,25,18,7,19,7,35,0,35,20,0,20
02/03/2022 00:00,2,1,1,2,2,0,1,0,1,0,0,0,0,0,0,2,2,0,0,0,0,11,8,3,12,1,14,0,14,6,0,6
02/03/2022 01:00,0,0,0,0,0,0,0,0,0,0,0,0,0,0,0,0,0,0,0,0,0,13,8,5,8,1,2,0,2,0,0,0
02/03/2022 02:00,0,0,0,0,0,0,0,0,0,0,0,0,0,0,0,0,0,0,0,0,0,4,4,0,2,0,5,0,5,1,0,1
02/03/2022 03:00,0,0,0,0,0,0,0,0,0,0,0,0,0,0,0,0,0,0,0,0,0,1,0,1,3,0,4,0,4,0,0,0
02/03/2022 04:00,1,1,0,2,1,1,3,2,1,0,0,0,1,1,0,0,0,0,0,0,0,2,0,2,0,3,0,0,0,0,0,0
02/03/2022 05:00,1,1,0,3,2,1,7,4,3,0,0,0,1,1,0,0,0,0,0,0,0,24,5,19,4,11,4,0,4,5,0,5
02/03/2022 06:00,17,16,1,13,10,3,16,11,5,0,0,0,9,9,0,3,3,0,0,0,0,105,23,82,14,68,11,1,10,28,0,28
02/03/2022 07:00,24,23,1,38,29,9,49,35,14,0,0,0,13,13,0,12,12,0,0,0,0,258,58,200,23,131,24,0,24,65,0,65
02/03/2022 08:00,69,62,7,38,32,6,52,43,9,0,0,0,29,29,0,25,25,0,0,0,0,435,81,354,32,230,45,0,45,162,0,162
02/03/2022 09:00,21,17,4,19,13,6,31,19,12,0,0,0,14,14,0,7,7,0,0,0,0,184,46,138,16,98,23,0,23,105,0,105
02/03/2022 10:00,10,6,4,12,4,8,10,4,6,0,0,0,9,8,1,4,4,0,2,2,0,74,26,48,12,38,21,0,21,56,0,56
02/03/2022 11:00,8,6,2,18,13,5,21,11,10,0,0,0,1,1,0,3,3,0,0,0,0,77,20,57,23,28,42,0,42,39,0,39
02/03/2022 12:00,7,4,3,7,4,3,9,4,5,0,0,0,1,1,0,9,9,0,0,0,0,93,37,56,19,27,50,0,50,54,0,54
02/03/2022 13:00,19,12,7,9,4,5,13,6,7,0,0,0,2,2,0,14,14,0,0,0,0,104,46,58,24,37,68,0,68,69,1,68
02/03/2022 14:00,9,3,6,5,2,3,14,6,8,0,0,0,1,1,0,4,4,0,0,0,0,104,54,50,51,23,63,1,62,67,0,67
02/03/2022 15:00,23,12,11,10,2,8,15,6,9,0,0,0,2,2,0,13,13,0,0,0,0,126,71,55,58,23,66,0,66,60,0,60
02/03/2022 16:00,28,16,12,16,4,12,22,7,15,0,0,0,3,3,0,16,16,0,0,0,0,200,123,77,97,29,94,0,94,66,1,65
02/03/2022 17:00,35,9,26,33,8,25,38,7,31,0,0,0,5,5,0,17,17,0,0,0,0,275,189,86,208,26,140,2,138,86,0,86
02/03/2022 18:00,25,11,14,30,3,27,48,9,39,0,0,0,4,4,0,12,12,0,0,0,0,278,175,103,164,28,183,0,183,98,0,98
02/03/2022 19:00,11,6,5,26,7,19,28,4,24,0,0,0,5,4,1,6,6,0,0,0,0,157,93,64,90,32,128,0,128,77,0,77
02/03/2022 20:00,6,4,2,14,4,10,18,6,12,0,0,0,4,4,0,7,7,0,0,0,0,125,74,51,67,38,75,0,75,92,0,92
02/03/2022 21:00,5,3,2,7,3,4,12,3,9,0,0,0,3,3,0,7,7,0,0,0,0,63,42,21,35,22,0,0,0,67,1,66
02/03/2022 22:00,10,6,4,6,3,3,3,1,2,0,0,0,1,1,0,3,3,0,0,0,0,50,28,22,27,13,0,0,0,27,0,27
02/03/2022 23:00,5,2,3,4,2,2,3,1,2,0,0,0,1,1,0,0,0,0,0,0,0,28,17,11,20,2,0,0,0,17,1,16
03/03/2022 00:00,0,0,0,0,0,0,2,0,2,0,0,0,0,0,0,1,1,0,0,0,0,18,17,1,14,4,17,0,17,8,0,8
03/03/2022 01:00,1,0,1,0,0,0,0,0,0,0,0,0,0,0,0,1,1,0,0,0,0,3,2,1,2,3,1,0,1,0,0,0
03/03/2022 02:00,0,0,0,0,0,0,0,0,0,0,0,0,0,0,0,0,0,0,0,0,0,6,6,0,3,0,10,0,10,4,0,4
03/03/2022 03:00,1,0,1,0,0,0,0,0,0,0,0,0,0,0,0,0,0,0,0,0,0,2,1,1,2,0,2,0,2,1,0,1
03/03/2022 04:00,1,1,0,0,0,0,3,1,2,0,0,0,2,2,0,0,0,0,0,0,0,6,0,6,2,2,1,0,1,1,0,1
03/03/2022 05:00,1,1,0,5,4,1,5,2,3,0,0,0,2,2,0,0,0,0,0,0,0,23,3,20,3,5,2,0,2,6,0,6
03/03/2022 06:00,19,16,3,16,12,4,23,16,7,0,0,0,3,3,0,7,7,0,0,0,0,99,25,74,15,61,14,0,14,25,0,25
03/03/2022 07:00,27,23,4,48,33,15,55,37,18,0,0,0,9,9,0,13,13,0,0,0,0,249,57,192,26,117,27,0,27,67,0,67
03/03/2022 08:00,71,63,8,67,52,15,88,69,19,0,0,0,23,23,0,29,29,0,0,0,0,457,80,377,43,283,60,1,59,156,0,156
03/03/2022 09:00,25,20,5,53,29,24,67,32,35,0,0,0,14,13,1,11,11,0,0,0,0,183,38,145,25,123,32,2,30,117,0,117
03/03/2022 10:00,18,11,7,56,26,30,52,18,34,0,0,0,17,17,0,9,9,0,2,2,0,102,38,64,22,58,0,0,0,69,0,69
03/03/2022 11:00,13,6,7,60,37,23,73,41,32,0,0,0,15,15,0,10,10,0,0,0,0,91,34,57,20,43,41,0,41,59,0,59
03/03/2022 12:00,20,11,9,72,30,42,82,29,53,0,0,0,22,22,0,11,11,0,2,2,0,106,43,63,57,58,70,1,69,91,0,91
03/03/2022 13:00,15,12,3,54,24,30,74,36,38,0,0,0,9,9,0,12,12,0,7,7,0,142,61,81,72,58,90,0,90,99,1,98
03/03/2022 14:00,39,18,21,58,25,33,85,39,46,0,0,0,11,11,0,10,10,0,15,15,0,131,52,79,63,42,86,1,85,64,0,64
03/03/2022 15:00,12,5,7,70,37,33,81,38,43,0,0,0,7,7,0,39,39,0,7,7,0,176,87,89,81,35,81,0,81,81,1,80
03/03/2022 16:00,29,13,16,70,25,45,101,35,66,0,0,0,7,7,0,24,24,0,0,0,0,206,114,92,145,45,114,0,114,94,2,92
03/03/2022 17:00,44,13,31,86,27,59,112,35,77,0,0,0,9,9,0,23,23,0,1,1,0,332,224,108,209,55,216,0,216,129,0,129
03/03/2022 18:00,33,11,22,87,30,57,107,40,67,0,0,0,5,5,0,21,21,0,1,1,0,318,189,129,173,53,187,1,186,126,0,126
03/03/2022 19:00,8,2,6,44,21,23,59,23,36,0,0,0,5,5,0,12,12,0,2,2,0,195,100,95,115,36,143,1,142,117,1,116
03/03/2022 20:00,6,1,5,45,25,20,49,21,28,0,0,0,4,4,0,11,11,0,0,0,0,136,76,60,90,41,106,2,104,98,1,97
03/03/2022 21:00,10,3,7,20,8,12,20,5,15,0,0,0,1,1,0,12,12,0,1,1,0,87,54,33,48,15,118,1,117,62,0,62
03/03/2022 22:00,9,5,4,3,2,1,9,3,6,0,0,0,1,1,0,7,7,0,1,1,0,54,40,14,26,9,56,0,56,29,0,29
03/03/2022 23:00,5,1,4,6,2,4,9,2,7,0,0,0,0,0,0,4,4,0,0,0,0,47,33,14,35,7,44,1,43,23,0,23
04/03/2022 00:00,3,1,2,1,1,0,0,0,0,0,0,0,0,0,0,2,2,0,0,0,0,29,20,9,26,5,33,1,32,8,0,8
04/03/2022 01:00,0,0,0,1,1,0,0,0,0,0,0,0,0,0,0,0,0,0,0,0,0,11,9,2,9,1,3,0,3,2,0,2
04/03/2022 02:00,0,0,0,0,0,0,1,0,1,0,0,0,0,0,0,0,0,0,0,0,0,13,9,4,10,1,8,0,8,1,0,1
04/03/2022 03:00,1,1,0,0,0,0,0,0,0,0,0,0,1,1,0,0,0,0,0,0,0,4,2,2,5,0,5,0,5,1,0,1
04/03/2022 04:00,1,1,0,3,1,2,4,3,1,0,0,0,0,0,0,0,0,0,0,0,0,4,1,3,6,4,4,0,4,0,0,0
04/03/2022 05:00,1,0,1,8,4,4,6,3,3,0,0,0,0,0,0,0,0,0,0,0,0,28,8,20,4,17,4,0,4,7,0,7
04/03/2022 06:00,17,14,3,12,11,1,13,8,5,0,0,0,7,7,0,5,5,0,0,0,0,107,16,91,16,52,14,1,13,26,0,26
04/03/2022 07:00,28,23,5,47,30,17,61,40,21,0,0,0,19,19,0,11,11,0,0,0,0,227,56,171,27,110,18,0,18,63,0,63
04/03/2022 08:00,49,45,4,56,38,18,81,59,22,0,0,0,27,27,0,24,24,0,0,0,0,400,76,324,31,205,29,0,29,128,1,127
04/03/2022 09:00,25,16,9,45,23,22,45,27,18,0,0,0,16,16,0,12,12,0,1,1,0,179,38,141,29,124,25,0,25,108,0,108
04/03/2022 10:00,15,10,5,61,24,37,78,31,47,0,0,0,17,16,1,9,9,0,1,1,0,104,28,76,24,57,18,0,18,78,0,78
04/03/2022 11:00,12,7,5,74,36,38,83,38,45,0,0,0,5,5,0,7,7,0,0,0,0,86,26,60,31,35,14,0,14,72,0,72
04/03/2022 12:00,15,9,6,69,33,36,83,37,46,0,0,0,6,6,0,14,14,0,0,0,0,133,47,86,61,57,75,0,75,97,2,95
04/03/2022 13:00,25,15,10,75,36,39,99,46,53,0,0,0,3,3,0,11,11,0,0,0,0,144,67,77,77,55,101,0,101,129,0,129
04/03/2022 14:00,27,12,15,54,27,27,95,47,48,0,0,0,6,6,0,16,16,0,0,0,0,140,69,71,68,39,92,0,92,109,0,109
04/03/2022 15:00,28,17,11,77,39,38,84,40,44,0,0,0,5,5,0,21,21,0,11,11,0,159,86,73,85,48,104,0,104,82,0,82
04/03/2022 16:00,28,11,17,78,38,40,95,37,58,0,0,0,9,9,0,21,21,0,0,0,0,203,118,85,119,45,133,0,133,101,0,101
04/03/2022 17:00,26,11,15,97,42,55,119,54,65,0,0,0,5,5,0,19,19,0,0,0,0,276,142,134,141,52,163,0,163,130,0,130
04/03/2022 18:00,19,7,12,62,23,39,90,34,56,0,0,0,3,3,0,21,21,0,1,1,0,276,147,129,132,48,187,0,187,135,1,134
04/03/2022 19:00,19,9,10,34,15,19,47,20,27,0,0,0,3,3,0,8,8,0,0,0,0,155,66,89,93,54,118,1,117,126,0,126
04/03/2022 20:00,13,7,6,11,6,5,22,8,14,0,0,0,8,8,0,5,5,0,4,4,0,117,65,52,68,42,118,0,118,114,0,114
04/03/2022 21:00,17,10,7,9,5,4,14,7,7,0,0,0,8,8,0,9,9,0,6,6,0,94,60,34,42,19,82,2,80,66,1,65
04/03/2022 22:00,9,3,6,1,1,0,9,4,5,0,0,0,4,4,0,7,7,0,0,0,0,55,36,19,40,10,49,0,49,49,0,49
04/03/2022 23:00,3,2,1,3,1,2,3,0,3,0,0,0,0,0,0,3,3,0,0,0,0,31,24,7,35,14,30,0,30,27,0,27
05/03/2022 00:00,1,0,1,3,0,3,6,2,4,0,0,0,2,2,0,1,1,0,0,0,0,38,26,12,31,4,46,0,46,9,0,9
05/03/2022 01:00,7,4,3,1,1,0,1,0,1,0,0,0,0,0,0,1,1,0,0,0,0,16,11,5,9,4,10,0,10,1,0,1
05/03/2022 02:00,1,1,0,0,0,0,0,0,0,0,0,0,0,0,0,0,0,0,0,0,0,14,9,5,16,2,16,0,16,4,0,4
05/03/2022 03:00,1,0,1,1,0,1,2,0,2,0,0,0,0,0,0,0,0,0,0,0,0,10,9,1,9,3,19,0,19,3,0,3
05/03/2022 04:00,0,0,0,1,0,1,1,0,1,0,0,0,1,1,0,0,0,0,0,0,0,3,1,2,4,2,8,0,8,1,0,1
05/03/2022 05:00,1,1,0,4,2,2,4,2,2,0,0,0,1,1,0,0,0,0,0,0,0,15,3,12,4,5,6,0,6,6,0,6
05/03/2022 06:00,5,5,0,8,4,4,9,4,5,0,0,0,4,4,0,1,1,0,0,0,0,34,7,27,13,10,11,0,11,8,0,8
05/03/2022 07:00,8,6,2,35,11,24,36,10,26,0,0,0,5,5,0,3,3,0,0,0,0,46,8,38,19,20,9,0,9,17,0,17
05/03/2022 08:00,9,7,2,73,33,40,87,40,47,0,0,0,2,2,0,8,8,0,0,0,0,65,19,46,20,32,15,0,15,28,0,28
05/03/2022 09:00,16,9,7,104,50,54,129,45,84,0,0,0,3,3,0,9,9,0,0,0,0,98,31,67,16,43,24,0,24,60,0,60
05/03/2022 10:00,8,7,1,141,58,83,152,63,89,0,0,0,3,3,0,9,9,0,0,0,0,100,31,69,38,40,39,0,39,70,0,70
05/03/2022 11:00,14,11,3,160,75,85,195,94,101,0,0,0,3,3,0,9,9,0,0,0,0,103,33,70,49,39,33,0,33,80,2,78
05/03/2022 12:00,7,4,3,149,74,75,184,81,103,0,0,0,3,3,0,10,10,0,0,0,0,136,55,81,85,45,56,1,55,119,0,119
05/03/2022 13:00,24,17,7,140,73,67,200,105,95,0,0,0,2,2,0,17,17,0,0,0,0,139,54,85,47,54,79,0,79,131,2,129
05/03/2022 14:00,25,14,11,110,60,50,162,85,77,0,0,0,7,7,0,15,15,0,0,0,0,140,53,87,69,65,85,0,85,119,1,118
05/03/2022 15:00,15,6,9,98,45,53,161,80,81,0,0,0,17,16,1,13,13,0,0,0,0,117,54,63,58,63,86,0,86,89,1,88
05/03/2022 16:00,18,9,9,101,61,40,137,77,60,0,0,0,4,4,0,11,11,0,0,0,0,124,59,65,64,35,101,0,101,95,2,93
05/03/2022 17:00,11,6,5,72,37,35,83,48,35,0,0,0,8,8,0,10,10,0,0,0,0,117,63,54,63,50,112,2,110,88,0,88
05/03/2022 18:00,13,8,5,42,30,12,53,30,23,0,0,0,2,2,0,9,9,0,0,0,0,130,52,78,67,51,107,0,107,106,1,105
05/03/2022 19:00,12,7,5,12,4,8,18,10,8,0,0,0,6,6,0,3,3,0,0,0,0,94,45,49,43,39,120,2,118,101,0,101
05/03/2022 20:00,3,2,1,11,6,5,18,9,9,0,0,0,1,1,0,3,3,0,0,0,0,88,41,47,51,29,87,0,87,90,1,89
05/03/2022 21:00,4,3,1,4,3,1,10,4,6,0,0,0,1,1,0,2,2,0,0,0,0,73,38,35,43,23,55,2,53,64,0,64
05/03/2022 22:00,7,5,2,5,1,4,4,0,4,0,0,0,0,0,0,1,1,0,0,0,0,39,22,17,37,16,37,1,36,30,1,29
05/03/2022 23:00,2,1,1,5,1,4,4,1,3,0,0,0,0,0,0,4,4,0,0,0,0,35,20,15,31,7,41,1,40,27,0,27
06/03/2022 00:00,2,1,1,3,0,3,1,0,1,0,0,0,0,0,0,0,0,0,0,0,0,25,14,11,19,4,23,1,22,15,0,15
06/03/2022 01:00,0,0,0,2,2,0,0,0,0,0,0,0,1,1,0,0,0,0,0,0,0,25,17,8,12,1,15,0,15,2,0,2
06/03/2022 02:00,1,1,0,2,1,1,0,0,0,0,0,0,0,0,0,0,0,0,0,0,0,11,7,4,5,3,19,0,19,2,0,2
06/03/2022 03:00,0,0,0,2,1,1,0,0,0,0,0,0,0,0,0,0,0,0,0,0,0,19,14,5,11,4,13,1,12,0,0,0
06/03/2022 04:00,1,0,1,1,0,1,1,1,0,0,0,0,0,0,0,0,0,0,0,0,0,6,4,2,7,0,6,0,6,1,0,1
06/03/2022 05:00,2,2,0,4,2,2,4,2,2,0,0,0,0,0,0,0,0,0,0,0,0,9,1,8,1,4,4,0,4,4,0,4
06/03/2022 06:00,2,2,0,8,4,4,7,3,4,0,0,0,0,0,0,0,0,0,0,0,0,19,3,16,12,11,11,0,11,3,0,3
06/03/2022 07:00,3,1,2,37,12,25,35,13,22,0,0,0,3,3,0,0,0,0,0,0,0,25,9,16,15,9,7,0,7,5,0,5
06/03/2022 08:00,7,6,1,88,40,48,83,31,52,0,0,0,5,5,0,3,3,0,0,0,0,43,12,31,12,15,8,0,8,12,0,12
06/03/2022 09:00,4,2,2,106,37,69,118,46,72,0,0,0,8,8,0,1,1,0,0,0,0,56,19,37,22,32,18,0,18,32,1,31
06/03/2022 10:00,6,4,2,208,79,129,210,92,118,0,0,0,5,5,0,7,7,0,0,0,0,81,23,58,30,37,22,0,22,45,0,45
06/03/2022 11:00,12,6,6,202,94,108,232,115,117,0,0,0,5,5,0,8,8,0,0,0,0,96,36,60,32,47,45,0,45,70,2,68
06/03/2022 12:00,16,11,5,189,108,81,239,122,117,0,0,0,2,2,0,9,9,0,0,0,0,116,34,82,46,55,53,0,53,80,0,80
06/03/2022 13:00,25,13,12,151,80,71,203,100,103,0,0,0,6,6,0,15,15,0,0,0,0,97,42,55,57,46,70,1,69,104,0,104
06/03/2022 14:00,23,13,10,180,81,99,214,96,118,0,0,0,2,2,0,14,14,0,0,0,0,118,45,73,47,65,69,1,68,93,1,92
06/03/2022 15:00,20,12,8,129,83,46,221,104,117,0,0,0,1,1,0,15,15,0,0,0,0,94,39,55,47,36,57,0,57,63,0,63
06/03/2022 16:00,16,7,9,86,44,42,134,58,76,0,0,0,3,3,0,13,13,0,0,0,0,114,52,62,47,43,89,0,89,84,0,84
06/03/2022 17:00,12,7,5,69,51,18,82,53,29,0,0,0,6,6,0,13,13,0,0,0,0,112,55,57,50,38,110,0,110,107,0,107
06/03/2022 18:00,16,7,9,38,24,14,49,28,21,0,0,0,7,7,0,7,7,0,0,0,0,99,47,52,65,28,97,0,97,105,0,105
06/03/2022 19:00,8,4,4,18,10,8,21,9,12,0,0,0,10,10,0,5,5,0,0,0,0,101,55,46,43,41,102,2,100,74,0,74
06/03/2022 20:00,4,3,1,9,5,4,8,2,6,0,0,0,7,7,0,0,0,0,0,0,0,65,47,18,36,18,64,0,64,61,0,61
06/03/2022 21:00,11,7,4,5,3,2,9,4,5,0,0,0,2,2,0,2,2,0,0,0,0,47,25,22,31,16,46,1,45,41,1,40
06/03/2022 22:00,4,3,1,1,0,1,4,1,3,0,0,0,1,1,0,1,1,0,0,0,0,38,28,10,25,13,40,1,39,28,2,26
06/03/2022 23:00,2,0,2,2,1,1,2,0,2,0,0,0,1,1,0,2,2,0,0,0,0,27,21,6,11,4,26,0,26,24,0,24
07/03/2022 00:00,0,0,0,3,2,1,4,1,3,0,0,0,0,0,0,1,1,0,0,0,0,8,5,3,11,1,13,0,13,7,0,7
07/03/2022 01:00,0,0,0,0,0,0,0,0,0,0,0,0,0,0,0,0,0,0,0,0,0,6,3,3,5,0,3,0,3,0,0,0
07/03/2022 02:00,1,0,1,0,0,0,0,0,0,0,0,0,0,0,0,0,0,0,0,0,0,2,2,0,3,0,3,0,3,2,0,2
07/03/2022 03:00,0,0,0,0,0,0,1,0,1,0,0,0,0,0,0,0,0,0,0,0,0,0,0,0,0,0,2,0,2,0,0,0
07/03/2022 04:00,1,1,0,0,0,0,1,0,1,0,0,0,1,1,0,0,0,0,0,0,0,3,1,2,1,2,0,0,0,0,0,0
07/03/2022 05:00,0,0,0,4,3,1,8,5,3,0,0,0,4,4,0,2,2,0,0,0,0,21,3,18,2,14,1,0,1,8,0,8
07/03/2022 06:00,18,16,2,15,12,3,14,8,6,0,0,0,7,7,0,7,7,0,0,0,0,108,23,85,14,65,15,3,12,29,1,28
07/03/2022 07:00,22,18,4,55,43,12,64,47,17,0,0,0,5,5,0,8,8,0,0,0,0,257,53,204,28,127,29,0,29,70,1,69
07/03/2022 08:00,63,54,9,60,49,11,87,67,20,0,0,0,25,25,0,25,25,0,0,0,0,419,87,332,42,243,42,0,42,137,0,137
07/03/2022 09:00,21,18,3,40,22,18,42,22,20,0,0,0,14,14,0,8,8,0,0,0,0,175,36,139,26,136,26,1,25,103,0,103
07/03/2022 10:00,17,10,7,29,19,10,37,14,23,0,0,0,6,6,0,10,10,0,0,0,0,70,20,50,20,42,16,0,16,42,1,41
07/03/2022 11:00,11,4,7,37,24,13,37,16,21,0,0,0,4,4,0,5,5,0,0,0,0,73,21,52,34,35,18,0,18,60,1,59
07/03/2022 12:00,13,9,4,37,18,19,55,33,22,0,0,0,1,1,0,9,9,0,0,0,0,103,45,58,47,44,58,0,58,87,0,87
07/03/2022 13:00,15,7,8,26,13,13,37,16,21,0,0,0,5,5,0,6,6,0,0,0,0,107,57,50,57,44,50,0,50,102,0,102
07/03/2022 14:00,25,14,11,26,10,16,31,13,18,0,0,0,3,3,0,7,7,0,0,0,0,116,54,62,56,31,46,0,46,64,0,64
07/03/2022 15:00,11,5,6,32,13,19,34,14,20,0,0,0,3,3,0,26,26,0,1,1,0,129,63,66,62,33,57,0,57,74,0,74
07/03/2022 16:00,29,15,14,44,18,26,55,21,34,0,0,0,2,2,0,21,21,0,0,0,0,183,111,72,142,42,111,1,110,74,0,74
07/03/2022 17:00,39,15,24,72,22,50,93,26,67,0,0,0,8,8,0,27,27,0,0,0,0,363,243,120,211,34,187,0,187,92,0,92
07/03/2022 18:00,24,6,18,66,17,49,87,29,58,0,0,0,8,8,0,17,17,0,0,0,0,268,155,113,175,42,165,0,165,114,0,114
07/03/2022 19:00,18,7,11,28,10,18,38,12,26,0,0,0,4,4,0,10,10,0,0,0,0,177,99,78,98,28,115,0,115,95,0,95
07/03/2022 20:00,7,3,4,18,8,10,24,10,14,0,0,0,1,1,0,9,9,0,0,0,0,91,55,36,48,20,96,0,96,70,0,70
07/03/2022 21:00,7,3,4,6,5,1,5,2,3,0,0,0,0,0,0,4,4,0,0,0,0,75,51,24,49,16,77,0,77,48,0,48
07/03/2022 22:00,5,3,2,3,1,2,1,0,1,0,0,0,3,3,0,4,4,0,0,0,0,39,22,17,31,8,32,1,31,23,0,23
07/03/2022 23:00,2,1,1,3,2,1,3,1,2,0,0,0,0,0,0,2,2,0,0,0,0,24,16,8,16,8,19,0,19,14,0,14
08/03/2022 00:00,0,0,0,0,0,0,0,0,0,0,0,0,0,0,0,0,0,0,0,0,0,14,12,2,9,4,14,1,13,2,0,2
08/03/2022 01:00,0,0,0,0,0,0,0,0,0,0,0,0,1,1,0,0,0,0,0,0,0,4,4,0,7,0,2,0,2,0,0,0
08/03/2022 02:00,0,0,0,0,0,0,0,0,0,0,0,0,0,0,0,0,0,0,0,0,0,4,4,0,5,0,5,0,5,1,0,1
08/03/2022 03:00,1,0,1,0,0,0,0,0,0,0,0,0,0,0,0,0,0,0,0,0,0,2,2,0,1,1,3,0,3,2,1,1
08/03/2022 04:00,1,1,0,2,1,1,1,0,1,0,0,0,1,1,0,0,0,0,0,0,0,3,1,2,2,3,1,0,1,1,0,1
08/03/2022 05:00,1,1,0,5,4,1,6,5,1,0,0,0,2,2,0,1,1,0,0,0,0,22,4,18,6,18,0,0,0,6,0,6
08/03/2022 06:00,20,19,1,7,7,0,8,6,2,0,0,0,4,4,0,6,6,0,0,0,0,107,19,88,12,60,9,1,8,35,0,35
08/03/2022 07:00,27,22,5,16,13,3,21,16,5,0,0,0,7,7,0,11,11,0,0,0,0,253,64,189,21,104,23,0,23,52,0,52
08/03/2022 08:00,58,49,9,23,18,5,33,23,10,0,0,0,38,37,1,29,29,0,0,0,0,417,82,335,30,219,50,0,50,132,0,132
08/03/2022 09:00,31,25,6,12,10,2,14,13,1,0,0,0,19,19,0,5,5,0,1,1,0,183,36,147,17,90,29,2,27,107,0,107
08/03/2022 10:00,14,8,6,10,5,5,9,4,5,0,0,0,0,0,0,3,3,0,3,3,0,57,11,46,20,40,9,0,9,56,0,56
08/03/2022 11:00,9,6,3,7,2,5,9,4,5,0,0,0,1,1,0,4,4,0,0,0,0,60,19,41,13,23,27,0,27,37,0,37
08/03/2022 12:00,11,4,7,2,1,1,5,1,4,0,0,0,0,0,0,8,8,0,0,0,0,84,34,50,25,26,44,0,44,37,0,37
08/03/2022 13:00,15,8,7,11,4,7,4,1,3,0,0,0,1,1,0,13,13,0,0,0,0,102,54,48,42,26,67,0,67,71,1,70
08/03/2022 14:00,19,9,10,8,2,6,11,2,9,0,0,0,3,3,0,11,11,0,0,0,0,106,49,57,50,22,49,0,49,50,0,50
08/03/2022 15:00,9,5,4,17,5,12,19,6,13,0,0,0,1,1,0,15,15,0,0,0,0,129,74,55,67,35,67,0,67,72,1,71
08/03/2022 16:00,27,15,12,21,10,11,24,11,13,0,0,0,0,0,0,23,23,0,1,1,0,161,104,57,119,37,85,0,85,56,0,56
08/03/2022 17:00,35,14,21,40,9,31,66,13,53,0,0,0,0,0,0,27,27,0,0,0,0,329,214,115,166,43,184,0,184,90,0,90
08/03/2022 18:00,27,10,17,51,16,35,68,17,51,0,0,0,1,1,0,18,18,0,2,2,0,253,160,93,150,40,189,1,188,81,0,81
08/03/2022 19:00,12,4,8,21,5,16,29,10,19,0,0,0,0,0,0,9,9,0,2,2,0,182,103,79,102,37,124,0,124,83,0,83
08/03/2022 20:00,11,6,5,16,6,10,20,5,15,0,0,0,0,0,0,7,7,0,3,3,0,117,70,47,55,31,102,0,102,97,0,97
08/03/2022 21:00,6,3,3,12,6,6,14,5,9,0,0,0,0,0,0,5,5,0,1,1,0,60,40,20,58,24,70,0,70,67,0,67
08/03/2022 22:00,8,4,4,4,1,3,11,3,8,0,0,0,1,1,0,3,3,0,0,0,0,54,36,18,30,16,51,0,51,29,0,29
08/03/2022 23:00,0,0,0,1,0,1,3,2,1,0,0,0,0,0,0,0,0,0,0,0,0,25,16,9,14,3,32,1,31,17,0,17
09/03/2022 00:00,1,0,1,2,0,2,3,0,3,0,0,0,0,0,0,1,1,0,0,0,0,18,14,4,8,5,24,0,24,5,0,5
09/03/2022 01:00,0,0,0,0,0,0,0,0,0,0,0,0,0,0,0,1,1,0,0,0,0,7,5,2,6,1,2,0,2,0,0,0
09/03/2022 02:00,0,0,0,0,0,0,2,0,2,0,0,0,0,0,0,0,0,0,0,0,0,4,4,0,4,0,5,0,5,2,0,2
09/03/2022 03:00,1,0,1,0,0,0,0,0,0,0,0,0,0,0,0,0,0,0,0,0,0,4,2,2,1,1,1,0,1,0,0,0
09/03/2022 04:00,1,1,0,4,2,2,2,1,1,0,0,0,1,1,0,0,0,0,0,0,0,3,0,3,3,4,1,0,1,0,0,0
09/03/2022 05:00,2,0,2,3,3,0,5,3,2,0,0,0,5,5,0,1,1,0,0,0,0,22,2,20,5,16,6,0,6,6,0,6
09/03/2022 06:00,15,15,0,10,6,4,9,3,6,0,0,0,4,4,0,7,7,0,0,0,0,98,19,79,11,66,12,0,12,30,0,30
09/03/2022 07:00,26,23,3,30,22,8,30,21,9,0,0,0,10,10,0,10,10,0,0,0,0,237,56,181,18,108,20,0,20,60,0,60
09/03/2022 08:00,68,60,8,30,22,8,36,26,10,0,0,0,25,25,0,18,18,0,10,10,0,387,77,310,31,180,47,1,46,132,0,132
09/03/2022 09:00,22,17,5,19,15,4,16,10,6,0,0,0,10,10,0,7,7,0,5,5,0,184,36,148,18,70,43,0,43,94,0,94
09/03/2022 10:00,13,9,4,16,10,6,14,5,9,0,0,0,8,8,0,7,7,0,1,1,0,51,15,36,16,35,27,2,25,54,0,54
09/03/2022 11:00,8,4,4,7,3,4,9,4,5,0,0,0,6,6,0,3,3,0,3,3,0,67,25,42,18,39,26,0,26,31,0,31
09/03/2022 12:00,7,6,1,6,2,4,5,1,4,0,0,0,6,6,0,3,3,0,0,0,0,54,26,28,18,12,52,1,51,31,0,31
09/03/2022 13:00,13,11,2,8,6,2,4,4,0,0,0,0,0,0,0,18,18,0,1,1,0,43,35,8,23,17,39,1,38,29,0,29
09/03/2022 14:00,9,5,4,2,1,1,9,2,7,0,0,0,1,1,0,3,3,0,5,5,0,56,37,19,34,17,35,0,35,45,0,45
09/03/2022 15:00,12,6,6,6,2,4,7,0,7,0,0,0,1,1,0,18,18,0,1,1,0,92,49,43,52,9,47,0,47,49,0,49
09/03/2022 16:00,19,11,8,11,3,8,21,3,18,0,0,0,1,1,0,15,15,0,3,3,0,161,83,78,81,24,84,0,84,59,0,59
09/03/2022 17:00,33,5,28,28,4,24,50,6,44,0,0,0,1,1,0,20,20,0,0,0,0,245,167,78,126,12,134,0,134,52,0,52
09/03/2022 18:00,19,6,13,20,3,17,29,1,28,0,0,0,0,0,0,11,11,0,0,0,0,194,135,59,109,16,122,0,122,62,2,60
09/03/2022 19:00,18,8,10,13,3,10,12,3,9,0,0,0,0,0,0,2,2,0,4,4,0,136,82,54,50,10,85,1,84,43,0,43
09/03/2022 20:00,3,3,0,8,3,5,10,4,6,0,0,0,2,2,0,6,6,0,2,2,0,95,51,44,31,12,64,1,63,57,0,57
09/03/2022 21:00,3,1,2,6,1,5,11,2,9,0,0,0,0,0,0,3,3,0,2,2,0,60,40,20,22,6,42,0,42,39,0,39
09/03/2022 22:00,5,2,3,2,1,1,3,1,2,0,0,0,0,0,0,0,0,0,5,5,0,53,30,23,15,7,38,0,38,15,0,15
09/03/2022 23:00,0,0,0,0,0,0,0,0,0,0,0,0,0,0,0,4,4,0,0,0,0,22,18,4,19,3,16,0,16,10,0,10
10/03/2022 00:00,2,2,0,0,0,0,0,0,0,0,0,0,0,0,0,0,0,0,0,0,0,16,10,6,7,0,13,0,13,7,0,7
10/03/2022 01:00,0,0,0,1,1,0,0,0,0,0,0,0,0,0,0,1,1,0,0,0,0,3,2,1,1,1,3,0,3,0,0,0
10/03/2022 02:00,0,0,0,0,0,0,1,0,1,0,0,0,1,1,0,0,0,0,0,0,0,0,0,0,2,0,3,0,3,2,0,2
10/03/2022 03:00,0,0,0,1,0,1,0,0,0,0,0,0,0,0,0,0,0,0,0,0,0,1,1,0,2,0,3,0,3,1,0,1
10/03/2022 04:00,1,1,0,6,2,4,5,3,2,0,0,0,0,0,0,1,1,0,1,1,0,3,1,2,1,2,1,0,1,0,0,0
10/03/2022 05:00,0,0,0,6,3,3,6,3,3,0,0,0,3,3,0,0,0,0,0,0,0,22,4,18,3,16,2,0,2,6,0,6
10/03/2022 06:00,17,17,0,7,4,3,8,5,3,0,0,0,3,3,0,8,8,0,1,1,0,102,20,82,15,56,10,0,10,34,0,34
10/03/2022 07:00,29,23,6,47,32,15,54,41,13,0,0,0,12,11,1,14,14,0,1,1,0,213,57,156,27,119,25,0,25,56,1,55
10/03/2022 08:00,83,74,9,70,55,15,92,72,20,0,0,0,32,32,0,34,34,0,37,37,0,427,70,357,41,247,39,1,38,166,2,164
10/03/2022 09:00,31,25,6,56,26,30,58,33,25,0,0,0,29,29,0,7,7,0,5,5,0,185,48,137,23,113,37,1,36,107,1,106
10/03/2022 10:00,21,12,9,51,26,25,55,24,31,0,0,0,8,8,0,8,8,0,7,7,0,88,32,56,19,46,23,0,23,70,0,70
10/03/2022 11:00,13,9,4,84,43,41,87,43,44,0,0,0,17,17,0,12,12,0,9,9,0,89,21,68,31,42,22,0,22,62,0,62
10/03/2022 12:00,19,12,7,80,27,53,84,37,47,0,0,0,15,15,0,10,10,0,10,10,0,127,54,73,42,41,38,0,38,105,0,105
10/03/2022 13:00,19,10,9,63,29,34,75,34,41,0,0,0,8,8,0,12,12,0,1,1,0,121,34,87,58,57,81,1,80,103,1,102
10/03/2022 14:00,21,8,13,65,32,33,87,43,44,0,0,0,7,7,0,11,11,0,7,7,0,141,60,81,61,27,78,1,77,78,1,77
10/03/2022 15:00,27,15,12,65,30,35,73,32,41,0,0,0,5,5,0,30,30,0,12,12,0,144,73,71,74,36,59,0,59,72,1,71
10/03/2022 16:00,27,14,13,40,19,21,49,19,30,0,0,0,7,7,0,19,19,0,15,15,0,185,105,80,135,54,117,1,116,72,0,72
10/03/2022 17:00,50,14,36,61,22,39,85,24,61,0,0,0,2,2,0,30,30,0,23,23,0,317,202,115,216,42,157,3,154,124,2,122
10/03/2022 18:00,27,14,13,62,17,45,88,26,62,0,0,0,5,5,0,28,28,0,12,12,0,281,181,100,150,38,154,3,151,116,1,115
10/03/2022 19:00,21,8,13,43,13,30,43,13,30,0,0,0,3,3,0,10,10,0,14,14,0,206,104,102,100,36,142,1,141,109,0,109
10/03/2022 20:00,14,4,10,22,9,13,19,6,13,0,0,0,3,3,0,9,9,0,4,4,0,122,74,48,67,30,126,2,124,95,0,95
10/03/2022 21:00,10,0,10,6,2,4,10,2,8,0,0,0,1,1,0,14,14,0,1,1,0,71,45,26,61,24,94,0,94,63,1,62
10/03/2022 22:00,5,2,3,3,0,3,11,0,11,0,0,0,3,3,0,6,6,0,0,0,0,71,48,23,42,17,58,0,58,15,0,15
10/03/2022 23:00,3,1,2,3,0,3,4,1,3,0,0,0,1,1,0,5,5,0,1,1,0,50,35,15,29,7,48,0,48,13,0,13
11/03/2022 00:00,1,1,0,1,0,1,2,1,1,0,0,0,0,0,0,2,2,0,1,1,0,21,20,1,17,4,23,0,23,7,0,7
11/03/2022 01:00,0,0,0,0,0,0,0,0,0,0,0,0,1,1,0,2,2,0,0,0,0,8,6,2,7,1,3,0,3,0,0,0
11/03/2022 02:00,0,0,0,1,0,1,2,0,2,0,0,0,0,0,0,0,0,0,1,1,0,3,3,0,6,1,6,0,6,1,0,1
11/03/2022 03:00,0,0,0,0,0,0,0,0,0,0,0,0,0,0,0,0,0,0,0,0,0,3,1,2,9,1,4,0,4,1,0,1
11/03/2022 04:00,0,0,0,3,2,1,4,3,1,0,0,0,0,0,0,0,0,0,0,0,0,5,2,3,3,4,1,0,1,2,0,2
11/03/2022 05:00,0,0,0,5,4,1,6,4,2,0,0,0,1,1,0,1,1,0,3,3,0,18,1,17,5,19,6,0,6,7,0,7
11/03/2022 06:00,13,12,1,7,5,2,9,7,2,0,0,0,7,7,0,6,6,0,5,5,0,86,13,73,14,64,14,0,14,28,0,28
11/03/2022 07:00,16,14,2,35,26,9,39,29,10,0,0,0,14,14,0,6,6,0,7,7,0,183,49,134,21,84,22,0,22,42,0,42
11/03/2022 08:00,53,42,11,29,22,7,36,27,9,0,0,0,22,22,0,18,18,0,26,26,0,270,68,202,24,120,39,0,39,92,0,92
11/03/2022 09:00,20,15,5,5,2,3,6,4,2,0,0,0,1,1,0,3,3,0,0,0,0,133,32,101,18,62,18,0,18,68,0,68
11/03/2022 10:00,10,5,5,3,2,1,3,3,0,0,0,0,0,0,0,3,3,0,1,1,0,56,14,42,12,36,21,1,20,27,0,27
11/03/2022 11:00,6,2,4,3,3,0,5,3,2,0,0,0,2,2,0,2,2,0,0,0,0,74,21,53,14,23,25,1,24,40,0,40
11/03/2022 12:00,4,2,2,3,0,3,7,1,6,0,0,0,3,3,0,6,6,0,0,0,0,66,28,38,39,27,42,0,42,56,1,55
11/03/2022 13:00,16,8,8,4,3,1,6,2,4,0,0,0,2,2,0,14,14,0,0,0,0,118,50,68,45,33,63,0,63,81,0,81
11/03/2022 14:00,17,10,7,19,6,13,24,5,19,0,0,0,5,4,1,9,9,0,0,0,0,118,58,60,68,25,44,0,44,86,0,86
11/03/2022 15:00,22,11,11,39,19,20,42,13,29,0,0,0,4,4,0,16,16,0,1,1,0,128,80,48,72,39,52,0,52,83,1,82
11/03/2022 16:00,16,9,7,52,21,31,62,20,42,0,0,0,4,4,0,8,8,0,0,0,0,164,92,72,92,38,109,1,108,73,0,73
11/03/2022 17:00,35,10,25,31,11,20,53,16,37,0,0,0,2,2,0,15,15,0,0,0,0,218,128,90,145,43,130,3,127,98,0,98
11/03/2022 18:00,19,9,10,34,8,26,48,11,37,0,0,0,6,6,0,11,11,0,1,1,0,202,110,92,117,56,164,0,164,131,0,131
11/03/2022 19:00,11,2,9,15,6,9,25,6,19,0,0,0,4,4,0,9,9,0,0,0,0,111,70,41,74,30,117,0,117,81,1,80
11/03/2022 20:00,13,7,6,9,4,5,7,2,5,0,0,0,3,3,0,7,7,0,0,0,0,97,58,39,54,33,96,0,96,82,0,82
11/03/2022 21:00,6,2,4,11,5,6,17,5,12,0,0,0,1,1,0,2,2,0,0,0,0,66,42,24,40,34,60,1,59,75,0,75
11/03/2022 22:00,5,4,1,2,1,1,11,4,7,0,0,0,1,1,0,3,3,0,0,0,0,48,24,24,38,8,48,0,48,38,1,37
11/03/2022 23:00,4,1,3,6,3,3,5,2,3,0,0,0,1,1,0,3,3,0,1,1,0,39,26,13,13,10,42,0,42,21,1,20
12/03/2022 00:00,1,0,1,0,0,0,2,0,2,0,0,0,1,1,0,2,2,0,0,0,0,30,21,9,19,4,42,0,42,12,1,11
12/03/2022 01:00,0,0,0,2,2,0,2,1,1,0,0,0,1,1,0,2,2,0,0,0,0,13,7,6,17,6,4,0,4,1,0,1
12/03/2022 02:00,0,0,0,0,0,0,3,1,2,0,0,0,0,0,0,0,0,0,1,1,0,17,14,3,11,0,18,0,18,3,0,3
12/03/2022 03:00,2,0,2,0,0,0,0,0,0,0,0,0,1,1,0,0,0,0,0,0,0,10,6,4,7,2,13,0,13,3,0,3
12/03/2022 04:00,0,0,0,0,0,0,1,1,0,0,0,0,0,0,0,0,0,0,0,0,0,4,3,1,5,1,6,0,6,2,0,2
12/03/2022 05:00,3,1,2,1,0,1,1,0,1,0,0,0,0,0,0,0,0,0,0,0,0,9,1,8,2,1,8,0,8,4,0,4
12/03/2022 06:00,5,5,0,6,3,3,7,1,6,0,0,0,2,2,0,0,0,0,1,1,0,33,9,24,5,12,7,0,7,9,0,9
12/03/2022 07:00,5,3,2,32,12,20,35,10,25,0,0,0,2,2,0,4,4,0,2,2,0,40,13,27,12,26,11,0,11,23,0,23
12/03/2022 08:00,6,5,1,73,29,44,90,38,52,0,0,0,5,5,0,8,8,0,5,5,0,68,22,46,13,34,20,1,19,19,0,19
12/03/2022 09:00,12,9,3,113,45,68,115,37,78,0,0,0,5,5,0,11,11,0,2,2,0,82,30,52,22,40,17,1,16,74,2,72
12/03/2022 10:00,16,9,7,157,79,78,151,68,83,0,0,0,7,7,0,4,4,0,7,7,0,83,25,58,22,39,32,1,31,61,0,61
12/03/2022 11:00,17,9,8,167,87,80,175,84,91,0,0,0,11,11,0,13,13,0,6,6,0,88,37,51,41,50,54,0,54,65,1,64
12/03/2022 12:00,18,11,7,175,99,76,217,108,109,0,0,0,8,8,0,9,9,0,12,12,0,142,59,83,61,50,64,0,64,110,2,108
12/03/2022 13:00,16,11,5,119,64,55,148,71,77,0,0,0,6,6,0,9,9,0,14,14,0,102,38,64,74,57,100,0,100,117,0,117
12/03/2022 14:00,15,7,8,91,48,43,96,49,47,0,0,0,3,3,0,7,7,0,10,10,0,132,65,67,65,62,109,1,108,108,0,108
12/03/2022 15:00,12,4,8,46,30,16,53,36,17,0,0,0,10,10,0,9,9,0,0,0,0,119,42,77,45,56,84,1,83,81,0,81
12/03/2022 16:00,7,5,2,11,8,3,22,8,14,0,0,0,3,3,0,2,2,0,0,0,0,88,49,39,38,31,79,1,78,41,2,39
12/03/2022 17:00,2,2,0,4,3,1,7,4,3,0,0,0,6,6,0,2,2,0,0,0,0,70,30,40,45,20,78,0,78,50,0,50
12/03/2022 18:00,7,3,4,3,2,1,2,1,1,0,0,0,0,0,0,2,2,0,0,0,0,57,29,28,44,14,70,0,70,45,0,45
12/03/2022 19:00,4,0,4,1,1,0,1,0,1,0,0,0,1,1,0,3,3,0,0,0,0,55,30,25,18,11,52,0,52,41,0,41
12/03/2022 20:00,3,1,2,1,1,0,1,0,1,0,0,0,0,0,0,3,3,0,0,0,0,51,28,23,14,7,44,0,44,36,0,36
12/03/2022 21:00,6,2,4,0,0,0,1,0,1,0,0,0,0,0,0,0,0,0,0,0,0,32,19,13,20,12,41,2,39,30,1,29
12/03/2022 22:00,7,4,3,0,0,0,0,0,0,0,0,0,0,0,0,0,0,0,0,0,0,24,18,6,24,9,25,1,24,28,0,28
12/03/2022 23:00,2,0,2,2,0,2,2,0,2,0,0,0,0,0,0,2,2,0,0,0,0,22,14,8,16,1,15,0,15,13,0,13
13/03/2022 00:00,2,1,1,0,0,0,2,0,2,0,0,0,0,0,0,1,1,0,0,0,0,15,10,5,14,4,12,0,12,7,0,7
13/03/2022 01:00,3,3,0,1,1,0,0,0,0,0,0,0,1,1,0,0,0,0,0,0,0,10,6,4,10,2,5,0,5,0,0,0
13/03/2022 02:00,3,0,3,0,0,0,0,0,0,0,0,0,0,0,0,0,0,0,0,0,0,11,9,2,4,1,10,0,10,2,0,2
13/03/2022 03:00,0,0,0,0,0,0,0,0,0,0,0,0,0,0,0,0,0,0,0,0,0,6,5,1,4,0,7,0,7,1,0,1
13/03/2022 04:00,0,0,0,0,0,0,0,0,0,0,0,0,0,0,0,0,0,0,0,0,0,1,1,0,6,1,3,0,3,0,0,0
13/03/2022 05:00,1,1,0,0,0,0,0,0,0,0,0,0,0,0,0,0,0,0,0,0,0,3,1,2,1,1,3,0,3,1,0,1
13/03/2022 06:00,2,1,1,1,0,1,1,0,1,0,0,0,1,1,0,2,2,0,0,0,0,11,2,9,3,5,2,0,2,5,0,5
13/03/2022 07:00,4,4,0,0,0,0,1,0,1,0,0,0,0,0,0,0,0,0,0,0,0,21,8,13,13,8,5,0,5,4,0,4
13/03/2022 08:00,3,2,1,19,8,11,23,5,18,0,0,0,4,4,0,1,1,0,1,1,0,31,14,17,4,8,10,0,10,7,0,7
13/03/2022 09:00,8,5,3,41,18,23,48,19,29,0,0,0,2,2,0,3,3,0,2,2,0,39,6,33,16,25,1,0,1,18,0,18
13/03/2022 10:00,12,8,4,38,11,27,63,26,37,0,0,0,2,2,0,4,4,0,5,5,0,63,22,41,14,22,0,0,0,43,0,43
13/03/2022 11:00,9,8,1,87,32,55,83,29,54,0,0,0,4,4,0,11,11,0,10,10,0,75,20,55,27,32,20,1,19,61,0,61
13/03/2022 12:00,16,14,2,86,38,48,109,51,58,0,0,0,1,1,0,5,5,0,12,12,0,92,39,53,28,21,55,0,55,83,0,83
13/03/2022 13:00,14,12,2,66,30,36,95,40,55,0,0,0,0,0,0,11,11,0,12,12,0,112,42,70,61,40,67,0,67,91,1,90
13/03/2022 14:00,21,13,8,87,45,42,97,45,52,0,0,0,1,1,0,11,11,0,7,7,0,102,35,67,49,56,72,0,72,83,0,83
13/03/2022 15:00,19,11,8,97,46,51,96,44,52,0,0,0,3,3,0,5,5,0,4,4,0,96,37,59,52,41,71,0,71,99,2,97
13/03/2022 16:00,11,7,4,75,46,29,104,57,47,0,0,0,2,2,0,4,4,0,0,0,0,85,39,46,46,35,73,2,71,81,1,80
13/03/2022 17:00,8,5,3,66,30,36,75,41,34,0,0,0,4,4,0,8,8,0,0,0,0,90,45,45,40,53,86,1,85,68,1,67
13/03/2022 18:00,11,4,7,39,26,13,52,32,20,0,0,0,2,2,0,5,5,0,0,0,0,95,55,40,45,46,102,0,102,69,2,67
13/03/2022 19:00,10,6,4,13,6,7,20,11,9,0,0,0,1,1,0,4,4,0,0,0,0,88,53,35,48,20,83,2,81,78,0,78
13/03/2022 20:00,9,5,4,11,6,5,11,2,9,0,0,0,1,1,0,1,1,0,1,1,0,72,41,31,51,23,69,0,69,81,0,81
13/03/2022 21:00,5,2,3,5,2,3,4,2,2,0,0,0,0,0,0,1,1,0,1,1,0,50,27,23,26,21,53,0,53,49,0,49
13/03/2022 22:00,6,2,4,3,1,2,3,1,2,0,0,0,0,0,0,1,1,0,0,0,0,32,19,13,32,11,31,0,31,33,1,32
13/03/2022 23:00,4,2,2,0,0,0,1,0,1,0,0,0,0,0,0,5,5,0,0,0,0,25,19,6,19,4,23,0,23,13,0,13
14/03/2022 00:00,1,1,0,2,1,1,2,1,1,0,0,0,0,0,0,1,1,0,0,0,0,9,7,2,10,3,10,0,10,10,0,10
14/03/2022 01:00,0,0,0,1,1,0,0,0,0,0,0,0,1,1,0,0,0,0,1,1,0,5,3,2,4,1,2,0,2,0,0,0
14/03/2022 02:00,0,0,0,0,0,0,0,0,0,0,0,0,0,0,0,0,0,0,0,0,0,1,0,1,6,0,1,0,1,0,0,0
14/03/2022 03:00,0,0,0,0,0,0,1,0,1,0,0,0,0,0,0,0,0,0,0,0,0,1,0,1,1,1,2,0,2,1,0,1
14/03/2022 04:00,2,1,1,1,0,1,2,1,1,0,0,0,0,0,0,0,0,0,1,1,0,4,0,4,0,5,1,0,1,1,0,1
14/03/2022 05:00,0,0,0,3,3,0,8,4,4,0,0,0,3,3,0,1,1,0,0,0,0,26,2,24,3,13,1,0,1,5,0,5
14/03/2022 06:00,22,18,4,13,9,4,15,11,4,0,0,0,12,12,0,6,6,0,0,0,0,119,20,99,14,58,11,0,11,33,0,33
14/03/2022 07:00,28,20,8,51,39,12,58,39,19,0,0,0,22,22,0,19,19,0,2,2,0,258,55,203,19,124,19,0,19,57,0,57
14/03/2022 08:00,55,51,4,47,34,13,70,54,16,0,0,0,37,36,1,19,19,0,4,4,0,388,98,290,29,190,47,0,47,134,0,134
14/03/2022 09:00,18,16,2,14,6,8,21,11,10,0,0,0,11,11,0,5,5,0,2,2,0,151,34,117,14,63,27,0,27,80,0,80
14/03/2022 10:00,7,5,2,11,8,3,14,7,7,0,0,0,5,5,0,6,6,0,4,4,0,60,15,45,8,30,15,0,15,37,0,37
14/03/2022 11:00,8,3,5,27,9,18,26,6,20,0,0,0,5,5,0,2,2,0,2,2,0,82,23,59,13,27,19,0,19,74,0,74
14/03/2022 12:00,10,6,4,25,9,16,28,11,17,0,0,0,0,0,0,2,2,0,3,3,0,95,28,67,41,36,64,1,63,77,0,77
14/03/2022 13:00,15,4,11,30,12,18,31,13,18,0,0,0,4,4,0,6,6,0,2,2,0,93,44,49,43,47,70,0,70,103,0,103
14/03/2022 14:00,10,4,6,37,12,25,41,16,25,0,0,0,6,6,0,10,10,0,6,6,0,131,68,63,49,34,70,0,70,68,0,68
14/03/2022 15:00,17,7,10,58,22,36,62,24,38,0,0,0,3,3,0,22,22,0,10,10,0,142,79,63,78,42,65,0,65,73,0,73
14/03/2022 16:00,20,13,7,76,35,41,81,38,43,0,0,0,0,0,0,27,27,0,9,9,0,208,132,76,117,41,85,1,84,63,1,62
14/03/2022 17:00,50,18,32,76,22,54,96,29,67,0,0,0,5,5,0,28,28,0,13,13,0,309,184,125,194,60,178,1,177,89,1,88
14/03/2022 18:00,23,12,11,77,28,49,98,32,66,0,0,0,0,0,0,17,17,0,5,5,0,259,159,100,160,32,202,0,202,77,1,76
14/03/2022 19:00,18,4,14,34,13,21,37,14,23,0,0,0,1,1,0,7,7,0,3,3,0,167,94,73,61,16,147,2,145,82,0,82
14/03/2022 20:00,7,3,4,28,12,16,25,11,14,0,0,0,2,2,0,11,11,0,3,3,0,99,62,37,52,19,103,1,102,57,1,56
14/03/2022 21:00,8,4,4,13,7,6,17,7,10,0,0,0,3,3,0,11,11,0,7,7,0,70,45,25,49,16,83,2,81,46,0,46
14/03/2022 22:00,4,3,1,5,2,3,7,1,6,0,0,0,1,1,0,2,2,0,3,3,0,45,32,13,39,12,48,0,48,20,0,20
14/03/2022 23:00,2,1,1,3,2,1,1,0,1,0,0,0,1,1,0,1,1,0,0,0,0,23,13,10,19,4,21,0,21,16,0,16
15/03/2022 00:00,1,0,1,1,0,1,3,1,2,0,0,0,0,0,0,0,0,0,0,0,0,10,8,2,11,5,11,0,11,5,0,5
15/03/2022 01:00,2,1,1,0,0,0,0,0,0,0,0,0,0,0,0,1,1,0,0,0,0,5,5,0,7,0,1,0,1,0,0,0
15/03/2022 02:00,1,0,1,0,0,0,0,0,0,0,0,0,0,0,0,0,0,0,0,0,0,1,1,0,2,0,3,0,3,3,0,3
15/03/2022 03:00,2,0,2,0,0,0,0,0,0,0,0,0,0,0,0,0,0,0,0,0,0,4,0,4,1,1,1,0,1,0,0,0
15/03/2022 04:00,1,1,0,2,2,0,2,2,0,0,0,0,0,0,0,0,0,0,1,1,0,8,1,7,0,2,1,0,1,2,0,2
15/03/2022 05:00,0,0,0,4,4,0,8,3,5,0,0,0,7,7,0,1,1,0,1,1,0,25,3,22,3,16,2,0,2,9,0,9
15/03/2022 06:00,16,15,1,14,11,3,19,15,4,0,0,0,13,12,1,4,4,0,2,2,0,112,17,95,15,67,12,0,12,35,0,35
15/03/2022 07:00,32,28,4,65,47,18,88,65,23,0,0,0,14,14,0,19,19,0,9,9,0,265,49,216,34,143,23,0,23,62,0,62
15/03/2022 08:00,84,74,10,67,45,22,90,67,23,0,0,0,25,25,0,22,22,0,45,45,0,447,79,368,35,240,44,0,44,180,0,180
15/03/2022 09:00,24,16,8,59,31,28,59,28,31,0,0,0,19,19,0,15,15,0,8,8,0,215,52,163,25,126,30,1,29,145,0,145
15/03/2022 10:00,10,6,4,43,24,19,55,21,34,0,0,0,11,11,0,8,8,0,6,6,0,78,31,47,26,40,18,0,18,86,0,86
15/03/2022 11:00,8,2,6,44,25,19,50,26,24,0,0,0,7,7,0,5,5,0,3,3,0,92,27,65,33,38,33,0,33,79,0,79
15/03/2022 12:00,10,5,5,60,29,31,70,32,38,0,0,0,8,8,0,9,9,0,10,10,0,121,45,76,39,42,60,0,60,82,1,81
15/03/2022 13:00,14,7,7,46,25,21,55,25,30,0,0,0,2,2,0,11,11,0,9,9,0,136,61,75,58,52,82,0,82,115,2,113
15/03/2022 14:00,14,6,8,45,18,27,54,20,34,0,0,0,5,5,0,11,11,0,8,8,0,108,46,62,66,38,71,0,71,78,0,78
15/03/2022 15:00,18,10,8,54,25,29,66,29,37,0,0,0,1,1,0,32,32,0,11,11,0,140,77,63,77,41,62,0,62,79,1,78
15/03/2022 16:00,26,15,11,54,22,32,60,21,39,0,0,0,3,3,0,26,26,0,4,4,0,216,128,88,145,53,125,0,125,65,0,65
15/03/2022 17:00,51,11,40,91,26,65,113,28,85,0,0,0,4,4,0,26,26,0,4,4,0,339,221,118,203,65,215,1,214,135,0,135
15/03/2022 18:00,31,9,22,81,24,57,120,38,82,0,0,0,3,3,0,32,32,0,5,5,0,288,179,109,153,29,224,3,221,105,0,105
15/03/2022 19:00,11,6,5,43,13,30,53,14,39,0,0,0,5,4,1,14,14,0,9,9,0,183,111,72,94,41,169,1,168,107,1,106
15/03/2022 20:00,6,1,5,25,10,15,32,11,21,0,0,0,5,5,0,8,8,0,3,3,0,124,73,51,55,20,106,0,106,96,0,96
15/03/2022 21:00,8,4,4,6,3,3,14,3,11,0,0,0,4,4,0,8,8,0,5,5,0,67,42,25,50,23,98,1,97,48,0,48
15/03/2022 22:00,5,3,2,10,4,6,11,2,9,0,0,0,3,3,0,4,4,0,3,3,0,67,47,20,45,13,60,0,60,26,0,26
15/03/2022 23:00,5,2,3,0,0,0,2,0,2,0,0,0,2,2,0,1,1,0,2,2,0,22,17,5,21,5,38,0,38,20,0,20
16/03/2022 00:00,2,1,1,0,0,0,2,0,2,0,0,0,0,0,0,0,0,0,2,2,0,17,12,5,16,0,16,0,16,10,0,10
16/03/2022 01:00,0,0,0,3,2,1,0,0,0,0,0,0,0,0,0,0,0,0,0,0,0,8,5,3,5,1,4,0,4,1,0,1
16/03/2022 02:00,0,0,0,0,0,0,2,1,1,0,0,0,0,0,0,0,0,0,0,0,0,5,4,1,6,0,4,0,4,1,0,1
16/03/2022 03:00,1,0,1,0,0,0,1,1,0,0,0,0,0,0,0,0,0,0,0,0,0,3,3,0,1,1,1,0,1,3,1,2
16/03/2022 04:00,0,0,0,3,2,1,3,2,1,0,0,0,1,1,0,0,0,0,1,1,0,4,0,4,2,4,0,0,0,2,0,2
16/03/2022 05:00,1,1,0,4,2,2,6,3,3,0,0,0,4,4,0,0,0,0,0,0,0,24,1,23,5,9,4,0,4,9,0,9
16/03/2022 06:00,22,20,2,15,11,4,18,13,5,0,0,0,9,8,1,6,6,0,4,4,0,106,15,91,15,62,9,0,9,34,0,34
16/03/2022 07:00,35,29,6,55,40,15,62,45,17,0,0,0,22,21,1,13,13,0,4,4,0,238,57,181,25,110,20,1,19,55,0,55
16/03/2022 08:00,72,65,7,59,45,14,72,59,13,0,0,0,37,37,0,23,23,0,15,15,0,405,80,325,27,226,53,0,53,139,2,137
16/03/2022 09:00,22,18,4,40,17,23,48,25,23,0,0,0,16,16,0,1,1,0,3,3,0,201,50,151,16,92,31,0,31,134,0,134
16/03/2022 10:00,8,4,4,40,23,17,42,16,26,0,0,0,10,10,0,14,14,0,7,7,0,88,28,60,21,42,19,2,17,78,0,78
16/03/2022 11:00,12,6,6,58,31,27,49,19,30,0,0,0,7,7,0,8,8,0,3,3,0,116,44,72,18,30,33,0,33,98,0,98
16/03/2022 12:00,13,10,3,62,25,37,73,26,47,0,0,0,19,19,0,5,5,0,7,7,0,132,54,78,51,52,91,0,91,86,0,86
16/03/2022 13:00,16,5,11,49,28,21,55,29,26,0,0,0,13,13,0,19,19,0,9,9,0,163,73,90,53,51,93,1,92,108,0,108
16/03/2022 14:00,20,10,10,39,19,20,52,19,33,0,0,0,10,10,0,15,15,0,11,11,0,121,59,62,49,37,64,0,64,84,0,84
16/03/2022 15:00,21,11,10,54,24,30,76,32,44,0,0,0,5,5,0,18,18,0,19,19,0,134,66,68,96,39,104,0,104,84,0,84
16/03/2022 16:00,37,20,17,69,34,35,87,34,53,0,0,0,8,8,0,25,25,0,12,12,0,203,109,94,121,48,111,1,110,73,1,72
16/03/2022 17:00,34,8,26,94,25,69,128,42,86,0,0,0,12,12,0,19,19,0,19,19,0,292,192,100,173,61,180,1,179,120,0,120
16/03/2022 18:00,29,7,22,78,35,43,96,39,57,0,0,0,9,9,0,10,10,0,11,11,0,277,162,115,142,42,188,0,188,111,1,110
16/03/2022 19:00,19,7,12,41,14,27,51,20,31,0,0,0,6,6,0,10,10,0,9,9,0,180,86,94,97,37,118,1,117,108,1,107
16/03/2022 20:00,14,8,6,21,6,15,32,11,21,0,0,0,3,3,0,10,10,0,0,0,0,153,78,75,47,29,119,0,119,114,0,114
16/03/2022 21:00,16,9,7,11,4,7,18,5,13,0,0,0,3,2,1,7,7,0,1,1,0,97,55,42,56,31,90,1,89,92,1,91
16/03/2022 22:00,8,3,5,6,4,2,15,6,9,0,0,0,2,2,0,6,6,0,3,3,0,64,44,20,35,21,59,1,58,48,0,48
16/03/2022 23:00,4,1,3,8,2,6,8,2,6,0,0,0,8,7,1,0,0,0,2,2,0,42,32,10,31,5,35,0,35,16,0,16
17/03/2022 00:00,1,0,1,0,0,0,1,0,1,0,0,0,0,0,0,1,1,0,0,0,0,35,23,12,28,3,38,0,38,14,0,14
17/03/2022 01:00,0,0,0,3,1,2,1,1,0,0,0,0,1,1,0,2,2,0,0,0,0,15,12,3,12,1,5,0,5,2,0,2
17/03/2022 02:00,0,0,0,0,0,0,0,0,0,0,0,0,0,0,0,0,0,0,0,0,0,12,8,4,11,3,15,0,15,5,0,5
17/03/2022 03:00,1,0,1,2,1,1,2,0,2,0,0,0,1,1,0,0,0,0,0,0,0,10,7,3,13,4,12,0,12,1,0,1
17/03/2022 04:00,0,0,0,2,1,1,1,1,0,0,0,0,0,0,0,0,0,0,0,0,0,7,4,3,10,4,10,0,10,4,0,4
17/03/2022 05:00,1,0,1,4,1,3,4,1,3,0,0,0,1,1,0,0,0,0,2,2,0,5,0,5,3,3,3,0,3,3,0,3
17/03/2022 06:00,3,3,0,6,4,2,7,3,4,0,0,0,5,4,1,2,2,0,1,1,0,38,6,32,10,19,6,0,6,16,0,16
17/03/2022 07:00,3,3,0,12,6,6,27,13,14,0,0,0,9,9,0,5,5,0,6,6,0,48,11,37,10,22,10,0,10,20,0,20
17/03/2022 08:00,6,6,0,47,29,18,45,23,22,0,0,0,6,6,0,5,5,0,4,4,0,64,21,43,11,30,18,0,18,28,0,28
17/03/2022 09:00,7,6,1,50,20,30,70,20,50,0,0,0,4,4,0,7,7,0,1,1,0,82,31,51,11,28,25,0,25,57,0,57
17/03/2022 10:00,11,6,5,83,35,48,113,44,69,0,0,0,4,4,0,7,7,0,7,7,0,72,16,56,21,30,31,0,31,61,1,60
17/03/2022 11:00,10,6,4,135,65,70,124,50,74,0,0,0,4,4,0,8,8,0,2,2,0,135,47,88,23,37,38,0,38,87,0,87
17/03/2022 12:00,20,10,10,88,42,46,120,61,59,0,0,0,8,8,0,12,12,0,1,1,0,108,38,70,30,55,39,0,39,87,0,87
17/03/2022 13:00,17,10,7,76,33,43,105,42,63,0,0,0,8,7,1,8,8,0,0,0,0,95,31,64,39,34,42,0,42,87,4,83
17/03/2022 14:00,22,12,10,76,36,40,80,37,43,0,0,0,1,1,0,7,7,0,2,2,0,116,56,60,42,27,61,0,61,60,1,59
17/03/2022 15:00,14,7,7,68,29,39,92,37,55,0,0,0,4,4,0,8,8,0,5,5,0,115,45,70,36,30,67,0,67,40,4,36
17/03/2022 16:00,12,5,7,50,28,22,78,45,33,0,0,0,0,0,0,6,6,0,3,3,0,94,42,52,34,31,58,0,58,56,3,53
17/03/2022 17:00,14,7,7,62,33,29,76,44,32,0,0,0,3,3,0,7,7,0,4,4,0,98,41,57,39,27,58,0,58,46,1,45
17/03/2022 18:00,10,4,6,41,22,19,52,30,22,0,0,0,4,4,0,10,10,0,7,7,0,95,38,57,32,23,53,1,52,59,0,59
17/03/2022 19:00,3,1,2,23,11,12,23,12,11,0,0,0,6,6,0,8,8,0,8,8,0,86,45,41,31,19,51,1,50,42,0,42
17/03/2022 20:00,8,5,3,6,3,3,16,6,10,0,0,0,3,3,0,2,2,0,6,6,0,57,30,27,40,25,48,0,48,25,0,25
17/03/2022 21:00,7,3,4,10,5,5,12,3,9,0,0,0,2,2,0,3,3,0,3,3,0,32,17,15,20,14,46,1,45,40,0,40
17/03/2022 22:00,4,2,2,5,3,2,8,1,7,0,0,0,5,5,0,6,6,0,0,0,0,49,29,20,30,11,35,0,35,23,0,23
17/03/2022 23:00,1,1,0,3,2,1,4,3,1,0,0,0,2,2,0,4,4,0,1,1,0,25,15,10,31,3,25,0,25,21,1,20
18/03/2022 00:00,1,0,1,5,3,2,4,1,3,0,0,0,0,0,0,2,2,0,0,0,0,21,12,9,18,5,14,1,13,6,0,6
18/03/2022 01:00,0,0,0,4,4,0,0,0,0,0,0,0,0,0,0,1,1,0,2,2,0,13,7,6,11,4,5,0,5,2,0,2
18/03/2022 02:00,0,0,0,0,0,0,1,0,1,0,0,0,0,0,0,0,0,0,0,0,0,10,6,4,10,1,14,1,13,4,0,4
18/03/2022 03:00,1,0,1,2,1,1,2,1,1,0,0,0,0,0,0,0,0,0,0,0,0,5,3,2,18,4,13,0,13,1,0,1
18/03/2022 04:00,0,0,0,1,1,0,0,0,0,0,0,0,3,3,0,0,0,0,0,0,0,11,6,5,4,4,11,0,11,3,0,3
18/03/2022 05:00,1,0,1,1,1,0,2,1,1,0,0,0,1,1,0,0,0,0,0,0,0,8,1,7,3,2,4,0,4,4,0,4
18/03/2022 06:00,3,3,0,6,3,3,4,2,2,0,0,0,8,8,0,3,3,0,0,0,0,31,10,21,6,14,7,0,7,12,0,12
18/03/2022 07:00,5,5,0,28,15,13,29,14,15,0,0,0,5,5,0,2,2,0,0,0,0,37,5,32,17,22,10,0,10,19,0,19
18/03/2022 08:00,4,3,1,71,32,39,83,37,46,0,0,0,7,7,0,4,4,0,0,0,0,56,12,44,15,21,6,0,6,25,0,25
18/03/2022 09:00,9,7,2,102,46,56,114,39,75,0,0,0,7,7,0,7,7,0,2,2,0,54,15,39,24,33,16,0,16,42,0,42
18/03/2022 10:00,10,8,2,161,63,98,184,60,124,0,0,0,7,7,0,16,16,0,19,19,0,71,23,48,18,29,14,1,13,62,0,62
18/03/2022 11:00,17,11,6,191,93,98,271,98,173,0,0,0,3,3,0,9,9,0,22,22,0,80,39,41,36,63,40,0,40,66,1,65
18/03/2022 12:00,12,6,6,139,71,68,179,61,118,0,0,0,2,2,0,14,14,0,20,20,0,100,45,55,50,43,39,0,39,83,1,82
18/03/2022 13:00,18,10,8,144,68,76,170,76,94,0,0,0,7,7,0,22,22,0,17,17,0,138,61,77,44,44,82,0,82,97,0,97
18/03/2022 14:00,28,15,13,117,50,67,192,84,108,0,0,0,6,6,0,20,20,0,18,18,0,109,38,71,58,44,82,0,82,97,0,97
18/03/2022 15:00,13,8,5,137,71,66,144,73,71,0,0,0,4,4,0,13,13,0,7,7,0,113,43,70,45,61,65,0,65,106,0,106
18/03/2022 16:00,22,17,5,136,77,59,182,101,81,0,0,0,3,3,0,10,10,0,1,1,0,120,54,66,54,56,85,0,85,68,0,68
18/03/2022 17:00,11,4,7,107,58,49,147,81,66,0,0,0,7,7,0,14,14,0,0,0,0,129,68,61,74,59,109,1,108,115,0,115
18/03/2022 18:00,17,9,8,51,29,22,84,40,44,0,0,0,1,1,0,6,6,0,0,0,0,112,56,56,76,54,110,2,108,105,0,105
18/03/2022 19:00,8,7,1,23,13,10,49,30,19,0,0,0,3,3,0,8,8,0,0,0,0,116,63,53,58,53,115,1,114,95,0,95
18/03/2022 20:00,10,9,1,11,5,6,11,4,7,0,0,0,8,8,0,8,8,0,1,1,0,68,35,33,45,32,88,0,88,88,2,86
18/03/2022 21:00,3,1,2,8,4,4,16,7,9,0,0,0,6,6,0,6,6,0,0,0,0,48,28,20,29,27,62,2,60,63,1,62
18/03/2022 22:00,14,10,4,2,2,0,12,6,6,0,0,0,5,5,0,1,1,0,0,0,0,52,32,20,29,9,38,0,38,41,1,40
18/03/2022 23:00,1,0,1,4,1,3,5,0,5,0,0,0,1,1,0,0,0,0,0,0,0,32,21,11,23,6,34,1,33,27,0,27
19/03/2022 00:00,1,0,1,0,0,0,0,0,0,0,0,0,0,0,0,2,2,0,0,0,0,21,14,7,12,4,28,0,28,16,0,16
19/03/2022 01:00,1,0,1,2,2,0,2,0,2,0,0,0,1,1,0,2,2,0,0,0,0,16,9,7,15,0,7,0,7,2,0,2
19/03/2022 02:00,0,0,0,0,0,0,1,0,1,0,0,0,2,2,0,0,0,0,0,0,0,9,8,1,11,1,16,0,16,6,0,6
19/03/2022 03:00,1,0,1,0,0,0,0,0,0,0,0,0,3,3,0,0,0,0,0,0,0,4,3,1,8,2,10,0,10,1,0,1
19/03/2022 04:00,1,1,0,1,1,0,0,0,0,0,0,0,2,2,0,0,0,0,0,0,0,9,4,5,7,2,8,0,8,1,0,1
19/03/2022 05:00,1,1,0,6,3,3,3,0,3,0,0,0,3,3,0,0,0,0,0,0,0,7,1,6,3,6,7,0,7,5,0,5
19/03/2022 06:00,1,0,1,7,3,4,6,0,6,0,0,0,4,4,0,1,1,0,1,1,0,25,4,21,8,13,10,0,10,15,0,15
19/03/2022 07:00,2,2,0,24,12,12,31,14,17,0,0,0,6,6,0,4,4,0,0,0,0,43,8,35,15,16,9,0,9,16,0,16
19/03/2022 08:00,2,2,0,66,29,37,63,24,39,0,0,0,9,9,0,3,3,0,1,1,0,57,18,39,20,27,13,0,13,35,0,35
19/03/2022 09:00,11,9,2,84,38,46,90,35,55,0,0,0,8,7,1,8,8,0,0,0,0,59,16,43,20,31,17,0,17,47,0,47
19/03/2022 10:00,8,5,3,91,33,58,121,43,78,0,0,0,5,5,0,9,9,0,0,0,0,81,21,60,40,53,25,0,25,73,2,71
19/03/2022 11:00,19,12,7,144,69,75,177,84,93,0,0,0,5,5,0,6,6,0,4,4,0,76,23,53,51,43,54,0,54,91,3,88
19/03/2022 12:00,11,6,5,112,54,58,136,50,86,0,0,0,4,3,1,11,11,0,5,5,0,95,36,59,65,32,66,0,66,95,0,95
19/03/2022 13:00,18,14,4,117,63,54,154,66,88,0,0,0,8,8,0,15,15,0,8,8,0,133,70,63,71,52,63,0,63,108,1,107
19/03/2022 14:00,20,11,9,92,50,42,120,52,68,0,0,0,10,10,0,15,15,0,5,5,0,108,44,64,54,63,70,0,70,113,0,113
19/03/2022 15:00,18,12,6,81,52,29,141,78,63,0,0,0,12,12,0,10,10,0,1,1,0,126,53,73,63,44,91,1,90,86,0,86
19/03/2022 16:00,6,3,3,77,40,37,120,70,50,0,0,0,8,8,0,11,11,0,1,1,0,140,52,88,54,51,83,1,82,86,0,86
19/03/2022 17:00,6,3,3,56,31,25,101,60,41,0,0,0,11,10,1,16,16,0,4,4,0,106,49,57,51,50,89,2,87,85,1,84
19/03/2022 18:00,14,5,9,27,15,12,43,21,22,0,0,0,6,6,0,10,10,0,3,3,0,90,48,42,54,37,105,0,105,95,1,94
19/03/2022 19:00,8,4,4,9,5,4,13,11,2,0,0,0,5,5,0,8,8,0,1,1,0,119,66,53,50,33,102,0,102,107,1,106
19/03/2022 20:00,10,5,5,4,2,2,11,5,6,0,0,0,5,5,0,5,5,0,2,2,0,82,36,46,72,32,70,0,70,95,0,95
19/03/2022 21:00,3,2,1,7,2,5,8,1,7,0,0,0,3,3,0,2,2,0,2,2,0,69,35,34,45,19,63,0,63,81,1,80
19/03/2022 22:00,7,3,4,5,3,2,5,1,4,0,0,0,4,4,0,3,3,0,2,2,0,70,37,33,27,10,52,0,52,49,1,48
19/03/2022 23:00,3,1,2,4,1,3,4,1,3,0,0,0,0,0,0,2,2,0,1,1,0,42,30,12,25,8,44,0,44,32,1,31
20/03/2022 00:00,6,4,2,3,2,1,3,0,3,0,0,0,1,1,0,1,1,0,0,0,0,33,19,14,20,3,38,2,36,15,0,15
20/03/2022 01:00,0,0,0,6,4,2,4,1,3,0,0,0,0,0,0,3,3,0,0,0,0,12,9,3,19,8,2,0,2,4,0,4
20/03/2022 02:00,1,0,1,0,0,0,0,0,0,0,0,0,0,0,0,0,0,0,1,1,0,13,11,2,9,5,21,0,21,3,0,3
20/03/2022 03:00,1,0,1,0,0,0,0,0,0,0,0,0,0,0,0,0,0,0,1,1,0,6,3,3,10,2,15,1,14,3,0,3
20/03/2022 04:00,0,0,0,0,0,0,1,0,1,0,0,0,1,1,0,0,0,0,2,2,0,6,3,3,7,2,8,0,8,1,0,1
20/03/2022 05:00,2,2,0,2,1,1,2,1,1,0,0,0,3,3,0,0,0,0,2,2,0,7,5,2,2,3,5,0,5,4,0,4
20/03/2022 06:00,1,1,0,5,1,4,10,2,8,0,0,0,2,2,0,1,1,0,5,5,0,24,5,19,6,11,5,0,5,10,0,10
20/03/2022 07:00,3,1,2,19,8,11,18,5,13,0,0,0,8,8,0,1,1,0,7,7,0,29,6,23,16,16,9,0,9,7,0,7
20/03/2022 08:00,3,3,0,61,23,38,79,27,52,0,0,0,5,4,1,6,6,0,11,11,0,30,6,24,12,25,7,0,7,17,0,17
20/03/2022 09:00,14,11,3,103,43,60,112,46,66,0,0,0,4,4,0,9,9,0,11,11,0,63,18,45,20,34,8,0,8,37,0,37
20/03/2022 10:00,8,4,4,103,52,51,123,51,72,0,0,0,8,8,0,11,11,0,18,18,0,67,24,43,28,45,9,0,9,52,0,52
20/03/2022 11:00,10,5,5,152,74,78,170,63,107,0,0,0,4,4,0,16,16,0,14,14,0,97,28,69,32,49,43,0,43,80,0,80
20/03/2022 12:00,21,15,6,136,71,65,166,79,87,0,0,0,1,1,0,12,12,0,19,19,0,101,26,75,55,66,63,0,63,63,1,62
20/03/2022 13:00,22,15,7,119,65,54,159,74,85,0,0,0,5,4,1,19,19,0,19,19,0,113,52,61,43,43,71,0,71,78,0,78
20/03/2022 14:00,22,11,11,113,62,51,164,79,85,0,0,0,0,0,0,21,21,0,18,18,0,94,37,57,68,37,76,0,76,113,1,112
20/03/2022 15:00,14,9,5,105,55,50,151,75,76,0,0,0,3,3,0,12,12,0,7,7,0,121,36,85,52,50,75,1,74,86,1,85
20/03/2022 16:00,11,8,3,90,54,36,102,61,41,0,0,0,0,0,0,13,13,0,11,11,0,108,50,58,50,42,83,0,83,89,0,89
20/03/2022 17:00,12,5,7,44,26,18,70,41,29,0,0,0,9,8,1,5,5,0,2,2,0,95,48,47,56,49,87,0,87,72,0,72
20/03/2022 18:00,6,4,2,33,21,12,44,24,20,0,0,0,14,14,0,5,5,0,2,2,0,103,62,41,58,47,88,1,87,59,0,59
20/03/2022 19:00,11,4,7,19,11,8,26,15,11,0,0,0,12,12,0,7,7,0,3,3,0,99,48,51,45,24,76,1,75,67,1,66
20/03/2022 20:00,5,3,2,7,2,5,8,3,5,0,0,0,3,3,0,5,5,0,0,0,0,88,46,42,39,20,72,0,72,50,1,49
20/03/2022 21:00,10,6,4,6,5,1,4,2,2,0,0,0,2,2,0,8,8,0,0,0,0,51,29,22,32,18,48,1,47,56,2,54
20/03/2022 22:00,3,0,3,5,3,2,5,2,3,0,0,0,2,2,0,1,1,0,3,3,0,43,25,18,28,11,32,0,32,35,0,35
20/03/2022 23:00,2,1,1,2,1,1,0,0,0,0,0,0,3,3,0,3,3,0,2,2,0,16,12,4,14,10,22,0,22,12,0,12
21/03/2022 00:00,1,0,1,0,0,0,0,0,0,0,0,0,1,1,0,3,3,0,0,0,0,16,13,3,12,3,12,0,12,3,0,3
21/03/2022 01:00,0,0,0,2,2,0,0,0,0,0,0,0,0,0,0,1,1,0,0,0,0,4,3,1,5,0,3,0,3,2,0,2
21/03/2022 02:00,0,0,0,1,0,1,1,0,1,0,0,0,0,0,0,0,0,0,0,0,0,0,0,0,2,0,2,0,2,2,0,2
21/03/2022 03:00,1,0,1,0,0,0,0,0,0,0,0,0,1,1,0,0,0,0,0,0,0,1,1,0,1,0,2,0,2,1,0,1
21/03/2022 04:00,0,0,0,1,1,0,2,1,1,0,0,0,1,1,0,0,0,0,0,0,0,6,1,5,1,6,1,0,1,1,0,1
21/03/2022 05:00,2,2,0,8,7,1,8,5,3,0,0,0,3,3,0,1,1,0,2,2,0,23,4,19,4,20,3,0,3,8,0,8
21/03/2022 06:00,19,15,4,18,15,3,23,19,4,0,0,0,9,9,0,8,8,0,4,4,0,118,18,100,14,65,14,0,14,26,0,26
21/03/2022 07:00,31,27,4,46,31,15,48,37,11,0,0,0,34,34,0,17,17,0,8,8,0,215,46,169,23,103,27,0,27,72,1,71
21/03/2022 08:00,68,60,8,68,51,17,82,57,25,0,0,0,40,40,0,18,18,0,20,20,0,402,88,314,26,177,56,0,56,161,2,159
21/03/2022 09:00,20,15,5,33,20,13,41,26,15,0,0,0,18,18,0,13,13,0,8,8,0,163,34,129,17,101,28,1,27,112,0,112
21/03/2022 10:00,24,20,4,43,21,22,50,22,28,0,0,0,18,18,0,5,5,0,5,5,0,75,27,48,21,47,14,0,14,58,0,58
21/03/2022 11:00,13,10,3,61,28,33,59,24,35,0,0,0,6,6,0,7,7,0,1,1,0,71,14,57,23,29,46,1,45,66,0,66
21/03/2022 12:00,17,6,11,51,26,25,50,25,25,0,0,0,4,4,0,9,9,0,0,0,0,99,33,66,34,27,69,1,68,128,2,126
21/03/2022 13:00,16,7,9,50,23,27,68,29,39,0,0,0,10,10,0,12,12,0,1,1,0,124,48,76,78,52,94,2,92,106,0,106
21/03/2022 14:00,19,12,7,54,27,27,57,25,32,0,0,0,5,5,0,19,19,0,8,8,0,128,56,72,68,29,76,0,76,73,0,73
21/03/2022 15:00,15,9,6,49,21,28,79,36,43,0,0,0,5,5,0,15,15,0,11,11,0,126,61,65,60,34,72,1,71,76,0,76
21/03/2022 16:00,33,15,18,71,34,37,83,38,45,0,0,0,4,4,0,20,20,0,18,18,0,190,126,64,154,53,121,1,120,91,0,91
21/03/2022 17:00,49,21,28,90,31,59,109,37,72,0,0,0,4,4,0,40,40,0,18,18,0,308,201,107,227,43,221,1,220,112,0,112
21/03/2022 18:00,17,4,13,112,46,66,142,47,95,0,0,0,8,7,1,13,13,0,12,12,0,265,165,100,196,37,198,2,196,112,1,111
21/03/2022 19:00,14,4,10,50,23,27,67,28,39,0,0,0,7,7,0,15,15,0,6,6,0,161,88,73,86,34,130,0,130,85,1,84
21/03/2022 20:00,14,7,7,26,9,17,34,16,18,0,0,0,3,3,0,15,15,0,0,0,0,90,51,39,40,16,105,0,105,79,0,79
21/03/2022 21:00,8,1,7,9,6,3,16,7,9,0,0,0,3,3,0,9,9,0,6,6,0,74,52,22,45,13,69,1,68,51,0,51
21/03/2022 22:00,7,5,2,8,2,6,8,1,7,0,0,0,1,1,0,3,3,0,6,6,0,57,38,19,27,9,55,0,55,28,0,28
21/03/2022 23:00,4,3,1,1,0,1,1,0,1,0,0,0,2,2,0,6,6,0,1,1,0,27,17,10,19,4,24,1,23,12,0,12
22/03/2022 00:00,2,0,2,0,0,0,0,0,0,0,0,0,0,0,0,0,0,0,0,0,0,14,10,4,14,1,15,0,15,5,2,3
22/03/2022 01:00,0,0,0,0,0,0,0,0,0,0,0,0,0,0,0,1,1,0,0,0,0,5,4,1,6,0,3,0,3,1,0,1
22/03/2022 02:00,0,0,0,0,0,0,2,1,1,0,0,0,0,0,0,0,0,0,0,0,0,3,3,0,5,0,3,0,3,2,0,2
22/03/2022 03:00,0,0,0,0,0,0,0,0,0,0,0,0,1,1,0,0,0,0,0,0,0,4,1,3,0,0,0,0,0,1,0,1
22/03/2022 04:00,1,1,0,1,1,0,3,2,1,0,0,0,3,3,0,1,1,0,0,0,0,5,1,4,1,3,1,0,1,1,0,1
22/03/2022 05:00,3,2,1,10,8,2,13,8,5,0,0,0,5,5,0,2,2,0,0,0,0,34,8,26,6,20,2,0,2,6,0,6
22/03/2022 06:00,17,16,1,32,18,14,35,24,11,0,0,0,9,9,0,6,6,0,1,1,0,128,23,105,13,91,15,0,15,38,0,38
22/03/2022 07:00,35,33,2,77,57,20,85,66,19,0,0,0,31,31,0,19,19,0,0,0,0,264,61,203,30,149,26,1,25,87,0,87
22/03/2022 08:00,87,73,14,79,61,18,103,79,24,0,0,0,56,56,0,36,36,0,0,0,0,446,80,366,29,205,58,1,57,205,0,205
22/03/2022 09:00,35,31,4,55,33,22,68,38,30,0,0,0,26,26,0,15,15,0,0,0,0,242,53,189,17,130,45,1,44,140,0,140
22/03/2022 10:00,15,12,3,54,31,23,60,27,33,0,0,0,13,13,0,10,10,0,1,1,0,87,29,58,21,53,37,0,37,86,0,86
22/03/2022 11:00,11,6,5,61,21,40,73,31,42,0,0,0,11,11,0,10,10,0,2,2,0,96,26,70,28,51,53,1,52,72,1,71
22/03/2022 12:00,17,10,7,75,40,35,77,42,35,0,0,0,11,11,0,9,9,0,14,14,0,122,49,73,46,59,93,0,93,115,0,115
22/03/2022 13:00,13,4,9,83,45,38,104,48,56,0,0,0,5,5,0,12,12,0,1,1,0,121,50,71,56,42,95,0,95,134,2,132
22/03/2022 14:00,16,9,7,78,34,44,86,33,53,0,0,0,5,5,0,20,20,0,2,2,0,118,56,62,54,25,61,0,61,78,0,78
22/03/2022 15:00,21,11,10,63,31,32,83,34,49,0,0,0,5,5,0,34,34,0,15,15,0,162,90,72,113,55,90,0,90,90,1,89
22/03/2022 16:00,40,18,22,85,44,41,125,45,80,0,0,0,5,5,0,27,27,0,22,22,0,233,141,92,175,66,130,1,129,75,0,75
22/03/2022 17:00,63,20,43,141,50,91,184,60,124,0,0,0,6,6,0,40,40,0,32,32,0,345,236,109,258,39,241,0,241,138,0,138
22/03/2022 18:00,36,9,27,165,62,103,205,81,124,0,0,0,12,12,0,27,27,0,19,19,0,334,203,131,233,43,245,1,244,134,0,134
22/03/2022 19:00,16,7,9,71,33,38,109,51,58,0,0,0,7,7,0,15,15,0,10,10,0,174,96,78,112,31,144,1,143,106,0,106
22/03/2022 20:00,12,3,9,44,22,22,56,27,29,0,0,0,4,4,0,9,9,0,3,3,0,119,64,55,51,31,141,0,141,102,0,102
22/03/2022 21:00,5,4,1,19,8,11,26,6,20,0,0,0,0,0,0,17,17,0,4,4,0,78,58,20,56,24,107,0,107,56,1,55
22/03/2022 22:00,7,3,4,6,3,3,8,1,7,0,0,0,4,4,0,6,6,0,0,0,0,61,40,21,51,6,59,0,59,30,1,29
22/03/2022 23:00,2,1,1,5,2,3,6,1,5,0,0,0,4,4,0,2,2,0,1,1,0,32,27,5,23,4,37,1,36,13,0,13
23/03/2022 00:00,1,1,0,5,4,1,2,1,1,0,0,0,2,2,0,2,2,0,1,1,0,19,12,7,9,2,13,0,13,7,0,7
23/03/2022 01:00,0,0,0,0,0,0,1,0,1,0,0,0,0,0,0,0,0,0,2,2,0,9,6,3,7,0,3,0,3,0,0,0
23/03/2022 02:00,0,0,0,1,0,1,0,0,0,0,0,0,1,1,0,0,0,0,1,1,0,5,4,1,6,0,4,0,4,4,0,4
23/03/2022 03:00,0,0,0,0,0,0,1,0,1,0,0,0,0,0,0,0,0,0,0,0,0,0,0,0,1,0,2,0,2,0,0,0
23/03/2022 04:00,1,1,0,2,2,0,1,0,1,0,0,0,4,4,0,1,1,0,0,0,0,6,0,6,2,6,1,0,1,2,0,2
23/03/2022 05:00,1,1,0,11,8,3,14,8,6,0,0,0,4,4,0,3,3,0,0,0,0,37,10,27,5,18,3,0,3,7,0,7
23/03/2022 06:00,20,18,2,40,27,13,43,24,19,0,0,0,13,13,0,9,9,0,0,0,0,142,28,114,14,89,14,0,14,46,0,46
23/03/2022 07:00,36,33,3,97,65,32,110,75,35,0,0,0,34,34,0,19,19,0,3,3,0,292,72,220,31,181,38,0,38,76,0,76
23/03/2022 08:00,97,85,12,102,76,26,135,107,28,0,0,0,63,63,0,33,33,0,72,72,0,470,87,383,34,296,72,1,71,192,2,190
23/03/2022 09:00,35,27,8,56,27,29,65,37,28,0,0,0,14,14,0,13,13,0,23,23,0,189,37,152,29,142,50,0,50,129,2,127
23/03/2022 10:00,11,7,4,72,37,35,83,38,45,0,0,0,23,22,1,14,14,0,6,6,0,99,27,72,22,63,17,1,16,83,2,81
23/03/2022 11:00,10,7,3,67,33,34,89,42,47,0,0,0,16,16,0,13,13,0,8,8,0,108,26,82,37,45,51,0,51,80,0,80
23/03/2022 12:00,12,8,4,83,42,41,103,48,55,0,0,0,11,11,0,11,11,0,0,0,0,101,44,57,62,57,93,0,93,104,0,104
23/03/2022 13:00,20,10,10,76,35,41,83,39,44,0,0,0,18,18,0,35,35,0,1,1,0,164,55,109,54,70,109,0,109,114,1,113
23/03/2022 14:00,12,7,5,65,32,33,83,37,46,0,0,0,9,9,0,20,20,0,2,2,0,128,64,64,80,36,97,0,97,101,0,101
23/03/2022 15:00,19,9,10,79,35,44,112,40,72,0,0,0,11,10,1,24,24,0,4,4,0,154,84,70,95,62,92,0,92,100,0,100
23/03/2022 16:00,40,19,21,87,38,49,130,57,73,0,0,0,3,3,0,38,38,0,9,9,0,229,137,92,172,71,139,0,139,115,0,115
23/03/2022 17:00,63,21,42,144,47,97,179,58,121,0,0,0,5,4,1,32,32,0,12,12,0,387,240,147,295,71,269,0,269,153,0,153
23/03/2022 18:00,26,8,18,135,53,82,190,74,116,0,0,0,11,11,0,19,19,0,19,19,0,347,216,131,199,34,217,1,216,123,0,123
23/03/2022 19:00,26,6,20,83,34,49,107,42,65,0,0,0,4,4,0,14,14,0,14,14,0,218,122,96,117,39,168,0,168,119,0,119
23/03/2022 20:00,13,6,7,37,12,25,43,17,26,0,0,0,2,2,0,11,11,0,3,3,0,153,89,64,79,24,130,3,127,115,0,115
23/03/2022 21:00,11,4,7,14,7,7,15,3,12,0,0,0,1,1,0,5,5,0,6,6,0,86,52,34,57,19,91,2,89,71,0,71
23/03/2022 22:00,3,0,3,5,4,1,14,7,7,0,0,0,0,0,0,7,7,0,3,3,0,69,36,33,40,11,69,0,69,33,0,33
23/03/2022 23:00,3,3,0,1,0,1,3,1,2,0,0,0,1,1,0,4,4,0,1,1,0,32,27,5,29,1,34,3,31,26,0,26
24/03/2022 00:00,0,0,0,4,2,2,3,1,2,0,0,0,0,0,0,0,0,0,1,1,0,19,12,7,20,1,27,1,26,16,0,16
24/03/2022 01:00,2,1,1,1,1,0,0,0,0,0,0,0,2,2,0,1,1,0,0,0,0,9,6,3,8,3,1,0,1,0,0,0
24/03/2022 02:00,1,0,1,0,0,0,2,0,2,0,0,0,0,0,0,0,0,0,0,0,0,7,5,2,3,0,9,0,9,2,0,2
24/03/2022 03:00,0,0,0,0,0,0,0,0,0,0,0,0,0,0,0,0,0,0,0,0,0,0,0,0,4,2,2,0,2,1,0,1
24/03/2022 04:00,1,1,0,1,1,0,0,0,0,0,0,0,2,2,0,0,0,0,0,0,0,9,0,9,2,6,1,0,1,2,0,2
24/03/2022 05:00,2,2,0,11,7,4,13,6,7,0,0,0,5,4,1,1,1,0,0,0,0,36,9,27,8,18,2,0,2,10,0,10
24/03/2022 06:00,16,15,1,39,28,11,48,29,19,0,0,0,14,14,0,11,11,0,3,3,0,123,25,98,17,78,13,0,13,38,0,38
24/03/2022 07:00,41,39,2,76,49,27,79,55,24,0,0,0,37,36,1,21,21,0,13,13,0,280,71,209,38,162,34,0,34,85,0,85
24/03/2022 08:00,83,74,9,81,59,22,109,78,31,0,0,0,47,47,0,33,33,0,26,26,0,473,100,373,44,270,85,0,85,199,3,196
24/03/2022 09:00,30,23,7,75,44,31,90,52,38,0,0,0,8,8,0,15,15,0,7,7,0,223,50,173,25,150,46,0,46,156,0,156
24/03/2022 10:00,18,12,6,62,33,29,72,38,34,0,0,0,13,13,0,9,9,0,14,14,0,82,22,60,29,57,29,1,28,90,0,90
24/03/2022 11:00,18,13,5,75,34,41,88,43,45,0,0,0,10,10,0,10,10,0,6,6,0,79,27,52,46,43,41,0,41,72,1,71
24/03/2022 12:00,10,6,4,76,38,38,75,36,39,0,0,0,8,6,2,9,9,0,12,12,0,94,36,58,43,37,91,0,91,98,1,97
24/03/2022 13:00,15,7,8,73,36,37,78,36,42,0,0,0,7,7,0,15,15,0,6,6,0,148,66,82,63,66,92,1,91,115,1,114
24/03/2022 14:00,19,8,11,66,29,37,72,27,45,0,0,0,7,7,0,11,11,0,9,9,0,136,52,84,80,43,86,0,86,108,2,106
24/03/2022 15:00,20,9,11,82,38,44,91,37,54,0,0,0,15,15,0,30,30,0,11,11,0,211,92,119,87,50,86,0,86,92,0,92
24/03/2022 16:00,34,15,19,89,32,57,127,50,77,0,0,0,17,16,1,32,32,0,8,8,0,233,134,99,140,64,139,0,139,91,1,90
24/03/2022 17:00,46,14,32,139,47,92,188,70,118,0,0,0,9,8,1,30,30,0,17,17,0,368,243,125,254,62,226,0,226,159,1,158
24/03/2022 18:00,19,7,12,138,62,76,197,81,116,0,0,0,11,11,0,24,24,0,7,7,0,309,191,118,225,52,229,0,229,173,1,172
24/03/2022 19:00,25,10,15,50,24,26,71,31,40,0,0,0,11,10,1,21,21,0,14,14,0,189,88,101,117,38,153,0,153,129,0,129
24/03/2022 20:00,14,9,5,35,17,18,38,18,20,0,0,0,4,4,0,12,12,0,8,8,0,140,78,62,88,42,132,0,132,110,0,110
24/03/2022 21:00,9,4,5,17,5,12,23,4,19,0,0,0,2,2,0,8,8,0,3,3,0,101,64,37,45,14,115,1,114,73,1,72
24/03/2022 22:00,7,3,4,11,6,5,13,3,10,0,0,0,1,1,0,5,5,0,5,5,0,72,46,26,47,17,68,0,68,46,1,45
24/03/2022 23:00,3,1,2,4,3,1,14,4,10,0,0,0,2,2,0,2,2,0,2,2,0,61,43,18,34,7,54,0,54,26,0,26
25/03/2022 00:00,4,1,3,4,2,2,5,1,4,0,0,0,1,1,0,2,2,0,2,2,0,32,26,6,25,6,28,0,28,14,0,14
25/03/2022 01:00,0,0,0,2,0,2,1,0,1,0,0,0,1,1,0,1,1,0,1,1,0,11,10,1,15,1,4,0,4,1,0,1
25/03/2022 02:00,0,0,0,2,0,2,2,0,2,0,0,0,0,0,0,0,0,0,0,0,0,3,3,0,5,2,11,1,10,2,0,2
25/03/2022 03:00,0,0,0,0,0,0,0,0,0,0,0,0,0,0,0,0,0,0,0,0,0,7,4,3,4,1,1,0,1,0,0,0
25/03/2022 04:00,1,1,0,2,2,0,2,0,2,0,0,0,3,3,0,1,1,0,0,0,0,6,3,3,8,3,4,0,4,3,0,3
25/03/2022 05:00,1,1,0,10,6,4,12,5,7,0,0,0,4,4,0,0,0,0,2,2,0,25,4,21,4,15,3,0,3,10,0,10
25/03/2022 06:00,22,19,3,17,13,4,22,14,8,0,0,0,7,7,0,12,12,0,4,4,0,117,26,91,18,81,19,0,19,33,0,33
25/03/2022 07:00,32,27,5,68,40,28,78,54,24,0,0,0,32,32,0,14,14,0,10,10,0,226,53,173,36,133,41,0,41,83,0,83
25/03/2022 08:00,54,50,4,78,52,26,81,60,21,0,0,0,30,30,0,28,28,0,37,37,0,387,84,303,44,187,59,2,57,159,0,159
25/03/2022 09:00,30,22,8,46,25,21,72,40,32,0,0,0,12,12,0,15,15,0,0,0,0,168,35,133,26,114,52,0,52,124,0,124
25/03/2022 10:00,11,5,6,81,28,53,96,39,57,0,0,0,10,10,0,8,8,0,1,1,0,85,32,53,30,48,24,0,24,73,1,72
25/03/2022 11:00,9,7,2,72,32,40,69,33,36,0,0,0,9,9,0,13,13,0,1,1,0,104,27,77,42,64,40,1,39,71,0,71
25/03/2022 12:00,20,12,8,107,58,49,112,61,51,0,0,0,6,5,1,17,17,0,2,2,0,123,56,67,67,60,92,1,91,134,1,133
25/03/2022 13:00,21,10,11,105,54,51,115,54,61,0,0,0,5,5,0,22,22,0,2,2,0,163,68,95,76,67,124,1,123,165,0,165
25/03/2022 14:00,27,14,13,91,41,50,104,40,64,0,0,0,7,7,0,22,22,0,0,0,0,163,80,83,97,53,96,1,95,115,1,114
25/03/2022 15:00,34,12,22,79,39,40,104,45,59,0,0,0,8,7,1,24,24,0,0,0,0,199,108,91,121,55,117,0,117,91,3,88
25/03/2022 16:00,32,15,17,105,49,56,159,76,83,0,0,0,8,8,0,25,25,0,1,1,0,214,105,109,145,61,136,0,136,115,1,114
25/03/2022 17:00,30,8,22,121,55,66,174,67,107,0,0,0,9,9,0,22,22,0,3,3,0,284,176,108,192,59,209,2,207,156,4,152
25/03/2022 18:00,23,13,10,90,39,51,138,62,76,0,0,0,14,14,0,19,19,0,12,12,0,216,121,95,129,67,184,0,184,168,4,164
25/03/2022 19:00,13,5,8,37,17,20,68,34,34,0,0,0,11,11,0,11,11,0,8,8,0,148,73,75,94,62,147,0,147,159,0,159
25/03/2022 20:00,13,7,6,26,12,14,43,18,25,0,0,0,8,7,1,7,7,0,3,3,0,122,71,51,81,61,129,2,127,131,0,131
25/03/2022 21:00,12,6,6,5,3,2,11,6,5,0,0,0,4,4,0,11,11,0,4,4,0,100,59,41,73,39,83,2,81,107,2,105
25/03/2022 22:00,12,7,5,12,4,8,15,5,10,0,0,0,4,4,0,5,5,0,2,2,0,63,44,19,53,21,42,0,42,60,0,60
25/03/2022 23:00,5,3,2,4,3,1,8,3,5,0,0,0,0,0,0,6,6,0,3,3,0,65,47,18,40,10,51,1,50,28,0,28
26/03/2022 00:00,4,1,3,5,3,2,8,2,6,0,0,0,0,0,0,2,2,0,3,3,0,31,22,9,23,8,38,0,38,23,0,23
26/03/2022 01:00,0,0,0,3,1,2,0,0,0,0,0,0,2,2,0,4,4,0,0,0,0,15,10,5,14,6,10,0,10,2,0,2
26/03/2022 02:00,0,0,0,0,0,0,4,3,1,0,0,0,0,0,0,0,0,0,0,0,0,18,14,4,10,4,25,1,24,8,0,8
26/03/2022 03:00,1,0,1,3,2,1,2,0,2,0,0,0,0,0,0,0,0,0,1,1,0,11,7,4,15,2,15,0,15,5,2,3
26/03/2022 04:00,3,1,2,0,0,0,1,0,1,0,0,0,1,1,0,0,0,0,0,0,0,6,3,3,8,5,8,0,8,6,0,6
26/03/2022 05:00,0,0,0,6,2,4,8,1,7,0,0,0,6,6,0,2,2,0,0,0,0,20,8,12,3,3,1,0,1,6,0,6
26/03/2022 06:00,0,0,0,7,3,4,16,4,12,0,0,0,5,5,0,3,3,0,4,4,0,31,4,27,8,16,15,0,15,18,0,18
26/03/2022 07:00,5,4,1,45,20,25,57,26,31,0,0,0,5,5,0,3,3,0,3,3,0,50,11,39,20,35,13,0,13,26,0,26
26/03/2022 08:00,13,11,2,96,41,55,105,41,64,0,0,0,12,12,0,7,7,0,4,4,0,86,32,54,29,38,24,0,24,37,0,37
26/03/2022 09:00,13,10,3,142,63,79,154,61,93,0,0,0,9,9,0,12,12,0,7,7,0,101,33,68,32,48,27,0,27,81,0,81
26/03/2022 10:00,17,11,6,197,73,124,217,91,126,0,0,0,10,10,0,13,13,0,4,4,0,110,25,85,39,48,37,1,36,86,0,86
26/03/2022 11:00,21,8,13,219,106,113,280,112,168,0,0,0,2,2,0,19,19,0,14,14,0,136,60,76,58,49,22,0,22,96,0,96
26/03/2022 12:00,22,11,11,238,121,117,291,135,156,0,0,0,20,20,0,22,22,0,4,4,0,169,62,107,70,65,95,2,93,123,0,123
26/03/2022 13:00,37,23,14,184,93,91,267,116,151,0,0,0,9,9,0,14,14,0,2,2,0,194,70,124,80,53,93,0,93,125,1,124
26/03/2022 14:00,26,14,12,174,86,88,268,112,156,0,0,0,7,7,0,12,12,0,2,2,0,171,62,109,85,68,91,0,91,137,0,137
26/03/2022 15:00,30,19,11,182,88,94,241,122,119,0,0,0,18,18,0,18,18,0,1,1,0,193,77,116,75,76,85,0,85,124,1,123
26/03/2022 16:00,16,10,6,170,95,75,241,133,108,0,0,0,19,18,1,16,16,0,0,0,0,172,75,97,63,67,104,0,104,107,0,107
26/03/2022 17:00,21,12,9,127,83,44,217,134,83,0,0,0,12,12,0,9,9,0,6,6,0,141,71,70,83,60,112,2,110,112,0,112
26/03/2022 18:00,17,14,3,66,39,27,113,67,46,0,0,0,20,20,0,18,18,0,17,17,0,147,67,80,79,67,118,1,117,97,0,97
26/03/2022 19:00,14,4,10,33,16,17,55,33,22,0,0,0,8,8,0,7,7,0,8,8,0,183,95,88,69,42,101,0,101,115,1,114
26/03/2022 20:00,10,6,4,8,6,2,44,24,20,0,0,0,11,11,0,1,1,0,6,6,0,153,64,89,49,39,91,0,91,97,0,97
26/03/2022 21:00,5,2,3,8,4,4,8,1,7,0,0,0,10,9,1,4,4,0,2,2,0,96,48,48,49,38,67,1,66,73,0,73
26/03/2022 22:00,11,3,8,8,5,3,15,6,9,0,0,0,7,7,0,2,2,0,0,0,0,48,30,18,31,22,57,1,56,42,1,41
26/03/2022 23:00,1,1,0,3,1,2,4,1,3,0,0,0,4,4,0,2,2,0,3,3,0,52,33,19,34,7,51,0,51,32,0,32
27/03/2022 00:00,5,1,4,9,5,4,6,1,5,0,0,0,3,3,0,3,3,0,5,5,0,43,34,9,31,8,37,1,36,16,1,15
27/03/2022 02:00,,,,,,,,,,,,,,,,,,,,,,,,,,,,,,,,
27/03/2022 02:00,0,0,0,7,5,2,2,0,2,0,0,0,1,1,0,2,2,0,0,0,0,33,22,11,18,5,10,0,10,0,0,0
27/03/2022 03:00,0,0,0,2,1,1,4,2,2,0,0,0,1,1,0,1,1,0,0,0,0,15,12,3,13,5,22,1,21,6,0,6
27/03/2022 04:00,1,0,1,3,0,3,4,1,3,0,0,0,1,1,0,0,0,0,0,0,0,15,6,9,10,3,18,0,18,6,0,6
27/03/2022 05:00,1,0,1,1,1,0,1,1,0,0,0,0,2,2,0,1,1,0,0,0,0,13,4,9,4,4,9,0,9,4,0,4
27/03/2022 06:00,3,2,1,11,7,4,11,5,6,0,0,0,3,3,0,0,0,0,2,2,0,21,5,16,7,12,10,0,10,8,0,8
27/03/2022 07:00,2,1,1,27,11,16,30,8,22,0,0,0,2,2,0,1,1,0,0,0,0,35,4,31,15,12,11,0,11,12,0,12
27/03/2022 08:00,3,2,1,71,28,43,82,28,54,0,0,0,7,7,0,4,4,0,0,0,0,42,14,28,18,31,11,0,11,15,0,15
27/03/2022 09:00,9,5,4,109,36,73,142,35,107,0,0,0,8,8,0,4,4,0,0,0,0,81,22,59,17,24,12,0,12,38,0,38
27/03/2022 10:00,16,14,2,180,80,100,190,86,104,0,0,0,4,4,0,4,4,0,0,0,0,69,25,44,45,32,28,0,28,54,0,54
27/03/2022 11:00,21,13,8,185,83,102,239,109,130,0,0,0,1,1,0,17,17,0,0,0,0,96,23,73,33,44,43,1,42,73,0,73
27/03/2022 12:00,9,4,5,231,106,125,289,145,144,0,0,0,11,11,0,16,16,0,0,0,0,129,37,92,52,43,62,0,62,96,0,96
27/03/2022 13:00,16,11,5,224,113,111,269,133,136,0,0,0,3,3,0,15,15,0,1,1,0,136,49,87,66,54,82,0,82,112,0,112
27/03/2022 14:00,27,16,11,173,83,90,235,100,135,0,0,0,9,9,0,9,9,0,1,1,0,144,46,98,59,53,88,0,88,99,0,99
27/03/2022 15:00,21,8,13,194,99,95,253,123,130,0,0,0,12,12,0,19,19,0,1,1,0,147,62,85,80,71,82,1,81,90,1,89
27/03/2022 16:00,18,11,7,143,90,53,220,128,92,0,0,0,16,16,0,16,16,0,0,0,0,148,59,89,55,63,89,0,89,67,0,67
27/03/2022 17:00,16,5,11,136,88,48,178,99,79,0,0,0,9,9,0,13,13,0,0,0,0,128,49,79,61,64,110,0,110,95,0,95
27/03/2022 18:00,17,10,7,95,63,32,141,89,52,0,0,0,13,13,0,15,15,0,0,0,0,136,78,58,48,29,100,0,100,71,0,71
27/03/2022 19:00,15,9,6,39,25,14,74,44,30,0,0,0,13,13,0,12,12,0,0,0,0,151,77,74,63,56,87,0,87,79,1,78
27/03/2022 20:00,9,5,4,21,13,8,44,21,23,0,0,0,6,6,0,4,4,0,0,0,0,100,61,39,52,32,81,0,81,77,0,77
27/03/2022 21:00,6,4,2,11,6,5,23,12,11,0,0,0,0,0,0,3,3,0,1,1,0,98,66,32,39,28,75,0,75,66,0,66
27/03/2022 22:00,6,2,4,12,8,4,12,3,9,0,0,0,4,4,0,7,7,0,0,0,0,48,27,21,48,18,49,2,47,41,0,41
27/03/2022 23:00,2,1,1,3,1,2,2,1,1,0,0,0,1,1,0,2,2,0,0,0,0,26,19,7,17,7,24,0,24,23,0,23
28/03/2022 00:00,1,0,1,0,0,0,1,0,1,0,0,0,0,0,0,4,4,0,0,0,0,23,16,7,14,4,25,0,25,9,0,9
28/03/2022 01:00,0,0,0,4,3,1,0,0,0,0,0,0,0,0,0,0,0,0,0,0,0,4,3,1,7,0,5,1,4,0,0,0
28/03/2022 02:00,1,1,0,0,0,0,0,0,0,0,0,0,1,1,0,0,0,0,0,0,0,5,2,3,4,2,3,0,3,7,0,7
28/03/2022 03:00,1,0,1,0,0,0,0,0,0,0,0,0,0,0,0,1,1,0,0,0,0,3,0,3,6,1,1,0,1,0,0,0
28/03/2022 04:00,1,1,0,0,0,0,1,0,1,0,0,0,1,1,0,1,1,0,0,0,0,7,1,6,2,5,1,0,1,2,0,2
28/03/2022 05:00,1,1,0,7,4,3,11,6,5,0,0,0,4,4,0,1,1,0,0,0,0,21,3,18,6,19,4,0,4,5,0,5
28/03/2022 06:00,19,17,2,19,14,5,26,17,9,0,0,0,16,16,0,12,12,0,0,0,0,112,24,88,12,77,19,0,19,36,0,36
28/03/2022 07:00,33,28,5,44,29,15,52,44,8,0,0,0,21,21,0,16,16,0,0,0,0,254,52,202,28,152,27,0,27,59,0,59
28/03/2022 08:00,74,65,9,83,59,24,105,82,23,0,0,0,50,50,0,39,39,0,101,101,0,456,91,365,38,249,54,0,54,144,1,143
28/03/2022 09:00,36,30,6,59,30,29,81,44,37,0,0,0,23,23,0,10,10,0,21,21,0,220,43,177,22,138,37,0,37,138,0,138
28/03/2022 10:00,10,5,5,68,32,36,77,32,45,0,0,0,18,18,0,12,12,0,7,7,0,80,25,55,20,61,35,0,35,82,1,81
28/03/2022 11:00,17,12,5,76,37,39,108,49,59,0,0,0,7,7,0,10,10,0,6,6,0,91,26,65,38,58,40,0,40,90,1,89
28/03/2022 12:00,8,3,5,90,43,47,98,45,53,0,0,0,8,8,0,12,12,0,11,11,0,124,50,74,56,51,89,0,89,84,0,84
28/03/2022 13:00,20,9,11,88,33,55,118,48,70,0,0,0,10,10,0,18,18,0,15,15,0,152,59,93,68,48,100,0,100,104,0,104
28/03/2022 14:00,17,12,5,98,46,52,120,57,63,0,0,0,19,18,1,21,21,0,9,9,0,136,80,56,63,41,81,0,81,89,0,89
28/03/2022 15:00,17,8,9,91,44,47,113,52,61,0,0,0,21,21,0,36,36,0,17,17,0,158,91,67,114,50,90,0,90,75,0,75
28/03/2022 16:00,24,10,14,103,45,58,126,49,77,0,0,0,11,11,0,24,24,0,28,28,0,224,147,77,159,51,117,2,115,95,1,94
28/03/2022 17:00,49,14,35,148,62,86,210,76,134,0,0,0,16,16,0,54,54,0,46,46,0,369,221,148,249,54,203,0,203,122,1,121
28/03/2022 18:00,39,19,20,187,79,108,217,85,132,0,0,0,15,15,0,32,32,0,35,35,0,314,193,121,227,71,211,0,211,133,3,130
28/03/2022 19:00,15,4,11,82,37,45,145,63,82,0,0,0,25,25,0,15,15,0,17,17,0,171,85,86,123,38,154,0,154,89,1,88
28/03/2022 20:00,12,5,7,63,31,32,72,35,37,0,0,0,12,12,0,11,11,0,12,12,0,130,69,61,70,24,118,0,118,91,0,91
28/03/2022 21:00,8,7,1,19,9,10,36,14,22,0,0,0,6,5,1,10,10,0,10,10,0,99,65,34,51,28,87,0,87,77,0,77
28/03/2022 22:00,4,1,3,11,5,6,13,5,8,0,0,0,4,4,0,5,5,0,9,9,0,52,36,16,38,15,61,1,60,26,1,25
28/03/2022 23:00,4,2,2,1,1,0,1,0,1,0,0,0,4,4,0,1,1,0,1,1,0,40,28,12,25,9,32,0,32,25,3,22
29/03/2022 00:00,0,0,0,1,1,0,0,0,0,0,0,0,0,0,0,0,0,0,2,2,0,24,17,7,10,7,13,0,13,3,0,3
29/03/2022 01:00,0,0,0,2,2,0,1,0,1,0,0,0,0,0,0,1,1,0,0,0,0,7,5,2,9,2,3,0,3,0,0,0
29/03/2022 02:00,1,0,1,0,0,0,0,0,0,0,0,0,0,0,0,0,0,0,0,0,0,4,3,1,5,0,4,0,4,5,0,5
29/03/2022 03:00,1,0,1,0,0,0,0,0,0,0,0,0,0,0,0,0,0,0,0,0,0,1,0,1,0,0,1,0,1,2,0,2
29/03/2022 04:00,1,1,0,1,1,0,3,2,1,0,0,0,1,1,0,1,1,0,1,1,0,7,2,5,1,1,0,0,0,4,0,4
29/03/2022 05:00,2,1,1,8,5,3,12,6,6,0,0,0,3,3,0,2,2,0,1,1,0,26,5,21,4,25,1,0,1,7,0,7
29/03/2022 06:00,15,14,1,23,16,7,31,20,11,0,0,0,18,18,0,4,4,0,9,9,0,126,31,95,15,75,18,0,18,35,0,35
29/03/2022 07:00,28,28,0,63,42,21,69,45,24,0,0,0,31,31,0,19,19,0,30,30,0,296,64,232,35,146,28,0,28,64,1,63
29/03/2022 08:00,93,79,14,117,88,29,142,108,34,0,0,0,55,55,0,33,33,0,132,132,0,511,98,413,43,329,77,1,76,199,1,198
29/03/2022 09:00,35,28,7,49,26,23,58,33,25,0,0,0,0,0,0,17,17,0,19,19,0,226,41,185,34,138,39,1,38,154,1,153
29/03/2022 10:00,20,12,8,55,23,32,75,31,44,0,0,0,0,0,0,5,5,0,8,8,0,97,28,69,29,47,34,0,34,79,0,79
29/03/2022 11:00,11,8,3,59,32,27,64,33,31,0,0,0,0,0,0,12,12,0,9,9,0,85,40,45,26,51,34,0,34,85,0,85
29/03/2022 12:00,12,7,5,60,28,32,63,30,33,0,0,0,0,0,0,10,10,0,11,11,0,126,42,84,47,28,84,0,84,105,0,105
29/03/2022 13:00,16,10,6,59,34,25,57,35,22,0,0,0,0,0,0,18,18,0,7,7,0,115,53,62,61,29,95,0,95,114,2,112
29/03/2022 14:00,14,10,4,56,18,38,76,28,48,0,0,0,0,0,0,15,15,0,15,15,0,126,55,71,69,29,84,0,84,86,0,86
29/03/2022 15:00,16,4,12,41,21,20,62,30,32,0,0,0,0,0,0,29,29,0,18,18,0,135,64,71,92,35,94,0,94,78,0,78
29/03/2022 16:00,38,19,19,106,51,55,112,48,64,0,0,0,3,3,0,39,39,0,16,16,0,253,149,104,173,55,135,1,134,114,0,114
29/03/2022 17:00,56,16,40,122,43,79,174,56,118,0,0,0,1,1,0,27,27,0,42,42,0,366,229,137,288,47,236,0,236,151,1,150
29/03/2022 18:00,33,15,18,162,59,103,204,66,138,0,0,0,17,16,1,33,33,0,29,29,0,386,229,157,231,47,232,0,232,132,0,132
29/03/2022 19:00,26,15,11,129,60,69,144,65,79,0,0,0,19,19,0,21,21,0,7,7,0,207,107,100,103,29,165,1,164,126,1,125
29/03/2022 20:00,11,1,10,45,25,20,70,37,33,0,0,0,5,5,0,15,15,0,12,12,0,153,93,60,88,40,124,0,124,88,1,87
29/03/2022 21:00,8,2,6,13,7,6,28,8,20,0,0,0,7,7,0,4,4,0,9,9,0,116,79,37,67,12,76,0,76,64,1,63
29/03/2022 22:00,5,0,5,4,2,2,6,3,3,0,0,0,4,4,0,4,4,0,12,12,0,104,73,31,47,8,70,0,70,42,0,42
29/03/2022 23:00,3,1,2,4,3,1,4,1,3,0,0,0,4,4,0,4,4,0,2,2,0,45,30,15,37,5,42,1,41,29,2,27
30/03/2022 00:00,3,2,1,0,0,0,1,1,0,0,0,0,1,1,0,0,0,0,1,1,0,27,20,7,14,3,23,0,23,9,0,9
30/03/2022 01:00,1,1,0,0,0,0,0,0,0,0,0,0,2,2,0,0,0,0,0,0,0,11,10,1,9,1,8,0,8,1,0,1
30/03/2022 02:00,1,0,1,1,0,1,1,0,1,0,0,0,0,0,0,0,0,0,0,0,0,6,3,3,5,1,8,0,8,3,0,3
30/03/2022 03:00,0,0,0,0,0,0,0,0,0,0,0,0,0,0,0,0,0,0,0,0,0,4,2,2,4,2,3,0,3,0,0,0
30/03/2022 04:00,1,1,0,2,2,0,1,0,1,0,0,0,3,3,0,1,1,0,1,1,0,2,0,2,2,5,0,0,0,4,0,4
30/03/2022 05:00,3,2,1,4,1,3,10,3,7,0,0,0,2,2,0,1,1,0,1,1,0,37,7,30,4,20,2,0,2,10,0,10
30/03/2022 06:00,17,16,1,25,20,5,30,24,6,0,0,0,23,23,0,7,7,0,2,2,0,119,28,91,21,80,14,0,14,48,0,48
30/03/2022 07:00,31,28,3,55,45,10,62,45,17,0,0,0,46,46,0,17,17,0,16,16,0,290,64,226,35,151,31,0,31,65,1,64
30/03/2022 08:00,79,70,9,63,47,16,93,72,21,0,0,0,45,45,0,29,29,0,91,91,0,492,104,388,34,260,67,0,67,185,1,184
30/03/2022 09:00,33,26,7,33,18,15,54,33,21,0,0,0,22,22,0,13,13,0,14,14,0,230,54,176,23,119,40,0,40,138,0,138
30/03/2022 10:00,17,12,5,41,22,19,44,21,23,0,0,0,12,12,0,11,11,0,1,1,0,85,28,57,15,50,33,0,33,86,1,85
30/03/2022 11:00,6,4,2,23,12,11,34,17,17,0,0,0,11,11,0,9,9,0,10,10,0,78,22,56,19,39,45,1,44,87,0,87
30/03/2022 12:00,7,4,3,33,15,18,47,19,28,0,0,0,14,14,0,15,15,0,12,12,0,102,41,61,43,41,80,0,80,89,0,89
30/03/2022 13:00,23,14,9,39,22,17,44,25,19,0,0,0,10,10,0,20,20,0,7,7,0,160,56,104,65,53,94,0,94,112,0,112
30/03/2022 14:00,14,7,7,26,12,14,36,16,20,0,0,0,10,10,0,17,17,0,8,8,0,107,50,57,61,56,81,0,81,82,1,81
30/03/2022 15:00,20,7,13,19,6,13,38,9,29,0,0,0,5,5,0,23,23,0,4,4,0,167,84,83,87,35,87,1,86,85,1,84
30/03/2022 16:00,25,10,15,30,13,17,46,16,30,0,0,0,15,13,2,23,23,0,8,8,0,211,125,86,138,44,115,1,114,80,0,80
30/03/2022 17:00,53,11,42,46,11,35,83,16,67,0,0,0,3,3,0,32,32,0,7,7,0,371,241,130,275,59,202,0,202,137,0,137
30/03/2022 18:00,34,9,25,55,13,42,70,18,52,0,0,0,8,8,0,16,16,0,5,5,0,290,209,81,227,47,205,0,205,135,0,135
30/03/2022 19:00,18,10,8,53,21,32,62,21,41,0,0,0,3,3,0,16,16,0,5,5,0,205,109,96,107,44,143,0,143,101,1,100
30/03/2022 20:00,21,4,17,24,12,12,35,15,20,0,0,0,3,3,0,9,9,0,3,3,0,136,76,60,75,27,110,1,109,85,0,85
30/03/2022 21:00,12,6,6,11,3,8,15,3,12,0,0,0,1,1,0,8,8,0,8,8,0,84,50,34,62,12,81,0,81,41,0,41
30/03/2022 22:00,2,1,1,3,1,2,5,0,5,0,0,0,2,2,0,4,4,0,4,4,0,60,44,16,43,10,51,0,51,47,1,46
30/03/2022 23:00,1,1,0,1,0,1,4,2,2,0,0,0,0,0,0,4,4,0,1,1,0,35,23,12,28,9,42,0,42,20,0,20
31/03/2022 00:00,0,0,0,1,1,0,3,1,2,0,0,0,0,0,0,2,2,0,2,2,0,21,14,7,17,2,23,0,23,10,0,10
31/03/2022 01:00,0,0,0,2,1,1,0,0,0,0,0,0,0,0,0,1,1,0,0,0,0,6,4,2,9,2,1,0,1,0,0,0
31/03/2022 02:00,1,1,0,0,0,0,2,2,0,0,0,0,0,0,0,0,0,0,0,0,0,5,4,1,3,1,6,0,6,2,0,2
31/03/2022 03:00,0,0,0,0,0,0,0,0,0,0,0,0,0,0,0,0,0,0,0,0,0,0,0,0,4,1,4,0,4,1,0,1
31/03/2022 04:00,2,2,0,0,0,0,0,0,0,0,0,0,3,3,0,0,0,0,1,1,0,3,0,3,0,2,1,0,1,3,0,3
31/03/2022 05:00,2,1,1,4,1,3,8,2,6,0,0,0,1,1,0,1,1,0,1,1,0,34,4,30,3,16,1,0,1,8,0,8
31/03/2022 06:00,19,18,1,11,10,1,19,17,2,0,0,0,14,14,0,6,6,0,6,6,0,114,20,94,15,64,12,0,12,37,0,37
31/03/2022 07:00,31,25,6,44,30,14,46,31,15,0,0,0,29,29,0,12,12,0,11,11,0,265,65,200,27,130,25,0,25,74,0,74
31/03/2022 08:00,65,57,8,72,51,21,87,67,20,0,0,0,41,41,0,30,30,0,90,90,0,474,88,386,48,258,55,1,54,167,0,167
31/03/2022 09:00,32,23,9,30,22,8,38,27,11,0,0,0,17,17,0,10,10,0,13,13,0,246,42,204,14,130,20,0,20,130,0,130
31/03/2022 10:00,10,6,4,22,9,13,38,13,25,0,0,0,17,16,1,10,10,0,4,4,0,109,34,75,24,41,10,0,10,75,0,75
31/03/2022 11:00,9,5,4,25,18,7,42,27,15,0,0,0,6,6,0,11,11,0,9,9,0,85,24,61,26,44,25,0,25,63,1,62
31/03/2022 12:00,16,7,9,17,8,9,37,20,17,0,0,0,8,8,0,14,14,0,12,12,0,112,33,79,40,48,64,2,62,108,0,108
31/03/2022 13:00,20,8,12,36,18,18,50,27,23,0,0,0,3,3,0,20,20,0,7,7,0,138,63,75,46,46,78,0,78,113,0,113
31/03/2022 14:00,17,9,8,34,16,18,52,26,26,0,0,0,4,4,0,15,15,0,11,11,0,123,61,62,51,34,91,1,90,98,1,97
31/03/2022 15:00,20,14,6,26,10,16,35,13,22,0,0,0,14,14,0,18,18,0,16,16,0,155,83,72,73,36,83,0,83,87,1,86
31/03/2022 16:00,26,11,15,63,28,35,81,32,49,0,0,0,13,13,0,20,20,0,25,25,0,188,102,86,149,53,102,0,102,76,0,76
31/03/2022 17:00,52,13,39,78,24,54,119,34,85,0,0,0,6,6,0,20,20,0,21,21,0,356,221,135,203,68,191,0,191,132,0,132
31/03/2022 18:00,20,4,16,94,24,70,123,35,88,0,0,0,11,11,0,24,24,0,12,12,0,332,198,134,186,53,189,0,189,158,2,156
31/03/2022 19:00,21,8,13,77,40,37,96,55,41,0,0,0,8,8,0,18,18,0,13,13,0,187,112,75,119,45,142,0,142,114,0,114
31/03/2022 20:00,15,4,11,27,13,14,43,22,21,0,0,0,10,10,0,14,14,0,6,6,0,150,76,74,89,37,102,2,100,108,1,107
31/03/2022 21:00,12,5,7,21,10,11,30,12,18,0,0,0,2,2,0,8,8,0,2,2,0,114,58,56,79,23,102,0,102,77,1,76
31/03/2022 22:00,9,3,6,9,5,4,8,1,7,0,0,0,4,4,0,8,8,0,4,4,0,86,49,37,56,22,78,1,77,60,0,60
31/03/2022 23:00,8,2,6,6,1,5,9,2,7,0,0,0,1,1,0,0,0,0,1,1,0,56,42,14,46,5,46,1,45,32,0,32
01/04/2022 00:00,3,2,1,1,0,1,2,0,2,0,0,0,0,0,0,0,0,0,1,1,0,26,21,5,40,5,32,1,31,9,0,9
01/04/2022 01:00,1,1,0,2,1,1,0,0,0,0,0,0,1,1,0,2,2,0,0,0,0,10,8,2,4,5,6,0,6,1,0,1
01/04/2022 02:00,1,0,1,1,1,0,1,0,1,0,0,0,0,0,0,0,0,0,0,0,0,11,9,2,10,2,9,1,8,4,0,4
01/04/2022 03:00,0,0,0,1,1,0,1,0,1,0,0,0,0,0,0,0,0,0,0,0,0,4,3,1,6,1,5,0,5,3,0,3
01/04/2022 04:00,1,1,0,2,2,0,3,2,1,0,0,0,2,2,0,0,0,0,2,2,0,6,1,5,6,2,2,0,2,2,0,2
01/04/2022 05:00,0,0,0,5,4,1,8,3,5,0,0,0,3,3,0,0,0,0,2,2,0,33,3,30,8,13,2,0,2,7,0,7
01/04/2022 06:00,11,9,2,10,8,2,17,14,3,0,0,0,15,15,0,6,6,0,7,7,0,110,24,86,21,67,12,0,12,36,0,36
01/04/2022 07:00,24,22,2,36,26,10,41,31,10,0,0,0,21,21,0,12,12,0,16,16,0,214,53,161,11,88,33,0,33,62,0,62
01/04/2022 08:00,55,50,5,53,37,16,72,51,21,0,0,0,16,16,0,28,28,0,78,78,0,368,81,287,33,207,55,2,53,156,0,156
01/04/2022 09:00,27,17,10,43,23,20,61,38,23,0,0,0,13,13,0,12,12,0,9,9,0,195,38,157,25,84,46,1,45,118,1,117
01/04/2022 10:00,18,13,5,55,22,33,58,24,34,0,0,0,12,12,0,3,3,0,0,0,0,93,26,67,29,60,11,0,11,88,0,88
01/04/2022 11:00,11,8,3,49,20,29,82,39,43,0,0,0,6,5,1,7,7,0,0,0,0,86,31,55,42,41,25,0,25,87,0,87
01/04/2022 12:00,15,6,9,60,34,26,67,33,34,0,0,0,5,5,0,14,14,0,0,0,0,127,59,68,45,55,65,0,65,90,0,90
01/04/2022 13:00,24,14,10,61,34,27,65,34,31,0,0,0,6,6,0,16,16,0,0,0,0,152,73,79,70,61,83,0,83,132,0,132
01/04/2022 14:00,19,13,6,43,21,22,64,28,36,0,0,0,3,3,0,17,17,0,0,0,0,149,70,79,76,53,106,0,106,107,0,107
01/04/2022 15:00,17,9,8,37,19,18,53,31,22,0,0,0,3,3,0,21,21,0,1,1,0,148,72,76,103,36,97,2,95,100,0,100
01/04/2022 16:00,36,17,19,51,21,30,78,28,50,0,0,0,3,3,0,28,28,0,1,1,0,212,116,96,115,42,124,2,122,127,0,127
01/04/2022 17:00,30,8,22,47,15,32,78,22,56,0,0,0,6,6,0,19,19,0,1,1,0,289,181,108,171,41,193,0,193,105,0,105
01/04/2022 18:00,15,5,10,33,9,24,52,15,37,0,0,0,7,7,0,7,7,0,1,1,0,201,135,66,130,47,153,1,152,115,0,115
01/04/2022 19:00,12,4,8,13,6,7,47,26,21,0,0,0,9,9,0,9,9,0,0,0,0,136,80,56,73,61,122,0,122,84,0,84
01/04/2022 20:00,13,5,8,8,2,6,17,5,12,0,0,0,3,3,0,7,7,0,0,0,0,108,62,46,47,38,106,0,106,101,2,99
01/04/2022 21:00,14,9,5,2,0,2,5,0,5,0,0,0,2,2,0,5,5,0,2,2,0,83,48,35,53,30,66,0,66,68,2,66
01/04/2022 22:00,7,4,3,5,2,3,11,4,7,0,0,0,1,1,0,3,3,0,3,3,0,73,43,30,46,21,43,0,43,46,1,45
01/04/2022 23:00,4,2,2,3,0,3,4,1,3,0,0,0,1,1,0,4,4,0,1,1,0,40,28,12,35,11,29,0,29,16,0,16
02/04/2022 00:00,1,0,1,2,1,1,4,1,3,0,0,0,0,0,0,1,1,0,0,0,0,34,25,9,23,6,15,0,15,11,0,11
02/04/2022 01:00,1,0,1,1,1,0,2,1,1,0,0,0,1,1,0,1,1,0,1,1,0,18,12,6,14,2,3,0,3,2,0,2
02/04/2022 02:00,1,0,1,0,0,0,0,0,0,0,0,0,1,1,0,0,0,0,0,0,0,15,13,2,16,3,21,1,20,5,0,5
02/04/2022 03:00,1,0,1,0,0,0,1,1,0,0,0,0,0,0,0,0,0,0,0,0,0,4,4,0,12,3,17,0,17,5,0,5
02/04/2022 04:00,0,0,0,3,1,2,2,1,1,0,0,0,0,0,0,0,0,0,1,1,0,5,4,1,3,2,3,0,3,3,0,3
02/04/2022 05:00,2,2,0,3,1,2,2,1,1,0,0,0,0,0,0,3,3,0,0,0,0,14,1,13,2,5,3,0,3,4,0,4
02/04/2022 06:00,5,5,0,6,5,1,9,4,5,0,0,0,3,3,0,0,0,0,4,4,0,33,10,23,9,13,8,0,8,15,0,15
02/04/2022 07:00,4,2,2,16,6,10,28,9,19,0,0,0,6,6,0,4,4,0,3,3,0,45,10,35,15,21,10,0,10,21,0,21
02/04/2022 08:00,8,5,3,39,18,21,35,15,20,0,0,0,8,8,0,1,1,0,4,4,0,43,13,30,17,27,12,0,12,20,0,20
02/04/2022 09:00,9,8,1,44,23,21,53,27,26,0,0,0,5,5,0,8,8,0,3,3,0,52,16,36,21,37,18,0,18,43,0,43
02/04/2022 10:00,5,5,0,61,27,34,73,35,38,0,0,0,6,6,0,6,6,0,1,1,0,86,30,56,22,43,19,0,19,67,0,67
02/04/2022 11:00,7,5,2,81,34,47,86,35,51,0,0,0,0,0,0,8,8,0,0,0,0,96,34,62,32,42,46,0,46,71,0,71
02/04/2022 12:00,13,8,5,96,60,36,134,69,65,0,0,0,4,4,0,14,14,0,0,0,0,108,40,68,40,30,67,2,65,103,1,102
02/04/2022 13:00,9,3,6,72,33,39,117,48,69,0,0,0,7,7,0,6,6,0,0,0,0,130,63,67,59,39,74,0,74,115,0,115
02/04/2022 14:00,16,10,6,78,48,30,99,51,48,0,0,0,2,2,0,9,9,0,0,0,0,113,43,70,46,56,93,0,93,97,2,95
02/04/2022 15:00,15,8,7,59,21,38,95,43,52,0,0,0,9,9,0,14,14,0,2,2,0,115,44,71,49,47,85,0,85,114,1,113
02/04/2022 16:00,11,8,3,69,37,32,101,50,51,0,0,0,10,10,0,5,5,0,0,0,0,110,50,60,49,44,103,0,103,92,0,92
02/04/2022 17:00,17,11,6,68,32,36,93,39,54,0,0,0,6,6,0,14,14,0,1,1,0,107,46,61,55,39,112,0,112,94,0,94
02/04/2022 18:00,14,8,6,49,33,16,73,47,26,0,0,0,8,8,0,5,5,0,0,0,0,112,52,60,55,34,102,0,102,102,0,102
02/04/2022 19:00,9,4,5,30,16,14,35,17,18,0,0,0,10,10,0,5,5,0,0,0,0,134,62,72,48,34,108,0,108,110,1,109
02/04/2022 20:00,11,4,7,11,7,4,26,17,9,0,0,0,1,1,0,5,5,0,1,1,0,91,45,46,57,41,91,0,91,98,1,97
02/04/2022 21:00,4,3,1,11,6,5,19,7,12,0,0,0,5,5,0,5,5,0,0,0,0,48,25,23,28,31,44,1,43,77,0,77
02/04/2022 22:00,2,1,1,4,3,1,4,3,1,0,0,0,3,3,0,4,4,0,0,0,0,55,34,21,37,20,43,0,43,51,1,50
02/04/2022 23:00,8,4,4,5,3,2,4,1,3,0,0,0,2,2,0,2,2,0,0,0,0,40,26,14,29,9,31,0,31,41,0,41
03/04/2022 00:00,4,2,2,1,0,1,5,0,5,0,0,0,2,2,0,1,1,0,0,0,0,30,18,12,29,9,37,0,37,19,0,19
03/04/2022 01:00,0,0,0,3,1,2,1,1,0,0,0,0,1,1,0,2,2,0,0,0,0,29,19,10,24,2,8,0,8,1,0,1
03/04/2022 02:00,0,0,0,0,0,0,0,0,0,0,0,0,1,1,0,0,0,0,0,0,0,14,8,6,11,6,18,0,18,7,0,7
03/04/2022 03:00,0,0,0,2,1,1,3,1,2,0,0,0,0,0,0,0,0,0,0,0,0,11,6,5,14,1,18,0,18,1,0,1
03/04/2022 04:00,0,0,0,2,1,1,4,2,2,0,0,0,0,0,0,0,0,0,0,0,0,5,3,2,9,1,8,0,8,5,0,5
03/04/2022 05:00,1,1,0,1,0,1,1,0,1,0,0,0,0,0,0,0,0,0,0,0,0,13,4,9,3,2,6,0,6,2,0,2
03/04/2022 06:00,1,1,0,8,3,5,8,3,5,0,0,0,0,0,0,1,1,0,0,0,0,21,3,18,5,9,2,0,2,7,0,7
03/04/2022 07:00,6,3,3,20,8,12,32,9,23,0,0,0,10,10,0,3,3,0,0,0,0,38,11,27,11,10,10,1,9,14,0,14
03/04/2022 08:00,5,1,4,80,27,53,84,34,50,0,0,0,9,9,0,4,4,0,0,0,0,29,5,24,12,23,19,0,19,24,0,24
03/04/2022 09:00,8,4,4,127,44,83,127,46,81,0,0,0,8,8,0,7,7,0,0,0,0,69,23,46,28,35,16,0,16,38,0,38
03/04/2022 10:00,11,10,1,186,75,111,199,78,121,0,0,0,15,14,1,6,6,0,0,0,0,81,19,62,32,26,27,0,27,44,0,44
03/04/2022 11:00,13,10,3,203,89,114,224,91,133,0,0,0,8,8,0,15,15,0,0,0,0,126,46,80,30,26,41,0,41,72,0,72
03/04/2022 12:00,13,9,4,168,93,75,218,117,101,0,0,0,1,1,0,7,7,0,0,0,0,142,42,100,47,55,56,0,56,70,0,70
03/04/2022 13:00,10,3,7,145,79,66,180,95,85,0,0,0,3,3,0,8,8,0,0,0,0,111,53,58,47,40,68,1,67,117,0,117
03/04/2022 14:00,28,18,10,110,63,47,142,72,70,0,0,0,4,4,0,22,22,0,0,0,0,116,52,64,59,43,78,0,78,91,1,90
03/04/2022 15:00,21,9,12,128,69,59,178,88,90,0,0,0,3,3,0,15,15,0,0,0,0,152,63,89,55,55,83,0,83,92,1,91
03/04/2022 16:00,19,12,7,104,57,47,173,93,80,0,0,0,4,4,0,9,9,0,0,0,0,137,63,74,46,58,73,0,73,109,1,108
03/04/2022 17:00,17,13,4,91,54,37,105,57,48,0,0,0,8,6,2,9,9,0,1,1,0,118,49,69,53,44,104,0,104,86,0,86
03/04/2022 18:00,17,8,9,46,23,23,61,30,31,0,0,0,3,3,0,4,4,0,0,0,0,128,63,65,53,44,110,0,110,102,1,101
03/04/2022 19:00,14,6,8,29,12,17,42,17,25,0,0,0,3,3,0,6,6,0,0,0,0,134,70,64,64,33,93,0,93,83,1,82
03/04/2022 20:00,12,6,6,17,13,4,27,18,9,0,0,0,7,7,0,1,1,0,3,3,0,62,36,26,51,25,86,0,86,74,0,74
03/04/2022 21:00,7,3,4,11,5,6,8,2,6,0,0,0,3,3,0,3,3,0,3,3,0,69,36,33,39,22,56,0,56,52,0,52
03/04/2022 22:00,3,2,1,5,2,3,9,7,2,0,0,0,1,1,0,2,2,0,0,0,0,44,29,15,32,22,43,0,43,29,0,29
03/04/2022 23:00,5,1,4,3,1,2,4,2,2,0,0,0,1,1,0,1,1,0,0,0,0,29,19,10,19,12,31,0,31,20,0,20
04/04/2022 00:00,3,2,1,1,0,1,2,0,2,0,0,0,0,0,0,1,1,0,0,0,0,6,6,0,14,0,16,0,16,7,0,7
04/04/2022 01:00,1,0,1,1,1,0,0,0,0,0,0,0,0,0,0,1,1,0,0,0,0,4,4,0,4,0,2,0,2,0,0,0
04/04/2022 02:00,1,0,1,0,0,0,0,0,0,0,0,0,0,0,0,0,0,0,0,0,0,4,2,2,7,1,6,0,6,1,0,1
04/04/2022 03:00,2,2,0,0,0,0,0,0,0,0,0,0,0,0,0,0,0,0,0,0,0,3,0,3,2,1,3,0,3,1,0,1
04/04/2022 04:00,1,1,0,3,2,1,5,2,3,0,0,0,1,1,0,1,1,0,0,0,0,9,1,8,1,3,2,0,2,1,0,1
04/04/2022 05:00,3,1,2,6,3,3,5,3,2,0,0,0,8,8,0,0,0,0,0,0,0,32,7,25,3,19,1,0,1,4,0,4
04/04/2022 06:00,15,14,1,17,13,4,17,13,4,0,0,0,17,16,1,6,6,0,2,2,0,97,13,84,12,57,12,0,12,32,0,32
04/04/2022 07:00,24,21,3,37,26,11,50,38,12,0,0,0,30,30,0,13,13,0,18,18,0,263,64,199,28,144,26,0,26,71,0,71
04/04/2022 08:00,56,47,9,60,46,14,71,53,18,0,0,0,37,37,0,31,31,0,43,43,0,435,88,347,32,245,49,1,48,161,1,160
04/04/2022 09:00,11,8,3,30,20,10,31,21,10,0,0,0,24,24,0,10,10,0,1,1,0,190,39,151,28,151,37,1,36,123,0,123
04/04/2022 10:00,13,11,2,31,18,13,46,17,29,0,0,0,11,11,0,7,7,0,0,0,0,69,16,53,13,37,25,1,24,66,2,64
04/04/2022 11:00,7,6,1,28,15,13,34,17,17,0,0,0,7,7,0,8,8,0,1,1,0,73,26,47,23,42,29,0,29,66,1,65
04/04/2022 12:00,15,9,6,27,16,11,36,18,18,0,0,0,4,4,0,2,2,0,2,2,0,91,33,58,33,29,45,0,45,70,0,70
04/04/2022 13:00,11,9,2,29,12,17,33,16,17,0,0,0,9,9,0,9,9,0,0,0,0,95,40,55,63,42,54,1,53,86,1,85
04/04/2022 14:00,15,10,5,26,10,16,40,14,26,0,0,0,10,10,0,16,16,0,0,0,0,113,56,57,60,45,72,0,72,77,0,77
04/04/2022 15:00,19,7,12,24,7,17,36,17,19,0,0,0,8,8,0,27,27,0,1,1,0,143,83,60,73,34,78,0,78,79,0,79
04/04/2022 16:00,31,11,20,36,13,23,60,18,42,0,0,0,5,5,0,22,22,0,0,0,0,204,113,91,135,51,108,1,107,79,0,79
04/04/2022 17:00,52,18,34,69,18,51,93,18,75,0,0,0,8,8,0,28,28,0,1,1,0,360,223,137,241,36,195,0,195,139,3,136
04/04/2022 18:00,34,8,26,55,13,42,85,28,57,0,0,0,5,5,0,17,17,0,0,0,0,285,189,96,175,44,190,1,189,120,1,119
04/04/2022 19:00,24,10,14,46,16,30,41,19,22,0,0,0,3,3,0,9,9,0,0,0,0,176,102,74,113,35,136,0,136,82,0,82
04/04/2022 20:00,12,2,10,31,14,17,30,10,20,0,0,0,4,4,0,9,9,0,0,0,0,119,69,50,48,35,116,2,114,79,1,78
04/04/2022 21:00,2,1,1,6,3,3,9,5,4,0,0,0,2,2,0,6,6,0,0,0,0,107,69,38,49,17,87,2,85,53,0,53
04/04/2022 22:00,2,2,0,6,1,5,9,1,8,0,0,0,3,3,0,4,4,0,0,0,0,49,38,11,42,14,53,0,53,33,2,31
04/04/2022 23:00,1,0,1,1,0,1,1,0,1,0,0,0,1,1,0,3,3,0,0,0,0,27,18,9,15,6,31,0,31,20,0,20
05/04/2022 00:00,0,0,0,2,1,1,4,0,4,0,0,0,3,2,1,1,1,0,0,0,0,11,7,4,16,3,11,0,11,8,1,7
05/04/2022 01:00,0,0,0,0,0,0,1,0,1,0,0,0,0,0,0,2,2,0,0,0,0,6,5,1,6,0,0,0,0,1,0,1
05/04/2022 02:00,0,0,0,0,0,0,2,2,0,0,0,0,0,0,0,0,0,0,0,0,0,3,2,1,5,2,6,0,6,1,0,1
05/04/2022 03:00,0,0,0,1,1,0,0,0,0,0,0,0,0,0,0,0,0,0,0,0,0,4,1,3,3,0,1,0,1,2,0,2
05/04/2022 04:00,1,1,0,1,1,0,1,0,1,0,0,0,0,0,0,0,0,0,0,0,0,7,1,6,2,2,1,0,1,4,0,4
05/04/2022 05:00,0,0,0,6,3,3,9,6,3,0,0,0,1,1,0,2,2,0,0,0,0,35,8,27,7,17,2,0,2,9,0,9
05/04/2022 06:00,13,10,3,18,14,4,23,16,7,0,0,0,12,12,0,4,4,0,2,2,0,122,12,110,20,65,15,0,15,39,0,39
05/04/2022 07:00,30,26,4,58,43,15,61,46,15,0,0,0,43,43,0,13,13,0,0,0,0,317,78,239,33,179,34,1,33,94,0,94
05/04/2022 08:00,78,65,13,75,57,18,77,58,19,0,0,0,53,52,1,36,36,0,0,0,0,526,90,436,43,323,58,0,58,218,3,215
05/04/2022 09:00,21,14,7,39,26,13,49,31,18,0,0,0,26,26,0,6,6,0,0,0,0,248,40,208,23,164,44,0,44,147,1,146
05/04/2022 10:00,12,6,6,38,22,16,42,16,26,0,0,0,17,17,0,4,4,0,0,0,0,98,28,70,24,66,24,0,24,71,0,71
05/04/2022 11:00,4,2,2,30,13,17,29,14,15,0,0,0,19,18,1,8,8,0,0,0,0,85,29,56,26,38,35,1,34,60,0,60
05/04/2022 12:00,19,11,8,32,14,18,32,13,19,0,0,0,7,7,0,6,6,0,0,0,0,97,34,63,44,46,74,1,73,105,0,105
05/04/2022 13:00,15,9,6,21,9,12,27,6,21,0,0,0,3,3,0,5,5,0,0,0,0,128,48,80,56,62,79,2,77,123,0,123
05/04/2022 14:00,11,8,3,51,25,26,54,22,32,0,0,0,4,4,0,12,12,0,0,0,0,100,49,51,62,33,77,0,77,70,0,70
05/04/2022 15:00,23,8,15,30,14,16,37,13,24,0,0,0,3,3,0,22,22,0,0,0,0,163,80,83,76,42,88,1,87,72,1,71
05/04/2022 16:00,34,13,21,43,17,26,53,19,34,0,0,0,12,12,0,17,17,0,0,0,0,241,146,95,148,50,113,0,113,80,1,79
05/04/2022 17:00,69,19,50,80,19,61,108,14,94,0,0,0,0,0,0,25,25,0,1,1,0,380,259,121,293,52,250,0,250,133,0,133
05/04/2022 18:00,38,7,31,69,13,56,105,22,83,0,0,0,5,5,0,18,18,0,0,0,0,325,222,103,237,47,193,1,192,114,3,111
05/04/2022 19:00,16,8,8,38,16,22,54,22,32,0,0,0,10,10,0,18,18,0,0,0,0,201,118,83,127,29,150,0,150,93,0,93
05/04/2022 20:00,14,8,6,20,13,7,20,7,13,0,0,0,4,4,0,10,10,0,0,0,0,107,63,44,63,15,113,1,112,70,0,70
05/04/2022 21:00,11,2,9,4,1,3,10,3,7,0,0,0,3,3,0,4,4,0,0,0,0,80,52,28,55,11,66,0,66,56,0,56
05/04/2022 22:00,9,5,4,7,1,6,11,2,9,0,0,0,4,4,0,2,2,0,1,1,0,53,38,15,43,12,23,0,23,45,2,43
05/04/2022 23:00,5,3,2,1,0,1,3,2,1,0,0,0,3,3,0,3,3,0,0,0,0,34,21,13,26,3,0,0,0,22,1,21
06/04/2022 00:00,1,0,1,3,1,2,7,2,5,0,0,0,1,1,0,1,1,0,0,0,0,19,17,2,19,4,11,0,11,6,0,6
06/04/2022 01:00,0,0,0,1,1,0,0,0,0,0,0,0,0,0,0,1,1,0,0,0,0,4,3,1,10,1,2,0,2,1,0,1
06/04/2022 02:00,0,0,0,1,1,0,1,1,0,0,0,0,0,0,0,0,0,0,0,0,0,4,4,0,3,3,7,0,7,1,0,1
06/04/2022 03:00,0,0,0,0,0,0,0,0,0,0,0,0,0,0,0,0,0,0,0,0,0,2,1,1,3,2,2,0,2,1,0,1
06/04/2022 04:00,1,1,0,1,1,0,1,0,1,0,0,0,1,1,0,2,2,0,0,0,0,5,1,4,2,4,1,0,1,3,0,3
06/04/2022 05:00,5,5,0,7,5,2,7,4,3,0,0,0,7,7,0,0,0,0,0,0,0,36,7,29,8,19,2,0,2,5,0,5
06/04/2022 06:00,12,10,2,9,7,2,11,6,5,0,0,0,8,8,0,6,6,0,1,1,0,90,13,77,14,74,14,0,14,34,0,34
06/04/2022 07:00,19,16,3,34,25,9,40,28,12,0,0,0,22,22,0,11,11,0,1,1,0,240,52,188,19,137,28,0,28,57,0,57
06/04/2022 08:00,82,71,11,60,52,8,76,64,12,0,0,0,20,20,0,23,23,0,0,0,0,500,90,410,32,305,51,1,50,171,0,171
06/04/2022 09:00,33,26,7,34,17,17,43,25,18,0,0,0,23,23,0,15,15,0,2,2,0,216,56,160,27,144,38,0,38,125,0,125
06/04/2022 10:00,13,8,5,29,13,16,30,15,15,0,0,0,15,15,0,5,5,0,0,0,0,72,23,49,17,45,23,0,23,72,0,72
06/04/2022 11:00,14,10,4,23,9,14,23,10,13,0,0,0,11,11,0,11,11,0,3,3,0,77,17,60,20,38,28,0,28,67,0,67
06/04/2022 12:00,18,11,7,22,14,8,25,14,11,0,0,0,4,4,0,14,14,0,0,0,0,86,33,53,36,48,74,0,74,74,0,74
06/04/2022 13:00,14,10,4,16,9,7,23,8,15,0,0,0,4,4,0,9,9,0,1,1,0,131,61,70,63,46,58,0,58,87,0,87
06/04/2022 14:00,19,7,12,21,7,14,27,9,18,0,0,0,6,6,0,14,14,0,0,0,0,94,40,54,59,26,53,0,53,78,1,77
06/04/2022 15:00,16,7,9,27,11,16,40,14,26,0,0,0,5,5,0,25,25,0,5,5,0,119,59,60,82,39,67,0,67,69,1,68
06/04/2022 16:00,32,14,18,29,7,22,36,6,30,0,0,0,5,5,0,24,24,0,1,1,0,194,107,87,131,50,123,1,122,59,0,59
06/04/2022 17:00,51,12,39,40,3,37,65,9,56,0,0,0,3,3,0,16,16,0,4,4,0,298,208,90,226,39,181,0,181,114,1,113
06/04/2022 18:00,42,5,37,35,6,29,64,8,56,0,0,0,0,0,0,12,12,0,2,2,0,285,184,101,218,38,171,0,171,98,1,97
06/04/2022 19:00,21,3,18,21,3,18,41,8,33,0,0,0,6,5,1,8,8,0,3,3,0,143,90,53,90,32,114,0,114,84,1,83
06/04/2022 20:00,13,5,8,15,7,8,14,2,12,0,0,0,0,0,0,7,7,0,7,7,0,101,65,36,68,21,100,0,100,64,0,64
06/04/2022 21:00,10,4,6,5,2,3,7,3,4,0,0,0,3,3,0,9,9,0,1,1,0,79,45,34,50,13,73,1,72,54,0,54
06/04/2022 22:00,5,2,3,5,2,3,4,1,3,0,0,0,3,3,0,7,7,0,0,0,0,54,33,21,34,8,59,0,59,36,1,35
06/04/2022 23:00,0,0,0,1,0,1,1,0,1,0,0,0,1,1,0,2,2,0,0,0,0,28,24,4,28,5,27,1,26,15,0,15
07/04/2022 00:00,2,1,1,0,0,0,4,2,2,0,0,0,0,0,0,1,1,0,0,0,0,18,16,2,16,2,15,0,15,8,0,8
07/04/2022 01:00,0,0,0,0,0,0,0,0,0,0,0,0,0,0,0,1,1,0,0,0,0,5,5,0,4,1,2,0,2,1,0,1
07/04/2022 02:00,0,0,0,0,0,0,2,1,1,0,0,0,0,0,0,0,0,0,0,0,0,5,4,1,5,1,6,0,6,2,0,2
07/04/2022 03:00,1,0,1,0,0,0,0,0,0,0,0,0,0,0,0,0,0,0,0,0,0,3,1,2,2,1,2,0,2,1,0,1
07/04/2022 04:00,0,0,0,3,2,1,2,0,2,0,0,0,2,2,0,0,0,0,0,0,0,4,1,3,1,3,0,0,0,1,0,1
07/04/2022 05:00,1,1,0,4,2,2,5,1,4,0,0,0,3,3,0,0,0,0,0,0,0,30,3,27,3,14,2,0,2,7,0,7
07/04/2022 06:00,17,14,3,8,7,1,13,12,1,0,0,0,10,9,1,3,3,0,1,1,0,107,14,93,14,56,12,0,12,34,0,34
07/04/2022 07:00,25,20,5,29,20,9,33,22,11,0,0,0,31,31,0,9,9,0,10,10,0,255,62,193,29,119,16,0,16,67,0,67
07/04/2022 08:00,70,65,5,45,32,13,61,44,17,0,0,0,62,62,0,23,23,0,74,74,0,436,80,356,34,194,47,1,46,160,1,159
07/04/2022 09:00,30,22,8,16,12,4,20,14,6,0,0,0,18,18,0,15,15,0,0,0,0,221,47,174,19,129,31,0,31,121,0,121
07/04/2022 10:00,13,6,7,18,8,10,11,4,7,0,0,0,20,20,0,3,3,0,0,0,0,102,23,79,16,45,28,0,28,65,1,64
07/04/2022 11:00,12,6,6,13,5,8,24,11,13,0,0,0,6,6,0,4,4,0,0,0,0,79,25,54,18,35,49,0,49,64,0,64
07/04/2022 12:00,12,4,8,15,10,5,20,11,9,0,0,0,5,5,0,10,10,0,0,0,0,96,33,63,43,36,63,1,62,105,0,105
07/04/2022 13:00,24,9,15,10,8,2,14,8,6,0,0,0,9,9,0,8,8,0,1,1,0,118,48,70,49,57,65,0,65,104,0,104
07/04/2022 14:00,11,7,4,12,6,6,28,7,21,0,0,0,2,2,0,9,9,0,0,0,0,101,42,59,64,43,70,1,69,87,0,87
07/04/2022 15:00,17,7,10,29,8,21,40,11,29,0,0,0,2,2,0,26,26,0,1,1,0,131,69,62,76,47,95,0,95,83,0,83
07/04/2022 16:00,24,12,12,52,21,31,53,17,36,0,0,0,6,6,0,26,26,0,1,1,0,209,115,94,119,67,128,0,128,96,0,96
07/04/2022 17:00,59,12,47,74,31,43,94,24,70,0,0,0,11,11,0,27,27,0,7,7,0,326,222,104,209,42,218,0,218,116,0,116
07/04/2022 18:00,42,16,26,100,32,68,117,37,80,0,0,0,11,11,0,22,22,0,2,2,0,269,167,102,192,49,188,0,188,133,0,133
07/04/2022 19:00,14,4,10,63,27,36,68,29,39,0,0,0,19,18,1,20,20,0,3,3,0,164,88,76,101,46,167,1,166,128,2,126
07/04/2022 20:00,13,8,5,29,17,12,44,23,21,0,0,0,11,11,0,8,8,0,0,0,0,137,76,61,76,54,129,2,127,108,0,108
07/04/2022 21:00,11,2,9,11,3,8,15,4,11,0,0,0,9,9,0,6,6,0,0,0,0,98,56,42,56,31,91,0,91,82,0,82
07/04/2022 22:00,6,1,5,7,3,4,11,2,9,0,0,0,5,5,0,6,6,0,0,0,0,74,48,26,41,21,62,1,61,35,0,35
07/04/2022 23:00,4,1,3,5,2,3,6,1,5,0,0,0,6,6,0,1,1,0,0,0,0,59,39,20,39,6,42,0,42,29,0,29
08/04/2022 00:00,3,1,2,2,2,0,3,2,1,0,0,0,0,0,0,5,5,0,0,0,0,29,23,6,14,7,43,0,43,20,0,20
08/04/2022 01:00,0,0,0,0,0,0,0,0,0,0,0,0,0,0,0,0,0,0,0,0,0,8,7,1,9,1,8,0,8,0,0,0
08/04/2022 02:00,0,0,0,0,0,0,2,2,0,0,0,0,0,0,0,0,0,0,0,0,0,2,2,0,4,4,9,0,9,3,1,2
08/04/2022 03:00,0,0,0,1,0,1,1,0,1,0,0,0,1,1,0,0,0,0,0,0,0,8,6,2,9,1,5,0,5,1,0,1
08/04/2022 04:00,4,3,1,4,2,2,3,1,2,0,0,0,0,0,0,0,0,0,0,0,0,10,4,6,3,4,3,0,3,2,0,2
08/04/2022 05:00,0,0,0,2,2,0,5,2,3,0,0,0,7,7,0,1,1,0,0,0,0,32,4,28,6,15,7,0,7,7,0,7
08/04/2022 06:00,14,11,3,19,12,7,20,15,5,0,0,0,16,16,0,6,6,0,2,2,0,110,14,96,9,66,15,1,14,38,0,38
08/04/2022 07:00,20,15,5,44,33,11,49,33,16,0,0,0,23,23,0,11,11,0,1,1,0,212,67,145,29,120,22,0,22,68,0,68
08/04/2022 08:00,61,56,5,58,46,12,78,56,22,0,0,0,34,34,0,27,27,0,2,2,0,376,83,293,49,184,45,0,45,138,1,137
08/04/2022 09:00,32,30,2,47,19,28,65,26,39,0,0,0,11,10,1,9,9,0,3,3,0,197,57,140,27,111,47,0,47,128,0,128
08/04/2022 10:00,6,3,3,55,30,25,65,31,34,0,0,0,14,14,0,8,8,0,6,6,0,95,26,69,18,71,31,1,30,74,0,74
08/04/2022 11:00,8,3,5,49,27,22,71,38,33,0,0,0,9,9,0,16,16,0,4,4,0,96,32,64,38,45,44,1,43,88,0,88
08/04/2022 12:00,8,5,3,56,24,32,68,34,34,0,0,0,8,8,0,15,15,0,4,4,0,136,60,76,60,49,81,1,80,113,0,113
08/04/2022 13:00,13,7,6,33,13,20,38,14,24,0,0,0,7,7,0,17,17,0,2,2,0,133,52,81,60,36,101,0,101,115,1,114
08/04/2022 14:00,24,14,10,23,9,14,44,15,29,0,0,0,9,9,0,11,11,0,6,6,0,123,46,77,75,38,76,0,76,96,1,95
08/04/2022 15:00,17,4,13,32,11,21,50,20,30,0,0,0,5,5,0,15,15,0,6,6,0,135,71,64,99,40,102,1,101,89,0,89
08/04/2022 16:00,34,14,20,49,17,32,53,18,35,0,0,0,9,9,0,17,17,0,16,16,0,208,120,88,116,50,124,0,124,91,0,91
08/04/2022 17:00,35,11,24,56,17,39,84,16,68,0,0,0,3,2,1,21,21,0,8,8,0,274,165,109,194,56,151,0,151,104,1,103
08/04/2022 18:00,28,13,15,52,23,29,70,25,45,0,0,0,13,12,1,16,16,0,9,9,0,220,116,104,130,64,169,0,169,112,0,112
08/04/2022 19:00,25,13,12,24,8,16,26,7,19,0,0,0,8,8,0,9,9,0,12,12,0,142,71,71,79,50,135,0,135,153,1,152
08/04/2022 20:00,13,5,8,12,6,6,27,11,16,0,0,0,5,5,0,10,10,0,8,8,0,124,71,53,70,49,118,0,118,141,1,140
08/04/2022 21:00,3,1,2,11,4,7,18,6,12,0,0,0,11,11,0,0,0,0,1,1,0,114,72,42,66,32,87,0,87,80,1,79
08/04/2022 22:00,11,5,6,4,0,4,9,2,7,0,0,0,10,10,0,3,3,0,6,6,0,73,46,27,44,16,76,0,76,58,1,57
08/04/2022 23:00,6,1,5,1,0,1,2,0,2,0,0,0,2,2,0,5,5,0,2,2,0,55,38,17,39,10,54,0,54,42,0,42
09/04/2022 00:00,1,1,0,1,0,1,6,0,6,0,0,0,1,1,0,2,2,0,3,3,0,23,15,8,29,8,39,1,38,23,0,23
09/04/2022 01:00,0,0,0,0,0,0,1,0,1,0,0,0,0,0,0,2,2,0,0,0,0,22,14,8,15,7,13,0,13,0,0,0
09/04/2022 02:00,0,0,0,0,0,0,0,0,0,0,0,0,0,0,0,0,0,0,0,0,0,15,9,6,7,8,25,1,24,6,0,6
09/04/2022 03:00,0,0,0,1,0,1,1,0,1,0,0,0,1,1,0,0,0,0,0,0,0,6,3,3,14,2,17,0,17,4,0,4
09/04/2022 04:00,1,1,0,2,0,2,4,1,3,0,0,0,0,0,0,0,0,0,0,0,0,6,4,2,10,2,7,0,7,3,0,3
09/04/2022 05:00,0,0,0,3,1,2,2,0,2,0,0,0,2,2,0,0,0,0,0,0,0,11,1,10,0,8,2,0,2,6,0,6
09/04/2022 06:00,3,3,0,4,3,1,10,5,5,0,0,0,4,4,0,2,2,0,0,0,0,21,3,18,6,8,7,0,7,13,0,13
09/04/2022 07:00,6,4,2,52,21,31,51,21,30,0,0,0,8,8,0,7,7,0,0,0,0,55,10,45,24,32,13,0,13,19,0,19
09/04/2022 08:00,6,5,1,64,25,39,63,26,37,0,0,0,9,9,0,5,5,0,0,0,0,84,30,54,17,41,16,0,16,35,0,35
09/04/2022 09:00,14,12,2,119,47,72,117,42,75,0,0,0,2,2,0,10,10,0,0,0,0,78,24,54,18,43,17,0,17,68,0,68
09/04/2022 10:00,23,17,6,134,52,82,166,55,111,0,0,0,9,9,0,16,16,0,0,0,0,112,37,75,34,48,31,0,31,69,1,68
09/04/2022 11:00,11,7,4,186,93,93,216,99,117,0,0,0,6,6,0,11,11,0,0,0,0,127,28,99,38,50,57,0,57,96,0,96
09/04/2022 12:00,11,4,7,192,99,93,196,91,105,0,0,0,10,10,0,12,12,0,0,0,0,105,27,78,65,47,71,0,71,111,0,111
09/04/2022 13:00,22,9,13,129,64,65,153,73,80,0,0,0,2,2,0,9,9,0,1,1,0,109,28,81,59,44,79,0,79,118,1,117
09/04/2022 14:00,25,11,14,133,69,64,161,70,91,0,0,0,10,10,0,11,11,0,15,15,0,142,53,89,85,60,88,1,87,114,1,113
09/04/2022 15:00,16,9,7,126,73,53,142,77,65,0,0,0,18,18,0,12,12,0,19,19,0,112,51,61,63,45,89,0,89,116,0,116
09/04/2022 16:00,17,8,9,83,45,38,112,62,50,0,0,0,21,21,0,10,10,0,21,21,0,118,52,66,58,52,109,0,109,92,0,92
09/04/2022 17:00,9,4,5,76,46,30,108,61,47,0,0,0,20,20,0,18,18,0,10,10,0,105,49,56,69,54,121,1,120,89,0,89
09/04/2022 18:00,18,8,10,32,19,13,45,23,22,0,0,0,11,11,0,4,4,0,13,13,0,121,59,62,60,55,131,0,131,93,1,92
09/04/2022 19:00,11,9,2,38,21,17,43,22,21,0,0,0,6,6,0,7,7,0,8,8,0,109,62,47,65,47,106,1,105,121,2,119
09/04/2022 20:00,10,7,3,10,6,4,22,12,10,0,0,0,5,5,0,3,3,0,6,6,0,85,42,43,35,40,106,0,106,102,0,102
09/04/2022 21:00,5,4,1,18,10,8,22,10,12,0,0,0,7,7,0,2,2,0,4,4,0,63,37,26,40,34,59,0,59,66,1,65
09/04/2022 22:00,13,7,6,4,2,2,7,3,4,0,0,0,3,3,0,5,5,0,2,2,0,44,22,22,25,12,73,0,73,60,0,60
09/04/2022 23:00,1,1,0,2,0,2,1,0,1,0,0,0,1,1,0,1,1,0,1,1,0,37,19,18,23,11,40,0,40,42,0,42
10/04/2022 00:00,4,1,3,3,0,3,5,1,4,0,0,0,2,2,0,2,2,0,0,0,0,24,19,5,23,6,33,0,33,20,0,20
10/04/2022 01:00,1,0,1,1,1,0,0,0,0,0,0,0,1,1,0,0,0,0,0,0,0,15,13,2,16,5,6,0,6,3,0,3
10/04/2022 02:00,0,0,0,0,0,0,0,0,0,0,0,0,1,1,0,0,0,0,0,0,0,15,12,3,7,4,16,0,16,10,0,10
10/04/2022 03:00,1,1,0,0,0,0,1,1,0,0,0,0,1,1,0,0,0,0,0,0,0,8,6,2,12,0,15,1,14,7,0,7
10/04/2022 04:00,0,0,0,2,1,1,1,0,1,0,0,0,1,1,0,0,0,0,0,0,0,6,4,2,6,3,9,0,9,4,0,4
10/04/2022 05:00,3,2,1,0,0,0,0,0,0,0,0,0,0,0,0,0,0,0,0,0,0,9,3,6,5,3,6,0,6,3,0,3
10/04/2022 06:00,1,1,0,9,4,5,7,2,5,0,0,0,1,1,0,0,0,0,0,0,0,15,4,11,8,8,4,0,4,9,0,9
10/04/2022 07:00,3,2,1,26,8,18,33,7,26,0,0,0,6,6,0,4,4,0,0,0,0,23,7,16,17,16,7,0,7,16,0,16
10/04/2022 08:00,4,2,2,98,30,68,101,35,66,0,0,0,0,0,0,7,7,0,0,0,0,52,10,42,14,40,18,0,18,20,0,20
10/04/2022 09:00,7,4,3,127,60,67,132,58,74,0,0,0,0,0,0,7,7,0,0,0,0,69,20,49,14,37,15,0,15,41,0,41
10/04/2022 10:00,9,9,0,99,51,48,126,55,71,0,0,0,0,0,0,11,11,0,0,0,0,73,19,54,22,27,27,0,27,55,0,55
10/04/2022 11:00,12,6,6,122,62,60,129,55,74,0,0,0,0,0,0,19,19,0,0,0,0,98,26,72,20,40,38,0,38,67,0,67
10/04/2022 12:00,13,6,7,73,44,29,92,45,47,0,0,0,0,0,0,13,13,0,0,0,0,87,32,55,42,55,42,1,41,88,0,88
10/04/2022 13:00,16,11,5,67,35,32,93,37,56,0,0,0,3,3,0,4,4,0,0,0,0,97,45,52,51,45,65,2,63,89,0,89
10/04/2022 14:00,19,9,10,53,28,25,81,38,43,0,0,0,2,2,0,10,10,0,3,3,0,123,58,65,43,52,82,0,82,92,0,92
10/04/2022 15:00,9,8,1,55,30,25,63,35,28,0,0,0,5,5,0,10,10,0,3,3,0,103,49,54,44,51,75,1,74,88,0,88
10/04/2022 16:00,16,9,7,46,27,19,48,26,22,0,0,0,9,9,0,11,11,0,3,3,0,103,46,57,51,39,77,0,77,89,1,88
10/04/2022 17:00,11,5,6,18,9,9,36,18,18,0,0,0,6,6,0,7,7,0,4,4,0,82,36,46,58,30,94,1,93,72,0,72
10/04/2022 18:00,16,8,8,15,10,5,16,8,8,0,0,0,13,13,0,7,7,0,3,3,0,109,59,50,54,41,90,1,89,82,2,80
10/04/2022 19:00,13,6,7,18,8,10,25,14,11,0,0,0,6,6,0,5,5,0,6,6,0,101,56,45,50,44,94,0,94,72,0,72
10/04/2022 20:00,8,5,3,13,9,4,25,16,9,0,0,0,4,4,0,7,7,0,2,2,0,73,42,31,46,36,83,1,82,76,1,75
10/04/2022 21:00,11,7,4,5,2,3,5,1,4,0,0,0,7,7,0,3,3,0,2,2,0,60,35,25,41,26,68,0,68,59,1,58
10/04/2022 22:00,9,4,5,2,2,0,3,1,2,0,0,0,5,5,0,4,4,0,2,2,0,48,33,15,27,10,14,1,13,36,0,36
10/04/2022 23:00,2,0,2,2,2,0,1,1,0,0,0,0,0,0,0,1,1,0,1,1,0,29,23,6,25,12,0,0,0,14,1,13
11/04/2022 00:00,0,0,0,1,0,1,1,0,1,0,0,0,0,0,0,0,0,0,1,1,0,6,4,2,15,4,5,0,5,9,0,9
11/04/2022 01:00,2,2,0,1,1,0,0,0,0,0,0,0,1,1,0,0,0,0,0,0,0,5,3,2,3,3,5,0,5,1,0,1
11/04/2022 02:00,1,1,0,1,0,1,1,0,1,0,0,0,0,0,0,0,0,0,0,0,0,6,4,2,5,0,2,0,2,2,0,2
11/04/2022 03:00,0,0,0,0,0,0,0,0,0,0,0,0,0,0,0,0,0,0,0,0,0,4,1,3,2,2,2,0,2,1,0,1
11/04/2022 04:00,3,1,2,3,2,1,5,3,2,0,0,0,1,1,0,0,0,0,0,0,0,7,1,6,2,8,1,0,1,2,0,2
11/04/2022 05:00,1,1,0,3,2,1,3,1,2,0,0,0,3,3,0,2,2,0,0,0,0,30,3,27,2,24,3,0,3,5,0,5
11/04/2022 06:00,14,13,1,17,12,5,16,12,4,0,0,0,15,15,0,5,5,0,3,3,0,110,17,93,15,72,10,0,10,36,0,36
11/04/2022 07:00,22,20,2,42,30,12,51,35,16,0,0,0,28,28,0,17,17,0,8,8,0,236,56,180,32,144,21,0,21,73,0,73
11/04/2022 08:00,60,55,5,49,37,12,72,53,19,0,0,0,35,34,1,23,23,0,18,18,0,402,82,320,44,215,45,0,45,149,0,149
11/04/2022 09:00,21,19,2,26,18,8,43,29,14,0,0,0,30,30,0,13,13,0,20,20,0,194,37,157,15,83,27,0,27,125,0,125
11/04/2022 10:00,11,8,3,49,32,17,58,29,29,0,0,0,22,22,0,11,11,0,0,0,0,76,31,45,25,38,21,0,21,54,0,54
11/04/2022 11:00,7,4,3,21,11,10,40,19,21,0,0,0,8,8,0,7,7,0,10,10,0,82,25,57,27,45,41,0,41,66,1,65
11/04/2022 12:00,8,1,7,16,11,5,28,13,15,0,0,0,3,3,0,8,8,0,5,5,0,53,21,32,43,28,38,0,38,49,0,49
11/04/2022 13:00,12,5,7,23,7,16,23,12,11,0,0,0,1,1,0,4,4,0,5,5,0,93,39,54,36,46,58,0,58,75,0,75
11/04/2022 14:00,18,6,12,21,8,13,25,10,15,0,0,0,5,5,0,10,10,0,10,10,0,99,49,50,65,34,64,0,64,69,1,68
11/04/2022 15:00,19,6,13,25,9,16,29,12,17,0,0,0,4,4,0,10,10,0,6,6,0,103,50,53,77,24,62,1,61,57,1,56
11/04/2022 16:00,26,15,11,34,11,23,45,15,30,0,0,0,6,6,0,17,17,0,18,18,0,191,119,72,132,33,120,0,120,85,1,84
11/04/2022 17:00,59,25,34,65,13,52,83,20,63,0,0,0,4,4,0,29,29,0,13,13,0,334,211,123,220,53,193,0,193,93,2,91
11/04/2022 18:00,36,14,22,64,16,48,89,25,64,0,0,0,11,11,0,11,11,0,18,18,0,245,153,92,173,37,186,0,186,117,1,116
11/04/2022 19:00,21,9,12,47,21,26,55,19,36,0,0,0,3,3,0,15,15,0,9,9,0,175,105,70,72,31,132,0,132,103,0,103
11/04/2022 20:00,16,7,9,18,9,9,31,15,16,0,0,0,3,3,0,11,11,0,1,1,0,68,26,42,73,29,108,0,108,84,2,82
11/04/2022 21:00,10,5,5,13,5,8,18,6,12,0,0,0,3,3,0,10,10,0,9,9,0,67,44,23,64,20,79,0,79,51,0,51
11/04/2022 22:00,7,3,4,8,5,3,18,7,11,0,0,0,5,5,0,4,4,0,3,3,0,52,34,18,24,16,46,0,46,34,3,31
11/04/2022 23:00,7,3,4,6,3,3,4,1,3,0,0,0,1,1,0,1,1,0,2,2,0,32,18,14,14,6,31,0,31,14,2,12
12/04/2022 00:00,0,0,0,0,0,0,1,1,0,0,0,0,0,0,0,0,0,0,1,1,0,11,8,3,16,3,14,0,14,2,0,2
12/04/2022 01:00,2,1,1,0,0,0,0,0,0,0,0,0,2,2,0,0,0,0,1,1,0,6,5,1,13,3,2,0,2,0,0,0
12/04/2022 02:00,0,0,0,2,2,0,2,0,2,0,0,0,0,0,0,0,0,0,0,0,0,6,2,4,3,2,1,1,0,2,0,2
12/04/2022 03:00,0,0,0,0,0,0,0,0,0,0,0,0,0,0,0,0,0,0,0,0,0,2,0,2,1,0,7,0,7,2,0,2
12/04/2022 04:00,1,1,0,3,2,1,3,1,2,0,0,0,2,2,0,0,0,0,0,0,0,5,0,5,2,1,0,0,0,2,0,2
12/04/2022 05:00,1,1,0,2,0,2,3,1,2,0,0,0,6,6,0,1,1,0,0,0,0,37,7,30,5,22,4,0,4,6,0,6
12/04/2022 06:00,15,15,0,30,19,11,31,23,8,0,0,0,18,18,0,5,5,0,0,0,0,129,17,112,17,75,16,2,14,36,0,36
12/04/2022 07:00,33,29,4,53,43,10,53,38,15,0,0,0,24,23,1,14,14,0,1,1,0,275,78,197,24,193,23,1,22,79,0,79
12/04/2022 08:00,58,50,8,48,40,8,73,61,12,0,0,0,50,50,0,16,16,0,6,6,0,420,84,336,24,236,60,2,58,140,0,140
12/04/2022 09:00,12,10,2,18,14,4,21,15,6,0,0,0,15,15,0,8,8,0,2,2,0,151,31,120,8,76,26,0,26,92,0,92
12/04/2022 10:00,5,2,3,7,2,5,8,2,6,0,0,0,9,9,0,3,3,0,0,0,0,58,17,41,8,22,20,0,20,49,0,49
12/04/2022 11:00,6,5,1,6,2,4,13,7,6,0,0,0,6,6,0,1,1,0,0,0,0,45,23,22,10,14,21,0,21,25,0,25
12/04/2022 12:00,4,2,2,8,4,4,12,5,7,0,0,0,3,3,0,10,10,0,0,0,0,66,22,44,32,20,37,0,37,53,0,53
12/04/2022 13:00,10,5,5,13,7,6,23,11,12,0,0,0,3,3,0,4,4,0,5,5,0,98,43,55,41,36,60,1,59,82,0,82
12/04/2022 14:00,7,2,5,20,7,13,22,9,13,0,0,0,2,2,0,7,7,0,2,2,0,86,29,57,48,26,60,0,60,73,0,73
12/04/2022 15:00,10,6,4,16,6,10,19,6,13,0,0,0,6,6,0,8,8,0,8,8,0,112,56,56,57,23,67,0,67,57,1,56
12/04/2022 16:00,16,9,7,25,6,19,29,11,18,0,0,0,2,2,0,12,12,0,3,3,0,191,116,75,140,35,103,0,103,77,0,77
12/04/2022 17:00,39,15,24,53,12,41,74,16,58,0,0,0,1,1,0,17,17,0,0,0,0,305,203,102,280,43,191,1,190,114,0,114
12/04/2022 18:00,37,11,26,53,13,40,80,15,65,0,0,0,8,8,0,26,26,0,0,0,0,270,173,97,180,39,164,0,164,95,0,95
12/04/2022 19:00,12,6,6,38,14,24,50,18,32,0,0,0,2,2,0,16,16,0,7,7,0,153,91,62,91,36,101,0,101,92,1,91
12/04/2022 20:00,12,6,6,32,14,18,37,19,18,0,0,0,5,4,1,9,9,0,1,1,0,96,57,39,54,25,88,0,88,70,0,70
12/04/2022 21:00,5,4,1,15,8,7,14,5,9,0,0,0,8,8,0,5,5,0,4,4,0,67,38,29,47,21,57,0,57,41,0,41
12/04/2022 22:00,7,4,3,5,2,3,12,3,9,0,0,0,1,1,0,5,5,0,0,0,0,70,44,26,47,15,12,0,12,35,1,34
12/04/2022 23:00,4,2,2,5,2,3,7,2,5,0,0,0,2,2,0,1,1,0,0,0,0,35,23,12,23,6,0,0,0,19,1,18
13/04/2022 00:00,0,0,0,0,0,0,4,2,2,0,0,0,0,0,0,1,1,0,0,0,0,30,19,11,15,0,20,1,19,12,0,12
13/04/2022 01:00,0,0,0,0,0,0,0,0,0,0,0,0,0,0,0,0,0,0,0,0,0,8,7,1,4,1,7,1,6,1,0,1
13/04/2022 02:00,0,0,0,0,0,0,0,0,0,0,0,0,1,1,0,0,0,0,0,0,0,2,1,1,4,0,3,0,3,3,0,3
13/04/2022 03:00,0,0,0,0,0,0,2,1,1,0,0,0,1,1,0,0,0,0,1,1,0,3,2,1,0,3,3,0,3,0,0,0
13/04/2022 04:00,2,0,2,1,1,0,4,3,1,0,0,0,2,2,0,0,0,0,2,2,0,8,1,7,2,1,5,0,5,3,0,3
13/04/2022 05:00,1,1,0,4,1,3,3,1,2,0,0,0,6,6,0,1,1,0,1,1,0,24,5,19,2,22,4,0,4,4,0,4
13/04/2022 06:00,15,14,1,28,20,8,36,26,10,0,0,0,16,16,0,5,5,0,2,2,0,133,27,106,22,87,13,1,12,39,0,39
13/04/2022 07:00,31,28,3,70,57,13,81,64,17,0,0,0,32,32,0,22,22,0,9,9,0,261,71,190,23,151,22,0,22,69,2,67
13/04/2022 08:00,83,77,6,77,58,19,99,79,20,0,0,0,40,40,0,17,17,0,13,13,0,511,100,411,33,310,52,3,49,161,2,159
13/04/2022 09:00,19,13,6,55,33,22,68,40,28,0,0,0,25,25,0,14,14,0,10,10,0,209,46,163,28,154,51,0,51,152,1,151
13/04/2022 10:00,14,12,2,57,23,34,55,19,36,0,0,0,6,6,0,9,9,0,7,7,0,111,34,77,22,51,22,0,22,70,0,70
13/04/2022 11:00,16,9,7,78,41,37,82,43,39,0,0,0,14,14,0,6,6,0,9,9,0,73,22,51,38,56,33,0,33,79,0,79
13/04/2022 12:00,13,6,7,64,26,38,86,45,41,0,0,0,8,8,0,9,9,0,6,6,0,124,42,82,58,70,69,0,69,104,1,103
13/04/2022 13:00,25,20,5,67,32,35,95,40,55,0,0,0,8,8,0,14,14,0,6,6,0,133,53,80,70,66,88,1,87,111,1,110
13/04/2022 14:00,20,11,9,46,25,21,85,42,43,0,0,0,1,1,0,12,12,0,4,4,0,110,66,44,66,47,77,0,77,87,0,87
13/04/2022 15:00,17,10,7,79,38,41,104,46,58,0,0,0,5,5,0,21,21,0,12,12,0,121,61,60,87,43,94,0,94,86,0,86
13/04/2022 16:00,26,9,17,66,24,42,91,25,66,0,0,0,5,5,0,19,19,0,16,16,0,229,128,101,155,47,139,1,138,82,0,82
13/04/2022 17:00,47,17,30,106,39,67,161,52,109,0,0,0,11,11,0,24,24,0,18,18,0,370,220,150,257,60,230,1,229,122,2,120
13/04/2022 18:00,47,19,28,153,44,109,189,51,138,0,0,0,12,12,0,21,21,0,7,7,0,305,195,110,195,27,194,1,193,117,0,117
13/04/2022 19:00,22,7,15,129,63,66,145,65,80,0,0,0,8,8,0,22,22,0,4,4,0,212,130,82,108,40,146,0,146,111,1,110
13/04/2022 20:00,15,9,6,56,27,29,89,42,47,0,0,0,7,7,0,18,18,0,9,9,0,162,81,81,81,46,118,0,118,113,0,113
13/04/2022 21:00,10,4,6,28,16,12,41,17,24,0,0,0,5,5,0,7,7,0,0,0,0,80,55,25,56,17,86,0,86,75,0,75
13/04/2022 22:00,12,5,7,13,8,5,21,10,11,0,0,0,3,3,0,4,4,0,0,0,0,80,47,33,55,14,76,0,76,53,0,53
13/04/2022 23:00,4,2,2,5,1,4,8,2,6,0,0,0,3,3,0,5,5,0,2,2,0,55,41,14,25,8,58,0,58,32,0,32
14/04/2022 00:00,0,0,0,3,1,2,6,2,4,0,0,0,1,1,0,2,2,0,1,1,0,22,13,9,24,5,24,0,24,12,0,12
14/04/2022 01:00,0,0,0,0,0,0,0,0,0,0,0,0,1,1,0,2,2,0,1,1,0,10,9,1,10,2,4,0,4,0,0,0
14/04/2022 02:00,0,0,0,1,1,0,3,2,1,0,0,0,0,0,0,0,0,0,1,1,0,7,4,3,6,2,9,0,9,4,0,4
14/04/2022 03:00,2,0,2,0,0,0,2,1,1,0,0,0,0,0,0,1,1,0,0,0,0,3,3,0,8,0,4,0,4,3,0,3
14/04/2022 04:00,1,1,0,4,4,0,4,3,1,0,0,0,4,4,0,0,0,0,2,2,0,7,0,7,3,2,2,0,2,1,0,1
14/04/2022 05:00,2,2,0,3,2,1,2,1,1,0,0,0,8,8,0,0,0,0,0,0,0,31,6,25,5,25,3,0,3,8,0,8
14/04/2022 06:00,13,10,3,26,18,8,22,15,7,0,0,0,15,15,0,5,5,0,0,0,0,107,16,91,15,63,16,0,16,28,0,28
14/04/2022 07:00,29,28,1,60,40,20,63,41,22,0,0,0,32,32,0,14,14,0,0,0,0,234,57,177,28,144,25,1,24,69,0,69
14/04/2022 08:00,57,51,6,61,45,16,94,64,30,0,0,0,45,44,1,25,25,0,0,0,0,398,77,321,25,237,45,0,45,170,2,168
14/04/2022 09:00,23,20,3,42,27,15,53,32,21,0,0,0,33,33,0,12,12,0,1,1,0,206,31,175,26,118,51,1,50,129,1,128
14/04/2022 10:00,17,14,3,56,23,33,60,18,42,0,0,0,9,9,0,7,7,0,0,0,0,94,24,70,24,59,34,0,34,83,0,83
14/04/2022 11:00,7,4,3,53,26,27,62,30,32,0,0,0,12,12,0,6,6,0,1,1,0,93,31,62,29,52,54,0,54,87,0,87
14/04/2022 12:00,12,5,7,54,31,23,61,34,27,0,0,0,18,18,0,10,10,0,0,0,0,107,41,66,54,37,78,0,78,123,0,123
14/04/2022 13:00,22,12,10,48,19,29,60,27,33,0,0,0,12,12,0,16,16,0,1,1,0,132,57,75,64,60,82,2,80,117,1,116
14/04/2022 14:00,21,11,10,43,21,22,56,28,28,0,0,0,12,12,0,11,11,0,0,0,0,115,56,59,74,61,88,0,88,64,0,64
14/04/2022 15:00,20,7,13,39,19,20,63,26,37,0,0,0,12,12,0,9,9,0,0,0,0,116,66,50,74,45,94,0,94,82,0,82
14/04/2022 16:00,27,8,19,46,18,28,74,28,46,0,0,0,15,15,0,19,19,0,3,3,0,194,118,76,128,55,125,0,125,98,0,98
14/04/2022 17:00,40,15,25,79,30,49,102,27,75,0,0,0,17,17,0,24,24,0,0,0,0,300,189,111,215,64,203,0,203,136,1,135
14/04/2022 18:00,47,20,27,97,39,58,103,31,72,0,0,0,20,20,0,15,15,0,0,0,0,239,154,85,175,52,185,1,184,125,1,124
14/04/2022 19:00,19,9,10,63,29,34,81,31,50,0,0,0,17,17,0,9,9,0,0,0,0,170,93,77,109,47,115,0,115,153,0,153
14/04/2022 20:00,19,13,6,33,15,18,52,22,30,0,0,0,11,11,0,12,12,0,0,0,0,117,64,53,75,39,125,1,124,113,1,112
14/04/2022 21:00,12,2,10,10,7,3,12,7,5,0,0,0,4,4,0,11,11,0,0,0,0,98,66,32,47,17,91,0,91,82,0,82
14/04/2022 22:00,7,5,2,4,2,2,12,4,8,0,0,0,3,3,0,1,1,0,0,0,0,67,47,20,50,20,64,1,63,46,1,45
14/04/2022 23:00,8,4,4,4,0,4,6,1,5,0,0,0,8,7,1,4,4,0,0,0,0,48,30,18,39,7,47,0,47,44,0,44
15/04/2022 00:00,1,0,1,4,2,2,6,2,4,0,0,0,2,2,0,2,2,0,0,0,0,41,33,8,24,9,42,0,42,23,0,23
15/04/2022 01:00,1,0,1,1,1,0,1,0,1,0,0,0,1,1,0,1,1,0,1,1,0,16,12,4,14,2,9,0,9,0,0,0
15/04/2022 02:00,0,0,0,2,0,2,2,1,1,0,0,0,1,1,0,0,0,0,0,0,0,12,11,1,9,3,19,1,18,7,1,6
15/04/2022 03:00,0,0,0,0,0,0,1,0,1,0,0,0,0,0,0,1,1,0,0,0,0,5,3,2,11,1,17,0,17,2,0,2
15/04/2022 04:00,1,1,0,2,1,1,3,1,2,0,0,0,0,0,0,0,0,0,0,0,0,6,2,4,5,3,1,1,0,2,0,2
15/04/2022 05:00,0,0,0,2,1,1,4,2,2,0,0,0,2,2,0,0,0,0,0,0,0,21,4,17,9,9,4,0,4,5,0,5
15/04/2022 06:00,8,7,1,13,10,3,17,9,8,0,0,0,16,16,0,3,3,0,2,2,0,77,10,67,17,47,16,0,16,23,0,23
15/04/2022 07:00,13,11,2,45,28,17,42,23,19,0,0,0,18,18,0,6,6,0,1,1,0,105,30,75,12,71,13,0,13,35,0,35
15/04/2022 08:00,13,9,4,55,29,26,70,34,36,0,0,0,24,24,0,13,13,0,0,0,0,129,51,78,21,60,24,0,24,48,0,48
15/04/2022 09:00,18,16,2,83,38,45,65,31,34,0,0,0,14,14,0,11,11,0,0,0,0,122,44,78,31,57,27,0,27,58,1,57
15/04/2022 10:00,8,6,2,106,43,63,114,38,76,0,0,0,10,10,0,8,8,0,0,0,0,79,19,60,29,52,29,2,27,72,0,72
15/04/2022 11:00,15,7,8,108,49,59,138,65,73,0,0,0,4,4,0,10,10,0,1,1,0,95,28,67,39,64,58,0,58,89,1,88
15/04/2022 12:00,10,4,6,122,69,53,179,85,94,0,0,0,2,2,0,15,15,0,0,0,0,119,52,67,64,62,84,0,84,101,0,101
15/04/2022 13:00,20,12,8,88,41,47,130,61,69,0,0,0,6,6,0,14,14,0,1,1,0,132,58,74,77,47,104,0,104,121,1,120
15/04/2022 14:00,11,4,7,81,34,47,112,44,68,0,0,0,6,6,0,11,11,0,0,0,0,119,49,70,64,53,87,2,85,132,2,130
15/04/2022 15:00,17,11,6,84,42,42,117,61,56,0,0,0,3,3,0,11,11,0,0,0,0,120,65,55,71,47,87,0,87,79,1,78
15/04/2022 16:00,15,9,6,67,40,27,90,43,47,0,0,0,12,12,0,19,19,0,8,8,0,173,73,100,71,63,97,0,97,95,2,93
15/04/2022 17:00,18,13,5,57,27,30,92,50,42,0,0,0,5,5,0,12,12,0,11,11,0,149,68,81,64,52,115,0,115,121,0,121
15/04/2022 18:00,20,6,14,51,25,26,77,37,40,0,0,0,31,31,0,8,8,0,8,8,0,133,55,78,65,35,116,0,116,123,1,122
15/04/2022 19:00,16,7,9,38,14,24,58,27,31,0,0,0,14,14,0,11,11,0,11,11,0,115,65,50,87,55,104,1,103,105,0,105
15/04/2022 20:00,13,6,7,28,17,11,49,19,30,0,0,0,3,3,0,11,11,0,14,14,0,118,68,50,50,29,90,0,90,111,0,111
15/04/2022 21:00,8,5,3,18,8,10,24,6,18,0,0,0,7,7,0,4,4,0,5,5,0,84,51,33,49,26,78,1,77,65,0,65
15/04/2022 22:00,8,6,2,9,3,6,18,6,12,0,0,0,5,5,0,5,5,0,4,4,0,66,39,27,41,22,62,0,62,56,1,55
15/04/2022 23:00,4,1,3,7,4,3,10,6,4,0,0,0,4,4,0,0,0,0,1,1,0,45,33,12,35,6,45,0,45,40,0,40
16/04/2022 00:00,2,0,2,3,1,2,10,4,6,0,0,0,2,2,0,3,3,0,2,2,0,44,34,10,26,7,33,0,33,28,1,27
16/04/2022 01:00,0,0,0,2,0,2,3,0,3,0,0,0,3,3,0,1,1,0,1,1,0,18,13,5,16,7,15,0,15,2,0,2
16/04/2022 02:00,0,0,0,1,0,1,2,0,2,0,0,0,0,0,0,0,0,0,0,0,0,10,8,2,12,3,20,0,20,9,0,9
16/04/2022 03:00,0,0,0,2,0,2,2,1,1,0,0,0,0,0,0,0,0,0,1,1,0,9,9,0,11,6,14,0,14,6,0,6
16/04/2022 04:00,0,0,0,1,1,0,1,1,0,0,0,0,2,2,0,0,0,0,1,1,0,8,4,4,10,1,13,0,13,4,0,4
16/04/2022 05:00,1,1,0,9,6,3,14,5,9,0,0,0,2,2,0,1,1,0,0,0,0,9,3,6,3,7,3,0,3,3,0,3
16/04/2022 06:00,2,0,2,9,4,5,10,6,4,0,0,0,3,3,0,1,1,0,3,3,0,24,5,19,14,14,7,0,7,9,0,9
16/04/2022 07:00,4,3,1,35,16,19,36,16,20,0,0,0,5,5,0,3,3,0,6,6,0,43,13,30,16,17,9,1,8,17,0,17
16/04/2022 08:00,6,5,1,63,29,34,83,23,60,0,0,0,3,3,0,4,4,0,7,7,0,48,15,33,22,35,27,0,27,27,0,27
16/04/2022 09:00,15,10,5,125,56,69,133,40,93,0,0,0,2,2,0,7,7,0,5,5,0,79,28,51,25,33,16,0,16,59,0,59
16/04/2022 10:00,10,7,3,131,61,70,164,59,105,0,0,0,5,5,0,10,10,0,3,3,0,86,31,55,24,37,26,0,26,58,0,58
16/04/2022 11:00,17,11,6,126,67,59,187,61,126,0,0,0,4,4,0,11,11,0,5,5,0,97,38,59,60,35,44,0,44,84,0,84
16/04/2022 12:00,10,6,4,157,73,84,225,97,128,0,0,0,4,4,0,13,13,0,6,6,0,113,47,66,91,62,71,2,69,94,0,94
16/04/2022 13:00,20,12,8,156,83,73,200,79,121,0,0,0,11,11,0,13,13,0,0,0,0,130,49,81,72,50,65,0,65,86,0,86
16/04/2022 14:00,21,12,9,120,55,65,178,68,110,0,0,0,6,6,0,12,12,0,1,1,0,117,54,63,72,52,79,1,78,105,1,104
16/04/2022 15:00,31,21,10,139,77,62,150,80,70,0,0,0,13,13,0,11,11,0,1,1,0,115,48,67,70,47,78,0,78,83,0,83
16/04/2022 16:00,16,9,7,122,75,47,180,96,84,0,0,0,13,13,0,13,13,0,0,0,0,107,38,69,61,59,71,1,70,86,0,86
16/04/2022 17:00,9,5,4,65,38,27,97,60,37,0,0,0,7,7,0,10,10,0,1,1,0,96,41,55,68,51,83,1,82,84,0,84
16/04/2022 18:00,11,4,7,69,44,25,90,50,40,0,0,0,16,16,0,5,5,0,1,1,0,87,52,35,65,39,89,0,89,78,2,76
16/04/2022 19:00,25,16,9,44,23,21,49,27,22,0,0,0,8,8,0,7,7,0,2,2,0,88,46,42,58,54,84,1,83,94,0,94
16/04/2022 20:00,17,9,8,14,8,6,40,24,16,0,0,0,6,6,0,11,11,0,0,0,0,75,34,41,43,50,59,1,58,105,1,104
16/04/2022 21:00,8,4,4,13,9,4,9,3,6,0,0,0,9,9,0,2,2,0,0,0,0,60,29,31,28,23,54,1,53,84,0,84
16/04/2022 22:00,9,6,3,7,4,3,10,3,7,0,0,0,5,5,0,4,4,0,1,1,0,43,30,13,28,15,46,1,45,53,0,53
16/04/2022 23:00,7,3,4,5,2,3,8,0,8,0,0,0,1,1,0,6,6,0,4,4,0,36,24,12,33,8,34,0,34,37,0,37
17/04/2022 00:00,2,0,2,1,0,1,4,1,3,0,0,0,2,2,0,0,0,0,0,0,0,33,18,15,16,7,27,0,27,20,0,20
17/04/2022 01:00,0,0,0,1,0,1,1,0,1,0,0,0,1,1,0,1,1,0,0,0,0,17,14,3,18,6,10,0,10,2,0,2
17/04/2022 02:00,0,0,0,0,0,0,5,2,3,0,0,0,0,0,0,0,0,0,0,0,0,11,9,2,16,5,12,0,12,7,0,7
17/04/2022 03:00,0,0,0,0,0,0,1,0,1,0,0,0,1,1,0,0,0,0,0,0,0,10,6,4,15,2,15,0,15,2,0,2
17/04/2022 04:00,1,0,1,0,0,0,0,0,0,0,0,0,0,0,0,0,0,0,0,0,0,3,2,1,7,1,6,0,6,4,0,4
17/04/2022 05:00,1,1,0,3,2,1,4,2,2,0,0,0,0,0,0,0,0,0,0,0,0,13,5,8,2,3,8,0,8,4,0,4
17/04/2022 06:00,2,2,0,3,2,1,11,5,6,0,0,0,2,2,0,2,2,0,0,0,0,21,5,16,11,11,5,0,5,10,0,10
17/04/2022 07:00,4,4,0,19,9,10,29,13,16,0,0,0,8,8,0,2,2,0,0,0,0,29,15,14,11,14,8,0,8,15,0,15
17/04/2022 08:00,2,1,1,63,28,35,56,20,36,0,0,0,6,6,0,5,5,0,3,3,0,41,8,33,16,15,13,0,13,25,0,25
17/04/2022 09:00,8,4,4,75,30,45,91,31,60,0,0,0,3,3,0,1,1,0,0,0,0,52,21,31,22,35,19,0,19,33,0,33
17/04/2022 10:00,4,3,1,84,50,34,83,33,50,0,0,0,2,2,0,6,6,0,0,0,0,52,15,37,18,21,23,0,23,40,0,40
17/04/2022 11:00,7,5,2,88,38,50,105,42,63,0,0,0,6,6,0,5,5,0,0,0,0,81,28,53,18,32,21,0,21,42,0,42
17/04/2022 12:00,11,8,3,73,42,31,104,55,49,0,0,0,3,3,0,9,9,0,0,0,0,69,27,42,30,36,47,0,47,52,0,52
17/04/2022 13:00,8,6,2,54,28,26,64,34,30,0,0,0,5,5,0,5,5,0,1,1,0,64,27,37,42,34,47,0,47,58,0,58
17/04/2022 14:00,10,7,3,19,9,10,23,12,11,0,0,0,4,3,1,5,5,0,0,0,0,45,19,26,29,27,58,1,57,55,0,55
17/04/2022 15:00,7,5,2,7,4,3,11,5,6,0,0,0,2,2,0,3,3,0,0,0,0,39,22,17,36,20,41,1,40,47,0,47
17/04/2022 16:00,7,6,1,10,7,3,15,5,10,0,0,0,6,6,0,11,11,0,0,0,0,47,16,31,26,27,41,0,41,66,0,66
17/04/2022 17:00,6,3,3,21,11,10,31,15,16,0,0,0,5,5,0,4,4,0,0,0,0,70,29,41,51,34,41,0,41,83,0,83
17/04/2022 18:00,9,6,3,16,10,6,29,12,17,0,0,0,6,6,0,9,9,0,0,0,0,68,41,27,42,29,47,1,46,78,0,78
17/04/2022 19:00,10,6,4,17,11,6,35,17,18,0,0,0,7,6,1,4,4,0,1,1,0,65,31,34,39,32,68,0,68,85,0,85
17/04/2022 20:00,3,1,2,14,6,8,20,11,9,0,0,0,2,1,1,4,4,0,1,1,0,81,35,46,44,29,56,0,56,66,0,66
17/04/2022 21:00,2,2,0,13,7,6,15,7,8,0,0,0,4,4,0,3,3,0,2,2,0,54,28,26,21,33,55,1,54,48,0,48
17/04/2022 22:00,4,2,2,3,2,1,4,1,3,0,0,0,4,4,0,3,3,0,3,3,0,52,20,32,24,19,17,0,17,49,0,49
17/04/2022 23:00,3,1,2,5,3,2,5,2,3,0,0,0,0,0,0,0,0,0,2,2,0,30,24,6,9,7,1,1,0,21,0,21
18/04/2022 00:00,1,0,1,0,0,0,3,1,2,0,0,0,2,2,0,0,0,0,0,0,0,13,10,3,10,3,1,0,1,15,1,14
18/04/2022 01:00,0,0,0,2,1,1,1,1,0,0,0,0,3,3,0,0,0,0,0,0,0,8,4,4,7,1,2,0,2,2,0,2
18/04/2022 02:00,1,1,0,0,0,0,2,1,1,0,0,0,0,0,0,0,0,0,0,0,0,4,3,1,7,2,5,0,5,3,0,3
18/04/2022 03:00,0,0,0,0,0,0,1,0,1,0,0,0,1,1,0,0,0,0,0,0,0,1,1,0,7,4,5,0,5,2,0,2
18/04/2022 04:00,0,0,0,2,0,2,0,0,0,0,0,0,1,1,0,0,0,0,0,0,0,6,2,4,4,2,3,0,3,2,0,2
18/04/2022 05:00,1,1,0,4,1,3,5,3,2,0,0,0,1,1,0,0,0,0,0,0,0,11,1,10,7,6,4,0,4,6,0,6
18/04/2022 06:00,3,2,1,6,5,1,7,5,2,0,0,0,1,1,0,0,0,0,0,0,0,33,6,27,8,10,5,0,5,15,0,15
18/04/2022 07:00,4,2,2,24,8,16,26,6,20,0,0,0,5,5,0,0,0,0,0,0,0,32,9,23,18,23,7,0,7,12,0,12
18/04/2022 08:00,7,6,1,59,29,30,63,28,35,0,0,0,8,8,0,3,3,0,0,0,0,48,15,33,13,24,16,0,16,19,0,19
18/04/2022 09:00,7,5,2,97,30,67,116,32,84,0,0,0,6,6,0,2,2,0,0,0,0,56,17,39,21,37,19,0,19,47,0,47
18/04/2022 10:00,14,7,7,164,78,86,192,84,108,0,0,0,9,8,1,7,7,0,0,0,0,80,27,53,33,34,23,0,23,43,0,43
18/04/2022 11:00,8,5,3,197,97,100,222,104,118,0,0,0,13,13,0,9,9,0,0,0,0,70,24,46,28,25,24,0,24,65,0,65
18/04/2022 12:00,5,3,2,126,67,59,165,83,82,0,0,0,1,1,0,10,10,0,2,2,0,81,34,47,29,31,51,0,51,74,0,74
18/04/2022 13:00,26,15,11,100,51,49,127,59,68,0,0,0,5,5,0,8,8,0,1,1,0,118,47,71,49,50,62,0,62,97,1,96
18/04/2022 14:00,10,5,5,58,29,29,71,41,30,0,0,0,5,5,0,6,6,0,0,0,0,75,43,32,20,28,42,0,42,58,0,58
18/04/2022 15:00,7,4,3,33,19,14,49,25,24,0,0,0,3,3,0,9,9,0,0,0,0,56,35,21,33,31,60,0,60,46,0,46
18/04/2022 16:00,13,8,5,27,13,14,35,18,17,0,0,0,1,1,0,4,4,0,2,2,0,87,38,49,32,21,64,0,64,64,0,64
18/04/2022 17:00,11,7,4,32,18,14,37,18,19,0,0,0,7,7,0,7,7,0,2,2,0,99,57,42,56,21,72,0,72,88,0,88
18/04/2022 18:00,15,7,8,50,27,23,73,36,37,0,0,0,7,7,0,2,2,0,4,4,0,93,50,43,47,28,91,0,91,81,1,80
18/04/2022 19:00,10,6,4,49,22,27,60,30,30,0,0,0,7,7,0,8,8,0,0,0,0,70,41,29,46,29,98,1,97,69,1,68
18/04/2022 20:00,10,4,6,27,13,14,39,18,21,0,0,0,0,0,0,6,6,0,4,4,0,80,44,36,38,40,77,0,77,77,0,77
18/04/2022 21:00,7,4,3,12,9,3,16,5,11,0,0,0,2,2,0,4,4,0,1,1,0,83,42,41,38,21,47,1,46,63,0,63
18/04/2022 22:00,5,2,3,12,8,4,14,7,7,0,0,0,5,5,0,1,1,0,1,1,0,41,22,19,23,8,10,0,10,39,2,37
18/04/2022 23:00,1,1,0,3,1,2,9,4,5,0,0,0,2,2,0,0,0,0,0,0,0,20,9,11,15,1,27,0,27,15,0,15
19/04/2022 00:00,1,1,0,2,1,1,3,0,3,0,0,0,5,5,0,0,0,0,0,0,0,19,17,2,16,1,16,0,16,11,0,11
19/04/2022 01:00,0,0,0,1,1,0,0,0,0,0,0,0,0,0,0,0,0,0,0,0,0,6,3,3,4,0,1,0,1,0,0,0
19/04/2022 02:00,0,0,0,0,0,0,0,0,0,0,0,0,0,0,0,0,0,0,0,0,0,0,0,0,4,1,4,0,4,2,0,2
19/04/2022 03:00,0,0,0,1,1,0,1,0,1,0,0,0,0,0,0,0,0,0,0,0,0,4,1,3,1,1,3,0,3,1,0,1
19/04/2022 04:00,2,1,1,0,0,0,1,0,1,0,0,0,2,2,0,0,0,0,0,0,0,9,0,9,1,2,4,0,4,2,0,2
19/04/2022 05:00,3,3,0,2,1,1,7,4,3,0,0,0,0,0,0,1,1,0,0,0,0,30,9,21,3,15,2,0,2,5,0,5
19/04/2022 06:00,9,9,0,33,22,11,32,19,13,0,0,0,11,11,0,2,2,0,3,3,0,119,17,102,16,73,13,0,13,36,0,36
19/04/2022 07:00,30,27,3,68,46,22,69,50,19,0,0,0,30,30,0,20,20,0,11,11,0,239,57,182,29,147,25,1,24,64,0,64
19/04/2022 08:00,79,72,7,75,57,18,97,74,23,0,0,0,60,60,0,19,19,0,18,18,0,431,82,349,32,257,44,0,44,157,0,157
19/04/2022 09:00,25,22,3,60,35,25,67,36,31,0,0,0,21,21,0,9,9,0,17,17,0,200,38,162,25,117,31,0,31,114,0,114
19/04/2022 10:00,11,7,4,73,34,39,74,30,44,0,0,0,6,6,0,6,6,0,8,8,0,71,21,50,13,30,26,0,26,64,0,64
19/04/2022 11:00,16,11,5,87,39,48,89,43,46,0,0,0,6,6,0,11,11,0,11,11,0,80,25,55,20,32,43,0,43,74,0,74
19/04/2022 12:00,8,5,3,76,31,45,94,45,49,0,0,0,5,5,0,11,11,0,11,11,0,100,36,64,37,29,71,0,71,80,0,80
19/04/2022 13:00,22,17,5,65,31,34,89,46,43,0,0,0,3,3,0,14,14,0,12,12,0,109,43,66,48,39,73,1,72,89,1,88
19/04/2022 14:00,16,8,8,69,39,30,98,45,53,0,0,0,3,3,0,20,20,0,9,9,0,100,52,48,69,36,62,1,61,84,0,84
19/04/2022 15:00,14,7,7,58,33,25,66,34,32,0,0,0,5,5,0,9,9,0,15,15,0,124,68,56,76,40,71,0,71,84,0,84
19/04/2022 16:00,27,7,20,67,33,34,88,48,40,0,0,0,9,9,0,18,18,0,23,23,0,172,107,65,146,48,118,0,118,63,0,63
19/04/2022 17:00,53,16,37,130,44,86,155,46,109,0,0,0,1,1,0,29,29,0,29,29,0,362,229,133,260,37,245,3,242,92,0,92
19/04/2022 18:00,36,14,22,141,45,96,187,64,123,0,0,0,18,17,1,28,28,0,4,4,0,283,166,117,168,48,160,0,160,128,2,126
19/04/2022 19:00,26,12,14,129,49,80,155,70,85,0,0,0,9,9,0,17,17,0,2,2,0,173,93,80,129,39,151,0,151,117,0,117
19/04/2022 20:00,13,4,9,51,27,24,49,28,21,0,0,0,8,8,0,12,12,0,2,2,0,123,72,51,65,26,97,2,95,109,1,108
19/04/2022 21:00,6,2,4,20,14,6,28,17,11,0,0,0,3,3,0,8,8,0,4,4,0,80,53,27,43,23,87,2,85,60,0,60
19/04/2022 22:00,6,3,3,9,4,5,18,6,12,0,0,0,3,3,0,2,2,0,8,8,0,69,45,24,39,16,18,0,18,30,0,30
19/04/2022 23:00,5,1,4,4,2,2,5,2,3,0,0,0,3,3,0,2,2,0,2,2,0,42,29,13,23,10,0,0,0,20,0,20
20/04/2022 00:00,2,1,1,1,0,1,2,1,1,0,0,0,3,3,0,1,1,0,0,0,0,15,14,1,11,1,10,0,10,6,0,6
20/04/2022 01:00,0,0,0,1,0,1,0,0,0,0,0,0,1,1,0,0,0,0,0,0,0,10,9,1,3,0,1,0,1,0,0,0
20/04/2022 02:00,0,0,0,1,0,1,4,1,3,0,0,0,0,0,0,0,0,0,0,0,0,5,3,2,4,1,2,0,2,2,0,2
20/04/2022 03:00,0,0,0,1,1,0,2,1,1,0,0,0,0,0,0,0,0,0,0,0,0,3,0,3,2,2,2,0,2,1,0,1
20/04/2022 04:00,0,0,0,1,1,0,2,1,1,0,0,0,5,5,0,0,0,0,0,0,0,10,2,8,3,5,2,0,2,3,0,3
20/04/2022 05:00,2,2,0,7,4,3,9,4,5,0,0,0,3,3,0,2,2,0,0,0,0,35,6,29,4,24,5,0,5,5,0,5
20/04/2022 06:00,16,15,1,37,25,12,39,25,14,0,0,0,28,28,0,3,3,0,4,4,0,123,17,106,21,86,13,0,13,47,0,47
20/04/2022 07:00,33,28,5,83,60,23,95,71,24,0,0,0,27,27,0,15,15,0,0,0,0,289,72,217,28,156,27,0,27,86,0,86
20/04/2022 08:00,88,82,6,112,88,24,135,108,27,0,0,0,32,32,0,18,18,0,0,0,0,544,103,441,37,285,56,0,56,174,0,174
20/04/2022 09:00,39,35,4,67,36,31,78,45,33,0,0,0,21,21,0,12,12,0,0,0,0,218,54,164,30,137,41,0,41,107,0,107
20/04/2022 10:00,23,17,6,66,30,36,92,38,54,0,0,0,8,8,0,7,7,0,0,0,0,103,24,79,24,39,36,0,36,85,0,85
20/04/2022 11:00,12,7,5,83,40,43,107,46,61,0,0,0,10,10,0,9,9,0,0,0,0,97,37,60,30,53,48,1,47,74,0,74
20/04/2022 12:00,20,10,10,84,36,48,129,49,80,0,0,0,6,6,0,11,11,0,0,0,0,118,48,70,55,56,63,0,63,102,1,101
20/04/2022 13:00,23,14,9,89,47,42,134,61,73,0,0,0,4,4,0,14,14,0,0,0,0,108,55,53,57,47,81,0,81,95,0,95
20/04/2022 14:00,12,6,6,72,42,30,113,59,54,0,0,0,4,4,0,8,8,0,0,0,0,124,62,62,73,44,74,0,74,97,0,97
20/04/2022 15:00,29,17,12,86,34,52,112,49,63,0,0,0,4,4,0,11,11,0,0,0,0,122,76,46,87,48,81,0,81,90,0,90
20/04/2022 16:00,29,12,17,99,42,57,143,64,79,0,0,0,14,13,1,17,17,0,0,0,0,228,136,92,149,49,133,0,133,85,1,84
20/04/2022 17:00,66,25,41,161,74,87,210,93,117,0,0,0,13,13,0,20,20,0,0,0,0,368,237,131,295,66,205,1,204,120,1,119
20/04/2022 18:00,37,11,26,174,60,114,239,70,169,0,0,0,11,11,0,14,14,0,0,0,0,312,205,107,240,72,211,2,209,125,1,124
20/04/2022 19:00,24,9,15,135,65,70,168,82,86,0,0,0,8,8,0,25,25,0,0,0,0,201,101,100,97,45,144,1,143,103,0,103
20/04/2022 20:00,15,6,9,92,45,47,119,60,59,0,0,0,5,5,0,8,8,0,0,0,0,129,87,42,65,39,103,0,103,103,2,101
20/04/2022 21:00,7,3,4,34,25,9,51,27,24,0,0,0,3,3,0,12,12,0,0,0,0,101,59,42,44,18,91,1,90,82,1,81
20/04/2022 22:00,5,3,2,7,4,3,15,6,9,0,0,0,2,2,0,8,8,0,1,1,0,92,52,40,48,8,78,2,76,58,2,56
20/04/2022 23:00,3,2,1,3,1,2,5,2,3,0,0,0,0,0,0,5,5,0,0,0,0,45,35,10,31,9,49,1,48,30,2,28
21/04/2022 00:00,2,1,1,2,2,0,6,3,3,0,0,0,1,1,0,2,2,0,0,0,0,33,24,9,7,5,23,0,23,18,0,18
21/04/2022 01:00,1,0,1,0,0,0,1,0,1,0,0,0,2,2,0,0,0,0,1,1,0,14,11,3,7,4,3,0,3,1,0,1
21/04/2022 02:00,0,0,0,0,0,0,0,0,0,0,0,0,0,0,0,0,0,0,0,0,0,6,3,3,7,0,7,0,7,0,0,0
21/04/2022 03:00,0,0,0,0,0,0,0,0,0,0,0,0,1,1,0,1,1,0,0,0,0,4,1,3,1,2,5,1,4,5,0,5
21/04/2022 04:00,1,1,0,5,4,1,2,1,1,0,0,0,4,4,0,1,1,0,0,0,0,7,1,6,3,5,1,0,1,4,0,4
21/04/2022 05:00,1,1,0,6,3,3,12,6,6,0,0,0,2,2,0,0,0,0,0,0,0,34,11,23,5,19,6,0,6,10,0,10
21/04/2022 06:00,18,15,3,36,25,11,35,26,9,0,0,0,27,26,1,6,6,0,4,4,0,127,22,105,16,86,12,0,12,39,0,39
21/04/2022 07:00,34,30,4,75,56,19,77,56,21,0,0,0,36,36,0,17,17,0,0,0,0,247,63,184,26,152,36,0,36,91,0,91
21/04/2022 08:00,76,70,6,88,65,23,114,88,26,0,0,0,62,62,0,21,21,0,0,0,0,494,68,426,32,270,55,0,55,177,0,177
21/04/2022 09:00,26,21,5,55,36,19,68,42,26,0,0,0,33,33,0,14,14,0,0,0,0,226,41,185,30,120,40,0,40,132,0,132
21/04/2022 10:00,20,12,8,55,25,30,77,31,46,0,0,0,18,18,0,4,4,0,0,0,0,95,30,65,28,48,30,1,29,77,1,76
21/04/2022 11:00,15,8,7,64,28,36,78,41,37,0,0,0,13,13,0,13,13,0,0,0,0,108,30,78,33,40,28,0,28,91,0,91
21/04/2022 12:00,20,16,4,73,36,37,82,46,36,0,0,0,9,9,0,7,7,0,0,0,0,150,53,97,52,39,91,1,90,98,1,97
21/04/2022 13:00,17,7,10,60,35,25,86,49,37,0,0,0,14,14,0,9,9,0,0,0,0,136,59,77,72,48,89,1,88,109,0,109
21/04/2022 14:00,23,14,9,54,25,29,79,39,40,0,0,0,6,6,0,17,17,0,2,2,0,134,70,64,79,55,81,0,81,66,0,66
21/04/2022 15:00,21,9,12,47,17,30,87,34,53,0,0,0,15,15,0,15,15,0,10,10,0,133,71,62,71,49,76,0,76,88,0,88
21/04/2022 16:00,24,13,11,66,25,41,114,53,61,0,0,0,15,15,0,17,17,0,20,20,0,199,111,88,142,56,123,1,122,88,1,87
21/04/2022 17:00,56,14,42,94,29,65,137,44,93,0,0,0,6,5,1,27,27,0,9,9,0,354,224,130,297,45,226,1,225,133,1,132
21/04/2022 18:00,34,9,25,125,41,84,203,71,132,0,0,0,16,16,0,24,24,0,8,8,0,307,179,128,218,53,185,1,184,162,0,162
21/04/2022 19:00,20,9,11,85,35,50,113,55,58,0,0,0,5,5,0,23,23,0,0,0,0,200,114,86,99,40,159,0,159,139,1,138
21/04/2022 20:00,22,11,11,49,25,24,77,36,41,0,0,0,5,5,0,18,18,0,5,5,0,144,80,64,63,38,103,1,102,107,0,107
21/04/2022 21:00,8,0,8,15,7,8,28,10,18,0,0,0,5,5,0,9,9,0,6,6,0,111,74,37,57,27,100,0,100,76,0,76
21/04/2022 22:00,6,5,1,10,4,6,17,6,11,0,0,0,7,7,0,6,6,0,5,5,0,86,62,24,51,18,66,0,66,55,0,55
21/04/2022 23:00,4,1,3,5,0,5,10,1,9,0,0,0,1,1,0,1,1,0,0,0,0,49,30,19,40,5,58,1,57,35,0,35
22/04/2022 00:00,4,1,3,2,2,0,5,2,3,0,0,0,3,3,0,2,2,0,0,0,0,33,22,11,13,6,32,0,32,18,1,17
22/04/2022 01:00,1,0,1,5,2,3,1,0,1,0,0,0,0,0,0,1,1,0,2,2,0,9,7,2,11,1,10,0,10,0,0,0
22/04/2022 02:00,0,0,0,0,0,0,1,0,1,0,0,0,0,0,0,0,0,0,0,0,0,3,3,0,5,0,11,0,11,1,0,1
22/04/2022 03:00,0,0,0,0,0,0,0,0,0,0,0,0,0,0,0,0,0,0,0,0,0,2,1,1,3,1,6,0,6,5,0,5
22/04/2022 04:00,1,1,0,3,3,0,5,2,3,0,0,0,1,1,0,0,0,0,1,1,0,13,4,9,7,4,1,0,1,2,0,2
22/04/2022 05:00,1,1,0,5,3,2,12,8,4,0,0,0,3,3,0,2,2,0,1,1,0,27,9,18,9,19,3,0,3,12,0,12
22/04/2022 06:00,13,10,3,23,14,9,27,14,13,0,0,0,19,19,0,4,4,0,2,2,0,108,17,91,18,89,13,0,13,36,0,36
22/04/2022 07:00,21,20,1,51,33,18,70,48,22,0,0,0,22,22,0,16,16,0,16,16,0,191,56,135,20,116,31,0,31,65,1,64
22/04/2022 08:00,55,50,5,55,40,15,75,61,14,0,0,0,65,65,0,17,17,0,16,16,0,378,84,294,28,198,47,0,47,137,0,137
22/04/2022 09:00,25,24,1,54,29,25,60,35,25,0,0,0,23,23,0,10,10,0,10,10,0,206,47,159,22,104,45,1,44,109,1,108
22/04/2022 10:00,14,11,3,46,21,25,47,13,34,0,0,0,19,18,1,7,7,0,8,8,0,90,24,66,28,49,43,1,42,81,0,81
22/04/2022 11:00,16,11,5,38,21,17,48,22,26,0,0,0,8,8,0,4,4,0,5,5,0,75,25,50,21,45,45,0,45,80,0,80
22/04/2022 12:00,17,10,7,50,28,22,63,32,31,0,0,0,9,9,0,8,8,0,6,6,0,131,56,75,45,50,77,0,77,114,0,114
22/04/2022 13:00,10,5,5,32,17,15,51,22,29,0,0,0,5,5,0,9,9,0,10,10,0,137,55,82,60,50,87,0,87,120,0,120
22/04/2022 14:00,23,15,8,30,17,13,42,22,20,0,0,0,5,5,0,9,9,0,17,17,0,145,77,68,82,44,95,0,95,97,0,97
22/04/2022 15:00,18,8,10,42,17,25,60,19,41,0,0,0,9,8,1,9,9,0,11,11,0,132,68,64,84,42,84,0,84,84,1,83
22/04/2022 16:00,25,4,21,57,23,34,95,37,58,0,0,0,9,9,0,16,16,0,18,18,0,190,103,87,121,60,130,0,130,111,0,111
22/04/2022 17:00,35,11,24,88,35,53,113,46,67,0,0,0,9,9,0,23,23,0,17,17,0,282,168,114,181,44,185,0,185,136,1,135
22/04/2022 18:00,21,4,17,56,22,34,114,47,67,0,0,0,11,11,0,16,16,0,7,7,0,253,141,112,142,63,175,0,175,166,0,166
22/04/2022 19:00,22,9,13,55,26,29,74,26,48,0,0,0,15,15,0,13,13,0,9,9,0,180,90,90,88,53,136,1,135,165,0,165
22/04/2022 20:00,22,7,15,23,16,7,60,34,26,0,0,0,3,3,0,4,4,0,10,10,0,122,64,58,67,40,95,0,95,116,2,114
22/04/2022 21:00,15,7,8,13,9,4,8,5,3,0,0,0,4,4,0,4,4,0,4,4,0,84,48,36,53,30,73,1,72,103,1,102
22/04/2022 22:00,9,7,2,4,0,4,7,1,6,0,0,0,11,11,0,8,8,0,4,4,0,70,43,27,48,16,66,1,65,64,0,64
22/04/2022 23:00,5,1,4,7,2,5,14,4,10,0,0,0,3,3,0,3,3,0,2,2,0,45,37,8,46,9,38,0,38,35,0,35
23/04/2022 00:00,1,0,1,1,1,0,4,1,3,0,0,0,1,1,0,3,3,0,3,3,0,36,28,8,24,7,48,0,48,17,0,17
23/04/2022 01:00,2,2,0,0,0,0,0,0,0,0,0,0,0,0,0,0,0,0,2,2,0,20,16,4,15,2,14,0,14,1,0,1
23/04/2022 02:00,0,0,0,1,1,0,2,1,1,0,0,0,1,1,0,0,0,0,0,0,0,14,11,3,9,1,22,1,21,10,1,9
23/04/2022 03:00,1,1,0,2,1,1,2,0,2,0,0,0,2,2,0,2,2,0,0,0,0,7,5,2,15,1,18,1,17,4,0,4
23/04/2022 04:00,1,0,1,1,0,1,0,0,0,0,0,0,1,1,0,1,1,0,0,0,0,9,4,5,8,3,4,0,4,3,0,3
23/04/2022 05:00,1,1,0,2,1,1,3,1,2,0,0,0,3,3,0,1,1,0,0,0,0,13,2,11,3,10,6,0,6,5,0,5
23/04/2022 06:00,1,1,0,6,4,2,9,6,3,0,0,0,4,4,0,2,2,0,2,2,0,44,14,30,11,20,10,0,10,15,0,15
23/04/2022 07:00,5,5,0,41,16,25,36,13,23,0,0,0,2,2,0,3,3,0,5,5,0,61,13,48,12,26,14,0,14,20,0,20
23/04/2022 08:00,12,10,2,68,30,38,75,38,37,0,0,0,16,16,0,3,3,0,6,6,0,67,23,44,26,37,20,0,20,38,0,38
23/04/2022 09:00,16,12,4,96,43,53,116,46,70,0,0,0,8,8,0,12,12,0,2,2,0,83,26,57,20,41,31,0,31,73,1,72
23/04/2022 10:00,16,9,7,103,52,51,137,73,64,0,0,0,5,4,1,16,16,0,6,6,0,88,35,53,27,38,39,0,39,77,4,73
23/04/2022 11:00,17,12,5,112,54,58,134,62,72,0,0,0,4,4,0,8,8,0,6,6,0,152,45,107,39,38,54,0,54,86,2,84
23/04/2022 12:00,15,6,9,123,60,63,159,76,83,0,0,0,3,3,0,17,17,0,12,12,0,135,54,81,71,57,72,1,71,99,0,99
23/04/2022 13:00,20,9,11,86,38,48,150,62,88,0,0,0,7,7,0,6,6,0,7,7,0,158,63,95,78,40,75,0,75,117,2,115
23/04/2022 14:00,18,9,9,85,47,38,133,67,66,0,0,0,8,8,0,10,10,0,17,17,0,146,65,81,65,57,79,2,77,124,1,123
23/04/2022 15:00,14,10,4,58,29,29,84,42,42,0,0,0,6,6,0,10,10,0,4,4,0,113,54,59,64,45,106,0,106,110,2,108
23/04/2022 16:00,13,5,8,47,24,23,73,32,41,0,0,0,9,9,0,11,11,0,14,14,0,124,59,65,60,46,94,0,94,102,2,100
23/04/2022 17:00,14,6,8,31,18,13,65,34,31,0,0,0,1,1,0,10,10,0,3,3,0,127,48,79,60,43,102,1,101,123,0,123
23/04/2022 18:00,14,3,11,34,14,20,45,20,25,0,0,0,0,0,0,11,11,0,6,6,0,104,50,54,50,48,93,0,93,95,1,94
23/04/2022 19:00,11,4,7,22,14,8,40,25,15,0,0,0,0,0,0,3,3,0,1,1,0,93,46,47,54,44,98,1,97,118,1,117
23/04/2022 20:00,6,2,4,10,10,0,22,15,7,0,0,0,0,0,0,11,11,0,2,2,0,80,29,51,44,22,74,0,74,105,0,105
23/04/2022 21:00,3,2,1,5,2,3,11,3,8,0,0,0,5,4,1,4,4,0,1,1,0,75,42,33,35,33,65,0,65,83,0,83
23/04/2022 22:00,10,4,6,2,2,0,6,3,3,0,0,0,0,0,0,1,1,0,2,2,0,61,32,29,37,23,51,1,50,55,0,55
23/04/2022 23:00,7,4,3,5,1,4,12,4,8,0,0,0,0,0,0,3,3,0,2,2,0,48,31,17,38,9,46,0,46,25,0,25
24/04/2022 00:00,4,1,3,4,2,2,4,1,3,0,0,0,0,0,0,4,4,0,1,1,0,41,28,13,19,16,42,0,42,16,0,16
24/04/2022 01:00,2,0,2,2,0,2,1,1,0,0,0,0,4,4,0,1,1,0,1,1,0,24,18,6,18,11,7,0,7,1,0,1
24/04/2022 02:00,0,0,0,1,1,0,3,0,3,0,0,0,1,1,0,0,0,0,1,1,0,19,16,3,13,2,37,0,37,9,0,9
24/04/2022 03:00,1,1,0,0,0,0,0,0,0,0,0,0,2,2,0,0,0,0,0,0,0,10,9,1,14,5,13,0,13,0,0,0
24/04/2022 04:00,0,0,0,0,0,0,0,0,0,0,0,0,1,1,0,0,0,0,0,0,0,7,3,4,7,4,7,0,7,4,0,4
24/04/2022 05:00,3,3,0,5,2,3,6,2,4,0,0,0,0,0,0,0,0,0,1,1,0,6,1,5,4,2,4,0,4,4,0,4
24/04/2022 06:00,0,0,0,9,3,6,22,11,11,0,0,0,3,3,0,2,2,0,3,3,0,29,6,23,10,20,6,0,6,11,1,10
24/04/2022 07:00,3,2,1,33,11,22,37,15,22,0,0,0,1,1,0,3,3,0,1,1,0,37,14,23,17,18,10,0,10,14,0,14
24/04/2022 08:00,3,3,0,89,34,55,84,39,45,0,0,0,3,3,0,13,13,0,2,2,0,49,19,30,16,31,17,0,17,19,0,19
24/04/2022 09:00,8,7,1,90,30,60,143,60,83,0,0,0,5,5,0,14,14,0,4,4,0,65,16,49,25,29,23,0,23,35,0,35
24/04/2022 10:00,12,9,3,135,54,81,191,67,124,0,0,0,5,5,0,10,10,0,15,15,0,84,27,57,39,36,36,0,36,61,0,61
24/04/2022 11:00,12,7,5,141,63,78,193,92,101,0,0,0,6,6,0,18,18,0,15,15,0,119,45,74,62,28,35,0,35,72,0,72
24/04/2022 12:00,18,13,5,159,85,74,207,101,106,0,0,0,0,0,0,15,15,0,8,8,0,151,38,113,62,48,56,1,55,96,1,95
24/04/2022 13:00,11,9,2,136,73,63,228,116,112,0,0,0,3,3,0,17,17,0,8,8,0,122,40,82,71,41,79,0,79,120,1,119
24/04/2022 14:00,18,9,9,123,55,68,181,86,95,0,0,0,7,7,0,21,21,0,14,14,0,142,55,87,50,52,64,0,64,98,0,98
24/04/2022 15:00,12,9,3,104,54,50,151,78,73,0,0,0,3,3,0,16,16,0,14,14,0,139,57,82,57,31,62,0,62,96,0,96
24/04/2022 16:00,14,6,8,118,67,51,166,88,78,0,0,0,3,3,0,15,15,0,12,12,0,126,52,74,57,50,67,0,67,86,0,86
24/04/2022 17:00,14,8,6,82,53,29,143,82,61,0,0,0,1,1,0,11,11,0,11,11,0,116,50,66,58,48,94,0,94,105,1,104
24/04/2022 18:00,11,5,6,64,40,24,81,51,30,0,0,0,4,4,0,7,7,0,16,16,0,143,71,72,59,44,99,1,98,99,1,98
24/04/2022 19:00,15,3,12,50,26,24,70,43,27,0,0,0,0,0,0,9,9,0,6,6,0,105,51,54,42,39,91,1,90,85,1,84
24/04/2022 20:00,10,4,6,34,18,16,63,35,28,0,0,0,2,2,0,4,4,0,6,6,0,85,55,30,34,32,87,1,86,91,1,90
24/04/2022 21:00,11,8,3,9,7,2,15,7,8,0,0,0,2,2,0,8,8,0,5,5,0,82,48,34,43,21,71,1,70,80,1,79
24/04/2022 22:00,8,2,6,6,2,4,10,5,5,0,0,0,0,0,0,3,3,0,3,3,0,58,36,22,38,12,11,0,11,65,1,64
24/04/2022 23:00,7,5,2,2,1,1,7,1,6,0,0,0,0,0,0,7,7,0,1,1,0,30,24,6,36,4,0,0,0,29,1,28
25/04/2022 00:00,1,1,0,2,1,1,2,1,1,0,0,0,3,3,0,1,1,0,0,0,0,21,15,6,12,8,11,0,11,12,0,12
25/04/2022 01:00,0,0,0,0,0,0,0,0,0,0,0,0,2,2,0,0,0,0,0,0,0,10,9,1,7,1,1,0,1,0,0,0
25/04/2022 02:00,0,0,0,0,0,0,3,2,1,0,0,0,0,0,0,0,0,0,1,1,0,7,6,1,9,2,9,0,9,4,0,4
25/04/2022 03:00,0,0,0,0,0,0,0,0,0,0,0,0,0,0,0,0,0,0,1,1,0,5,2,3,1,0,2,0,2,2,0,2
25/04/2022 04:00,1,1,0,3,2,1,3,0,3,0,0,0,0,0,0,0,0,0,1,1,0,5,1,4,4,6,1,0,1,2,0,2
25/04/2022 05:00,4,3,1,4,2,2,4,2,2,0,0,0,8,8,0,1,1,0,1,1,0,31,6,25,5,17,7,0,7,7,0,7
25/04/2022 06:00,16,12,4,29,23,6,30,23,7,0,0,0,16,16,0,11,11,0,2,2,0,136,19,117,20,77,11,0,11,41,0,41
25/04/2022 07:00,27,26,1,65,50,15,84,61,23,0,0,0,23,23,0,17,17,0,1,1,0,264,71,193,27,165,26,0,26,76,0,76
25/04/2022 08:00,73,62,11,81,63,18,113,85,28,0,0,0,45,43,2,33,33,0,1,1,0,504,91,413,59,318,62,0,62,174,1,173
25/04/2022 09:00,32,29,3,54,34,20,70,47,23,0,0,0,18,18,0,14,14,0,0,0,0,197,31,166,23,142,41,0,41,142,0,142
25/04/2022 10:00,11,8,3,61,32,29,74,32,42,0,0,0,12,12,0,12,12,0,0,0,0,77,25,52,22,48,27,0,27,67,0,67
25/04/2022 11:00,10,5,5,56,27,29,60,32,28,0,0,0,6,6,0,3,3,0,0,0,0,76,33,43,37,26,35,0,35,65,0,65
25/04/2022 12:00,7,5,2,62,33,29,61,34,27,0,0,0,9,9,0,4,4,0,0,0,0,105,37,68,45,52,57,0,57,102,0,102
25/04/2022 13:00,15,9,6,37,20,17,54,31,23,0,0,0,5,5,0,8,8,0,0,0,0,144,60,84,52,37,86,0,86,97,0,97
25/04/2022 14:00,20,11,9,33,18,15,57,24,33,0,0,0,9,9,0,13,13,0,0,0,0,116,74,42,64,52,79,0,79,75,0,75
25/04/2022 15:00,21,10,11,52,24,28,61,22,39,0,0,0,12,12,0,27,27,0,0,0,0,153,96,57,90,41,86,1,85,79,0,79
25/04/2022 16:00,22,11,11,74,35,39,92,33,59,0,0,0,15,14,1,32,32,0,15,15,0,258,150,108,176,48,132,0,132,94,1,93
25/04/2022 17:00,56,13,43,115,42,73,149,46,103,0,0,0,15,15,0,30,30,0,35,35,0,371,241,130,279,50,215,2,213,121,0,121
25/04/2022 18:00,33,9,24,125,45,80,190,66,124,0,0,0,11,11,0,35,35,0,31,31,0,309,208,101,224,68,186,0,186,115,1,114
25/04/2022 19:00,25,10,15,120,52,68,143,62,81,0,0,0,7,7,0,16,16,0,20,20,0,183,101,82,97,38,139,3,136,105,0,105
25/04/2022 20:00,16,6,10,47,21,26,55,29,26,0,0,0,3,3,0,11,11,0,10,10,0,111,67,44,58,49,109,2,107,84,0,84
25/04/2022 21:00,3,3,0,17,7,10,28,8,20,0,0,0,2,2,0,10,10,0,9,9,0,84,54,30,56,19,88,1,87,69,0,69
25/04/2022 22:00,3,1,2,14,8,6,14,6,8,0,0,0,1,1,0,4,4,0,6,6,0,37,28,9,45,19,50,0,50,29,0,29
25/04/2022 23:00,1,1,0,2,1,1,1,0,1,0,0,0,3,3,0,3,3,0,2,2,0,22,17,5,15,3,26,0,26,13,0,13
26/04/2022 00:00,1,1,0,4,3,1,2,1,1,0,0,0,0,0,0,0,0,0,0,0,0,16,14,2,10,5,17,1,16,8,0,8
26/04/2022 01:00,0,0,0,0,0,0,0,0,0,0,0,0,0,0,0,0,0,0,1,1,0,10,10,0,2,2,5,0,5,1,0,1
26/04/2022 02:00,0,0,0,0,0,0,0,0,0,0,0,0,1,1,0,0,0,0,0,0,0,4,4,0,4,0,6,0,6,2,0,2
26/04/2022 03:00,0,0,0,0,0,0,0,0,0,0,0,0,0,0,0,0,0,0,1,1,0,2,1,1,3,1,2,0,2,0,0,0
26/04/2022 04:00,1,1,0,3,2,1,4,1,3,0,0,0,2,2,0,1,1,0,1,1,0,8,1,7,1,1,1,0,1,2,0,2
26/04/2022 05:00,1,1,0,8,4,4,9,3,6,0,0,0,3,3,0,3,3,0,2,2,0,35,9,26,9,27,1,0,1,4,0,4
26/04/2022 06:00,18,14,4,34,26,8,44,33,11,0,0,0,12,12,0,6,6,0,16,16,0,141,20,121,17,79,13,0,13,47,1,46
26/04/2022 07:00,40,36,4,83,68,15,84,67,17,0,0,0,38,37,1,20,20,0,21,21,0,340,67,273,36,220,30,0,30,104,0,104
26/04/2022 08:00,118,102,16,99,79,20,133,105,28,0,0,0,50,50,0,45,45,0,92,92,0,578,107,471,59,359,69,2,67,227,2,225
26/04/2022 09:00,34,28,6,53,31,22,75,38,37,0,0,0,23,23,0,9,9,0,11,11,0,232,38,194,35,177,42,1,41,114,1,113
26/04/2022 10:00,14,11,3,55,25,30,58,27,31,0,0,0,17,17,0,11,11,0,6,6,0,92,25,67,19,58,32,0,32,72,2,70
26/04/2022 11:00,17,13,4,60,33,27,69,40,29,0,0,0,9,8,1,9,9,0,8,8,0,91,29,62,22,50,50,0,50,66,0,66
26/04/2022 12:00,8,5,3,61,32,29,67,30,37,0,0,0,7,7,0,9,9,0,7,7,0,114,35,79,47,42,71,0,71,103,1,102
26/04/2022 13:00,17,12,5,46,25,21,56,27,29,0,0,0,5,4,1,9,9,0,9,9,0,133,58,75,57,46,96,0,96,109,0,109
26/04/2022 14:00,20,11,9,39,17,22,59,25,34,0,0,0,7,7,0,19,19,0,16,16,0,122,54,68,69,34,77,1,76,83,0,83
26/04/2022 15:00,20,8,12,54,23,31,56,20,36,0,0,0,4,4,0,36,36,0,16,16,0,154,89,65,113,36,85,0,85,87,0,87
26/04/2022 16:00,30,13,17,81,38,43,103,39,64,0,0,0,9,9,0,31,31,0,21,21,0,266,166,100,187,58,145,0,145,82,0,82
26/04/2022 17:00,65,13,52,128,42,86,179,52,127,0,0,0,3,3,0,38,38,0,29,29,0,426,291,135,371,61,244,0,244,139,1,138
26/04/2022 18:00,51,11,40,156,51,105,201,62,139,0,0,0,9,9,0,32,32,0,27,27,0,337,220,117,260,48,200,1,199,135,0,135
26/04/2022 19:00,29,12,17,108,51,57,163,79,84,0,0,0,9,9,0,19,19,0,20,20,0,186,116,70,135,53,128,1,127,141,0,141
26/04/2022 20:00,13,3,10,63,30,33,82,47,35,0,0,0,2,2,0,6,6,0,12,12,0,148,77,71,58,44,84,1,83,110,0,110
26/04/2022 21:00,9,6,3,23,14,9,44,18,26,0,0,0,5,5,0,8,8,0,8,8,0,91,57,34,62,21,93,1,92,74,2,72
26/04/2022 22:00,5,3,2,9,4,5,16,5,11,0,0,0,7,7,0,3,3,0,6,6,0,82,61,21,40,18,22,0,22,41,0,41
26/04/2022 23:00,4,3,1,7,3,4,8,3,5,0,0,0,1,1,0,2,2,0,3,3,0,42,32,10,26,2,13,0,13,21,0,21
27/04/2022 00:00,0,0,0,3,1,2,4,3,1,0,0,0,2,2,0,2,2,0,1,1,0,26,19,7,18,5,23,0,23,14,1,13
27/04/2022 01:00,0,0,0,1,1,0,0,0,0,0,0,0,0,0,0,0,0,0,0,0,0,8,6,2,3,2,6,0,6,0,0,0
27/04/2022 02:00,0,0,0,1,0,1,1,0,1,0,0,0,0,0,0,0,0,0,0,0,0,4,3,1,2,2,8,0,8,5,0,5
27/04/2022 03:00,0,0,0,0,0,0,0,0,0,0,0,0,0,0,0,0,0,0,0,0,0,3,3,0,2,0,6,0,6,1,0,1
27/04/2022 04:00,1,1,0,3,2,1,3,1,2,0,0,0,1,1,0,0,0,0,1,1,0,7,1,6,2,7,2,0,2,4,0,4
27/04/2022 05:00,2,2,0,9,4,5,7,1,6,0,0,0,6,6,0,1,1,0,4,4,0,40,8,32,8,25,5,0,5,7,0,7
27/04/2022 06:00,19,16,3,39,25,14,44,27,17,0,0,0,13,13,0,7,7,0,7,7,0,149,25,124,22,90,16,0,16,52,0,52
27/04/2022 07:00,33,26,7,95,76,19,108,86,22,0,0,0,40,40,0,25,25,0,19,19,0,322,80,242,36,196,32,0,32,81,0,81
27/04/2022 08:00,112,99,13,118,91,27,163,126,37,0,0,0,32,32,0,40,40,0,95,95,0,582,102,480,39,337,77,0,77,208,2,206
27/04/2022 09:00,31,25,6,73,47,26,103,56,47,0,0,0,12,12,0,12,12,0,19,19,0,262,54,208,31,179,39,1,38,158,0,158
27/04/2022 10:00,22,18,4,58,37,21,70,32,38,0,0,0,15,15,0,12,12,0,13,13,0,107,28,79,33,57,40,0,40,91,1,90
27/04/2022 11:00,16,12,4,48,27,21,66,33,33,0,0,0,14,14,0,7,7,0,11,11,0,85,30,55,28,39,37,1,36,72,2,70
27/04/2022 12:00,12,8,4,77,42,35,74,31,43,0,0,0,6,6,0,17,17,0,6,6,0,125,49,76,56,50,74,0,74,85,1,84
27/04/2022 13:00,15,8,7,53,28,25,65,39,26,0,0,0,10,10,0,27,27,0,13,13,0,153,70,83,78,63,101,1,100,123,1,122
27/04/2022 14:00,20,7,13,58,32,26,57,27,30,0,0,0,4,4,0,21,21,0,5,5,0,131,71,60,72,48,84,0,84,90,1,89
27/04/2022 15:00,22,15,7,48,24,24,61,25,36,0,0,0,9,9,0,33,33,0,21,21,0,178,88,90,93,49,74,0,74,81,0,81
27/04/2022 16:00,23,7,16,55,23,32,68,34,34,0,0,0,8,8,0,32,32,0,14,14,0,246,148,98,170,52,133,1,132,63,0,63
27/04/2022 17:00,70,20,50,107,36,71,162,44,118,0,0,0,9,9,0,27,27,0,30,30,0,427,287,140,328,50,220,0,220,125,0,125
27/04/2022 18:00,38,9,29,151,53,98,190,63,127,0,0,0,16,16,0,21,21,0,22,22,0,362,232,130,265,51,221,0,221,137,1,136
27/04/2022 19:00,31,9,22,112,40,72,138,51,87,0,0,0,9,9,0,22,22,0,9,9,0,202,117,85,100,53,146,0,146,121,0,121
27/04/2022 20:00,16,6,10,68,37,31,82,45,37,0,0,0,5,5,0,11,11,0,10,10,0,161,106,55,89,44,120,1,119,135,0,135
27/04/2022 21:00,14,7,7,25,11,14,31,12,19,0,0,0,2,2,0,10,10,0,5,5,0,105,72,33,68,24,78,0,78,74,0,74
27/04/2022 22:00,13,2,11,7,3,4,16,8,8,0,0,0,3,3,0,9,9,0,6,6,0,76,52,24,65,18,73,0,73,43,1,42
27/04/2022 23:00,7,5,2,7,3,4,10,5,5,0,0,0,5,5,0,6,6,0,4,4,0,41,34,7,29,4,40,0,40,19,0,19
28/04/2022 00:00,4,2,2,3,0,3,4,1,3,0,0,0,1,1,0,2,2,0,1,1,0,29,25,4,17,2,25,0,25,13,0,13
28/04/2022 01:00,1,1,0,0,0,0,0,0,0,0,0,0,1,1,0,1,1,0,1,1,0,10,9,1,7,1,3,0,3,0,0,0
28/04/2022 02:00,0,0,0,0,0,0,1,1,0,0,0,0,2,2,0,0,0,0,0,0,0,7,6,1,6,2,9,0,9,5,0,5
28/04/2022 03:00,3,0,3,0,0,0,0,0,0,0,0,0,0,0,0,0,0,0,0,0,0,4,3,1,3,1,6,0,6,0,0,0
28/04/2022 04:00,2,1,1,3,3,0,4,1,3,0,0,0,2,2,0,0,0,0,1,1,0,8,2,6,1,5,0,0,0,3,0,3
28/04/2022 05:00,1,1,0,10,6,4,10,5,5,0,0,0,4,4,0,0,0,0,1,1,0,39,7,32,5,16,8,0,8,3,0,3
28/04/2022 06:00,18,15,3,36,21,15,38,27,11,0,0,0,16,16,0,6,6,0,7,7,0,146,31,115,11,80,12,0,12,50,0,50
28/04/2022 07:00,37,27,10,74,58,16,96,74,22,0,0,0,39,39,0,20,20,0,19,19,0,283,59,224,37,187,29,0,29,92,0,92
28/04/2022 08:00,96,83,13,110,85,25,143,109,34,0,0,0,35,35,0,35,35,0,102,102,0,607,101,506,45,281,83,1,82,219,0,219
28/04/2022 09:00,46,39,7,45,28,17,67,43,24,0,0,0,16,16,0,12,12,0,19,19,0,272,59,213,34,152,51,0,51,152,0,152
28/04/2022 10:00,19,15,4,47,25,22,55,25,30,0,0,0,13,13,0,14,14,0,6,6,0,91,22,69,26,45,14,0,14,92,1,91
28/04/2022 11:00,18,11,7,47,23,24,53,25,28,0,0,0,1,1,0,8,8,0,8,8,0,85,34,51,20,52,38,1,37,78,1,77
28/04/2022 12:00,16,8,8,40,25,15,47,27,20,0,0,0,12,12,0,10,10,0,11,11,0,135,47,88,38,50,99,1,98,109,1,108
28/04/2022 13:00,21,12,9,42,23,19,64,28,36,0,0,0,5,5,0,10,10,0,8,8,0,145,69,76,83,52,60,0,60,108,0,108
28/04/2022 14:00,19,11,8,36,12,24,49,20,29,0,0,0,8,8,0,19,19,0,10,10,0,127,60,67,69,55,88,0,88,92,1,91
28/04/2022 15:00,19,8,11,34,12,22,35,13,22,0,0,0,8,8,0,34,34,0,19,19,0,172,87,85,105,56,81,0,81,85,0,85
28/04/2022 16:00,20,12,8,78,32,46,94,37,57,0,0,0,8,8,0,37,37,0,25,25,0,234,141,93,179,54,143,0,143,109,1,108
28/04/2022 17:00,58,19,39,114,47,67,151,53,98,0,0,0,15,14,1,31,31,0,24,24,0,379,251,128,304,75,246,1,245,146,0,146
28/04/2022 18:00,37,17,20,143,36,107,179,43,136,0,0,0,19,19,0,25,25,0,17,17,0,338,203,135,251,59,218,1,217,162,1,161
28/04/2022 19:00,30,17,13,106,50,56,126,54,72,0,0,0,17,17,0,18,18,0,11,11,0,221,121,100,128,47,149,1,148,141,0,141
28/04/2022 20:00,20,8,12,80,45,35,96,52,44,0,0,0,6,6,0,19,19,0,9,9,0,168,99,69,80,52,137,0,137,119,0,119
28/04/2022 21:00,18,5,13,28,14,14,28,14,14,0,0,0,10,9,1,9,9,0,6,6,0,129,78,51,62,16,118,0,118,67,1,66
28/04/2022 22:00,8,1,7,19,10,9,16,4,12,0,0,0,3,3,0,5,5,0,6,6,0,81,57,24,44,18,78,0,78,52,0,52
28/04/2022 23:00,6,3,3,5,2,3,9,3,6,0,0,0,2,2,0,4,4,0,4,4,0,53,45,8,30,10,48,0,48,23,1,22
29/04/2022 00:00,3,1,2,4,2,2,2,0,2,0,0,0,3,3,0,2,2,0,0,0,0,32,25,7,18,3,38,0,38,9,0,9
29/04/2022 01:00,0,0,0,2,0,2,1,0,1,0,0,0,0,0,0,4,4,0,0,0,0,16,10,6,11,2,5,0,5,0,0,0
29/04/2022 02:00,1,1,0,0,0,0,0,0,0,0,0,0,0,0,0,0,0,0,0,0,0,7,6,1,11,1,11,0,11,5,0,5
29/04/2022 03:00,2,1,1,0,0,0,1,1,0,0,0,0,1,1,0,1,1,0,1,1,0,6,3,3,7,0,4,0,4,4,0,4
29/04/2022 04:00,0,0,0,1,1,0,2,1,1,0,0,0,2,2,0,0,0,0,2,2,0,6,3,3,4,4,3,0,3,3,0,3
29/04/2022 05:00,2,2,0,8,3,5,12,7,5,0,0,0,3,3,0,0,0,0,0,0,0,30,5,25,7,19,0,0,0,6,0,6
29/04/2022 06:00,11,9,2,31,20,11,42,25,17,0,0,0,15,15,0,8,8,0,4,4,0,126,18,108,18,73,14,0,14,42,0,42
29/04/2022 07:00,22,20,2,50,34,16,67,52,15,0,0,0,31,31,0,17,17,0,23,23,0,230,66,164,28,125,27,0,27,68,0,68
29/04/2022 08:00,68,58,10,84,56,28,94,67,27,0,0,0,54,54,0,34,34,0,92,92,0,364,91,273,36,176,61,1,60,166,0,166
29/04/2022 09:00,29,24,5,59,33,26,74,46,28,0,0,0,28,28,0,12,12,0,13,13,0,194,35,159,25,146,43,1,42,110,0,110
29/04/2022 10:00,22,15,7,71,37,34,70,34,36,0,0,0,18,18,0,7,7,0,9,9,0,110,36,74,22,60,46,0,46,77,0,77
29/04/2022 11:00,11,8,3,63,31,32,67,28,39,0,0,0,6,6,0,17,17,0,9,9,0,93,28,65,36,48,39,0,39,108,0,108
29/04/2022 12:00,18,13,5,65,40,25,84,45,39,0,0,0,8,8,0,22,22,0,7,7,0,152,66,86,53,71,95,1,94,116,1,115
29/04/2022 13:00,19,8,11,67,27,40,73,30,43,0,0,0,3,3,0,14,14,0,8,8,0,165,82,83,84,57,120,0,120,132,1,131
29/04/2022 14:00,20,11,9,56,27,29,75,35,40,0,0,0,7,7,0,22,22,0,8,8,0,178,79,99,109,54,100,1,99,120,0,120
29/04/2022 15:00,23,13,10,73,29,44,77,31,46,0,0,0,4,4,0,18,18,0,19,19,0,173,88,85,98,49,115,0,115,104,0,104
29/04/2022 16:00,21,9,12,92,36,56,109,41,68,0,0,0,8,8,0,32,32,0,21,21,0,211,113,98,138,69,137,0,137,108,0,108
29/04/2022 17:00,41,11,30,104,51,53,123,52,71,0,0,0,7,7,0,30,30,0,26,26,0,271,162,109,177,50,197,1,196,146,1,145
29/04/2022 18:00,31,8,23,61,24,37,87,37,50,0,0,0,21,21,0,10,10,0,14,14,0,198,113,85,161,56,142,0,142,134,1,133
29/04/2022 19:00,22,11,11,68,35,33,76,31,45,0,0,0,13,12,1,6,6,0,11,11,0,156,85,71,96,48,148,0,148,105,2,103
29/04/2022 20:00,9,5,4,33,14,19,38,16,22,0,0,0,7,7,0,8,8,0,6,6,0,136,74,62,59,28,103,1,102,105,2,103
29/04/2022 21:00,10,5,5,15,7,8,31,12,19,0,0,0,5,5,0,7,7,0,2,2,0,99,67,32,59,21,75,2,73,85,1,84
29/04/2022 22:00,8,8,0,8,2,6,15,6,9,0,0,0,7,7,0,4,4,0,6,6,0,79,46,33,41,25,63,0,63,68,0,68
29/04/2022 23:00,5,1,4,8,3,5,12,4,8,0,0,0,3,3,0,4,4,0,4,4,0,51,33,18,35,9,45,1,44,37,0,37
30/04/2022 00:00,8,3,5,5,3,2,9,5,4,0,0,0,2,2,0,3,3,0,1,1,0,29,19,10,22,6,41,0,41,16,0,16
30/04/2022 01:00,1,1,0,5,3,2,2,1,1,0,0,0,3,2,1,2,2,0,1,1,0,24,16,8,16,4,17,0,17,2,0,2
30/04/2022 02:00,2,0,2,2,1,1,1,1,0,0,0,0,2,2,0,1,1,0,0,0,0,11,10,1,12,1,27,1,26,13,0,13
30/04/2022 03:00,0,0,0,0,0,0,0,0,0,0,0,0,1,1,0,0,0,0,1,1,0,11,9,2,10,4,20,0,20,5,0,5
30/04/2022 04:00,0,0,0,2,1,1,0,0,0,0,0,0,1,1,0,0,0,0,1,1,0,7,1,6,9,2,8,0,8,3,0,3
30/04/2022 05:00,1,1,0,1,0,1,3,1,2,0,0,0,1,1,0,1,1,0,1,1,0,9,2,7,2,5,2,0,2,5,0,5
30/04/2022 06:00,1,1,0,8,2,6,13,4,9,0,0,0,6,6,0,0,0,0,1,1,0,43,9,34,18,20,3,0,3,15,0,15
30/04/2022 07:00,6,4,2,33,12,21,35,13,22,0,0,0,12,12,0,1,1,0,5,5,0,45,12,33,19,17,10,0,10,15,0,15
30/04/2022 08:00,6,4,2,70,35,35,70,30,40,0,0,0,12,12,0,9,9,0,7,7,0,63,18,45,18,36,19,0,19,37,0,37
30/04/2022 09:00,8,6,2,72,36,36,74,34,40,0,0,0,9,8,1,9,9,0,10,10,0,66,17,49,20,40,33,0,33,60,0,60
30/04/2022 10:00,6,3,3,66,34,32,60,28,32,0,0,0,5,5,0,7,7,0,6,6,0,71,16,55,21,28,31,0,31,46,0,46
30/04/2022 11:00,11,9,2,52,30,22,68,33,35,0,0,0,1,1,0,9,9,0,9,9,0,68,26,42,16,18,36,0,36,63,0,63
30/04/2022 12:00,12,7,5,40,24,16,38,15,23,0,0,0,3,3,0,6,6,0,4,4,0,75,27,48,33,22,54,0,54,88,0,88
30/04/2022 13:00,10,3,7,30,15,15,37,18,19,0,0,0,4,4,0,7,7,0,7,7,0,96,46,50,46,25,61,0,61,96,0,96
30/04/2022 14:00,14,9,5,27,13,14,26,13,13,0,0,0,3,3,0,6,6,0,12,12,0,80,35,45,56,39,63,0,63,84,0,84
30/04/2022 15:00,9,6,3,31,13,18,38,22,16,0,0,0,7,7,0,9,9,0,6,6,0,91,25,66,40,28,64,2,62,80,0,80
30/04/2022 16:00,7,6,1,19,9,10,23,9,14,0,0,0,10,9,1,7,7,0,4,4,0,81,39,42,43,29,86,0,86,58,1,57
30/04/2022 17:00,5,2,3,23,13,10,20,7,13,0,0,0,6,5,1,4,4,0,2,2,0,85,47,38,41,19,61,0,61,62,0,62
30/04/2022 18:00,6,3,3,11,7,4,22,14,8,0,0,0,8,8,0,5,5,0,2,2,0,68,41,27,53,14,68,0,68,54,0,54
30/04/2022 19:00,8,3,5,3,2,1,4,3,1,0,0,0,0,0,0,3,3,0,0,0,0,69,28,41,42,24,57,0,57,58,0,58
30/04/2022 20:00,11,7,4,2,1,1,8,4,4,0,0,0,2,2,0,3,3,0,2,2,0,66,31,35,31,18,39,0,39,68,1,67
30/04/2022 21:00,4,1,3,3,2,1,6,3,3,0,0,0,3,3,0,2,2,0,1,1,0,32,18,14,22,18,31,2,29,33,0,33
30/04/2022 22:00,9,7,2,5,3,2,6,3,3,0,0,0,2,2,0,1,1,0,1,1,0,41,22,19,28,13,30,0,30,40,0,40
30/04/2022 23:00,2,0,2,3,3,0,6,3,3,0,0,0,2,2,0,4,4,0,1,1,0,31,20,11,17,6,23,1,22,23,0,23
01/05/2022 00:00,0,0,0,1,0,1,4,2,2,0,0,0,4,4,0,1,1,0,0,0,0,15,11,4,11,3,21,0,21,10,0,10
01/05/2022 01:00,1,1,0,3,2,1,2,0,2,0,0,0,1,1,0,0,0,0,0,0,0,12,8,4,3,5,4,0,4,2,0,2
01/05/2022 02:00,1,0,1,2,0,2,5,2,3,0,0,0,1,1,0,0,0,0,0,0,0,13,10,3,6,4,8,0,8,3,0,3
01/05/2022 03:00,0,0,0,0,0,0,0,0,0,0,0,0,1,1,0,0,0,0,0,0,0,10,7,3,11,0,10,0,10,2,1,1
01/05/2022 04:00,0,0,0,0,0,0,0,0,0,0,0,0,0,0,0,0,0,0,1,1,0,11,8,3,5,1,11,0,11,3,0,3
01/05/2022 05:00,1,1,0,2,0,2,2,0,2,0,0,0,0,0,0,0,0,0,0,0,0,5,1,4,2,2,7,0,7,2,0,2
01/05/2022 06:00,1,0,1,5,2,3,6,3,3,0,0,0,7,7,0,1,1,0,3,3,0,27,8,19,7,11,3,0,3,9,0,9
01/05/2022 07:00,3,2,1,18,8,10,24,10,14,0,0,0,2,2,0,1,1,0,2,2,0,37,14,23,12,14,10,0,10,14,0,14
01/05/2022 08:00,2,1,1,32,13,19,38,15,23,0,0,0,5,5,0,3,3,0,4,4,0,42,11,31,9,11,14,0,14,24,0,24
01/05/2022 09:00,8,5,3,53,23,30,53,22,31,0,0,0,5,5,0,6,6,0,3,3,0,56,11,45,5,19,22,0,22,31,0,31
01/05/2022 10:00,4,3,1,34,16,18,44,17,27,0,0,0,5,5,0,3,3,0,8,8,0,49,16,33,15,18,25,0,25,36,0,36
01/05/2022 11:00,4,3,1,50,29,21,58,34,24,0,0,0,3,3,0,2,2,0,3,3,0,49,22,27,7,20,33,0,33,35,0,35
01/05/2022 12:00,7,7,0,22,13,9,30,17,13,0,0,0,0,0,0,4,4,0,6,6,0,61,21,40,22,13,39,0,39,48,1,47
01/05/2022 13:00,6,5,1,15,11,4,25,18,7,0,0,0,2,2,0,2,2,0,2,2,0,41,17,24,24,20,43,0,43,48,0,48
01/05/2022 14:00,5,5,0,16,8,8,24,11,13,0,0,0,2,1,1,4,4,0,10,10,0,55,29,26,22,25,31,0,31,67,0,67
01/05/2022 15:00,6,4,2,28,14,14,32,15,17,0,0,0,8,7,1,3,3,0,5,5,0,74,39,35,29,31,49,1,48,75,0,75
01/05/2022 16:00,5,4,1,37,15,22,56,17,39,0,0,0,9,9,0,8,8,0,6,6,0,83,38,45,36,29,65,0,65,82,1,81
01/05/2022 17:00,10,4,6,50,25,25,64,24,40,0,0,0,8,8,0,5,5,0,12,12,0,96,36,60,41,18,62,1,61,85,0,85
01/05/2022 18:00,11,4,7,30,12,18,40,19,21,0,0,0,11,11,0,8,8,0,5,5,0,81,41,40,41,26,80,0,80,94,0,94
01/05/2022 19:00,9,6,3,33,19,14,43,23,20,0,0,0,10,8,2,8,8,0,6,6,0,74,40,34,38,29,65,0,65,91,1,90
01/05/2022 20:00,4,4,0,23,13,10,18,9,9,0,0,0,5,5,0,5,5,0,3,3,0,81,32,49,34,29,61,0,61,72,1,71
01/05/2022 21:00,7,5,2,14,8,6,24,12,12,0,0,0,3,3,0,4,4,0,3,3,0,58,35,23,32,19,55,1,54,46,0,46
01/05/2022 22:00,4,1,3,5,2,3,10,4,6,0,0,0,1,1,0,2,2,0,1,1,0,45,23,22,39,22,8,0,8,44,2,42
01/05/2022 23:00,2,1,1,2,1,1,8,4,4,0,0,0,3,3,0,3,3,0,2,2,0,27,18,9,19,6,0,0,0,29,0,29
02/05/2022 00:00,4,2,2,2,1,1,3,1,2,0,0,0,1,1,0,0,0,0,2,2,0,19,9,10,15,7,0,0,0,14,0,14
02/05/2022 01:00,0,0,0,1,1,0,0,0,0,0,0,0,2,2,0,0,0,0,2,2,0,10,5,5,8,1,8,0,8,1,0,1
02/05/2022 02:00,0,0,0,0,0,0,2,1,1,0,0,0,1,1,0,0,0,0,0,0,0,11,7,4,6,3,9,0,9,5,1,4
02/05/2022 03:00,0,0,0,3,1,2,3,1,2,0,0,0,0,0,0,0,0,0,0,0,0,5,4,1,11,2,6,0,6,2,1,1
02/05/2022 04:00,0,0,0,2,1,1,1,1,0,0,0,0,0,0,0,0,0,0,0,0,0,6,3,3,7,0,2,0,2,4,0,4
02/05/2022 05:00,0,0,0,1,0,1,1,0,1,0,0,0,1,1,0,1,1,0,0,0,0,9,2,7,3,5,0,0,0,7,0,7
02/05/2022 06:00,2,1,1,8,5,3,9,6,3,0,0,0,0,0,0,3,3,0,0,0,0,43,7,36,9,19,6,0,6,14,0,14
02/05/2022 07:00,3,3,0,33,12,21,39,11,28,0,0,0,9,9,0,1,1,0,0,0,0,38,12,26,16,27,4,0,4,8,0,8
02/05/2022 08:00,5,4,1,74,34,40,82,35,47,0,0,0,5,5,0,5,5,0,2,2,0,49,15,34,11,16,13,0,13,18,0,18
02/05/2022 09:00,8,7,1,137,59,78,142,60,82,0,0,0,8,8,0,7,7,0,6,6,0,62,21,41,13,45,22,0,22,42,0,42
02/05/2022 10:00,8,4,4,141,63,78,181,74,107,0,0,0,3,3,0,7,7,0,6,6,0,63,15,48,26,41,27,1,26,44,0,44
02/05/2022 11:00,13,10,3,185,75,110,235,108,127,0,0,0,1,1,0,9,9,0,7,7,0,73,22,51,43,28,14,0,14,57,0,57
02/05/2022 12:00,17,11,6,167,90,77,207,116,91,0,0,0,3,3,0,20,20,0,7,7,0,86,31,55,50,38,63,0,63,71,1,70
02/05/2022 13:00,15,10,5,149,69,80,203,90,113,0,0,0,2,2,0,9,9,0,5,5,0,99,42,57,53,37,74,0,74,82,0,82
02/05/2022 14:00,9,5,4,151,76,75,173,81,92,0,0,0,4,4,0,19,19,0,10,10,0,109,50,59,52,38,61,0,61,73,0,73
02/05/2022 15:00,15,10,5,120,67,53,157,85,72,0,0,0,5,5,0,18,18,0,5,5,0,92,45,47,59,53,60,0,60,80,0,80
02/05/2022 16:00,19,10,9,157,85,72,177,94,83,0,0,0,6,6,0,10,10,0,6,6,0,105,47,58,54,50,89,0,89,65,1,64
02/05/2022 17:00,9,4,5,98,56,42,147,82,65,0,0,0,9,8,1,9,9,0,9,9,0,103,61,42,64,36,99,0,99,86,0,86
02/05/2022 18:00,10,5,5,64,42,22,64,38,26,0,0,0,3,3,0,10,10,0,10,10,0,133,69,64,54,35,110,0,110,70,0,70
02/05/2022 19:00,12,6,6,39,21,18,52,31,21,0,0,0,10,10,0,16,16,0,5,5,0,96,44,52,41,31,109,0,109,83,1,82
02/05/2022 20:00,14,7,7,24,12,12,29,14,15,0,0,0,7,7,0,7,7,0,4,4,0,93,50,43,32,28,72,0,72,79,0,79
02/05/2022 21:00,8,3,5,12,5,7,24,12,12,0,0,0,8,8,0,3,3,0,2,2,0,56,33,23,31,19,67,1,66,51,0,51
02/05/2022 22:00,5,2,3,9,5,4,16,5,11,0,0,0,3,3,0,3,3,0,0,0,0,30,16,14,24,9,10,0,10,32,0,32
02/05/2022 23:00,0,0,0,2,1,1,2,1,1,0,0,0,1,1,0,1,1,0,0,0,0,17,12,5,15,5,9,0,9,23,1,22
03/05/2022 00:00,0,0,0,2,1,1,4,3,1,0,0,0,0,0,0,0,0,0,0,0,0,8,7,1,11,1,11,0,11,8,0,8
03/05/2022 01:00,0,0,0,1,1,0,0,0,0,0,0,0,1,1,0,0,0,0,0,0,0,3,2,1,2,0,2,0,2,0,0,0
03/05/2022 02:00,0,0,0,0,0,0,2,2,0,0,0,0,1,1,0,0,0,0,0,0,0,0,0,0,0,1,5,0,5,1,0,1
03/05/2022 03:00,0,0,0,0,0,0,0,0,0,0,0,0,0,0,0,1,1,0,0,0,0,4,3,1,1,0,3,0,3,1,0,1
03/05/2022 04:00,0,0,0,4,3,1,4,2,2,0,0,0,2,2,0,0,0,0,0,0,0,6,1,5,1,4,3,0,3,3,0,3
03/05/2022 05:00,2,2,0,8,5,3,8,4,4,0,0,0,4,4,0,2,2,0,0,0,0,28,5,23,4,17,2,0,2,4,0,4
03/05/2022 06:00,13,10,3,27,21,6,34,24,10,0,0,0,17,17,0,9,9,0,7,7,0,121,21,100,13,86,12,1,11,47,0,47
03/05/2022 07:00,41,39,2,79,60,19,89,63,26,0,0,0,39,39,0,15,15,0,25,25,0,303,72,231,33,183,23,0,23,84,0,84
03/05/2022 08:00,101,88,13,100,78,22,122,96,26,0,0,0,57,57,0,28,28,0,70,70,0,572,108,464,48,340,66,1,65,206,0,206
03/05/2022 09:00,35,31,4,55,39,16,63,46,17,0,0,0,26,26,0,16,16,0,12,12,0,226,43,183,26,163,30,0,30,139,0,139
03/05/2022 10:00,16,11,5,54,24,30,71,25,46,0,0,0,6,6,0,14,14,0,8,8,0,88,23,65,24,44,33,0,33,54,1,53
03/05/2022 11:00,15,10,5,68,30,38,75,34,41,0,0,0,7,7,0,7,7,0,4,4,0,82,24,58,36,42,50,0,50,78,1,77
03/05/2022 12:00,13,8,5,75,39,36,74,29,45,0,0,0,2,2,0,5,5,0,8,8,0,104,42,62,37,41,58,0,58,76,0,76
03/05/2022 13:00,21,13,8,55,29,26,63,32,31,0,0,0,10,10,0,13,13,0,7,7,0,126,64,62,52,46,90,1,89,95,1,94
03/05/2022 14:00,14,8,6,37,20,17,42,20,22,0,0,0,7,6,1,14,14,0,9,9,0,112,57,55,64,36,71,0,71,85,0,85
03/05/2022 15:00,21,6,15,51,18,33,71,28,43,0,0,0,4,4,0,29,29,0,26,26,0,170,87,83,94,37,71,0,71,59,2,57
03/05/2022 16:00,23,12,11,60,28,32,87,26,61,0,0,0,4,4,0,33,33,0,26,26,0,204,122,82,195,59,131,1,130,97,2,95
03/05/2022 17:00,69,18,51,114,32,82,148,42,106,0,0,0,9,8,1,27,27,0,28,28,0,398,260,138,329,48,242,0,242,141,1,140
03/05/2022 18:00,56,16,40,105,28,77,155,41,114,0,0,0,12,11,1,30,30,0,10,10,0,337,224,113,254,51,201,0,201,111,1,110
03/05/2022 19:00,26,14,12,99,40,59,130,52,78,0,0,0,4,4,0,18,18,0,20,20,0,203,124,79,96,36,135,0,135,101,1,100
03/05/2022 20:00,13,7,6,53,26,27,60,23,37,0,0,0,9,8,1,14,14,0,9,9,0,163,102,61,67,30,83,1,82,107,0,107
03/05/2022 21:00,5,1,4,20,10,10,30,13,17,0,0,0,4,4,0,9,9,0,8,8,0,89,65,24,70,20,70,1,69,55,0,55
03/05/2022 22:00,6,4,2,15,9,6,18,8,10,0,0,0,1,1,0,2,2,0,9,9,0,61,42,19,34,15,17,0,17,28,0,28
03/05/2022 23:00,3,2,1,2,1,1,6,1,5,0,0,0,0,0,0,2,2,0,3,3,0,32,26,6,19,6,0,0,0,24,0,24
04/05/2022 00:00,2,0,2,1,0,1,1,0,1,0,0,0,1,1,0,2,2,0,0,0,0,15,11,4,14,5,26,1,25,7,0,7
04/05/2022 01:00,1,0,1,1,1,0,0,0,0,0,0,0,1,1,0,0,0,0,0,0,0,7,6,1,5,1,1,0,1,1,0,1
04/05/2022 02:00,1,1,0,0,0,0,0,0,0,0,0,0,2,2,0,0,0,0,0,0,0,1,1,0,3,1,5,0,5,3,0,3
04/05/2022 03:00,0,0,0,0,0,0,0,0,0,0,0,0,0,0,0,1,1,0,1,1,0,3,2,1,4,0,1,0,1,0,0,0
04/05/2022 04:00,0,0,0,3,2,1,4,2,2,0,0,0,3,3,0,1,1,0,0,0,0,6,0,6,4,3,0,0,0,3,0,3
04/05/2022 05:00,1,1,0,5,2,3,6,3,3,0,0,0,5,5,0,0,0,0,3,3,0,34,4,30,5,27,4,0,4,8,0,8
04/05/2022 06:00,21,16,5,45,29,16,43,28,15,0,0,0,16,16,0,11,11,0,4,4,0,150,28,122,23,90,11,0,11,49,1,48
04/05/2022 07:00,56,50,6,88,62,26,106,89,17,0,0,0,50,50,0,13,13,0,10,10,0,345,91,254,38,221,38,0,38,90,0,90
04/05/2022 08:00,117,105,12,121,96,25,151,108,43,0,0,0,41,41,0,43,43,0,35,35,0,667,106,561,45,363,70,0,70,254,1,253
04/05/2022 09:00,34,28,6,71,44,27,75,47,28,0,0,0,23,23,0,11,11,0,10,10,0,248,48,200,15,182,45,0,45,138,1,137
04/05/2022 10:00,18,12,6,54,32,22,51,21,30,0,0,0,25,25,0,8,8,0,11,11,0,97,25,72,20,46,24,0,24,78,0,78
04/05/2022 11:00,10,9,1,46,30,16,56,36,20,0,0,0,16,16,0,11,11,0,8,8,0,84,30,54,35,55,53,0,53,92,0,92
04/05/2022 12:00,11,7,4,65,28,37,74,32,42,0,0,0,14,14,0,11,11,0,4,4,0,121,48,73,54,55,76,0,76,112,0,112
04/05/2022 13:00,22,16,6,71,33,38,98,41,57,0,0,0,12,12,0,27,27,0,7,7,0,137,56,81,83,46,88,1,87,110,1,109
04/05/2022 14:00,26,15,11,55,23,32,102,48,54,0,0,0,6,6,0,20,20,0,8,8,0,135,62,73,68,48,88,0,88,106,1,105
04/05/2022 15:00,27,12,15,59,20,39,79,33,46,0,0,0,14,14,0,32,32,0,9,9,0,177,95,82,69,50,99,0,99,85,0,85
04/05/2022 16:00,37,12,25,92,38,54,117,40,77,0,0,0,16,15,1,30,30,0,3,3,0,249,131,118,192,68,148,1,147,105,2,103
04/05/2022 17:00,83,27,56,167,54,113,223,74,149,0,0,0,3,3,0,45,45,0,2,2,0,406,272,134,317,73,240,0,240,109,0,109
04/05/2022 18:00,46,13,33,204,63,141,277,82,195,0,0,0,12,12,0,38,38,0,0,0,0,392,245,147,251,51,217,0,217,140,0,140
04/05/2022 19:00,31,10,21,160,71,89,200,84,116,0,0,0,10,10,0,24,24,0,0,0,0,244,137,107,121,70,145,0,145,122,0,122
04/05/2022 20:00,14,4,10,110,61,49,137,76,61,0,0,0,11,11,0,10,10,0,0,0,0,168,101,67,72,55,102,0,102,78,0,78
04/05/2022 21:00,16,7,9,38,27,11,52,33,19,0,0,0,7,7,0,8,8,0,2,2,0,103,55,48,66,32,106,3,103,74,0,74
04/05/2022 22:00,3,1,2,10,2,8,23,6,17,0,0,0,5,5,0,5,5,0,4,4,0,93,62,31,58,17,67,0,67,49,1,48
04/05/2022 23:00,6,2,4,8,2,6,6,2,4,0,0,0,2,2,0,4,4,0,4,4,0,50,42,8,31,8,42,1,41,27,0,27
05/05/2022 00:00,1,0,1,0,0,0,7,3,4,0,0,0,4,3,1,2,2,0,1,1,0,24,16,8,13,1,22,0,22,10,0,10
05/05/2022 01:00,1,1,0,1,1,0,1,0,1,0,0,0,2,2,0,0,0,0,0,0,0,11,8,3,8,1,5,0,5,1,0,1
05/05/2022 02:00,0,0,0,1,0,1,1,0,1,0,0,0,0,0,0,0,0,0,0,0,0,3,2,1,3,0,11,0,11,3,0,3
05/05/2022 03:00,0,0,0,0,0,0,0,0,0,0,0,0,0,0,0,0,0,0,2,2,0,1,1,0,6,0,3,0,3,3,0,3
05/05/2022 04:00,1,1,0,1,1,0,1,0,1,0,0,0,2,2,0,0,0,0,0,0,0,8,1,7,3,3,0,0,0,3,0,3
05/05/2022 05:00,4,4,0,7,3,4,7,2,5,0,0,0,4,4,0,1,1,0,3,3,0,46,6,40,6,26,9,0,9,4,0,4
05/05/2022 06:00,14,11,3,35,29,6,39,31,8,0,0,0,11,11,0,6,6,0,7,7,0,142,20,122,15,78,11,0,11,51,0,51
05/05/2022 07:00,45,40,5,79,53,26,98,71,27,0,0,0,54,54,0,18,18,0,10,10,0,324,75,249,36,194,41,0,41,110,0,110
05/05/2022 08:00,110,99,11,122,94,28,155,118,37,0,0,0,78,78,0,39,39,0,53,53,0,613,109,504,54,350,70,0,70,239,0,239
05/05/2022 09:00,34,31,3,53,34,19,70,49,21,0,0,0,31,31,0,18,18,0,1,1,0,255,47,208,21,153,46,0,46,153,0,153
05/05/2022 10:00,18,11,7,66,32,34,74,25,49,0,0,0,23,23,0,5,5,0,5,5,0,93,29,64,27,58,30,0,30,73,0,73
05/05/2022 11:00,16,11,5,63,29,34,75,35,40,0,0,0,21,21,0,12,12,0,5,5,0,106,37,69,39,33,44,0,44,73,0,73
05/05/2022 12:00,21,12,9,53,30,23,68,33,35,0,0,0,17,17,0,8,8,0,5,5,0,117,44,73,50,53,79,1,78,91,1,90
05/05/2022 13:00,24,16,8,55,28,27,69,32,37,0,0,0,7,7,0,17,17,0,7,7,0,139,59,80,70,45,95,0,95,100,1,99
05/05/2022 14:00,17,11,6,46,23,23,66,26,40,0,0,0,6,6,0,22,22,0,6,6,0,118,55,63,79,36,77,0,77,95,0,95
05/05/2022 15:00,24,16,8,52,20,32,76,35,41,0,0,0,14,14,0,33,33,0,3,3,0,178,83,95,107,54,89,0,89,70,0,70
05/05/2022 16:00,32,15,17,58,24,34,92,30,62,0,0,0,16,15,1,25,25,0,11,11,0,232,143,89,175,65,118,0,118,105,0,105
05/05/2022 17:00,62,11,51,130,39,91,152,40,112,0,0,0,13,13,0,38,38,0,4,4,0,421,285,136,256,60,251,0,251,137,0,137
05/05/2022 18:00,43,15,28,140,39,101,185,51,134,0,0,0,14,14,0,37,37,0,2,2,0,332,209,123,187,34,226,0,226,145,2,143
05/05/2022 19:00,27,12,15,97,34,63,109,41,68,0,0,0,17,17,0,22,22,0,1,1,0,226,135,91,149,57,130,0,130,128,0,128
05/05/2022 20:00,18,5,13,70,39,31,91,51,40,0,0,0,8,7,1,18,18,0,0,0,0,158,88,70,82,32,106,0,106,109,1,108
05/05/2022 21:00,9,5,4,25,13,12,48,24,24,0,0,0,6,6,0,11,11,0,0,0,0,93,59,34,76,32,86,3,83,77,1,76
05/05/2022 22:00,6,4,2,9,2,7,12,2,10,0,0,0,12,12,0,4,4,0,0,0,0,94,65,29,55,14,67,1,66,49,0,49
05/05/2022 23:00,5,4,1,3,0,3,13,5,8,0,0,0,2,2,0,2,2,0,2,2,0,53,36,17,53,15,53,0,53,34,0,34
06/05/2022 00:00,1,1,0,6,4,2,12,4,8,0,0,0,2,2,0,2,2,0,1,1,0,35,30,5,19,,45,1,44,20,0,20
06/05/2022 01:00,0,0,0,1,1,0,0,0,0,0,0,0,1,1,0,1,1,0,0,0,0,13,12,1,8,,6,0,6,0,0,0
06/05/2022 02:00,0,0,0,0,0,0,0,0,0,0,0,0,1,1,0,1,1,0,0,0,0,7,4,3,8,,12,0,12,4,0,4
06/05/2022 03:00,0,0,0,1,0,1,1,0,1,0,0,0,0,0,0,0,0,0,0,0,0,2,1,1,6,,4,0,4,2,0,2
06/05/2022 04:00,0,0,0,1,1,0,1,0,1,0,0,0,3,2,1,0,0,0,2,2,0,10,3,7,4,,1,0,1,2,0,2
06/05/2022 05:00,2,2,0,5,5,0,9,6,3,0,0,0,6,6,0,1,1,0,1,1,0,29,5,24,8,,6,0,6,6,0,6
06/05/2022 06:00,17,14,3,23,18,5,26,19,7,0,0,0,24,22,2,4,4,0,7,7,0,135,19,116,18,,15,0,15,50,1,49
06/05/2022 07:00,29,25,4,70,48,22,69,43,26,0,0,0,43,43,0,18,18,0,14,14,0,235,55,180,21,,32,1,31,85,0,85
06/05/2022 08:00,62,55,7,89,53,36,112,86,26,0,0,0,23,23,0,33,33,0,61,61,0,384,88,296,35,,60,0,60,150,1,149
06/05/2022 09:00,21,18,3,42,31,11,53,33,20,0,0,0,20,20,0,17,17,0,11,11,0,199,43,156,28,,36,0,36,126,1,125
06/05/2022 10:00,13,10,3,39,16,23,36,17,19,0,0,0,9,9,0,7,7,0,6,6,0,73,18,55,21,,23,0,23,70,0,70
06/05/2022 11:00,2,1,1,20,9,11,27,12,15,0,0,0,9,9,0,3,3,0,1,1,0,70,23,47,25,,29,0,29,59,1,58
06/05/2022 12:00,11,4,7,18,14,4,25,13,12,0,0,0,7,7,0,6,6,0,4,4,0,102,50,52,42,,58,2,56,74,1,73
06/05/2022 13:00,14,9,5,7,4,3,22,10,12,0,0,0,8,8,0,12,12,0,3,3,0,123,53,70,55,,98,0,98,88,1,87
06/05/2022 14:00,11,6,5,20,6,14,27,7,20,0,0,0,1,1,0,14,14,0,1,1,0,122,69,53,64,,62,1,61,72,1,71
06/05/2022 15:00,25,13,12,20,7,13,21,6,15,0,0,0,4,4,0,17,17,0,0,0,0,127,71,56,62,,39,0,39,60,1,59
06/05/2022 16:00,24,12,12,31,10,21,47,10,37,0,0,0,9,9,0,14,14,0,3,3,0,198,117,81,111,,98,2,96,84,0,84
06/05/2022 17:00,26,5,21,42,11,31,67,17,50,0,0,0,7,7,0,25,25,0,6,6,0,244,152,92,176,,153,2,151,111,0,111
06/05/2022 18:00,30,16,14,56,16,40,77,20,57,0,0,0,11,11,0,21,21,0,12,12,0,227,137,90,166,,154,0,154,117,0,117
06/05/2022 19:00,17,8,9,59,26,33,64,21,43,0,0,0,5,5,0,9,9,0,5,5,0,174,88,86,55,,138,1,137,119,1,118
06/05/2022 20:00,15,6,9,27,15,12,42,19,23,0,0,0,7,6,1,5,5,0,5,5,0,107,57,50,73,,96,0,96,104,0,104
06/05/2022 21:00,7,3,4,12,4,8,16,4,12,0,0,0,6,6,0,7,7,0,3,3,0,77,47,30,52,,74,0,74,85,0,85
06/05/2022 22:00,6,3,3,7,3,4,12,5,7,0,0,0,4,4,0,1,1,0,2,2,0,72,47,25,38,,56,1,55,52,2,50
06/05/2022 23:00,5,1,4,4,1,3,9,2,7,0,0,0,1,1,0,1,1,0,1,1,0,61,49,12,26,,39,0,39,34,1,33
07/05/2022 00:00,1,1,0,2,1,1,1,1,0,0,0,0,1,1,0,1,1,0,3,3,0,27,16,11,24,,35,0,35,16,1,15
07/05/2022 01:00,2,2,0,0,0,0,0,0,0,0,0,0,1,1,0,1,1,0,0,0,0,20,15,5,12,,7,0,7,3,0,3
07/05/2022 02:00,0,0,0,1,0,1,1,0,1,0,0,0,0,0,0,1,1,0,0,0,0,13,12,1,8,,11,1,10,7,0,7
07/05/2022 03:00,1,1,0,2,1,1,7,3,4,0,0,0,1,1,0,0,0,0,3,3,0,10,9,1,16,,16,0,16,3,0,3
07/05/2022 04:00,1,1,0,10,4,6,4,1,3,0,0,0,2,2,0,0,0,0,0,0,0,12,6,6,8,,6,0,6,3,0,3
07/05/2022 05:00,0,0,0,15,6,9,12,3,9,0,0,0,0,0,0,1,1,0,0,0,0,14,3,11,3,,4,1,3,6,0,6
07/05/2022 06:00,0,0,0,29,15,14,36,17,19,0,0,0,5,5,0,2,2,0,0,0,0,37,10,27,18,,10,0,10,18,0,18
07/05/2022 07:00,7,6,1,47,21,26,51,20,31,0,0,0,18,18,0,8,8,0,4,4,0,58,22,36,20,,7,0,7,18,0,18
07/05/2022 08:00,10,9,1,61,30,31,72,37,35,0,0,0,8,8,0,6,6,0,1,1,0,81,18,63,21,,20,1,19,28,0,28
07/05/2022 09:00,11,11,0,131,55,76,117,42,75,0,0,0,11,10,1,8,8,0,5,5,0,88,27,61,18,,21,0,21,80,1,79
07/05/2022 10:00,19,14,5,127,52,75,135,67,68,0,0,0,11,11,0,17,17,0,1,1,0,98,32,66,34,,47,0,47,87,0,87
07/05/2022 11:00,22,14,8,141,61,80,170,69,101,0,0,0,7,7,0,13,13,0,5,5,0,116,55,61,52,,44,0,44,83,0,83
07/05/2022 12:00,14,7,7,150,83,67,184,90,94,0,0,0,5,5,0,10,10,0,3,3,0,153,63,90,48,,61,2,59,87,1,86
07/05/2022 13:00,17,9,8,133,65,68,140,71,69,0,0,0,10,10,0,13,13,0,6,6,0,148,58,90,70,,79,0,79,111,1,110
07/05/2022 14:00,29,18,11,95,50,45,149,60,89,0,0,0,10,10,0,8,8,0,8,8,0,177,61,116,66,,78,1,77,118,0,118
07/05/2022 15:00,14,11,3,109,56,53,151,74,77,0,0,0,12,11,1,17,17,0,8,8,0,130,64,66,46,,94,0,94,102,0,102
07/05/2022 16:00,14,6,8,114,53,61,157,64,93,0,0,0,16,16,0,18,18,0,7,7,0,141,63,78,53,,92,0,92,100,1,99
07/05/2022 17:00,19,9,10,88,41,47,128,59,69,0,0,0,22,22,0,12,12,0,4,4,0,113,49,64,53,,105,1,104,102,0,102
07/05/2022 18:00,23,9,14,79,39,40,104,54,50,0,0,0,22,22,0,14,14,0,12,12,0,154,78,76,59,,129,0,129,132,1,131
07/05/2022 19:00,15,8,7,54,33,21,74,39,35,0,0,0,15,15,0,18,18,0,4,4,0,134,63,71,45,,117,2,115,129,1,128
07/05/2022 20:00,6,3,3,41,26,15,50,32,18,0,0,0,9,9,0,5,5,0,4,4,0,102,49,53,36,,70,0,70,104,1,103
07/05/2022 21:00,5,2,3,19,10,9,23,9,14,0,0,0,5,5,0,4,4,0,3,3,0,76,36,40,48,,51,0,51,80,0,80
07/05/2022 22:00,2,2,0,13,7,6,17,5,12,0,0,0,3,3,0,2,2,0,2,2,0,74,40,34,49,,44,0,44,62,0,62
07/05/2022 23:00,2,1,1,4,3,1,6,2,4,0,0,0,9,9,0,1,1,0,1,1,0,46,32,14,40,,16,0,16,40,0,40
08/05/2022 00:00,2,1,1,4,2,2,8,3,5,0,0,0,2,2,0,0,0,0,0,0,0,31,20,11,32,,31,0,31,19,0,19
08/05/2022 01:00,0,0,0,2,2,0,1,0,1,0,0,0,2,2,0,2,2,0,0,0,0,27,23,4,16,,3,0,3,2,0,2
08/05/2022 02:00,2,0,2,0,0,0,1,0,1,0,0,0,3,3,0,0,0,0,0,0,0,34,24,10,10,,20,0,20,7,0,7
08/05/2022 03:00,1,0,1,1,0,1,1,0,1,0,0,0,2,2,0,2,2,0,0,0,0,13,12,1,19,,24,0,24,4,0,4
08/05/2022 04:00,0,0,0,7,2,5,5,1,4,0,0,0,3,3,0,0,0,0,0,0,0,10,5,5,8,,8,0,8,1,0,1
08/05/2022 05:00,2,1,1,6,3,3,13,5,8,0,0,0,0,0,0,1,1,0,1,1,0,8,2,6,3,,8,0,8,6,0,6
08/05/2022 06:00,1,1,0,14,8,6,17,8,9,0,0,0,4,4,0,1,1,0,2,2,0,35,10,25,10,,7,0,7,9,1,8
08/05/2022 07:00,4,4,0,53,20,33,47,14,33,0,0,0,15,15,0,4,4,0,4,4,0,41,15,26,20,,9,0,9,8,0,8
08/05/2022 08:00,8,6,2,130,48,82,125,44,81,0,0,0,13,13,0,3,3,0,4,4,0,60,23,37,28,,20,0,20,21,0,21
08/05/2022 09:00,14,11,3,165,71,94,196,74,122,0,0,0,11,9,2,8,8,0,5,5,0,88,21,67,33,,31,1,30,44,0,44
08/05/2022 10:00,10,8,2,224,108,116,249,106,143,0,0,0,18,18,0,15,15,0,14,14,0,106,41,65,41,,29,0,29,52,0,52
08/05/2022 11:00,12,8,4,275,115,160,320,136,184,0,0,0,12,12,0,19,19,0,17,17,0,146,53,93,68,,49,0,49,79,0,79
08/05/2022 12:00,17,12,5,319,168,151,399,186,213,0,0,0,3,3,0,23,23,0,13,13,0,146,48,98,62,,60,0,60,95,0,95
08/05/2022 13:00,17,10,7,201,101,100,275,139,136,0,0,0,6,6,0,23,23,0,9,9,0,166,64,102,63,,84,0,84,113,2,111
08/05/2022 14:00,37,30,7,181,96,85,258,113,145,0,0,0,19,18,1,21,21,0,4,4,0,170,72,98,51,,83,0,83,104,0,104
08/05/2022 15:00,21,12,9,156,85,71,237,115,122,0,0,0,15,15,0,12,12,0,0,0,0,125,65,60,56,,81,1,80,95,0,95
08/05/2022 16:00,20,10,10,153,95,58,238,140,98,0,0,0,4,4,0,21,21,0,7,7,0,155,70,85,69,,80,0,80,83,1,82
08/05/2022 17:00,21,11,10,128,66,62,211,97,114,0,0,0,6,5,1,13,13,0,2,2,0,127,66,61,47,,89,0,89,92,0,92
08/05/2022 18:00,16,8,8,103,59,44,163,95,68,0,0,0,9,9,0,25,25,0,9,9,0,135,78,57,71,,99,0,99,90,0,90
08/05/2022 19:00,11,4,7,84,50,34,149,77,72,0,0,0,7,7,0,15,15,0,10,10,0,144,87,57,70,,49,1,48,114,2,112
08/05/2022 20:00,14,8,6,42,26,16,73,44,29,0,0,0,3,3,0,6,6,0,1,1,0,119,60,59,39,,83,0,83,92,0,92
08/05/2022 21:00,10,6,4,22,13,9,26,14,12,0,0,0,3,2,1,5,5,0,1,1,0,75,45,30,40,,68,1,67,66,0,66
08/05/2022 22:00,6,3,3,13,8,5,16,10,6,0,0,0,5,5,0,0,0,0,0,0,0,66,41,25,44,,11,0,11,42,0,42
08/05/2022 23:00,5,2,3,1,1,0,5,2,3,0,0,0,4,4,0,3,3,0,0,0,0,28,25,3,32,,0,0,0,35,0,35
09/05/2022 00:00,1,1,0,1,0,1,4,1,3,0,0,0,3,3,0,0,0,0,0,0,0,20,15,5,11,,9,0,9,12,0,12
09/05/2022 01:00,0,0,0,0,0,0,0,0,0,0,0,0,0,0,0,1,1,0,0,0,0,8,8,0,8,,1,0,1,1,0,1
09/05/2022 02:00,0,0,0,1,0,1,1,0,1,0,0,0,0,0,0,1,1,0,0,0,0,5,4,1,6,,9,0,9,2,0,2
09/05/2022 03:00,0,0,0,1,1,0,0,0,0,0,0,0,0,0,0,0,0,0,0,0,0,4,2,2,2,,2,0,2,4,0,4
09/05/2022 04:00,1,1,0,2,2,0,1,1,0,0,0,0,2,2,0,0,0,0,0,0,0,5,2,3,1,,2,0,2,2,0,2
09/05/2022 05:00,2,2,0,5,3,2,11,1,10,0,0,0,8,8,0,2,2,0,0,0,0,40,7,33,12,,2,0,2,7,0,7
09/05/2022 06:00,19,15,4,32,22,10,31,24,7,0,0,0,16,16,0,10,10,0,1,1,0,125,19,106,16,,10,0,10,44,0,44
09/05/2022 07:00,25,23,2,68,49,19,74,54,20,0,0,0,30,30,0,17,17,0,3,3,0,260,69,191,21,,34,0,34,66,0,66
09/05/2022 08:00,85,74,11,85,66,19,95,81,14,0,0,0,75,75,0,38,38,0,16,16,0,477,92,385,42,,58,0,58,168,2,166
09/05/2022 09:00,32,29,3,26,16,10,50,30,20,0,0,0,34,34,0,12,12,0,11,11,0,214,38,176,26,,39,1,38,121,0,121
09/05/2022 10:00,22,14,8,32,17,15,31,15,16,0,0,0,21,20,1,8,8,0,3,3,0,69,25,44,20,,24,0,24,62,0,62
09/05/2022 11:00,9,5,4,32,19,13,43,24,19,0,0,0,4,4,0,5,5,0,0,0,0,89,39,50,27,,33,0,33,53,0,53
09/05/2022 12:00,15,10,5,26,11,15,21,11,10,0,0,0,6,5,1,7,7,0,1,1,0,90,33,57,31,,74,0,74,71,0,71
09/05/2022 13:00,18,13,5,17,4,13,28,10,18,0,0,0,0,0,0,7,7,0,1,1,0,124,50,74,48,,89,0,89,95,0,95
09/05/2022 14:00,16,6,10,13,5,8,17,3,14,0,0,0,5,5,0,14,14,0,0,0,0,100,52,48,56,,66,1,65,69,0,69
09/05/2022 15:00,14,8,6,25,10,15,26,8,18,0,0,0,8,8,0,34,34,0,0,0,0,141,75,66,76,,68,0,68,72,0,72
09/05/2022 16:00,34,17,17,24,10,14,49,13,36,0,0,0,6,6,0,27,27,0,1,1,0,195,117,78,135,,111,0,111,83,0,83
09/05/2022 17:00,58,13,45,61,14,47,101,16,85,0,0,0,6,6,0,38,38,0,4,4,0,354,238,116,272,,199,0,199,104,0,104
09/05/2022 18:00,28,7,21,62,20,42,100,22,78,0,0,0,10,10,0,21,21,0,3,3,0,311,199,112,189,,189,0,189,109,0,109
09/05/2022 19:00,15,4,11,54,24,30,76,27,49,0,0,0,11,10,1,11,11,0,0,0,0,190,108,82,90,,142,0,142,96,0,96
09/05/2022 20:00,13,5,8,24,8,16,49,20,29,0,0,0,4,4,0,11,11,0,1,1,0,116,70,46,42,,97,0,97,79,0,79
09/05/2022 21:00,7,4,3,21,12,9,17,8,9,0,0,0,5,5,0,9,9,0,0,0,0,99,75,24,45,,27,1,26,50,0,50
09/05/2022 22:00,6,4,2,5,1,4,13,5,8,0,0,0,5,5,0,3,3,0,2,2,0,53,35,18,32,,7,0,7,33,1,32
09/05/2022 23:00,1,1,0,0,0,0,5,2,3,0,0,0,0,0,0,3,3,0,0,0,0,25,20,5,20,,28,0,28,18,0,18
10/05/2022 00:00,1,1,0,0,0,0,0,0,0,0,0,0,2,2,0,1,1,0,0,0,0,13,10,3,7,,14,0,14,14,1,13
10/05/2022 01:00,0,0,0,1,1,0,0,0,0,0,0,0,2,2,0,1,1,0,0,0,0,7,5,2,2,,4,0,4,0,0,0
10/05/2022 02:00,0,0,0,1,0,1,1,0,1,0,0,0,1,1,0,1,1,0,0,0,0,2,2,0,2,,4,0,4,3,0,3
10/05/2022 03:00,0,0,0,1,1,0,0,0,0,0,0,0,0,0,0,0,0,0,0,0,0,1,1,0,2,,1,0,1,2,1,1
10/05/2022 04:00,2,2,0,2,2,0,1,1,0,0,0,0,2,2,0,0,0,0,0,0,0,8,1,7,1,,2,0,2,3,0,3
10/05/2022 05:00,2,2,0,15,6,9,20,8,12,0,0,0,8,8,0,1,1,0,0,0,0,40,11,29,8,,6,0,6,7,2,5
10/05/2022 06:00,20,15,5,33,18,15,36,19,17,0,0,0,18,18,0,11,11,0,1,1,0,145,26,119,20,,10,0,10,43,0,43
10/05/2022 07:00,43,38,5,62,46,16,77,59,18,0,0,0,39,37,2,23,23,0,17,17,0,359,86,273,30,,36,1,35,104,0,104
10/05/2022 08:00,105,95,10,109,79,30,140,98,42,0,0,0,63,63,0,40,40,0,9,9,0,654,106,548,51,,69,0,69,193,2,191
10/05/2022 09:00,46,35,11,35,20,15,52,37,15,0,0,0,36,36,0,18,18,0,2,2,0,263,60,203,31,,39,0,39,135,0,135
10/05/2022 10:00,14,9,5,44,20,24,51,23,28,0,0,0,18,17,1,11,11,0,3,3,0,100,37,63,30,,28,0,28,75,0,75
10/05/2022 11:00,12,8,4,35,15,20,49,20,29,0,0,0,7,7,0,6,6,0,1,1,0,112,34,78,31,,38,0,38,81,1,80
10/05/2022 12:00,20,12,8,48,22,26,56,21,35,0,0,0,4,3,1,9,9,0,1,1,0,119,39,80,37,,67,0,67,92,1,91
10/05/2022 13:00,17,7,10,43,19,24,42,13,29,0,0,0,6,6,0,14,14,0,0,0,0,114,49,65,80,,96,0,96,106,0,106
10/05/2022 14:00,15,9,6,27,9,18,61,26,35,0,0,0,7,7,0,17,17,0,0,0,0,113,55,58,71,,67,1,66,87,2,85
10/05/2022 15:00,20,10,10,37,17,20,50,15,35,0,0,0,5,5,0,30,30,0,12,12,0,163,85,78,84,,77,0,77,94,0,94
10/05/2022 16:00,46,26,20,57,28,29,83,27,56,0,0,0,11,10,1,37,37,0,31,31,0,267,157,110,197,,143,0,143,99,1,98
10/05/2022 17:00,74,11,63,113,33,80,175,37,138,0,0,0,15,15,0,36,36,0,39,39,0,424,271,153,299,,247,0,247,125,3,122
10/05/2022 18:00,51,13,38,142,51,91,163,41,122,0,0,0,19,19,0,30,30,0,13,13,0,373,250,123,280,,224,2,222,112,0,112
10/05/2022 19:00,25,8,17,78,32,46,103,40,63,0,0,0,5,5,0,18,18,0,14,14,0,215,127,88,121,,151,1,150,133,1,132
10/05/2022 20:00,17,4,13,42,15,27,62,27,35,0,0,0,6,6,0,12,12,0,13,13,0,139,84,55,76,,101,0,101,96,0,96
10/05/2022 21:00,9,5,4,17,9,8,25,9,16,0,0,0,6,6,0,10,10,0,3,3,0,101,63,38,49,,70,1,69,69,0,69
10/05/2022 22:00,4,2,2,12,6,6,19,9,10,0,0,0,9,8,1,3,3,0,5,5,0,55,42,13,45,,58,0,58,40,0,40
10/05/2022 23:00,3,0,3,2,0,2,10,3,7,0,0,0,2,2,0,3,3,0,2,2,0,37,29,8,30,,35,0,35,22,1,21
11/05/2022 00:00,0,0,0,1,0,1,5,0,5,0,0,0,1,1,0,6,6,0,0,0,0,21,16,5,18,,25,0,25,13,0,13
11/05/2022 01:00,1,0,1,1,0,1,1,0,1,0,0,0,0,0,0,0,0,0,0,0,0,7,6,1,5,,3,0,3,1,0,1
11/05/2022 02:00,0,0,0,3,2,1,0,0,0,0,0,0,1,1,0,0,0,0,0,0,0,2,2,0,3,,5,0,5,4,0,4
11/05/2022 03:00,1,1,0,2,1,1,1,0,1,0,0,0,1,0,1,0,0,0,0,0,0,3,3,0,1,,2,0,2,2,0,2
11/05/2022 04:00,2,2,0,1,1,0,1,0,1,0,0,0,2,2,0,0,0,0,0,0,0,5,1,4,4,,2,0,2,4,0,4
11/05/2022 05:00,2,2,0,11,7,4,14,4,10,0,0,0,6,6,0,2,2,0,0,0,0,33,4,29,13,,6,0,6,10,0,10
11/05/2022 06:00,18,16,2,39,28,11,44,32,12,0,0,0,23,22,1,9,9,0,3,3,0,141,24,117,16,,11,1,10,53,0,53
11/05/2022 07:00,46,43,3,73,54,19,94,67,27,0,0,0,57,57,0,19,19,0,20,20,0,324,80,244,34,,34,0,34,91,1,90
11/05/2022 08:00,120,107,13,99,77,22,132,104,28,0,0,0,94,93,1,36,36,0,11,11,0,630,110,520,56,,69,0,69,207,0,207
11/05/2022 09:00,44,34,10,44,28,16,61,40,21,0,0,0,31,30,1,9,9,0,4,4,0,248,46,202,28,,52,1,51,132,1,131
11/05/2022 10:00,18,11,7,39,20,19,37,14,23,0,0,0,26,26,0,13,13,0,10,10,0,107,32,75,25,,37,0,37,84,2,82
11/05/2022 11:00,11,7,4,53,30,23,60,33,27,0,0,0,24,24,0,12,12,0,7,7,0,86,29,57,34,,46,0,46,76,0,76
11/05/2022 12:00,14,9,5,49,24,25,61,31,30,0,0,0,13,13,0,8,8,0,10,10,0,122,39,83,55,,77,0,77,96,0,96
11/05/2022 13:00,28,20,8,55,29,26,54,28,26,0,0,0,6,6,0,24,24,0,16,16,0,151,73,78,65,,95,0,95,112,1,111
11/05/2022 14:00,22,11,11,34,15,19,46,19,27,0,0,0,5,5,0,17,17,0,22,22,0,124,60,64,58,,78,0,78,85,0,85
11/05/2022 15:00,19,11,8,45,19,26,68,26,42,0,0,0,13,13,0,30,30,0,5,5,0,188,98,90,76,,70,0,70,81,1,80
11/05/2022 16:00,37,14,23,51,22,29,78,30,48,0,0,0,16,16,0,21,21,0,0,0,0,242,133,109,209,,151,2,149,98,1,97
11/05/2022 17:00,70,10,60,115,24,91,157,41,116,0,0,0,20,19,1,43,43,0,1,1,0,391,252,139,310,,253,0,253,107,3,104
11/05/2022 18:00,36,3,33,116,29,87,139,30,109,0,0,0,15,15,0,25,25,0,1,1,0,346,238,108,255,,225,1,224,130,0,130
11/05/2022 19:00,27,6,21,83,26,57,115,36,79,0,0,0,17,17,0,17,17,0,1,1,0,221,139,82,104,,152,0,152,119,0,119
11/05/2022 20:00,17,8,9,71,30,41,113,52,61,0,0,0,8,8,0,12,12,0,9,9,0,174,99,75,55,,117,0,117,113,0,113
11/05/2022 21:00,6,2,4,35,14,21,62,25,37,0,0,0,3,3,0,4,4,0,7,7,0,106,68,38,69,,81,0,81,76,0,76
11/05/2022 22:00,7,4,3,11,6,5,12,6,6,0,0,0,2,2,0,6,6,0,0,0,0,80,50,30,58,,60,0,60,45,0,45
11/05/2022 23:00,5,5,0,5,2,3,8,5,3,0,0,0,5,5,0,2,2,0,3,3,0,51,40,11,37,,40,0,40,27,0,27
12/05/2022 00:00,1,1,0,2,1,1,4,1,3,0,0,0,1,1,0,2,2,0,1,1,0,18,16,2,8,,28,0,28,12,0,12
12/05/2022 01:00,0,0,0,1,0,1,0,0,0,0,0,0,2,2,0,2,2,0,0,0,0,6,5,1,4,,1,0,1,0,0,0
12/05/2022 02:00,0,0,0,1,1,0,2,1,1,0,0,0,0,0,0,0,0,0,0,0,0,7,3,4,9,,9,0,9,2,0,2
12/05/2022 03:00,1,0,1,1,1,0,0,0,0,0,0,0,0,0,0,0,0,0,0,0,0,2,2,0,4,,4,0,4,2,0,2
12/05/2022 04:00,0,0,0,2,2,0,1,0,1,0,0,0,0,0,0,0,0,0,0,0,0,6,0,6,1,,3,0,3,4,0,4
12/05/2022 05:00,1,1,0,13,6,7,17,7,10,0,0,0,6,6,0,0,0,0,0,0,0,29,3,26,5,,5,0,5,5,0,5
12/05/2022 06:00,20,18,2,45,32,13,41,31,10,0,0,0,17,17,0,7,7,0,6,6,0,142,26,116,16,,9,0,9,46,0,46
12/05/2022 07:00,41,34,7,72,51,21,82,63,19,0,0,0,33,33,0,15,15,0,1,1,0,321,80,241,37,,37,0,37,97,1,96
12/05/2022 08:00,103,95,8,119,86,33,151,110,41,0,0,0,91,91,0,43,43,0,3,3,0,612,103,509,56,,71,0,71,223,0,223
12/05/2022 09:00,37,28,9,46,31,15,65,43,22,0,0,0,29,28,1,12,12,0,20,20,0,238,37,201,41,,53,0,53,148,1,147
12/05/2022 10:00,14,9,5,61,32,29,69,29,40,0,0,0,12,12,0,8,8,0,4,4,0,102,31,71,21,,33,0,33,104,0,104
12/05/2022 11:00,16,11,5,66,27,39,67,26,41,0,0,0,12,12,0,3,3,0,7,7,0,80,26,54,31,,42,1,41,87,0,87
12/05/2022 12:00,20,7,13,52,27,25,71,35,36,0,0,0,9,9,0,11,11,0,5,5,0,129,51,78,39,,74,1,73,102,1,101
12/05/2022 13:00,22,14,8,35,19,16,42,20,22,0,0,0,12,12,0,12,12,0,4,4,0,134,56,78,60,,71,0,71,116,3,113
12/05/2022 14:00,21,8,13,29,10,19,52,14,38,0,0,0,3,3,0,14,14,0,2,2,0,132,57,75,68,,105,0,105,88,0,88
12/05/2022 15:00,19,9,10,39,17,22,54,19,35,0,0,0,12,12,0,39,39,0,6,6,0,150,77,73,84,,95,0,95,85,0,85
12/05/2022 16:00,32,11,21,56,22,34,78,23,55,0,0,0,11,11,0,18,18,0,3,3,0,240,138,102,166,,116,0,116,78,0,78
12/05/2022 17:00,68,18,50,102,31,71,139,36,103,0,0,0,7,7,0,26,26,0,0,0,0,418,280,138,297,,231,1,230,127,2,125
12/05/2022 18:00,46,11,35,102,23,79,119,25,94,0,0,0,11,10,1,30,30,0,0,0,0,368,238,130,250,,210,1,209,139,2,137
12/05/2022 19:00,29,14,15,65,28,37,93,40,53,0,0,0,8,8,0,14,14,0,0,0,0,218,129,89,103,,131,2,129,131,0,131
12/05/2022 20:00,14,7,7,40,20,20,50,23,27,0,0,0,5,5,0,6,6,0,0,0,0,160,94,66,60,,98,0,98,93,0,93
12/05/2022 21:00,10,8,2,9,3,6,19,8,11,0,0,0,5,5,0,12,12,0,6,6,0,106,73,33,59,,95,0,95,73,0,73
12/05/2022 22:00,4,3,1,7,1,6,12,3,9,0,0,0,2,2,0,7,7,0,5,5,0,88,56,32,41,,60,0,60,45,0,45
12/05/2022 23:00,1,0,1,3,2,1,7,2,5,0,0,0,1,1,0,3,3,0,2,2,0,66,47,19,33,,56,0,56,28,0,28
13/05/2022 00:00,1,1,0,1,1,0,4,3,1,0,0,0,5,5,0,2,2,0,1,1,0,22,18,4,33,,23,0,23,25,1,24
13/05/2022 01:00,1,0,1,0,0,0,0,0,0,0,0,0,3,3,0,0,0,0,0,0,0,8,8,0,8,,3,0,3,0,0,0
13/05/2022 02:00,0,0,0,2,0,2,6,3,3,0,0,0,0,0,0,0,0,0,0,0,0,5,3,2,5,,8,0,8,0,0,0
13/05/2022 03:00,0,0,0,3,2,1,3,1,2,0,0,0,0,0,0,0,0,0,0,0,0,4,3,1,4,,18,0,18,3,0,3
13/05/2022 04:00,0,0,0,1,1,0,0,0,0,0,0,0,2,2,0,0,0,0,0,0,0,8,2,6,2,,1,0,1,7,0,7
13/05/2022 05:00,2,1,1,5,2,3,9,4,5,0,0,0,5,5,0,0,0,0,0,0,0,30,7,23,4,,5,0,5,8,0,8
13/05/2022 06:00,13,12,1,21,12,9,22,15,7,0,0,0,17,17,0,8,8,0,1,1,0,116,24,92,16,,11,0,11,44,0,44
13/05/2022 07:00,30,26,4,38,28,10,37,29,8,0,0,0,34,34,0,14,14,0,0,0,0,245,67,178,18,,32,0,32,72,0,72
13/05/2022 08:00,68,60,8,63,41,22,65,50,15,0,0,0,48,48,0,37,37,0,29,29,0,394,94,300,43,,60,0,60,155,1,154
13/05/2022 09:00,33,28,5,28,19,9,35,21,14,0,0,0,30,30,0,14,14,0,3,3,0,179,27,152,33,,41,0,41,106,0,106
13/05/2022 10:00,10,8,2,30,14,16,43,17,26,0,0,0,19,18,1,11,11,0,5,5,0,83,23,60,24,,29,0,29,72,0,72
13/05/2022 11:00,12,6,6,31,17,14,45,23,22,0,0,0,1,1,0,6,6,0,1,1,0,84,19,65,25,,29,0,29,68,2,66
13/05/2022 12:00,18,13,5,32,14,18,43,18,25,0,0,0,4,4,0,18,18,0,4,4,0,134,54,80,55,,78,0,78,120,0,120
13/05/2022 13:00,20,9,11,26,13,13,56,27,29,0,0,0,12,12,0,25,25,0,2,2,0,135,59,76,66,,109,0,109,125,1,124
13/05/2022 14:00,24,12,12,37,16,21,48,19,29,0,0,0,3,3,0,17,17,0,1,1,0,138,66,72,87,,99,0,99,99,0,99
13/05/2022 15:00,27,16,11,44,20,24,54,17,37,0,0,0,7,7,0,27,27,0,7,7,0,166,83,83,91,,85,0,85,103,0,103
13/05/2022 16:00,34,13,21,72,19,53,99,30,69,0,0,0,8,8,0,16,16,0,10,10,0,242,138,104,140,,129,0,129,94,1,93
13/05/2022 17:00,41,10,31,89,30,59,130,40,90,0,0,0,10,10,0,32,32,0,5,5,0,262,165,97,168,,201,2,199,124,0,124
13/05/2022 18:00,28,9,19,89,37,52,112,45,67,0,0,0,8,8,0,21,21,0,20,20,0,263,141,122,151,,157,0,157,136,0,136
13/05/2022 19:00,22,11,11,68,31,37,89,40,49,0,0,0,24,22,2,16,16,0,12,12,0,183,102,81,111,,113,0,113,139,1,138
13/05/2022 20:00,14,5,9,48,26,22,70,31,39,0,0,0,6,6,0,14,14,0,15,15,0,148,66,82,70,,89,1,88,132,1,131
13/05/2022 21:00,18,8,10,28,17,11,43,23,20,0,0,0,5,5,0,9,9,0,8,8,0,116,67,49,64,,99,1,98,88,0,88
13/05/2022 22:00,13,6,7,9,5,4,12,5,7,0,0,0,3,3,0,5,5,0,4,4,0,73,46,27,48,,64,0,64,81,0,81
13/05/2022 23:00,3,1,2,12,4,8,14,8,6,0,0,0,8,8,0,6,6,0,0,0,0,54,39,15,50,,31,0,31,32,0,32
14/05/2022 00:00,1,1,0,5,2,3,5,3,2,0,0,0,5,5,0,0,0,0,0,0,0,34,27,7,24,,33,0,33,17,0,17
14/05/2022 01:00,1,0,1,1,1,0,2,0,2,0,0,0,3,3,0,0,0,0,0,0,0,25,20,5,20,,13,0,13,1,0,1
14/05/2022 02:00,1,1,0,2,0,2,4,1,3,0,0,0,3,3,0,0,0,0,0,0,0,17,14,3,10,,21,0,21,4,0,4
14/05/2022 03:00,1,0,1,0,0,0,0,0,0,0,0,0,0,0,0,0,0,0,0,0,0,11,6,5,10,,15,0,15,4,1,3
14/05/2022 04:00,1,1,0,1,0,1,3,2,1,0,0,0,1,1,0,0,0,0,0,0,0,5,4,1,7,,8,0,8,5,1,4
14/05/2022 05:00,2,1,1,3,2,1,7,3,4,0,0,0,2,2,0,0,0,0,0,0,0,13,6,7,5,,4,0,4,6,0,6
14/05/2022 06:00,1,0,1,23,9,14,28,12,16,0,0,0,1,1,0,3,3,0,1,1,0,46,15,31,14,,4,0,4,18,0,18
14/05/2022 07:00,12,12,0,49,18,31,44,13,31,0,0,0,14,14,0,3,3,0,4,4,0,50,17,33,13,,10,0,10,22,1,21
14/05/2022 08:00,8,8,0,123,56,67,122,49,73,0,0,0,14,14,0,6,6,0,15,15,0,78,29,49,25,,32,0,32,48,0,48
14/05/2022 09:00,16,9,7,168,70,98,186,69,117,0,0,0,10,10,0,18,18,0,11,11,0,111,31,80,28,,25,0,25,69,0,69
14/05/2022 10:00,14,8,6,199,88,111,233,93,140,0,0,0,8,8,0,15,15,0,17,17,0,104,32,72,44,,38,0,38,95,0,95
14/05/2022 11:00,17,12,5,210,99,111,269,109,160,0,0,0,5,5,0,20,20,0,9,9,0,161,61,100,49,,63,0,63,80,0,80
14/05/2022 12:00,20,10,10,230,129,101,268,132,136,0,0,0,2,2,0,16,16,0,4,4,0,150,55,95,65,,72,0,72,105,0,105
14/05/2022 13:00,20,13,7,154,78,76,204,108,96,0,0,0,6,6,0,15,15,0,12,12,0,185,47,138,61,,83,0,83,123,0,123
14/05/2022 14:00,19,14,5,179,85,94,185,88,97,0,0,0,14,14,0,14,14,0,23,23,0,197,71,126,74,,101,0,101,120,0,120
14/05/2022 15:00,19,11,8,124,66,58,178,97,81,0,0,0,17,17,0,18,18,0,16,16,0,140,66,74,89,,96,1,95,111,1,110
14/05/2022 16:00,16,5,11,101,52,49,147,78,69,0,0,0,22,22,0,14,14,0,13,13,0,114,60,54,67,,105,0,105,101,1,100
14/05/2022 17:00,14,9,5,77,44,33,124,68,56,0,0,0,17,17,0,10,10,0,13,13,0,165,88,77,80,,88,1,87,96,0,96
14/05/2022 18:00,16,10,6,62,37,25,97,56,41,0,0,0,11,11,0,9,9,0,16,16,0,157,83,74,83,,98,0,98,90,0,90
14/05/2022 19:00,17,10,7,46,23,23,74,44,30,0,0,0,9,9,0,4,4,0,5,5,0,154,68,86,73,,103,0,103,94,1,93
14/05/2022 20:00,15,8,7,39,24,15,48,24,24,0,0,0,5,5,0,14,14,0,4,4,0,119,60,59,57,,77,0,77,99,0,99
14/05/2022 21:00,10,5,5,18,11,7,31,19,12,0,0,0,4,4,0,1,1,0,6,6,0,92,41,51,42,,57,0,57,69,0,69
14/05/2022 22:00,7,5,2,11,4,7,14,7,7,0,0,0,10,10,0,5,5,0,2,2,0,62,39,23,32,,63,1,62,77,1,76
14/05/2022 23:00,2,1,1,3,1,2,4,1,3,0,0,0,3,3,0,3,3,0,0,0,0,43,27,16,34,,35,0,35,41,0,41
15/05/2022 00:00,1,0,1,9,5,4,13,5,8,0,0,0,7,7,0,1,1,0,0,0,0,32,24,8,24,,22,0,22,24,1,23
15/05/2022 01:00,1,0,1,3,1,2,3,0,3,0,0,0,2,2,0,1,1,0,0,0,0,22,12,10,15,,9,0,9,0,0,0
15/05/2022 02:00,0,0,0,2,2,0,1,0,1,0,0,0,0,0,0,0,0,0,0,0,0,19,18,1,13,,20,1,19,8,0,8
15/05/2022 03:00,2,1,1,3,1,2,6,1,5,0,0,0,1,1,0,0,0,0,0,0,0,19,13,6,13,,18,0,18,8,0,8
15/05/2022 04:00,0,0,0,1,1,0,0,0,0,0,0,0,1,1,0,0,0,0,0,0,0,8,4,4,6,,8,0,8,4,0,4
15/05/2022 05:00,3,2,1,2,1,1,3,0,3,0,0,0,2,2,0,0,0,0,0,0,0,5,4,1,6,,8,0,8,7,1,6
15/05/2022 06:00,1,0,1,11,2,9,16,3,13,0,0,0,2,2,0,1,1,0,0,0,0,27,7,20,8,,4,0,4,15,0,15
15/05/2022 07:00,5,4,1,56,22,34,60,24,36,0,0,0,6,6,0,3,3,0,0,0,0,39,12,27,12,,11,0,11,8,0,8
15/05/2022 08:00,7,5,2,98,40,58,109,47,62,0,0,0,9,9,0,6,6,0,3,3,0,48,18,30,21,,12,0,12,24,1,23
15/05/2022 09:00,11,7,4,164,63,101,192,71,121,0,0,0,7,6,1,8,8,0,11,11,0,81,17,64,30,,28,0,28,46,0,46
15/05/2022 10:00,13,9,4,175,83,92,210,90,120,0,0,0,11,10,1,11,11,0,7,7,0,98,37,61,55,,21,0,21,67,0,67
15/05/2022 11:00,16,11,5,227,106,121,288,126,162,0,0,0,13,13,0,18,18,0,16,16,0,88,31,57,49,,39,0,39,67,0,67
15/05/2022 12:00,21,15,6,222,108,114,342,156,186,0,0,0,3,3,0,9,9,0,22,22,0,107,48,59,73,,72,0,72,88,0,88
15/05/2022 13:00,23,10,13,157,90,67,219,140,79,0,0,0,3,3,0,22,22,0,12,12,0,130,53,77,57,,76,0,76,84,0,84
15/05/2022 14:00,14,8,6,114,62,52,196,98,98,0,0,0,5,5,0,13,13,0,11,11,0,124,47,77,47,,69,1,68,96,2,94
15/05/2022 15:00,10,3,7,108,53,55,137,68,69,0,0,0,10,10,0,8,8,0,4,4,0,110,51,59,47,,71,0,71,97,1,96
15/05/2022 16:00,17,12,5,112,69,43,146,90,56,0,0,0,3,3,0,12,12,0,0,0,0,124,58,66,57,,76,2,74,70,0,70
15/05/2022 17:00,16,8,8,87,49,38,119,71,48,0,0,0,5,5,0,8,8,0,0,0,0,124,70,54,63,,95,2,93,74,1,73
15/05/2022 18:00,15,10,5,64,36,28,95,49,46,0,0,0,2,2,0,18,18,0,0,0,0,126,62,64,62,,107,1,106,99,1,98
15/05/2022 19:00,19,10,9,61,26,35,67,31,36,0,0,0,11,11,0,9,9,0,1,1,0,131,74,57,70,,79,1,78,98,0,98
15/05/2022 20:00,17,10,7,22,15,7,34,21,13,0,0,0,13,13,0,4,4,0,0,0,0,92,47,45,63,,79,1,78,93,0,93
15/05/2022 21:00,3,1,2,21,10,11,32,17,15,0,0,0,7,7,0,3,3,0,0,0,0,96,55,41,55,,49,1,48,59,1,58
15/05/2022 22:00,10,8,2,10,4,6,16,9,7,0,0,0,3,3,0,0,0,0,0,0,0,52,30,22,44,,13,0,13,43,0,43
15/05/2022 23:00,5,2,3,3,2,1,5,1,4,0,0,0,4,4,0,5,5,0,0,0,0,32,24,8,24,,24,0,24,16,0,16
16/05/2022 00:00,1,0,1,1,1,0,2,0,2,0,0,0,1,1,0,0,0,0,0,0,0,16,11,5,16,,12,0,12,12,0,12
16/05/2022 01:00,0,0,0,0,0,0,0,0,0,0,0,0,0,0,0,0,0,0,0,0,0,2,2,0,4,,5,0,5,1,0,1
16/05/2022 02:00,0,0,0,0,0,0,0,0,0,0,0,0,0,0,0,0,0,0,0,0,0,14,8,6,8,,3,0,3,1,0,1
16/05/2022 03:00,0,0,0,0,0,0,0,0,0,0,0,0,0,0,0,0,0,0,0,0,0,1,1,0,0,,1,0,1,0,0,0
16/05/2022 04:00,1,1,0,2,2,0,1,0,1,0,0,0,1,1,0,0,0,0,0,0,0,9,1,8,1,,3,0,3,3,0,3
16/05/2022 05:00,1,1,0,5,2,3,9,3,6,0,0,0,3,3,0,1,1,0,0,0,0,29,4,25,9,,4,0,4,5,0,5
16/05/2022 06:00,18,16,2,15,10,5,16,15,1,0,0,0,7,7,0,5,5,0,0,0,0,117,21,96,10,,9,0,9,37,0,37
16/05/2022 07:00,27,25,2,36,30,6,46,38,8,0,0,0,32,32,0,10,10,0,1,1,0,227,57,170,21,,38,0,38,63,0,63
16/05/2022 08:00,73,65,8,44,34,10,77,60,17,0,0,0,46,46,0,25,25,0,21,21,0,464,98,366,43,,44,0,44,190,0,190
16/05/2022 09:00,27,22,5,34,22,12,45,25,20,0,0,0,27,27,0,8,8,0,7,7,0,196,32,164,25,,45,1,44,108,3,105
16/05/2022 10:00,19,16,3,22,7,15,30,11,19,0,0,0,11,11,0,5,5,0,4,4,0,68,19,49,18,,29,0,29,73,0,73
16/05/2022 11:00,8,5,3,20,8,12,35,13,22,0,0,0,11,11,0,7,7,0,4,4,0,71,19,52,21,,33,0,33,64,0,64
16/05/2022 12:00,6,3,3,46,23,23,63,30,33,0,0,0,2,2,0,4,4,0,0,0,0,96,37,59,40,,62,0,62,105,0,105
16/05/2022 13:00,16,8,8,47,23,24,50,20,30,0,0,0,3,3,0,14,14,0,0,0,0,124,57,67,62,,71,1,70,93,0,93
16/05/2022 14:00,11,7,4,41,17,24,60,30,30,0,0,0,7,7,0,15,15,0,0,0,0,123,53,70,51,,62,0,62,82,0,82
16/05/2022 15:00,17,12,5,31,13,18,47,22,25,0,0,0,8,8,0,31,31,0,0,0,0,134,72,62,77,,77,1,76,69,1,68
16/05/2022 16:00,32,20,12,80,41,39,100,47,53,0,0,0,3,3,0,18,18,0,0,0,0,231,135,96,161,,109,0,109,81,0,81
16/05/2022 17:00,50,17,33,108,33,75,163,50,113,0,0,0,2,2,0,24,24,0,0,0,0,342,233,109,270,,253,3,250,114,1,113
16/05/2022 18:00,41,14,27,124,44,80,166,54,112,0,0,0,9,8,1,22,22,0,0,0,0,326,205,121,191,,199,0,199,119,1,118
16/05/2022 19:00,25,9,16,109,52,57,119,50,69,0,0,0,8,8,0,16,16,0,0,0,0,206,120,86,101,,131,1,130,107,0,107
16/05/2022 20:00,21,6,15,72,42,30,91,47,44,0,0,0,4,4,0,11,11,0,0,0,0,118,69,49,60,,92,0,92,77,1,76
16/05/2022 21:00,13,7,6,25,11,14,46,23,23,0,0,0,15,15,0,8,8,0,0,0,0,106,57,49,50,,78,1,77,62,0,62
16/05/2022 22:00,9,7,2,13,7,6,16,6,10,0,0,0,5,5,0,4,4,0,0,0,0,59,37,22,32,,38,0,38,35,0,35
16/05/2022 23:00,5,3,2,0,0,0,1,0,1,0,0,0,7,7,0,2,2,0,0,0,0,35,23,12,20,,33,0,33,20,0,20
17/05/2022 00:00,0,0,0,1,0,1,2,0,2,0,0,0,3,3,0,1,1,0,0,0,0,19,14,5,19,,14,0,14,10,0,10
17/05/2022 01:00,1,1,0,2,1,1,0,0,0,0,0,0,1,1,0,0,0,0,0,0,0,9,6,3,10,,3,0,3,1,0,1
17/05/2022 02:00,0,0,0,1,0,1,1,0,1,0,0,0,0,0,0,0,0,0,0,0,0,3,1,2,6,,4,0,4,2,0,2
17/05/2022 03:00,3,1,2,1,0,1,1,0,1,0,0,0,0,0,0,0,0,0,0,0,0,4,1,3,1,,4,0,4,1,0,1
17/05/2022 04:00,0,0,0,4,3,1,3,2,1,0,0,0,1,1,0,1,1,0,0,0,0,9,0,9,4,,1,0,1,4,0,4
17/05/2022 05:00,1,1,0,3,1,2,9,5,4,0,0,0,5,5,0,1,1,0,0,0,0,34,6,28,6,,5,0,5,10,0,10
17/05/2022 06:00,18,17,1,27,15,12,27,16,11,0,0,0,22,21,1,7,7,0,3,3,0,142,24,118,24,,13,0,13,55,0,55
17/05/2022 07:00,45,40,5,62,43,19,65,47,18,0,0,0,65,65,0,12,12,0,1,1,0,323,72,251,34,,39,0,39,81,0,81
17/05/2022 08:00,116,107,9,70,59,11,92,73,19,0,0,0,61,61,0,35,35,0,1,1,0,545,97,448,43,,63,0,63,209,0,209
17/05/2022 09:00,35,34,1,41,25,16,52,34,18,0,0,0,49,48,1,12,12,0,2,2,0,230,43,187,30,,41,0,41,152,2,150
17/05/2022 10:00,13,7,6,33,18,15,41,20,21,0,0,0,26,26,0,7,7,0,1,1,0,106,47,59,23,,25,0,25,59,1,58
17/05/2022 11:00,9,8,1,40,25,15,46,29,17,0,0,0,18,18,0,12,12,0,9,9,0,87,33,54,24,,39,0,39,69,0,69
17/05/2022 12:00,14,9,5,29,15,14,39,20,19,0,0,0,14,14,0,14,14,0,13,13,0,93,32,61,37,,79,0,79,99,0,99
17/05/2022 13:00,21,10,11,9,5,4,15,10,5,0,0,0,7,6,1,14,14,0,3,3,0,115,49,66,69,,91,2,89,101,1,100
17/05/2022 14:00,9,4,5,15,8,7,17,5,12,0,0,0,5,5,0,12,12,0,7,7,0,119,71,48,46,,53,0,53,55,0,55
17/05/2022 15:00,13,5,8,12,2,10,13,3,10,0,0,0,6,6,0,23,23,0,2,2,0,109,58,51,78,,48,0,48,42,0,42
17/05/2022 16:00,33,10,23,17,6,11,32,7,25,0,0,0,3,3,0,24,24,0,2,2,0,187,116,71,124,,89,0,89,43,0,43
17/05/2022 17:00,53,13,40,48,7,41,67,10,57,0,0,0,7,6,1,21,21,0,2,2,0,321,224,97,292,,175,0,175,70,1,69
17/05/2022 18:00,43,12,31,47,5,42,75,9,66,0,0,0,11,11,0,26,26,0,6,6,0,303,218,85,242,,186,0,186,80,0,80
17/05/2022 19:00,27,10,17,48,12,36,55,14,41,0,0,0,11,11,0,10,10,0,5,5,0,193,119,74,101,,105,1,104,89,0,89
17/05/2022 20:00,15,4,11,48,23,25,56,22,34,0,0,0,5,5,0,3,3,0,7,7,0,100,65,35,57,,87,0,87,78,0,78
17/05/2022 21:00,5,2,3,20,8,12,39,18,21,0,0,0,11,11,0,9,9,0,6,6,0,83,51,32,39,,79,1,78,40,0,40
17/05/2022 22:00,4,1,3,9,5,4,9,4,5,0,0,0,7,7,0,6,6,0,3,3,0,61,40,21,32,,8,0,8,29,0,29
17/05/2022 23:00,2,2,0,2,1,1,5,2,3,0,0,0,1,1,0,0,0,0,0,0,0,23,21,2,17,,0,0,0,13,1,12
18/05/2022 00:00,0,0,0,0,0,0,0,0,0,0,0,0,0,0,0,1,1,0,0,0,0,17,13,4,7,,10,0,10,3,0,3
18/05/2022 01:00,2,0,2,1,1,0,0,0,0,0,0,0,3,3,0,0,0,0,0,0,0,4,2,2,4,,4,0,4,2,1,1
18/05/2022 02:00,0,0,0,0,0,0,5,4,1,0,0,0,1,1,0,1,1,0,0,0,0,3,2,1,3,,3,0,3,3,0,3
18/05/2022 03:00,0,0,0,0,0,0,0,0,0,0,0,0,0,0,0,1,1,0,0,0,0,2,2,0,4,,3,0,3,2,0,2
18/05/2022 04:00,1,1,0,3,2,1,2,0,2,0,0,0,1,1,0,0,0,0,2,2,0,6,1,5,0,,0,0,0,3,1,2
18/05/2022 05:00,3,3,0,11,5,6,15,5,10,0,0,0,7,7,0,1,1,0,3,3,0,31,5,26,7,,6,0,6,11,0,11
18/05/2022 06:00,15,14,1,28,17,11,36,20,16,0,0,0,26,26,0,8,8,0,11,11,0,135,20,115,31,,11,0,11,48,0,48
18/05/2022 07:00,41,35,6,82,60,22,83,59,24,0,0,0,45,44,1,15,15,0,32,32,0,327,82,245,33,,35,0,35,94,0,94
18/05/2022 08:00,113,102,11,95,69,26,127,96,31,0,0,0,73,73,0,33,33,0,117,117,0,555,103,452,44,,75,1,74,220,2,218
18/05/2022 09:00,40,33,7,56,32,24,77,47,30,0,0,0,36,36,0,13,13,0,28,28,0,198,41,157,31,,51,0,51,144,1,143
18/05/2022 10:00,17,9,8,58,29,29,67,27,40,0,0,0,9,9,0,8,8,0,8,8,0,86,26,60,20,,36,0,36,85,0,85
18/05/2022 11:00,11,10,1,56,30,26,80,39,41,0,0,0,11,10,1,9,9,0,10,10,0,97,35,62,28,,43,0,43,68,0,68
18/05/2022 12:00,12,11,1,37,20,17,55,31,24,0,0,0,7,7,0,12,12,0,7,7,0,124,45,79,41,,75,0,75,99,1,98
18/05/2022 13:00,23,12,11,35,22,13,53,25,28,0,0,0,7,7,0,35,35,0,15,15,0,139,70,69,70,,92,1,91,101,0,101
18/05/2022 14:00,18,10,8,30,14,16,49,23,26,0,0,0,4,4,0,11,11,0,12,12,0,101,52,49,57,,74,0,74,62,0,62
18/05/2022 15:00,16,7,9,30,10,20,50,19,31,0,0,0,6,6,0,37,37,0,10,10,0,145,79,66,78,,80,0,80,82,0,82
18/05/2022 16:00,29,13,16,43,17,26,54,18,36,0,0,0,13,13,0,26,26,0,20,20,0,243,151,92,182,,139,1,138,96,0,96
18/05/2022 17:00,63,17,46,66,18,48,94,19,75,0,0,0,4,4,0,27,27,0,36,36,0,376,244,132,314,,249,2,247,125,1,124
18/05/2022 18:00,40,13,27,70,15,55,103,25,78,0,0,0,11,11,0,21,21,0,26,26,0,375,252,123,225,,200,1,199,112,1,111
18/05/2022 19:00,24,9,15,49,19,30,62,29,33,0,0,0,3,3,0,18,18,0,10,10,0,190,123,67,96,,133,0,133,69,0,69
18/05/2022 20:00,16,5,11,26,10,16,27,11,16,0,0,0,3,3,0,14,14,0,4,4,0,138,83,55,51,,81,0,81,56,0,56
18/05/2022 21:00,17,7,10,16,4,12,24,9,15,0,0,0,4,4,0,5,5,0,5,5,0,90,46,44,44,,88,0,88,55,1,54
18/05/2022 22:00,6,2,4,5,5,0,6,5,1,0,0,0,2,1,1,6,6,0,7,7,0,64,48,16,39,,48,1,47,37,0,37
18/05/2022 23:00,4,2,2,3,1,2,4,1,3,0,0,0,0,0,0,2,2,0,0,0,0,44,36,8,34,,35,2,33,20,0,20
19/05/2022 00:00,0,0,0,3,1,2,7,3,4,0,0,0,4,4,0,3,3,0,0,0,0,24,19,5,19,,26,1,25,11,0,11
19/05/2022 01:00,1,1,0,0,0,0,0,0,0,0,0,0,2,2,0,0,0,0,0,0,0,2,1,1,4,,3,0,3,1,0,1
19/05/2022 02:00,0,0,0,0,0,0,0,0,0,0,0,0,0,0,0,0,0,0,0,0,0,3,1,2,3,,4,0,4,2,0,2
19/05/2022 03:00,0,0,0,0,0,0,0,0,0,0,0,0,0,0,0,0,0,0,0,0,0,4,4,0,0,,1,0,1,0,0,0
19/05/2022 04:00,0,0,0,3,2,1,3,0,3,0,0,0,1,1,0,0,0,0,0,0,0,8,1,7,6,,1,0,1,2,0,2
19/05/2022 05:00,2,2,0,5,2,3,11,4,7,0,0,0,7,7,0,2,2,0,0,0,0,37,3,34,6,,3,0,3,8,0,8
19/05/2022 06:00,17,16,1,42,26,16,41,25,16,0,0,0,26,25,1,7,7,0,0,0,0,146,25,121,14,,9,0,9,46,0,46
19/05/2022 07:00,50,45,5,75,52,23,100,72,28,0,0,0,46,46,0,19,19,0,8,8,0,321,77,244,26,,42,2,40,94,0,94
19/05/2022 08:00,99,87,12,128,99,29,158,122,36,0,0,0,73,73,0,44,44,0,66,66,0,624,108,516,60,,84,0,84,206,0,206
19/05/2022 09:00,37,31,6,67,38,29,83,48,35,0,0,0,42,42,0,12,12,0,8,8,0,236,45,191,27,,52,3,49,147,0,147
19/05/2022 10:00,16,12,4,69,32,37,83,33,50,0,0,0,23,23,0,11,11,0,4,4,0,107,28,79,14,,37,1,36,89,0,89
19/05/2022 11:00,10,6,4,67,28,39,75,32,43,0,0,0,14,14,0,12,12,0,1,1,0,103,40,63,37,,56,0,56,93,0,93
19/05/2022 12:00,16,10,6,63,40,23,79,41,38,0,0,0,14,14,0,11,11,0,0,0,0,111,50,61,59,,74,2,72,93,1,92
19/05/2022 13:00,19,14,5,63,30,33,104,47,57,0,0,0,10,10,0,13,13,0,1,1,0,133,59,74,81,,89,1,88,111,1,110
19/05/2022 14:00,21,13,8,70,31,39,78,34,44,0,0,0,7,7,0,16,16,0,1,1,0,128,61,67,77,,93,0,93,90,0,90
19/05/2022 15:00,17,7,10,64,35,29,91,41,50,0,0,0,10,10,0,24,24,0,1,1,0,182,104,78,101,,78,1,77,87,0,87
19/05/2022 16:00,46,18,28,66,23,43,104,32,72,0,0,0,17,17,0,40,40,0,0,0,0,236,126,110,192,,130,0,130,83,0,83
19/05/2022 17:00,59,12,47,111,49,62,158,39,119,0,0,0,20,20,0,31,31,0,1,1,0,363,236,127,282,,240,0,240,141,0,141
19/05/2022 18:00,44,13,31,140,34,106,214,54,160,0,0,0,15,15,0,27,27,0,1,1,0,377,240,137,238,,208,2,206,155,0,155
19/05/2022 19:00,28,13,15,96,43,53,115,38,77,0,0,0,17,17,0,18,18,0,0,0,0,209,115,94,141,,149,0,149,120,1,119
19/05/2022 20:00,24,10,14,72,41,31,103,44,59,0,0,0,7,7,0,18,18,0,2,2,0,152,100,52,71,,133,0,133,117,0,117
19/05/2022 21:00,14,4,10,36,16,20,50,25,25,0,0,0,15,15,0,12,12,0,2,2,0,110,67,43,84,,84,0,84,85,0,85
19/05/2022 22:00,10,7,3,13,6,7,26,12,14,0,0,0,6,6,0,7,7,0,0,0,0,101,66,35,51,,75,0,75,52,1,51
19/05/2022 23:00,5,2,3,9,3,6,14,3,11,0,0,0,4,4,0,8,8,0,3,3,0,59,44,15,36,,51,0,51,35,0,35
20/05/2022 00:00,7,4,3,2,1,1,2,2,0,0,0,0,4,4,0,2,2,0,0,0,0,35,27,8,22,,38,0,38,13,0,13
20/05/2022 01:00,0,0,0,0,0,0,0,0,0,0,0,0,6,6,0,0,0,0,0,0,0,15,12,3,11,,8,0,8,1,0,1
20/05/2022 02:00,1,0,1,2,1,1,2,0,2,0,0,0,0,0,0,0,0,0,0,0,0,8,8,0,11,,13,0,13,2,0,2
20/05/2022 03:00,1,0,1,2,0,2,1,0,1,0,0,0,0,0,0,1,1,0,0,0,0,8,6,2,6,,3,0,3,4,0,4
20/05/2022 04:00,0,0,0,4,3,1,3,0,3,0,0,0,1,1,0,0,0,0,1,1,0,13,3,10,5,,0,0,0,4,0,4
20/05/2022 05:00,1,1,0,9,5,4,7,3,4,0,0,0,9,9,0,1,1,0,0,0,0,32,5,27,6,,2,0,2,9,0,9
20/05/2022 06:00,15,13,2,26,15,11,29,19,10,0,0,0,16,16,0,11,11,0,0,0,0,124,24,100,19,,15,0,15,50,0,50
20/05/2022 07:00,31,25,6,68,41,27,73,44,29,0,0,0,38,36,2,11,11,0,2,2,0,253,71,182,28,,35,0,35,76,1,75
20/05/2022 08:00,69,60,9,77,58,19,96,67,29,0,0,0,54,54,0,31,31,0,3,3,0,381,82,299,46,,60,0,60,153,0,153
20/05/2022 09:00,27,21,6,38,24,14,47,25,22,0,0,0,24,24,0,13,13,0,1,1,0,168,35,133,28,,39,0,39,118,0,118
20/05/2022 10:00,11,7,4,50,24,26,49,18,31,0,0,0,23,23,0,11,11,0,4,4,0,100,20,80,32,,22,0,22,55,1,54
20/05/2022 11:00,15,9,6,29,17,12,44,21,23,0,0,0,13,13,0,8,8,0,3,3,0,87,25,62,27,,40,0,40,79,0,79
20/05/2022 12:00,14,10,4,16,10,6,21,12,9,0,0,0,4,4,0,12,12,0,1,1,0,123,58,65,54,,71,1,70,72,0,72
20/05/2022 13:00,20,14,6,13,5,8,34,11,23,0,0,0,4,4,0,17,17,0,0,0,0,131,54,77,67,,78,1,77,90,0,90
20/05/2022 14:00,22,10,12,22,6,16,33,8,25,0,0,0,4,4,0,18,18,0,0,0,0,139,76,63,58,,86,0,86,87,0,87
20/05/2022 15:00,22,8,14,35,12,23,47,16,31,0,0,0,5,5,0,10,10,0,0,0,0,165,85,80,89,,59,0,59,79,0,79
20/05/2022 16:00,26,13,13,43,14,29,65,19,46,0,0,0,5,5,0,19,19,0,0,0,0,231,132,99,153,,135,1,134,100,1,99
20/05/2022 17:00,49,13,36,59,16,43,100,22,78,0,0,0,6,6,0,21,21,0,0,0,0,284,169,115,212,,175,1,174,124,0,124
20/05/2022 18:00,34,16,18,64,16,48,90,26,64,0,0,0,13,13,0,14,14,0,0,0,0,234,136,98,113,,152,0,152,129,1,128
20/05/2022 19:00,29,14,15,57,25,32,72,27,45,0,0,0,22,22,0,8,8,0,0,0,0,178,97,81,81,,110,1,109,113,1,112
20/05/2022 20:00,15,9,6,36,16,20,57,23,34,0,0,0,15,15,0,6,6,0,1,1,0,128,61,67,60,,69,2,67,107,1,106
20/05/2022 21:00,23,16,7,13,8,5,27,16,11,0,0,0,9,7,2,6,6,0,6,6,0,94,57,37,51,,63,0,63,76,0,76
20/05/2022 22:00,9,5,4,8,6,2,22,11,11,0,0,0,6,6,0,3,3,0,6,6,0,81,41,40,52,,41,0,41,50,3,47
20/05/2022 23:00,3,0,3,7,3,4,12,2,10,0,0,0,4,4,0,3,3,0,1,1,0,45,34,11,36,,42,0,42,41,0,41
21/05/2022 00:00,2,1,1,5,1,4,9,1,8,0,0,0,3,3,0,3,3,0,0,0,0,35,23,12,25,,35,1,34,22,0,22
21/05/2022 01:00,0,0,0,3,0,3,2,1,1,0,0,0,4,4,0,1,1,0,0,0,0,17,12,5,13,,8,0,8,3,0,3
21/05/2022 02:00,2,0,2,1,0,1,8,3,5,0,0,0,1,1,0,1,1,0,0,0,0,16,9,7,15,,18,2,16,13,0,13
21/05/2022 03:00,2,1,1,2,0,2,1,0,1,0,0,0,0,0,0,0,0,0,0,0,0,13,13,0,15,,17,0,17,5,0,5
21/05/2022 04:00,0,0,0,0,0,0,0,0,0,0,0,0,1,1,0,1,1,0,0,0,0,6,4,2,2,,9,0,9,3,0,3
21/05/2022 05:00,1,1,0,6,3,3,7,1,6,0,0,0,2,2,0,1,1,0,0,0,0,16,4,12,7,,2,0,2,9,0,9
21/05/2022 06:00,5,3,2,28,15,13,34,18,16,0,0,0,6,6,0,8,8,0,1,1,0,33,9,24,15,,6,0,6,14,0,14
21/05/2022 07:00,9,4,5,53,21,32,74,23,51,0,0,0,10,10,0,4,4,0,3,3,0,51,16,35,15,,12,0,12,19,0,19
21/05/2022 08:00,9,9,0,67,34,33,69,37,32,0,0,0,22,22,0,10,10,0,3,3,0,74,27,47,17,,21,0,21,34,1,33
21/05/2022 09:00,18,15,3,105,47,58,121,42,79,0,0,0,8,7,1,10,10,0,10,10,0,115,41,74,21,,26,2,24,75,0,75
21/05/2022 10:00,11,7,4,126,53,73,133,48,85,0,0,0,17,16,1,9,9,0,3,3,0,97,37,60,28,,48,0,48,73,1,72
21/05/2022 11:00,14,12,2,138,70,68,168,83,85,0,0,0,6,6,0,13,13,0,5,5,0,130,47,83,50,,52,0,52,98,0,98
21/05/2022 12:00,17,7,10,147,68,79,178,83,95,0,0,0,5,5,0,9,9,0,6,6,0,127,50,77,63,,72,0,72,101,0,101
21/05/2022 13:00,22,11,11,119,53,66,134,65,69,0,0,0,16,16,0,10,10,0,6,6,0,122,52,70,63,,80,0,80,120,0,120
21/05/2022 14:00,13,6,7,128,66,62,157,76,81,0,0,0,12,12,0,20,20,0,3,3,0,136,64,72,68,,82,0,82,119,0,119
21/05/2022 15:00,17,13,4,128,63,65,157,77,80,0,0,0,14,14,0,13,13,0,0,0,0,110,45,65,54,,88,0,88,110,0,110
21/05/2022 16:00,25,16,9,97,52,45,127,56,71,0,0,0,23,22,1,8,8,0,0,0,0,133,57,76,53,,104,1,103,95,0,95
21/05/2022 17:00,18,9,9,65,39,26,116,61,55,0,0,0,19,19,0,16,16,0,0,0,0,143,53,90,49,,94,1,93,101,0,101
21/05/2022 18:00,12,6,6,60,25,35,91,49,42,0,0,0,13,13,0,8,8,0,0,0,0,170,72,98,64,,98,1,97,102,1,101
21/05/2022 19:00,12,6,6,34,21,13,55,33,22,0,0,0,8,8,0,7,7,0,0,0,0,114,45,69,50,,83,2,81,102,1,101
21/05/2022 20:00,17,9,8,13,8,5,47,27,20,0,0,0,7,7,0,4,4,0,0,0,0,80,41,39,74,,65,1,64,108,0,108
21/05/2022 21:00,9,1,8,9,6,3,20,11,9,0,0,0,4,4,0,7,7,0,0,0,0,76,42,34,43,,66,3,63,86,1,85
21/05/2022 22:00,4,3,1,8,3,5,11,4,7,0,0,0,8,8,0,3,3,0,0,0,0,82,45,37,35,,52,0,52,58,1,57
21/05/2022 23:00,6,3,3,7,4,3,13,6,7,0,0,0,9,9,0,7,7,0,0,0,0,54,38,16,26,,31,0,31,44,0,44
22/05/2022 00:00,0,0,0,3,1,2,5,2,3,0,0,0,4,4,0,1,1,0,0,0,0,30,20,10,28,,23,0,23,23,1,22
22/05/2022 01:00,3,2,1,1,1,0,2,1,1,0,0,0,2,2,0,1,1,0,0,0,0,32,21,11,17,,4,0,4,2,0,2
22/05/2022 02:00,0,0,0,2,2,0,6,3,3,0,0,0,1,1,0,1,1,0,0,0,0,18,16,2,13,,26,0,26,4,0,4
22/05/2022 03:00,1,0,1,2,1,1,0,0,0,0,0,0,0,0,0,2,2,0,0,0,0,19,15,4,11,,12,0,12,6,0,6
22/05/2022 04:00,1,1,0,0,0,0,2,0,2,0,0,0,2,2,0,1,1,0,0,0,0,8,4,4,5,,6,0,6,4,0,4
22/05/2022 05:00,3,1,2,2,2,0,2,0,2,0,0,0,0,0,0,0,0,0,0,0,0,11,5,6,1,,5,0,5,1,0,1
22/05/2022 06:00,3,2,1,8,5,3,14,4,10,0,0,0,5,5,0,1,1,0,0,0,0,24,3,21,16,,5,0,5,10,0,10
22/05/2022 07:00,4,4,0,52,24,28,47,16,31,0,0,0,13,13,0,5,5,0,2,2,0,37,14,23,18,,5,0,5,4,0,4
22/05/2022 08:00,5,5,0,83,35,48,94,38,56,0,0,0,4,4,0,8,8,0,8,8,0,60,31,29,12,,14,0,14,18,0,18
22/05/2022 09:00,9,6,3,112,54,58,130,53,77,0,0,0,14,14,0,10,10,0,2,2,0,85,32,53,18,,17,0,17,40,0,40
22/05/2022 10:00,9,4,5,173,83,90,183,87,96,0,0,0,18,17,1,11,11,0,0,0,0,99,23,76,27,,28,1,27,75,0,75
22/05/2022 11:00,40,30,10,159,79,80,186,89,97,0,0,0,4,4,0,8,8,0,0,0,0,96,36,60,34,,38,0,38,56,0,56
22/05/2022 12:00,14,12,2,142,76,66,159,80,79,0,0,0,2,2,0,12,12,0,8,8,0,98,40,58,60,,67,0,67,78,0,78
22/05/2022 13:00,18,8,10,150,81,69,216,121,95,0,0,0,8,8,0,10,10,0,5,5,0,98,45,53,50,,76,0,76,86,1,85
22/05/2022 14:00,15,10,5,111,56,55,147,64,83,0,0,0,4,4,0,9,9,0,3,3,0,102,43,59,45,,75,0,75,119,2,117
22/05/2022 15:00,18,14,4,105,57,48,142,72,70,0,0,0,6,6,0,9,9,0,2,2,0,112,53,59,65,,60,1,59,88,1,87
22/05/2022 16:00,17,11,6,99,56,43,135,67,68,0,0,0,4,4,0,7,7,0,1,1,0,135,56,79,55,,68,0,68,95,0,95
22/05/2022 17:00,11,9,2,92,45,47,103,59,44,0,0,0,12,12,0,6,6,0,0,0,0,115,63,52,72,,98,0,98,91,0,91
22/05/2022 18:00,17,6,11,48,25,23,69,38,31,0,0,0,13,13,0,10,10,0,0,0,0,97,44,53,52,,100,0,100,83,0,83
22/05/2022 19:00,17,10,7,42,26,16,53,32,21,0,0,0,10,10,0,8,8,0,1,1,0,95,42,53,63,,81,1,80,91,0,91
22/05/2022 20:00,4,2,2,38,19,19,58,25,33,0,0,0,5,5,0,7,7,0,0,0,0,92,48,44,47,,69,1,68,95,1,94
22/05/2022 21:00,9,2,7,28,17,11,37,23,14,0,0,0,14,13,1,4,4,0,0,0,0,75,35,40,38,,53,0,53,53,1,52
22/05/2022 22:00,12,7,5,13,8,5,15,5,10,0,0,0,6,6,0,3,3,0,0,0,0,54,21,33,37,,9,0,9,48,1,47
22/05/2022 23:00,3,3,0,2,2,0,4,2,2,0,0,0,4,3,1,3,3,0,0,0,0,37,27,10,22,,0,0,0,25,2,23
23/05/2022 00:00,2,1,1,3,2,1,5,2,3,0,0,0,4,4,0,1,1,0,1,1,0,13,7,6,13,,15,0,15,10,0,10
23/05/2022 01:00,0,0,0,1,0,1,3,2,1,0,0,0,1,1,0,0,0,0,0,0,0,4,3,1,2,,5,0,5,2,0,2
23/05/2022 02:00,0,0,0,0,0,0,0,0,0,0,0,0,0,0,0,1,1,0,0,0,0,8,7,1,6,,8,0,8,2,0,2
23/05/2022 03:00,0,0,0,0,0,0,0,0,0,0,0,0,0,0,0,0,0,0,0,0,0,4,1,3,2,,1,0,1,1,0,1
23/05/2022 04:00,0,0,0,1,1,0,4,3,1,0,0,0,1,1,0,0,0,0,0,0,0,9,3,6,2,,2,0,2,6,1,5
23/05/2022 05:00,0,0,0,4,2,2,6,4,2,0,0,0,8,8,0,1,1,0,0,0,0,30,3,27,5,,4,0,4,4,0,4
23/05/2022 06:00,17,15,2,29,20,9,32,22,10,0,0,0,27,27,0,7,7,0,3,3,0,117,21,96,21,,11,0,11,46,0,46
23/05/2022 07:00,35,26,9,70,52,18,73,56,17,0,0,0,41,41,0,16,16,0,12,12,0,246,66,180,21,,29,0,29,79,1,78
23/05/2022 08:00,86,76,10,82,57,25,118,88,30,0,0,0,66,66,0,38,38,0,28,28,0,464,89,375,37,,62,0,62,168,1,167
23/05/2022 09:00,25,23,2,52,29,23,65,38,27,0,0,0,38,38,0,6,6,0,0,0,0,210,42,168,27,,35,0,35,123,0,123
23/05/2022 10:00,16,9,7,61,27,34,57,24,33,0,0,0,18,18,0,14,14,0,0,0,0,82,34,48,26,,29,0,29,51,0,51
23/05/2022 11:00,13,7,6,80,38,42,69,27,42,0,0,0,18,17,1,7,7,0,0,0,0,89,33,56,37,,35,1,34,45,0,45
23/05/2022 12:00,12,7,5,68,32,36,88,43,45,0,0,0,7,7,0,12,12,0,0,0,0,115,48,67,51,,66,0,66,101,0,101
23/05/2022 13:00,25,18,7,45,23,22,55,25,30,0,0,0,6,6,0,14,14,0,1,1,0,131,57,74,49,,78,0,78,81,0,81
23/05/2022 14:00,16,8,8,33,16,17,31,12,19,0,0,0,1,1,0,18,18,0,3,3,0,106,57,49,61,,67,1,66,55,0,55
23/05/2022 15:00,13,7,6,39,13,26,58,25,33,0,0,0,7,7,0,21,21,0,4,4,0,122,78,44,78,,73,0,73,89,0,89
23/05/2022 16:00,29,14,15,43,16,27,70,21,49,0,0,0,8,8,0,24,24,0,3,3,0,213,128,85,141,,106,1,105,70,0,70
23/05/2022 17:00,54,19,35,75,20,55,106,24,82,0,0,0,7,6,1,37,37,0,0,0,0,332,226,106,273,,224,4,220,102,0,102
23/05/2022 18:00,42,16,26,76,16,60,114,34,80,0,0,0,17,17,0,23,23,0,1,1,0,290,197,93,198,,169,0,169,103,1,102
23/05/2022 19:00,23,9,14,45,15,30,66,29,37,0,0,0,8,8,0,13,13,0,1,1,0,135,77,58,71,,128,0,128,91,2,89
23/05/2022 20:00,10,4,6,57,24,33,80,31,49,0,0,0,12,12,0,10,10,0,2,2,0,118,58,60,67,,95,0,95,93,0,93
23/05/2022 21:00,9,5,4,19,10,9,48,25,23,0,0,0,4,4,0,13,13,0,0,0,0,95,63,32,44,,64,1,63,52,0,52
23/05/2022 22:00,7,5,2,2,1,1,11,4,7,0,0,0,5,5,0,4,4,0,1,1,0,54,29,25,36,,37,0,37,36,1,35
23/05/2022 23:00,3,2,1,3,1,2,9,3,6,0,0,0,6,6,0,3,3,0,0,0,0,32,25,7,17,,25,0,25,18,1,17
24/05/2022 00:00,2,1,1,1,0,1,1,1,0,0,0,0,0,0,0,1,1,0,1,1,0,12,7,5,15,,23,0,23,7,1,6
24/05/2022 01:00,1,1,0,0,0,0,0,0,0,0,0,0,2,2,0,0,0,0,0,0,0,2,2,0,3,,1,0,1,0,0,0
24/05/2022 02:00,1,0,1,1,1,0,1,1,0,0,0,0,0,0,0,0,0,0,0,0,0,5,2,3,1,,4,0,4,0,0,0
24/05/2022 03:00,0,0,0,0,0,0,1,1,0,0,0,0,0,0,0,0,0,0,0,0,0,3,2,1,2,,0,0,0,3,1,2
24/05/2022 04:00,0,0,0,1,1,0,3,1,2,0,0,0,2,2,0,0,0,0,0,0,0,8,1,7,1,,1,0,1,4,0,4
24/05/2022 05:00,3,3,0,14,9,5,17,10,7,0,0,0,5,5,0,2,2,0,0,0,0,33,7,26,4,,1,0,1,3,0,3
24/05/2022 06:00,15,13,2,44,28,16,44,30,14,0,0,0,25,24,1,8,8,0,2,2,0,143,28,115,24,,15,0,15,47,0,47
24/05/2022 07:00,52,45,7,86,62,24,106,78,28,0,0,0,50,50,0,23,23,0,1,1,0,312,65,247,36,,38,0,38,82,0,82
24/05/2022 08:00,120,112,8,119,92,27,146,112,34,0,0,0,91,91,0,42,42,0,0,0,0,561,102,459,50,,62,0,62,203,0,203
24/05/2022 09:00,35,29,6,60,36,24,84,50,34,0,0,0,41,41,0,9,9,0,0,0,0,229,32,197,25,,38,1,37,149,0,149
24/05/2022 10:00,19,11,8,56,26,30,59,31,28,0,0,0,14,14,0,8,8,0,0,0,0,112,36,76,24,,31,1,30,82,0,82
24/05/2022 11:00,13,7,6,59,35,24,82,37,45,0,0,0,22,22,0,11,11,0,0,0,0,103,38,65,0,,54,1,53,65,1,64
24/05/2022 12:00,17,9,8,53,27,26,76,38,38,0,0,0,13,13,0,7,7,0,0,0,0,117,38,79,1,,76,1,75,97,0,97
24/05/2022 13:00,24,12,12,57,28,29,75,35,40,0,0,0,4,4,0,11,11,0,0,0,0,137,69,68,18,,105,0,105,110,1,109
24/05/2022 14:00,16,8,8,56,22,34,50,18,32,0,0,0,7,7,0,17,17,0,2,2,0,117,54,63,30,,84,1,83,70,0,70
24/05/2022 15:00,20,4,16,57,25,32,75,35,40,0,0,0,9,9,0,30,30,0,12,12,0,170,92,78,43,,91,0,91,98,0,98
24/05/2022 16:00,36,19,17,70,30,40,92,35,57,0,0,0,7,7,0,34,34,0,27,27,0,290,182,108,61,,153,1,152,101,0,101
24/05/2022 17:00,64,13,51,141,37,104,196,50,146,0,0,0,4,3,1,37,37,0,40,40,0,401,264,137,259,,274,3,271,166,0,166
24/05/2022 18:00,66,20,46,143,48,95,182,54,128,0,0,0,13,13,0,25,25,0,11,11,0,357,230,127,255,,220,2,218,163,1,162
24/05/2022 19:00,29,12,17,116,45,71,125,37,88,0,0,0,11,11,0,13,13,0,3,3,0,190,116,74,115,,139,1,138,116,0,116
24/05/2022 20:00,16,4,12,79,41,38,88,46,42,0,0,0,4,4,0,15,15,0,2,2,0,140,90,50,74,,105,0,105,81,0,81
24/05/2022 21:00,12,4,8,48,26,22,42,18,24,0,0,0,9,9,0,17,17,0,2,2,0,94,54,40,60,,75,0,75,63,0,63
24/05/2022 22:00,5,4,1,19,9,10,28,9,19,0,0,0,3,3,0,9,9,0,0,0,0,80,51,29,43,,7,0,7,37,0,37
24/05/2022 23:00,4,1,3,9,3,6,9,1,8,0,0,0,6,6,0,1,1,0,0,0,0,28,21,7,34,,18,0,18,30,0,30
25/05/2022 00:00,1,1,0,2,0,2,6,3,3,0,0,0,2,2,0,3,3,0,0,0,0,21,16,5,12,,19,0,19,12,0,12
25/05/2022 01:00,1,1,0,2,2,0,3,2,1,0,0,0,2,2,0,0,0,0,0,0,0,5,5,0,5,,2,0,2,1,0,1
25/05/2022 02:00,0,0,0,1,0,1,5,2,3,0,0,0,0,0,0,0,0,0,0,0,0,8,6,2,3,,7,0,7,5,0,5
25/05/2022 03:00,0,0,0,1,0,1,0,0,0,0,0,0,0,0,0,0,0,0,0,0,0,8,3,5,1,,5,0,5,3,0,3
25/05/2022 04:00,0,0,0,1,1,0,1,1,0,0,0,0,3,3,0,0,0,0,0,0,0,8,3,5,1,,2,0,2,3,0,3
25/05/2022 05:00,2,2,0,9,5,4,11,6,5,0,0,0,8,8,0,1,1,0,0,0,0,31,2,29,7,,5,0,5,6,0,6
25/05/2022 06:00,18,15,3,31,20,11,33,19,14,0,0,0,21,21,0,6,6,0,0,0,0,147,27,120,26,,17,0,17,56,0,56
25/05/2022 07:00,41,36,5,62,45,17,68,47,21,0,0,0,49,49,0,18,18,0,1,1,0,318,73,245,39,,28,0,28,83,0,83
25/05/2022 08:00,104,96,8,92,74,18,135,108,27,0,0,0,105,104,1,32,32,0,27,27,0,595,104,491,39,,69,1,68,224,0,224
25/05/2022 09:00,31,25,6,35,22,13,49,29,20,0,0,0,26,26,0,15,15,0,17,17,0,256,49,207,24,,40,0,40,149,0,149
25/05/2022 10:00,20,13,7,61,27,34,47,21,26,0,0,0,8,8,0,7,7,0,9,9,0,83,29,54,13,,28,0,28,70,0,70
25/05/2022 11:00,10,5,5,28,12,16,35,16,19,0,0,0,7,7,0,8,8,0,4,4,0,87,28,59,16,,41,0,41,47,0,47
25/05/2022 12:00,15,7,8,47,24,23,53,22,31,0,0,0,9,9,0,8,8,0,2,2,0,115,53,62,44,,64,0,64,84,0,84
25/05/2022 13:00,22,15,7,45,21,24,49,22,27,0,0,0,9,9,0,25,25,0,5,5,0,146,61,85,74,,88,1,87,102,0,102
25/05/2022 14:00,14,4,10,35,16,19,48,16,32,0,0,0,13,13,0,12,12,0,23,23,0,124,60,64,72,,82,0,82,98,0,98
25/05/2022 15:00,28,12,16,28,7,21,45,16,29,0,0,0,7,6,1,20,20,0,17,17,0,137,76,61,85,,63,1,62,101,2,99
25/05/2022 16:00,40,24,16,62,26,36,72,27,45,0,0,0,11,11,0,21,21,0,29,29,0,227,134,93,160,,135,0,135,79,0,79
25/05/2022 17:00,60,16,44,111,27,84,162,35,127,0,0,0,10,10,0,36,36,0,24,24,0,426,287,139,289,,230,3,227,128,1,127
25/05/2022 18:00,49,18,31,111,24,87,160,36,124,0,0,0,12,12,0,31,31,0,19,19,0,352,227,125,251,,223,0,223,141,0,141
25/05/2022 19:00,25,10,15,81,30,51,116,44,72,0,0,0,16,16,0,19,19,0,14,14,0,198,111,87,114,,131,0,131,122,2,120
25/05/2022 20:00,19,7,12,66,30,36,88,48,40,0,0,0,7,7,0,15,15,0,0,0,0,145,94,51,72,,96,1,95,104,0,104
25/05/2022 21:00,27,6,21,41,25,16,55,31,24,0,0,0,6,6,0,13,13,0,1,1,0,104,64,40,48,,84,2,82,62,0,62
25/05/2022 22:00,6,1,5,19,10,9,18,8,10,0,0,0,1,1,0,3,3,0,0,0,0,102,59,43,57,,65,0,65,36,0,36
25/05/2022 23:00,3,0,3,2,0,2,6,1,5,0,0,0,3,3,0,1,1,0,0,0,0,36,28,8,35,,39,1,38,23,1,22
26/05/2022 00:00,0,0,0,3,1,2,6,3,3,0,0,0,5,4,1,1,1,0,0,0,0,27,21,6,21,,30,1,29,16,0,16
26/05/2022 01:00,2,2,0,2,1,1,0,0,0,0,0,0,2,2,0,2,2,0,0,0,0,12,9,3,12,,7,0,7,3,0,3
26/05/2022 02:00,0,0,0,1,0,1,4,1,3,0,0,0,0,0,0,0,0,0,0,0,0,8,4,4,6,,9,0,9,1,0,1
26/05/2022 03:00,0,0,0,0,0,0,0,0,0,0,0,0,1,1,0,0,0,0,0,0,0,7,4,3,2,,4,1,3,3,0,3
26/05/2022 04:00,0,0,0,1,1,0,2,1,1,0,0,0,2,2,0,0,0,0,0,0,0,6,2,4,4,,0,0,0,7,1,6
26/05/2022 05:00,2,2,0,8,5,3,11,6,5,0,0,0,7,7,0,1,1,0,0,0,0,31,4,27,6,,5,0,5,6,0,6
26/05/2022 06:00,17,16,1,22,16,6,30,22,8,0,0,0,20,20,0,2,2,0,1,1,0,143,25,118,22,,10,0,10,42,0,42
26/05/2022 07:00,47,42,5,48,39,9,55,40,15,0,0,0,43,43,0,12,12,0,15,15,0,281,67,214,34,,37,0,37,83,0,83
26/05/2022 08:00,110,98,12,87,70,17,110,89,21,0,0,0,77,76,1,36,36,0,85,85,0,595,107,488,45,,64,0,64,219,0,219
26/05/2022 09:00,41,31,10,32,22,10,50,32,18,0,0,0,23,23,0,10,10,0,15,15,0,246,34,212,31,,49,2,47,172,1,171
26/05/2022 10:00,17,10,7,33,19,14,37,17,20,0,0,0,13,13,0,8,8,0,13,13,0,94,30,64,22,,22,3,19,74,0,74
26/05/2022 11:00,8,4,4,30,13,17,34,17,17,0,0,0,10,10,0,6,6,0,9,9,0,96,26,70,24,,39,0,39,59,0,59
26/05/2022 12:00,14,7,7,36,19,17,39,16,23,0,0,0,11,10,1,11,11,0,9,9,0,105,38,67,45,,50,0,50,83,0,83
26/05/2022 13:00,25,17,8,29,12,17,37,16,21,0,0,0,11,11,0,8,8,0,7,7,0,129,56,73,71,,81,0,81,108,1,107
26/05/2022 14:00,20,10,10,35,16,19,49,17,32,0,0,0,6,6,0,17,17,0,6,6,0,117,47,70,61,,80,0,80,88,0,88
26/05/2022 15:00,16,11,5,45,16,29,49,16,33,0,0,0,5,5,0,21,21,0,5,5,0,153,78,75,94,,54,0,54,89,0,89
26/05/2022 16:00,31,14,17,69,29,40,78,26,52,0,0,0,9,9,0,32,32,0,0,0,0,266,162,104,152,,131,1,130,116,0,116
26/05/2022 17:00,61,16,45,113,39,74,157,43,114,0,0,0,16,16,0,29,29,0,22,22,0,383,250,133,265,,220,1,219,162,0,162
26/05/2022 18:00,47,16,31,128,38,90,156,49,107,0,0,0,24,24,0,25,25,0,23,23,0,323,211,112,198,,212,2,210,152,0,152
26/05/2022 19:00,29,15,14,90,37,53,106,41,65,0,0,0,13,13,0,19,19,0,16,16,0,198,113,85,112,,162,0,162,130,0,130
26/05/2022 20:00,27,11,16,76,40,36,85,33,52,0,0,0,8,8,0,19,19,0,7,7,0,164,86,78,87,,124,1,123,103,0,103
26/05/2022 21:00,10,2,8,26,13,13,44,24,20,0,0,0,7,7,0,10,10,0,7,7,0,105,70,35,64,,102,3,99,89,1,88
26/05/2022 22:00,8,6,2,17,5,12,25,9,16,0,0,0,13,13,0,9,9,0,4,4,0,82,63,19,86,,58,2,56,39,0,39
26/05/2022 23:00,5,2,3,5,2,3,10,4,6,0,0,0,3,3,0,4,4,0,0,0,0,60,40,20,38,,50,1,49,36,1,35
27/05/2022 00:00,2,2,0,5,2,3,14,3,11,0,0,0,5,5,0,3,3,0,0,0,0,41,30,11,24,,35,0,35,20,0,20
27/05/2022 01:00,0,0,0,1,0,1,0,0,0,0,0,0,0,0,0,2,2,0,0,0,0,11,9,2,13,,11,0,11,2,0,2
27/05/2022 02:00,0,0,0,0,0,0,0,0,0,0,0,0,1,1,0,0,0,0,0,0,0,8,7,1,13,,12,0,12,5,0,5
27/05/2022 03:00,0,0,0,0,0,0,0,0,0,0,0,0,0,0,0,2,2,0,0,0,0,9,7,2,10,,5,0,5,5,1,4
27/05/2022 04:00,0,0,0,2,1,1,3,0,3,0,0,0,0,0,0,0,0,0,0,0,0,10,3,7,4,,5,0,5,3,0,3
27/05/2022 05:00,1,1,0,13,6,7,16,9,7,0,0,0,5,4,1,3,3,0,0,0,0,28,3,25,5,,1,0,1,7,0,7
27/05/2022 06:00,21,17,4,29,15,14,41,23,18,0,0,0,21,21,0,5,5,0,1,1,0,130,24,106,19,,16,0,16,47,2,45
27/05/2022 07:00,33,27,6,65,41,24,65,44,21,0,0,0,51,51,0,19,19,0,1,1,0,250,55,195,23,,29,0,29,75,0,75
27/05/2022 08:00,70,60,10,79,66,13,110,82,28,0,0,0,76,76,0,31,31,0,14,14,0,374,76,298,35,,70,0,70,140,0,140
27/05/2022 09:00,29,22,7,59,26,33,72,37,35,0,0,0,44,44,0,10,10,0,8,8,0,199,35,164,30,,46,0,46,118,0,118
27/05/2022 10:00,20,12,8,46,24,22,79,32,47,0,0,0,20,20,0,14,14,0,7,7,0,106,31,75,31,,2,0,2,80,0,80
27/05/2022 11:00,14,8,6,57,29,28,81,43,38,0,0,0,13,13,0,12,12,0,6,6,0,128,36,92,29,,15,0,15,86,0,86
27/05/2022 12:00,22,11,11,71,33,38,84,39,45,0,0,0,13,13,0,21,21,0,2,2,0,137,57,80,58,,69,0,69,132,0,132
27/05/2022 13:00,23,12,11,62,31,31,77,34,43,0,0,0,11,11,0,24,24,0,3,3,0,155,71,84,78,,105,0,105,137,0,137
27/05/2022 14:00,22,12,10,49,22,27,82,38,44,0,0,0,14,14,0,21,21,0,7,7,0,169,81,88,101,,91,1,90,92,0,92
27/05/2022 15:00,28,11,17,73,33,40,83,41,42,0,0,0,8,8,0,14,14,0,6,6,0,175,96,79,114,,101,0,101,122,0,122
27/05/2022 16:00,38,21,17,97,41,56,144,54,90,0,0,0,12,12,0,17,17,0,4,4,0,234,128,106,153,,172,1,171,93,0,93
27/05/2022 17:00,38,11,27,122,46,76,160,59,101,0,0,0,12,12,0,19,19,0,14,14,0,283,159,124,200,,202,0,202,141,0,141
27/05/2022 18:00,23,3,20,125,53,72,165,61,104,0,0,0,19,18,1,26,26,0,19,19,0,260,147,113,127,,185,2,183,139,0,139
27/05/2022 19:00,27,8,19,90,35,55,125,62,63,0,0,0,23,23,0,11,11,0,14,14,0,179,97,82,100,,127,1,126,134,1,133
27/05/2022 20:00,25,6,19,62,36,26,66,35,31,0,0,0,15,15,0,14,14,0,13,13,0,141,81,60,87,,127,1,126,129,1,128
27/05/2022 21:00,13,4,9,42,21,21,56,32,24,0,0,0,6,6,0,8,8,0,5,5,0,107,54,53,48,,89,2,87,88,0,88
27/05/2022 22:00,7,4,3,14,10,4,14,7,7,0,0,0,4,4,0,8,8,0,5,5,0,93,54,39,54,,71,0,71,86,1,85
27/05/2022 23:00,4,1,3,8,2,6,14,5,9,0,0,0,7,7,0,3,3,0,3,3,0,63,51,12,39,,58,3,55,55,1,54
28/05/2022 00:00,2,1,1,5,1,4,6,2,4,0,0,0,9,9,0,2,2,0,3,3,0,47,33,14,38,,28,0,28,22,0,22
28/05/2022 01:00,0,0,0,3,2,1,2,0,2,0,0,0,4,4,0,3,3,0,0,0,0,30,25,5,21,,10,1,9,2,0,2
28/05/2022 02:00,2,0,2,1,0,1,3,1,2,0,0,0,0,0,0,0,0,0,0,0,0,14,9,5,16,,20,0,20,11,1,10
28/05/2022 03:00,0,0,0,3,0,3,3,0,3,0,0,0,0,0,0,0,0,0,0,0,0,14,12,2,13,,13,0,13,10,0,10
28/05/2022 04:00,0,0,0,0,0,0,1,0,1,0,0,0,1,1,0,1,1,0,0,0,0,7,4,3,4,,9,0,9,4,1,3
28/05/2022 05:00,1,1,0,4,2,2,5,2,3,0,0,0,3,3,0,0,0,0,0,0,0,7,1,6,7,,6,0,6,3,0,3
28/05/2022 06:00,0,0,0,30,12,18,31,13,18,0,0,0,4,4,0,2,2,0,0,0,0,26,7,19,11,,12,0,12,14,0,14
28/05/2022 07:00,10,6,4,47,23,24,53,23,30,0,0,0,22,22,0,6,6,0,5,5,0,66,9,57,9,,9,0,9,21,0,21
28/05/2022 08:00,11,9,2,79,32,47,99,37,62,0,0,0,11,11,0,7,7,0,2,2,0,88,21,67,29,,31,0,31,44,0,44
28/05/2022 09:00,12,10,2,155,63,92,151,53,98,0,0,0,15,15,0,15,15,0,1,1,0,105,41,64,31,,26,0,26,72,0,72
28/05/2022 10:00,23,14,9,162,71,91,218,96,122,0,0,0,9,9,0,13,13,0,2,2,0,114,37,77,45,,51,0,51,87,1,86
28/05/2022 11:00,28,19,9,157,81,76,255,121,134,0,0,0,0,0,0,14,14,0,8,8,0,139,41,98,67,,55,0,55,79,2,77
28/05/2022 12:00,26,14,12,188,94,94,247,115,132,0,0,0,4,4,0,20,20,0,3,3,0,149,73,76,70,,69,0,69,104,0,104
28/05/2022 13:00,10,5,5,152,80,72,212,114,98,0,0,0,5,5,0,18,18,0,10,10,0,162,68,94,76,,91,0,91,123,0,123
28/05/2022 14:00,15,8,7,108,49,59,170,79,91,0,0,0,4,4,0,14,14,0,19,19,0,131,60,71,75,,79,0,79,98,1,97
28/05/2022 15:00,17,11,6,126,63,63,179,99,80,0,0,0,6,6,0,14,14,0,7,7,0,120,49,71,66,,73,1,72,98,1,97
28/05/2022 16:00,11,5,6,96,54,42,158,90,68,0,0,0,12,12,0,12,12,0,9,9,0,143,63,80,69,,103,1,102,81,0,81
28/05/2022 17:00,13,6,7,77,44,33,99,63,36,0,0,0,2,2,0,11,11,0,11,11,0,123,54,69,68,,97,1,96,97,0,97
28/05/2022 18:00,10,6,4,78,50,28,85,55,30,0,0,0,10,10,0,8,8,0,13,13,0,124,69,55,62,,99,0,99,85,0,85
28/05/2022 19:00,17,11,6,67,37,30,86,54,32,0,0,0,26,26,0,4,4,0,8,8,0,122,65,57,62,,75,0,75,103,0,103
28/05/2022 20:00,11,7,4,25,16,9,39,21,18,0,0,0,12,12,0,3,3,0,4,4,0,74,35,39,37,,62,0,62,66,0,66
28/05/2022 21:00,6,1,5,14,6,8,23,15,8,0,0,0,7,7,0,8,8,0,3,3,0,62,36,26,20,,53,0,53,59,0,59
28/05/2022 22:00,8,3,5,19,11,8,26,12,14,0,0,0,5,5,0,2,2,0,2,2,0,58,30,28,53,,37,0,37,56,1,55
28/05/2022 23:00,5,1,4,11,7,4,15,8,7,0,0,0,10,10,0,9,9,0,1,1,0,73,44,29,48,,44,0,44,38,0,38
29/05/2022 00:00,2,0,2,8,4,4,11,3,8,0,0,0,3,3,0,0,0,0,1,1,0,35,20,15,34,,30,0,30,28,0,28
29/05/2022 01:00,1,1,0,3,2,1,1,0,1,0,0,0,0,0,0,2,2,0,1,1,0,32,18,14,17,,10,0,10,1,0,1
29/05/2022 02:00,1,0,1,2,2,0,8,4,4,0,0,0,1,1,0,1,1,0,0,0,0,31,18,13,19,,21,0,21,9,1,8
29/05/2022 03:00,2,2,0,1,0,1,2,0,2,0,0,0,2,2,0,0,0,0,0,0,0,18,14,4,14,,17,0,17,2,0,2
29/05/2022 04:00,0,0,0,0,0,0,0,0,0,0,0,0,2,2,0,1,1,0,0,0,0,10,6,4,11,,7,0,7,4,0,4
29/05/2022 05:00,1,1,0,10,4,6,6,3,3,0,0,0,0,0,0,0,0,0,0,0,0,6,1,5,3,,8,0,8,3,0,3
29/05/2022 06:00,3,0,3,18,6,12,17,5,12,0,0,0,4,4,0,2,2,0,2,2,0,23,4,19,7,,6,0,6,11,0,11
29/05/2022 07:00,5,4,1,37,17,20,39,15,24,0,0,0,11,11,0,3,3,0,0,0,0,41,22,19,20,,11,0,11,10,0,10
29/05/2022 08:00,7,7,0,73,33,40,91,38,53,0,0,0,8,8,0,10,10,0,1,1,0,29,8,21,23,,18,0,18,22,0,22
29/05/2022 09:00,15,10,5,126,57,69,131,61,70,0,0,0,10,10,0,11,11,0,4,4,0,31,9,22,24,,31,2,29,47,0,47
29/05/2022 10:00,15,8,7,149,69,80,181,74,107,0,0,0,15,15,0,16,16,0,0,0,0,45,15,30,26,,21,0,21,49,0,49
29/05/2022 11:00,8,4,4,137,59,78,176,81,95,0,0,0,13,13,0,9,9,0,0,0,0,85,14,71,34,,40,0,40,65,0,65
29/05/2022 12:00,12,9,3,108,53,55,180,86,94,0,0,0,7,7,0,10,10,0,0,0,0,125,36,89,43,,47,0,47,101,0,101
29/05/2022 13:00,28,21,7,103,55,48,150,76,74,0,0,0,2,2,0,11,11,0,3,3,0,107,55,52,44,,70,0,70,87,0,87
29/05/2022 14:00,23,16,7,112,55,57,138,74,64,0,0,0,7,7,0,18,18,0,4,4,0,109,51,58,61,,56,0,56,72,0,72
29/05/2022 15:00,13,9,4,99,52,47,137,69,68,0,0,0,13,12,1,13,13,0,3,3,0,116,49,67,54,,76,1,75,90,1,89
29/05/2022 16:00,14,6,8,94,46,48,131,51,80,0,0,0,18,17,1,9,9,0,5,5,0,116,50,66,50,,83,0,83,116,1,115
29/05/2022 17:00,14,7,7,100,59,41,142,93,49,0,0,0,18,18,0,8,8,0,7,7,0,127,60,67,75,,88,1,87,66,0,66
29/05/2022 18:00,14,5,9,78,46,32,119,75,44,0,0,0,18,18,0,15,15,0,4,4,0,127,60,67,57,,117,1,116,77,0,77
29/05/2022 19:00,10,4,6,68,34,34,81,44,37,0,0,0,8,8,0,18,18,0,1,1,0,134,73,61,60,,93,0,93,91,1,90
29/05/2022 20:00,15,6,9,40,21,19,63,36,27,0,0,0,9,9,0,4,4,0,1,1,0,101,56,45,43,,90,0,90,75,0,75
29/05/2022 21:00,12,6,6,16,10,6,27,16,11,0,0,0,7,7,0,5,5,0,2,2,0,63,29,34,38,,33,0,33,64,1,63
29/05/2022 22:00,3,1,2,7,1,6,16,6,10,0,0,0,4,4,0,6,6,0,1,1,0,53,38,15,26,,9,0,9,37,0,37
29/05/2022 23:00,0,0,0,3,3,0,8,2,6,0,0,0,2,2,0,2,2,0,1,1,0,29,22,7,19,,10,0,10,21,2,19
30/05/2022 00:00,2,1,1,6,4,2,8,3,5,0,0,0,5,5,0,2,2,0,0,0,0,17,12,5,23,,12,0,12,14,0,14
30/05/2022 01:00,3,3,0,2,1,1,0,0,0,0,0,0,1,1,0,0,0,0,0,0,0,10,10,0,7,,4,0,4,2,0,2
30/05/2022 02:00,1,0,1,1,0,1,1,0,1,0,0,0,0,0,0,0,0,0,0,0,0,7,6,1,5,,8,0,8,4,0,4
30/05/2022 03:00,0,0,0,0,0,0,0,0,0,0,0,0,0,0,0,0,0,0,0,0,0,3,2,1,2,,7,0,7,3,0,3
30/05/2022 04:00,0,0,0,2,1,1,4,1,3,0,0,0,2,2,0,0,0,0,0,0,0,9,2,7,2,,3,0,3,3,1,2
30/05/2022 05:00,0,0,0,8,5,3,8,6,2,0,0,0,6,6,0,1,1,0,0,0,0,36,5,31,1,,1,0,1,9,0,9
30/05/2022 06:00,18,14,4,25,18,7,34,24,10,0,0,0,23,23,0,7,7,0,1,1,0,143,29,114,19,,17,0,17,35,0,35
30/05/2022 07:00,28,23,5,59,38,21,69,47,22,0,0,0,39,39,0,14,14,0,0,0,0,257,53,204,27,,31,0,31,82,0,82
30/05/2022 08:00,90,84,6,74,59,15,98,77,21,0,0,0,64,64,0,21,21,0,0,0,0,459,90,369,43,,60,1,59,153,0,153
30/05/2022 09:00,18,16,2,42,24,18,58,38,20,0,0,0,38,38,0,10,10,0,0,0,0,185,33,152,23,,47,0,47,132,0,132
30/05/2022 10:00,15,12,3,41,22,19,50,25,25,0,0,0,23,23,0,11,11,0,0,0,0,91,29,62,18,,27,0,27,64,0,64
30/05/2022 11:00,15,8,7,30,9,21,53,20,33,0,0,0,8,8,0,8,8,0,1,1,0,80,19,61,24,,28,0,28,71,0,71
30/05/2022 12:00,14,6,8,43,22,21,64,30,34,0,0,0,8,8,0,13,13,0,8,8,0,90,40,50,48,,67,0,67,83,0,83
30/05/2022 13:00,13,8,5,39,22,17,53,23,30,0,0,0,8,8,0,16,16,0,11,11,0,148,76,72,73,,97,0,97,97,0,97
30/05/2022 14:00,13,8,5,43,19,24,46,20,26,0,0,0,6,6,0,21,21,0,17,17,0,121,63,58,68,,81,0,81,72,0,72
30/05/2022 15:00,26,8,18,36,16,20,42,14,28,0,0,0,5,5,0,18,18,0,12,12,0,134,68,66,79,,74,0,74,49,1,48
30/05/2022 16:00,23,11,12,33,13,20,44,14,30,0,0,0,7,7,0,23,23,0,20,20,0,182,115,67,128,,118,1,117,61,1,60
30/05/2022 17:00,44,15,29,67,14,53,100,26,74,0,0,0,7,7,0,25,25,0,10,10,0,335,222,113,265,,191,0,191,104,0,104
30/05/2022 18:00,40,11,29,67,16,51,86,23,63,0,0,0,8,8,0,18,18,0,8,8,0,268,183,85,209,,169,1,168,103,0,103
30/05/2022 19:00,21,9,12,25,8,17,33,9,24,0,0,0,15,15,0,14,14,0,3,3,0,172,104,68,94,,117,0,117,73,1,72
30/05/2022 20:00,16,6,10,32,8,24,38,10,28,0,0,0,8,8,0,15,15,0,0,0,0,85,55,30,62,,94,0,94,60,0,60
30/05/2022 21:00,15,4,11,12,9,3,25,14,11,0,0,0,9,9,0,5,5,0,1,1,0,77,51,26,48,,57,1,56,42,0,42
30/05/2022 22:00,3,2,1,3,3,0,10,3,7,0,0,0,0,0,0,3,3,0,2,2,0,45,31,14,31,,31,1,30,45,0,45
30/05/2022 23:00,4,2,2,3,1,2,4,1,3,0,0,0,0,0,0,1,1,0,0,0,0,24,16,8,14,,18,0,18,16,0,16
31/05/2022 00:00,0,0,0,0,0,0,1,0,1,0,0,0,2,2,0,0,0,0,0,0,0,18,12,6,11,,10,0,10,7,0,7
31/05/2022 01:00,0,0,0,0,0,0,0,0,0,0,0,0,1,1,0,0,0,0,0,0,0,5,4,1,6,,1,0,1,0,0,0
31/05/2022 02:00,0,0,0,1,0,1,2,0,2,0,0,0,0,0,0,0,0,0,0,0,0,4,3,1,4,,5,0,5,1,0,1
31/05/2022 03:00,1,1,0,0,0,0,0,0,0,0,0,0,0,0,0,1,1,0,0,0,0,3,1,2,1,,1,0,1,2,0,2
31/05/2022 04:00,0,0,0,1,1,0,2,1,1,0,0,0,0,0,0,0,0,0,0,0,0,12,4,8,2,,0,0,0,3,0,3
31/05/2022 05:00,2,2,0,15,10,5,18,13,5,0,0,0,4,4,0,2,2,0,0,0,0,31,5,26,7,,2,0,2,8,0,8
31/05/2022 06:00,18,16,2,40,24,16,43,28,15,0,0,0,29,28,1,8,8,0,1,1,0,129,25,104,26,,11,0,11,50,0,50
31/05/2022 07:00,37,31,6,80,53,27,72,50,22,0,0,0,40,39,1,15,15,0,1,1,0,332,69,263,30,,34,0,34,77,0,77
31/05/2022 08:00,115,105,10,95,76,19,130,103,27,0,0,0,90,90,0,33,33,0,0,0,0,616,111,505,48,,66,0,66,198,0,198
31/05/2022 09:00,39,34,5,57,39,18,71,42,29,0,0,0,42,42,0,10,10,0,0,0,0,231,36,195,26,,44,1,43,160,0,160
31/05/2022 10:00,12,9,3,42,24,18,59,29,30,0,0,0,21,20,1,9,9,0,0,0,0,85,20,65,19,,42,0,42,79,0,79
31/05/2022 11:00,8,4,4,56,25,31,56,22,34,0,0,0,16,16,0,13,13,0,0,0,0,95,32,63,27,,35,1,34,78,0,78
31/05/2022 12:00,12,7,5,50,24,26,64,28,36,0,0,0,14,14,0,11,11,0,0,0,0,103,46,57,57,,65,2,63,89,1,88
31/05/2022 13:00,22,14,8,58,30,28,61,29,32,0,0,0,9,8,1,12,12,0,0,0,0,116,64,52,45,,83,1,82,106,0,106
31/05/2022 14:00,19,7,12,34,10,24,39,14,25,0,0,0,14,14,0,17,17,0,0,0,0,138,67,71,74,,82,0,82,93,0,93
31/05/2022 15:00,20,10,10,34,14,20,41,14,27,0,0,0,5,5,0,20,20,0,1,1,0,151,87,64,101,,78,0,78,71,1,70
31/05/2022 16:00,37,15,22,52,22,30,73,25,48,0,0,0,13,13,0,14,14,0,0,0,0,228,140,88,171,,142,0,142,88,0,88
31/05/2022 17:00,52,7,45,62,11,51,89,21,68,0,0,0,2,2,0,25,25,0,0,0,0,376,250,126,297,,219,0,219,109,1,108
31/05/2022 18:00,55,18,37,65,10,55,100,16,84,0,0,0,5,5,0,23,23,0,0,0,0,327,219,108,251,,214,3,211,94,0,94
31/05/2022 19:00,30,14,16,50,19,31,60,20,40,0,0,0,10,9,1,15,15,0,1,1,0,197,112,85,100,,146,1,145,90,0,90
31/05/2022 20:00,14,2,12,38,15,23,32,12,20,0,0,0,10,10,0,14,14,0,0,0,0,123,79,44,69,,77,0,77,75,1,74
31/05/2022 21:00,16,5,11,18,11,7,32,17,15,0,0,0,16,16,0,6,6,0,1,1,0,103,75,28,58,,73,0,73,55,0,55
31/05/2022 22:00,7,5,2,8,4,4,10,2,8,0,0,0,4,4,0,1,1,0,2,2,0,50,33,17,29,,15,1,14,38,0,38
31/05/2022 23:00,4,1,3,1,1,0,1,1,0,0,0,0,2,2,0,1,1,0,0,0,0,34,25,9,29,,0,0,0,23,0,23
01/06/2022 00:00,3,0,3,3,1,2,3,2,1,0,0,0,3,3,0,3,3,0,0,0,0,17,13,4,14,,3,0,3,9,1,8
01/06/2022 01:00,0,0,0,0,0,0,0,0,0,0,0,0,1,1,0,0,0,0,0,0,0,4,4,0,5,,5,0,5,1,0,1
01/06/2022 02:00,0,0,0,0,0,0,0,0,0,0,0,0,1,1,0,1,1,0,0,0,0,3,2,1,2,,8,0,8,4,0,4
01/06/2022 03:00,1,0,1,0,0,0,0,0,0,0,0,0,0,0,0,1,1,0,0,0,0,11,7,4,1,,5,0,5,3,0,3
01/06/2022 04:00,1,1,0,2,2,0,3,2,1,0,0,0,0,0,0,0,0,0,0,0,0,7,1,6,4,,4,0,4,2,0,2
01/06/2022 05:00,3,3,0,8,5,3,7,4,3,0,0,0,5,5,0,1,1,0,0,0,0,33,7,26,7,,3,0,3,7,0,7
01/06/2022 06:00,20,19,1,32,18,14,44,26,18,0,0,0,22,22,0,9,9,0,0,0,0,145,23,122,23,,17,0,17,57,0,57
01/06/2022 07:00,60,53,7,102,72,30,117,85,32,0,0,0,62,62,0,9,9,0,1,1,0,328,78,250,37,,41,0,41,76,0,76
01/06/2022 08:00,133,120,13,116,84,32,149,113,36,0,0,0,80,80,0,16,16,0,0,0,0,609,110,499,48,,66,0,66,194,2,192
01/06/2022 09:00,37,29,8,65,38,27,76,43,33,0,0,0,27,27,0,5,5,0,0,0,0,248,55,193,26,,39,1,38,155,2,153
01/06/2022 10:00,17,14,3,48,23,25,60,29,31,0,0,0,11,11,0,4,4,0,0,0,0,93,29,64,24,,24,0,24,64,1,63
01/06/2022 11:00,17,13,4,77,37,40,89,37,52,0,0,0,19,19,0,4,4,0,0,0,0,93,32,61,27,,45,1,44,82,0,82
01/06/2022 12:00,24,14,10,76,34,42,90,44,46,0,0,0,29,29,0,14,14,0,0,0,0,120,44,76,42,,82,0,82,96,1,95
01/06/2022 13:00,20,13,7,77,39,38,109,52,57,0,0,0,12,12,0,16,16,0,0,0,0,131,62,69,70,,97,0,97,99,1,98
01/06/2022 14:00,15,5,10,71,31,40,100,47,53,0,0,0,11,11,0,23,23,0,0,0,0,148,61,87,92,,78,0,78,92,0,92
01/06/2022 15:00,24,11,13,79,34,45,114,50,64,0,0,0,11,11,0,21,21,0,1,1,0,152,70,82,99,,74,0,74,85,0,85
01/06/2022 16:00,27,13,14,98,43,55,128,52,76,0,0,0,23,23,0,17,17,0,0,0,0,255,142,113,176,,153,1,152,85,0,85
01/06/2022 17:00,58,20,38,178,61,117,210,71,139,0,0,0,26,24,2,25,25,0,0,0,0,409,264,145,337,,245,2,243,137,0,137
01/06/2022 18:00,51,15,36,224,89,135,258,95,163,0,0,0,29,29,0,28,28,0,0,0,0,361,231,130,271,,191,1,190,141,0,141
01/06/2022 19:00,37,13,24,183,88,95,252,126,126,0,0,0,12,12,0,30,30,0,1,1,0,231,130,101,112,,142,0,142,127,0,127
01/06/2022 20:00,33,11,22,116,57,59,143,78,65,0,0,0,10,10,0,19,19,0,4,4,0,182,105,77,84,,105,0,105,99,1,98
01/06/2022 21:00,10,6,4,39,24,15,77,43,34,0,0,0,6,6,0,13,13,0,2,2,0,148,88,60,62,,82,1,81,66,0,66
01/06/2022 22:00,8,3,5,17,4,13,39,14,25,0,0,0,8,8,0,6,6,0,1,1,0,105,74,31,44,,51,0,51,41,2,39
01/06/2022 23:00,2,1,1,5,3,2,9,3,6,0,0,0,4,4,0,3,3,0,0,0,0,56,36,20,39,,51,1,50,31,0,31
02/06/2022 00:00,0,0,0,2,1,1,1,1,0,0,0,0,2,2,0,2,2,0,0,0,0,31,23,8,15,,35,0,35,19,0,19
02/06/2022 01:00,0,0,0,2,2,0,0,0,0,0,0,0,0,0,0,1,1,0,0,0,0,10,7,3,5,,4,0,4,1,0,1
02/06/2022 02:00,2,1,1,2,0,2,2,1,1,0,0,0,1,1,0,0,0,0,0,0,0,6,4,2,2,,10,0,10,2,0,2
02/06/2022 03:00,0,0,0,1,1,0,0,0,0,0,0,0,0,0,0,0,0,0,0,0,0,4,2,2,4,,3,0,3,3,0,3
02/06/2022 04:00,0,0,0,2,2,0,2,1,1,0,0,0,2,2,0,1,1,0,0,0,0,6,0,6,2,,1,0,1,3,0,3
02/06/2022 05:00,3,3,0,12,9,3,16,10,6,0,0,0,5,5,0,0,0,0,0,0,0,38,7,31,5,,3,0,3,6,0,6
02/06/2022 06:00,19,19,0,33,22,11,40,30,10,0,0,0,25,25,0,7,7,0,1,1,0,141,32,109,19,,11,0,11,44,0,44
02/06/2022 07:00,31,27,4,87,63,24,88,60,28,0,0,0,58,57,1,16,16,0,0,0,0,287,68,219,31,,39,0,39,82,0,82
02/06/2022 08:00,112,100,12,122,95,27,174,135,39,0,0,0,105,104,1,25,25,0,0,0,0,592,106,486,59,,68,0,68,194,1,193
02/06/2022 09:00,47,42,5,82,48,34,80,45,35,0,0,0,39,39,0,4,4,0,0,0,0,258,49,209,30,,39,2,37,135,1,134
02/06/2022 10:00,19,13,6,77,43,34,64,33,31,0,0,0,29,29,0,11,11,0,0,0,0,112,32,80,24,,31,1,30,76,1,75
02/06/2022 11:00,14,9,5,53,24,29,64,25,39,0,0,0,16,15,1,6,6,0,0,0,0,85,32,53,23,,44,0,44,77,0,77
02/06/2022 12:00,10,6,4,52,31,21,73,35,38,0,0,0,4,4,0,11,11,0,0,0,0,116,43,73,51,,81,0,81,113,1,112
02/06/2022 13:00,18,9,9,66,33,33,90,44,46,0,0,0,3,3,0,12,12,0,0,0,0,176,88,88,72,,64,0,64,114,0,114
02/06/2022 14:00,17,9,8,36,11,25,55,18,37,0,0,0,4,4,0,14,14,0,0,0,0,133,67,66,76,,68,0,68,72,0,72
02/06/2022 15:00,15,4,11,41,15,26,70,24,46,0,0,0,11,11,0,14,14,0,2,2,0,141,73,68,105,,74,0,74,79,0,79
02/06/2022 16:00,41,17,24,78,24,54,108,42,66,0,0,0,10,10,0,15,15,0,10,10,0,247,140,107,196,,139,0,139,102,0,102
02/06/2022 17:00,59,12,47,99,33,66,129,32,97,0,0,0,26,25,1,20,20,0,5,5,0,380,255,125,298,,209,2,207,130,0,130
02/06/2022 18:00,33,13,20,106,24,82,139,34,105,0,0,0,26,25,1,12,12,0,2,2,0,298,195,103,228,,212,0,212,120,0,120
02/06/2022 19:00,25,11,14,46,23,23,50,19,31,0,0,0,9,9,0,12,12,0,7,7,0,164,102,62,110,,125,0,125,101,0,101
02/06/2022 20:00,8,3,5,24,13,11,31,18,13,0,0,0,5,5,0,4,4,0,5,5,0,115,77,38,59,,103,1,102,69,0,69
02/06/2022 21:00,5,1,4,5,1,4,5,1,4,0,0,0,3,3,0,2,2,0,1,1,0,68,47,21,48,,64,2,62,35,0,35
02/06/2022 22:00,5,2,3,3,0,3,7,0,7,0,0,0,4,4,0,1,1,0,1,1,0,60,37,23,38,,55,0,55,28,1,27
02/06/2022 23:00,2,2,0,3,0,3,7,2,5,0,0,0,5,5,0,3,3,0,1,1,0,49,35,14,30,,31,1,30,25,0,25
03/06/2022 00:00,0,0,0,1,0,1,3,0,3,0,0,0,1,1,0,0,0,0,0,0,0,28,24,4,20,,25,1,24,11,1,10
03/06/2022 01:00,0,0,0,0,0,0,0,0,0,0,0,0,1,1,0,1,1,0,0,0,0,2,2,0,6,,4,0,4,2,0,2
03/06/2022 02:00,0,0,0,3,1,2,3,1,2,0,0,0,0,0,0,1,1,0,0,0,0,5,5,0,10,,6,0,6,3,0,3
03/06/2022 03:00,0,0,0,0,0,0,0,0,0,0,0,0,0,0,0,0,0,0,0,0,0,7,5,2,3,,3,0,3,2,0,2
03/06/2022 04:00,0,0,0,1,1,0,5,2,3,0,0,0,3,3,0,0,0,0,0,0,0,12,5,7,2,,2,0,2,3,0,3
03/06/2022 05:00,0,0,0,9,7,2,12,7,5,0,0,0,4,4,0,0,0,0,0,0,0,28,7,21,7,,5,0,5,6,0,6
03/06/2022 06:00,15,14,1,25,18,7,24,17,7,0,0,0,9,9,0,10,10,0,0,0,0,110,18,92,18,,9,0,9,47,1,46
03/06/2022 07:00,23,22,1,34,24,10,49,34,15,0,0,0,33,33,0,17,17,0,8,8,0,185,47,138,28,,32,0,32,75,0,75
03/06/2022 08:00,62,54,8,71,52,19,84,61,23,0,0,0,41,41,0,12,12,0,1,1,0,311,64,247,39,,54,0,54,113,0,113
03/06/2022 09:00,20,15,5,39,24,15,46,26,20,0,0,0,19,19,0,9,9,0,0,0,0,168,40,128,21,,36,0,36,118,0,118
03/06/2022 10:00,8,6,2,33,15,18,40,21,19,0,0,0,18,17,1,6,6,0,0,0,0,96,28,68,15,,24,0,24,68,0,68
03/06/2022 11:00,16,12,4,43,20,23,47,22,25,0,0,0,2,2,0,7,7,0,0,0,0,99,40,59,38,,55,0,55,66,0,66
03/06/2022 12:00,16,8,8,42,20,22,68,32,36,0,0,0,11,11,0,9,9,0,0,0,0,122,47,75,48,,71,2,69,108,0,108
03/06/2022 13:00,13,6,7,43,19,24,75,29,46,0,0,0,7,7,0,14,14,0,3,3,0,160,75,85,58,,93,1,92,108,0,108
03/06/2022 14:00,23,8,15,52,18,34,72,26,46,0,0,0,5,5,0,14,14,0,12,12,0,137,69,68,93,,86,0,86,122,2,120
03/06/2022 15:00,26,13,13,77,36,41,100,44,56,0,0,0,4,4,0,15,15,0,9,9,0,152,73,79,84,,95,2,93,85,0,85
03/06/2022 16:00,30,12,18,78,28,50,110,51,59,0,0,0,11,10,1,18,18,0,13,13,0,202,103,99,136,,151,0,151,112,0,112
03/06/2022 17:00,21,8,13,84,30,54,127,50,77,0,0,0,7,7,0,25,25,0,7,7,0,256,141,115,184,,171,1,170,144,0,144
03/06/2022 18:00,33,8,25,89,36,53,132,54,78,0,0,0,29,29,0,13,13,0,10,10,0,216,112,104,103,,177,0,177,125,1,124
03/06/2022 19:00,13,6,7,61,31,30,89,46,43,0,0,0,23,23,0,7,7,0,8,8,0,189,90,99,81,,129,2,127,143,0,143
03/06/2022 20:00,10,5,5,48,24,24,61,34,27,0,0,0,18,17,1,3,3,0,10,10,0,112,62,50,63,,100,0,100,136,0,136
03/06/2022 21:00,9,5,4,17,9,8,45,25,20,0,0,0,10,10,0,7,7,0,0,0,0,104,66,38,57,,88,1,87,90,0,90
03/06/2022 22:00,12,5,7,14,8,6,23,13,10,0,0,0,7,7,0,6,6,0,0,0,0,81,51,30,50,,49,0,49,54,1,53
03/06/2022 23:00,4,4,0,5,3,2,5,2,3,0,0,0,7,6,1,3,3,0,0,0,0,60,42,18,38,,37,0,37,42,1,41
04/06/2022 00:00,2,2,0,5,3,2,8,6,2,0,0,0,2,2,0,1,1,0,0,0,0,29,20,9,24,,28,0,28,29,0,29
04/06/2022 01:00,2,2,0,8,3,5,4,2,2,0,0,0,5,5,0,1,1,0,0,0,0,27,23,4,21,,12,0,12,1,0,1
04/06/2022 02:00,0,0,0,0,0,0,0,0,0,0,0,0,0,0,0,0,0,0,0,0,0,15,11,4,4,,19,0,19,10,0,10
04/06/2022 03:00,0,0,0,1,0,1,0,0,0,0,0,0,2,2,0,2,2,0,0,0,0,7,6,1,13,,12,0,12,1,0,1
04/06/2022 04:00,0,0,0,1,0,1,1,0,1,0,0,0,4,4,0,0,0,0,0,0,0,7,5,2,3,,13,0,13,5,0,5
04/06/2022 05:00,1,1,0,9,6,3,14,8,6,0,0,0,1,1,0,0,0,0,0,0,0,10,2,8,8,,2,0,2,5,0,5
04/06/2022 06:00,2,2,0,17,10,7,22,11,11,0,0,0,6,6,0,1,1,0,0,0,0,45,7,38,12,,7,0,7,15,0,15
04/06/2022 07:00,5,4,1,42,18,24,55,24,31,0,0,0,8,8,0,7,7,0,0,0,0,46,11,35,14,,11,0,11,21,0,21
04/06/2022 08:00,5,4,1,63,29,34,76,36,40,0,0,0,20,20,0,7,7,0,0,0,0,80,31,49,17,,25,0,25,32,0,32
04/06/2022 09:00,15,11,4,79,38,41,94,44,50,0,0,0,12,12,0,10,10,0,2,2,0,84,25,59,25,,23,0,23,70,0,70
04/06/2022 10:00,7,1,6,85,29,56,109,48,61,0,0,0,14,13,1,8,8,0,1,1,0,100,41,59,33,,41,1,40,81,0,81
04/06/2022 11:00,15,8,7,77,32,45,114,55,59,0,0,0,3,3,0,9,9,0,2,2,0,131,50,81,40,,64,0,64,75,0,75
04/06/2022 12:00,14,11,3,88,39,49,131,61,70,0,0,0,6,6,0,7,7,0,4,4,0,130,54,76,44,,72,0,72,105,1,104
04/06/2022 13:00,13,11,2,78,42,36,115,58,57,0,0,0,9,9,0,11,11,0,4,4,0,117,55,62,60,,77,2,75,131,1,130
04/06/2022 14:00,21,17,4,68,34,34,127,57,70,0,0,0,12,12,0,9,9,0,4,4,0,129,54,75,51,,79,1,78,104,0,104
04/06/2022 15:00,9,4,5,88,42,46,117,61,56,0,0,0,14,14,0,20,20,0,1,1,0,118,50,68,55,,83,0,83,107,0,107
04/06/2022 16:00,14,7,7,76,39,37,102,63,39,0,0,0,6,5,1,13,13,0,5,5,0,94,45,49,51,,87,2,85,76,1,75
04/06/2022 17:00,12,6,6,64,31,33,88,41,47,0,0,0,2,2,0,11,11,0,2,2,0,81,42,39,49,,91,0,91,86,1,85
04/06/2022 18:00,16,3,13,48,24,24,82,48,34,0,0,0,7,7,0,8,8,0,3,3,0,104,46,58,68,,106,1,105,99,2,97
04/06/2022 19:00,5,3,2,40,16,24,52,33,19,0,0,0,13,13,0,5,5,0,1,1,0,98,46,52,50,,87,0,87,115,1,114
04/06/2022 20:00,17,11,6,24,15,9,42,22,20,0,0,0,5,5,0,6,6,0,1,1,0,65,33,32,38,,70,0,70,88,1,87
04/06/2022 21:00,5,1,4,17,10,7,20,15,5,0,0,0,7,7,0,5,5,0,0,0,0,82,45,37,25,,59,2,57,67,0,67
04/06/2022 22:00,5,3,2,12,5,7,11,5,6,0,0,0,7,7,0,6,6,0,0,0,0,53,30,23,34,,33,2,31,41,1,40
04/06/2022 23:00,4,2,2,8,6,2,25,16,9,0,0,0,6,6,0,2,2,0,0,0,0,56,35,21,22,,54,0,54,39,1,38
05/06/2022 00:00,2,2,0,2,0,2,11,5,6,0,0,0,4,4,0,2,2,0,0,0,0,23,17,6,21,,34,0,34,16,0,16
05/06/2022 01:00,1,0,1,6,3,3,1,1,0,0,0,0,2,2,0,1,1,0,0,0,0,16,14,2,17,,12,0,12,2,0,2
05/06/2022 02:00,1,1,0,3,1,2,2,0,2,0,0,0,0,0,0,1,1,0,0,0,0,11,7,4,16,,17,0,17,8,0,8
05/06/2022 03:00,2,0,2,1,0,1,3,1,2,0,0,0,1,1,0,0,0,0,0,0,0,6,5,1,13,,10,0,10,5,0,5
05/06/2022 04:00,1,1,0,1,0,1,0,0,0,0,0,0,2,2,0,0,0,0,0,0,0,10,3,7,6,,8,0,8,5,1,4
05/06/2022 05:00,4,2,2,0,0,0,3,0,3,0,0,0,1,1,0,0,0,0,0,0,0,7,3,4,4,,4,0,4,4,0,4
05/06/2022 06:00,1,1,0,10,4,6,8,4,4,0,0,0,3,3,0,0,0,0,0,0,0,23,3,20,8,,5,0,5,9,0,9
05/06/2022 07:00,1,1,0,19,11,8,22,8,14,0,0,0,9,9,0,4,4,0,0,0,0,28,9,19,11,,7,0,7,12,0,12
05/06/2022 08:00,5,4,1,34,14,20,34,15,19,0,0,0,10,10,0,3,3,0,0,0,0,40,9,31,10,,14,0,14,20,0,20
05/06/2022 09:00,3,2,1,38,18,20,46,19,27,0,0,0,3,3,0,6,6,0,1,1,0,41,8,33,13,,17,0,17,27,0,27
05/06/2022 10:00,6,3,3,46,24,22,63,32,31,0,0,0,6,6,0,5,5,0,1,1,0,51,16,35,12,,13,0,13,36,0,36
05/06/2022 11:00,5,4,1,44,17,27,38,24,14,0,0,0,10,10,0,7,7,0,2,2,0,68,30,38,19,,39,1,38,43,0,43
05/06/2022 12:00,11,6,5,32,14,18,38,21,17,0,0,0,1,1,0,3,3,0,5,5,0,63,27,36,18,,46,2,44,67,2,65
05/06/2022 13:00,7,4,3,22,16,6,34,23,11,0,0,0,4,4,0,4,4,0,2,2,0,65,28,37,35,,45,0,45,76,0,76
05/06/2022 14:00,11,7,4,21,10,11,32,20,12,0,0,0,3,3,0,3,3,0,2,2,0,65,22,43,43,,58,0,58,67,0,67
05/06/2022 15:00,11,5,6,17,10,7,24,12,12,0,0,0,0,0,0,2,2,0,0,0,0,66,32,34,29,,27,0,27,61,0,61
05/06/2022 16:00,8,5,3,9,4,5,11,5,6,0,0,0,4,4,0,4,4,0,0,0,0,65,30,35,29,,50,0,50,59,0,59
05/06/2022 17:00,5,4,1,11,4,7,16,9,7,0,0,0,3,3,0,3,3,0,0,0,0,84,46,38,40,,57,0,57,50,0,50
05/06/2022 18:00,8,1,7,5,3,2,12,5,7,0,0,0,5,5,0,2,2,0,0,0,0,71,41,30,43,,59,0,59,47,0,47
05/06/2022 19:00,2,1,1,9,4,5,10,6,4,0,0,0,2,2,0,4,4,0,0,0,0,56,34,22,21,,51,0,51,44,1,43
05/06/2022 20:00,2,1,1,8,7,1,10,5,5,0,0,0,2,2,0,1,1,0,1,1,0,45,23,22,27,,53,0,53,48,0,48
05/06/2022 21:00,7,7,0,7,3,4,10,3,7,0,0,0,3,3,0,1,1,0,0,0,0,40,19,21,26,,36,0,36,29,1,28
05/06/2022 22:00,8,3,5,1,1,0,10,9,1,0,0,0,5,5,0,2,2,0,0,0,0,35,20,15,17,,1,0,1,30,2,28
05/06/2022 23:00,4,1,3,3,2,1,9,5,4,0,0,0,1,1,0,2,2,0,0,0,0,27,17,10,13,,1,0,1,22,0,22
06/06/2022 00:00,1,0,1,4,2,2,2,0,2,0,0,0,2,2,0,1,1,0,0,0,0,17,11,6,10,,1,0,1,13,0,13
06/06/2022 01:00,0,0,0,6,5,1,3,1,2,0,0,0,0,0,0,1,1,0,0,0,0,10,6,4,10,,0,0,0,0,0,0
06/06/2022 02:00,0,0,0,0,0,0,1,0,1,0,0,0,0,0,0,0,0,0,0,0,0,2,1,1,6,,11,0,11,6,0,6
06/06/2022 03:00,0,0,0,2,1,1,0,0,0,0,0,0,0,0,0,0,0,0,0,0,0,4,3,1,7,,9,0,9,4,0,4
06/06/2022 04:00,1,0,1,0,0,0,1,1,0,0,0,0,1,1,0,0,0,0,0,0,0,4,2,2,1,,2,0,2,5,1,4
06/06/2022 05:00,2,2,0,1,1,0,3,2,1,0,0,0,2,2,0,2,2,0,0,0,0,8,1,7,6,,1,0,1,1,0,1
06/06/2022 06:00,3,2,1,14,6,8,14,7,7,0,0,0,11,11,0,2,2,0,0,0,0,33,6,27,9,,1,0,1,9,0,9
06/06/2022 07:00,8,3,5,36,16,20,34,14,20,0,0,0,14,13,1,3,3,0,2,2,0,36,8,28,19,,9,0,9,9,0,9
06/06/2022 08:00,7,6,1,75,35,40,71,31,40,0,0,0,16,16,0,0,0,0,0,0,0,51,17,34,15,,14,0,14,17,0,17
06/06/2022 09:00,6,4,2,85,36,49,119,53,66,0,0,0,7,7,0,2,2,0,0,0,0,51,17,34,12,,16,0,16,45,0,45
06/06/2022 10:00,6,4,2,118,46,72,118,44,74,0,0,0,4,4,0,5,5,0,0,0,0,83,23,60,26,,27,1,26,35,0,35
06/06/2022 11:00,15,9,6,154,80,74,174,93,81,0,0,0,5,5,0,10,10,0,0,0,0,82,27,55,39,,49,0,49,73,0,73
06/06/2022 12:00,16,11,5,145,76,69,192,87,105,0,0,0,4,4,0,5,5,0,0,0,0,67,30,37,72,,64,0,64,96,0,96
06/06/2022 13:00,16,9,7,157,74,83,171,78,93,0,0,0,0,0,0,4,4,0,0,0,0,100,39,61,58,,66,1,65,85,0,85
06/06/2022 14:00,10,9,1,158,75,83,182,76,106,0,0,0,6,5,1,2,2,0,0,0,0,96,34,62,54,,64,0,64,101,0,101
06/06/2022 15:00,18,12,6,170,89,81,223,107,116,0,0,0,12,12,0,5,5,0,0,0,0,104,46,58,63,,58,1,57,75,0,75
06/06/2022 16:00,18,15,3,168,99,69,220,104,116,0,0,0,14,14,0,9,9,0,0,0,0,111,58,53,52,,65,0,65,87,1,86
06/06/2022 17:00,25,16,9,173,92,81,229,134,95,0,0,0,11,11,0,7,7,0,0,0,0,144,76,68,71,,94,2,92,91,1,90
06/06/2022 18:00,18,8,10,135,74,61,208,126,82,0,0,0,11,11,0,9,9,0,0,0,0,116,56,60,64,,93,0,93,98,1,97
06/06/2022 19:00,14,6,8,96,48,48,139,78,61,0,0,0,11,11,0,8,8,0,0,0,0,124,66,58,37,,81,0,81,85,0,85
06/06/2022 20:00,13,4,9,59,32,27,101,65,36,0,0,0,13,13,0,4,4,0,0,0,0,102,62,40,56,,79,0,79,80,0,80
06/06/2022 21:00,7,4,3,34,25,9,49,32,17,0,0,0,8,7,1,2,2,0,0,0,0,64,37,27,28,,72,1,71,63,0,63
06/06/2022 22:00,7,5,2,23,16,7,25,16,9,0,0,0,3,3,0,4,4,0,0,0,0,59,40,19,26,,46,0,46,44,0,44
06/06/2022 23:00,3,3,0,11,8,3,5,3,2,0,0,0,3,3,0,1,1,0,0,0,0,25,13,12,31,,21,0,21,24,0,24
07/06/2022 00:00,6,0,6,3,0,3,6,3,3,0,0,0,0,0,0,0,0,0,0,0,0,18,14,4,8,,13,0,13,11,0,11
07/06/2022 01:00,0,0,0,2,2,0,1,1,0,0,0,0,0,0,0,0,0,0,0,0,0,12,8,4,7,,4,0,4,0,0,0
07/06/2022 02:00,1,0,1,0,0,0,1,0,1,0,0,0,2,2,0,0,0,0,0,0,0,5,3,2,4,,6,0,6,1,0,1
07/06/2022 03:00,0,0,0,2,1,1,2,1,1,0,0,0,0,0,0,0,0,0,0,0,0,2,1,1,2,,3,0,3,4,0,4
07/06/2022 04:00,1,1,0,2,2,0,7,4,3,0,0,0,3,3,0,0,0,0,0,0,0,9,2,7,3,,1,0,1,2,0,2
07/06/2022 05:00,2,2,0,14,8,6,18,8,10,0,0,0,11,11,0,1,1,0,0,0,0,31,6,25,7,,2,0,2,3,1,2
07/06/2022 06:00,21,18,3,29,20,9,35,26,9,0,0,0,20,19,1,10,10,0,1,1,0,129,24,105,22,,15,0,15,46,0,46
07/06/2022 07:00,39,38,1,70,52,18,73,58,15,0,0,0,58,58,0,15,15,0,28,28,0,293,73,220,31,,28,1,27,96,0,96
07/06/2022 08:00,103,91,12,110,91,19,144,110,34,0,0,0,62,62,0,22,22,0,19,19,0,503,86,417,46,,57,1,56,172,0,172
07/06/2022 09:00,28,26,2,71,42,29,96,56,40,0,0,0,45,45,0,11,11,0,15,15,0,235,47,188,27,,50,0,50,132,0,132
07/06/2022 10:00,19,15,4,69,29,40,95,40,55,0,0,0,13,13,0,8,8,0,14,14,0,94,28,66,34,,32,0,32,79,1,78
07/06/2022 11:00,15,7,8,98,47,51,106,48,58,0,0,0,7,7,0,12,12,0,14,14,0,110,45,65,38,,51,0,51,70,0,70
07/06/2022 12:00,15,8,7,88,45,43,113,57,56,0,0,0,9,9,0,14,14,0,14,14,0,110,41,69,44,,75,0,75,95,0,95
07/06/2022 13:00,23,15,8,58,31,27,82,47,35,0,0,0,11,11,0,16,16,0,4,4,0,145,72,73,72,,71,1,70,103,1,102
07/06/2022 14:00,16,11,5,55,31,24,72,34,38,0,0,0,14,14,0,12,12,0,7,7,0,116,61,55,75,,67,1,66,68,0,68
07/06/2022 15:00,19,8,11,44,19,25,62,30,32,0,0,0,8,8,0,12,12,0,14,14,0,145,72,73,89,,69,1,68,79,0,79
07/06/2022 16:00,42,18,24,70,30,40,97,42,55,0,0,0,8,8,0,26,26,0,17,17,0,222,145,77,155,,126,0,126,104,0,104
07/06/2022 17:00,63,19,44,113,38,75,148,45,103,0,0,0,5,5,0,28,28,0,36,36,0,362,242,120,314,,246,2,244,118,0,118
07/06/2022 18:00,43,10,33,99,26,73,138,45,93,0,0,0,8,8,0,26,26,0,16,16,0,325,212,113,254,,191,0,191,103,0,103
07/06/2022 19:00,50,21,29,68,26,42,76,36,40,0,0,0,4,4,0,21,21,0,16,16,0,158,93,65,115,,105,0,105,101,0,101
07/06/2022 20:00,12,5,7,26,12,14,32,17,15,0,0,0,11,11,0,9,9,0,12,12,0,111,71,40,60,,85,0,85,68,0,68
07/06/2022 21:00,9,5,4,11,9,2,23,10,13,0,0,0,1,1,0,6,6,0,4,4,0,86,56,30,51,,54,1,53,48,1,47
07/06/2022 22:00,6,3,3,6,1,5,12,5,7,0,0,0,8,8,0,0,0,0,6,6,0,64,48,16,33,,18,0,18,33,0,33
07/06/2022 23:00,2,1,1,2,0,2,3,0,3,0,0,0,1,1,0,2,2,0,0,0,0,18,11,7,20,,0,0,0,12,0,12
08/06/2022 00:00,2,2,0,0,0,0,1,1,0,0,0,0,0,0,0,0,0,0,0,0,0,9,6,3,8,,0,0,0,4,0,4
08/06/2022 01:00,0,0,0,2,2,0,1,1,0,0,0,0,2,2,0,0,0,0,0,0,0,4,4,0,5,,6,0,6,1,0,1
08/06/2022 02:00,0,0,0,1,1,0,1,1,0,0,0,0,0,0,0,1,1,0,0,0,0,8,4,4,3,,6,0,6,2,1,1
08/06/2022 03:00,0,0,0,0,0,0,1,1,0,0,0,0,0,0,0,0,0,0,0,0,0,3,1,2,2,,7,1,6,2,0,2
08/06/2022 04:00,1,0,1,3,3,0,4,2,2,0,0,0,2,2,0,0,0,0,0,0,0,9,3,6,1,,0,0,0,2,0,2
08/06/2022 05:00,4,4,0,12,8,4,10,6,4,0,0,0,6,6,0,1,1,0,2,2,0,36,8,28,6,,2,0,2,8,0,8
08/06/2022 06:00,17,13,4,28,16,12,32,19,13,0,0,0,26,26,0,6,6,0,7,7,0,146,31,115,25,,15,0,15,52,0,52
08/06/2022 07:00,47,42,5,60,45,15,83,56,27,0,0,0,59,59,0,22,22,0,19,19,0,318,69,249,32,,42,1,41,106,1,105
08/06/2022 08:00,108,96,12,86,67,19,112,80,32,0,0,0,88,88,0,34,34,0,43,43,0,585,102,483,47,,73,0,73,215,0,215
08/06/2022 09:00,37,32,5,50,24,26,57,32,25,0,0,0,33,33,0,7,7,0,12,12,0,220,40,180,17,,47,0,47,139,0,139
08/06/2022 10:00,17,8,9,41,20,21,53,19,34,0,0,0,18,18,0,8,8,0,4,4,0,86,31,55,17,,33,0,33,54,0,54
08/06/2022 11:00,13,8,5,42,23,19,53,29,24,0,0,0,7,7,0,5,5,0,9,9,0,96,37,59,26,,52,0,52,59,1,58
08/06/2022 12:00,10,7,3,41,17,24,42,17,25,0,0,0,19,18,1,11,11,0,6,6,0,101,40,61,41,,73,0,73,101,0,101
08/06/2022 13:00,17,9,8,17,12,5,41,17,24,0,0,0,7,7,0,15,15,0,8,8,0,113,46,67,57,,70,0,70,109,0,109
08/06/2022 14:00,10,5,5,21,10,11,26,10,16,0,0,0,8,8,0,9,9,0,7,7,0,108,52,56,56,,84,0,84,69,0,69
08/06/2022 15:00,22,14,8,20,7,13,25,9,16,0,0,0,5,5,0,10,10,0,6,6,0,127,71,56,82,,77,0,77,82,1,81
08/06/2022 16:00,48,19,29,45,13,32,66,18,48,0,0,0,9,9,0,23,23,0,14,14,0,208,119,89,150,,115,0,115,88,0,88
08/06/2022 17:00,55,13,42,79,19,60,128,29,99,0,0,0,10,10,0,28,28,0,22,22,0,379,251,128,277,,224,1,223,123,0,123
08/06/2022 18:00,59,19,40,100,28,72,146,34,112,0,0,0,19,19,0,30,30,0,6,6,0,343,196,147,268,,220,0,220,120,0,120
08/06/2022 19:00,30,15,15,64,24,40,86,34,52,0,0,0,7,6,1,14,14,0,5,5,0,205,112,93,114,,121,1,120,102,0,102
08/06/2022 20:00,21,4,17,65,38,27,87,43,44,0,0,0,14,13,1,10,10,0,9,9,0,165,98,67,57,,103,0,103,99,1,98
08/06/2022 21:00,15,4,11,30,19,11,48,25,23,0,0,0,3,3,0,8,8,0,5,5,0,117,61,56,55,,84,0,84,63,0,63
08/06/2022 22:00,12,3,9,12,4,8,26,9,17,0,0,0,6,6,0,7,7,0,5,5,0,159,118,41,55,,52,0,52,47,1,46
08/06/2022 23:00,8,2,6,4,2,2,7,1,6,0,0,0,4,4,0,4,4,0,0,0,0,51,40,11,37,,30,1,29,26,0,26
09/06/2022 00:00,1,0,1,4,0,4,8,5,3,0,0,0,0,0,0,2,2,0,1,1,0,20,17,3,22,,19,0,19,13,0,13
09/06/2022 01:00,0,0,0,1,1,0,0,0,0,0,0,0,1,1,0,0,0,0,0,0,0,12,10,2,3,,7,0,7,2,0,2
09/06/2022 02:00,1,0,1,2,1,1,3,1,2,0,0,0,0,0,0,1,1,0,0,0,0,3,2,1,4,,6,0,6,2,0,2
09/06/2022 03:00,0,0,0,0,0,0,0,0,0,0,0,0,0,0,0,1,1,0,0,0,0,6,2,4,3,,5,0,5,1,0,1
09/06/2022 04:00,1,1,0,3,3,0,5,3,2,0,0,0,1,1,0,0,0,0,1,1,0,7,0,7,1,,0,0,0,3,0,3
09/06/2022 05:00,1,1,0,9,5,4,13,5,8,0,0,0,7,7,0,1,1,0,1,1,0,39,7,32,5,,5,0,5,4,0,4
09/06/2022 06:00,17,16,1,35,27,8,38,28,10,0,0,0,17,17,0,6,6,0,4,4,0,131,26,105,25,,13,0,13,45,0,45
09/06/2022 07:00,32,28,4,41,35,6,56,47,9,0,0,0,24,24,0,12,12,0,19,19,0,239,50,189,21,,25,0,25,64,0,64
09/06/2022 08:00,72,66,6,37,29,8,65,51,14,0,0,0,59,58,1,14,14,0,21,21,0,382,70,312,20,,42,0,42,149,0,149
09/06/2022 09:00,29,28,1,24,15,9,30,19,11,0,0,0,18,18,0,8,8,0,11,11,0,219,45,174,21,,28,0,28,110,0,110
09/06/2022 10:00,11,9,2,10,5,5,12,7,5,0,0,0,22,22,0,4,4,0,2,2,0,77,27,50,15,,26,1,25,63,0,63
09/06/2022 11:00,5,2,3,18,7,11,16,10,6,0,0,0,9,9,0,3,3,0,5,5,0,67,25,42,14,,36,0,36,63,0,63
09/06/2022 12:00,10,6,4,21,13,8,22,9,13,0,0,0,7,7,0,4,4,0,8,8,0,87,38,49,42,,73,0,73,99,0,99
09/06/2022 13:00,21,8,13,25,12,13,44,22,22,0,0,0,8,8,0,7,7,0,12,12,0,113,43,70,51,,80,1,79,106,0,106
09/06/2022 14:00,15,8,7,33,14,19,49,16,33,0,0,0,5,5,0,10,10,0,6,6,0,126,60,66,54,,76,0,76,78,0,78
09/06/2022 15:00,16,8,8,51,19,32,66,29,37,0,0,0,12,12,0,17,17,0,12,12,0,152,73,79,71,,78,0,78,65,0,65
09/06/2022 16:00,25,13,12,72,32,40,80,33,47,0,0,0,11,11,0,24,24,0,11,11,0,205,118,87,149,,111,0,111,79,0,79
09/06/2022 17:00,57,18,39,99,30,69,139,32,107,0,0,0,16,16,0,31,31,0,25,25,0,316,191,125,217,,195,2,193,113,0,113
09/06/2022 18:00,32,10,22,140,43,97,190,64,126,0,0,0,11,11,0,23,23,0,11,11,0,338,215,123,195,,148,1,147,135,0,135
09/06/2022 19:00,35,18,17,124,57,67,172,74,98,0,0,0,15,15,0,10,10,0,17,17,0,206,105,101,108,,98,1,97,113,1,112
09/06/2022 20:00,23,7,16,104,62,42,140,76,64,0,0,0,13,13,0,11,11,0,8,8,0,165,95,70,72,,76,0,76,92,0,92
09/06/2022 21:00,20,7,13,53,32,21,87,50,37,0,0,0,7,7,0,7,7,0,3,3,0,112,75,37,52,,89,0,89,61,0,61
09/06/2022 22:00,18,8,10,27,16,11,38,23,15,0,0,0,7,7,0,6,6,0,4,4,0,98,73,25,39,,62,0,62,52,2,50
09/06/2022 23:00,4,1,3,6,3,3,11,4,7,0,0,0,6,6,0,1,1,0,0,0,0,58,46,12,52,,37,0,37,39,0,39
10/06/2022 00:00,3,0,3,4,2,2,7,2,5,0,0,0,2,2,0,1,1,0,0,0,0,42,30,12,23,,32,2,30,17,0,17
10/06/2022 01:00,3,0,3,3,2,1,5,2,3,0,0,0,2,2,0,1,1,0,0,0,0,11,10,1,16,,4,0,4,2,0,2
10/06/2022 02:00,0,0,0,2,0,2,0,0,0,0,0,0,1,1,0,0,0,0,0,0,0,8,6,2,5,,8,0,8,5,0,5
10/06/2022 03:00,2,0,2,1,0,1,3,1,2,0,0,0,2,1,1,1,1,0,0,0,0,5,2,3,5,,8,0,8,2,0,2
10/06/2022 04:00,1,1,0,4,3,1,2,2,0,0,0,0,1,1,0,1,1,0,0,0,0,9,2,7,3,,1,0,1,0,0,0
10/06/2022 05:00,3,3,0,10,6,4,12,7,5,0,0,0,4,2,2,0,0,0,1,1,0,35,6,29,8,,2,0,2,7,0,7
10/06/2022 06:00,18,16,2,26,13,13,32,15,17,0,0,0,18,18,0,10,10,0,8,8,0,132,24,108,22,,13,0,13,42,0,42
10/06/2022 07:00,36,32,4,58,36,22,67,41,26,0,0,0,44,44,0,18,18,0,14,14,0,223,55,168,23,,29,0,29,70,1,69
10/06/2022 08:00,72,60,12,59,40,19,99,61,38,0,0,0,53,53,0,30,30,0,38,38,0,370,90,280,32,,53,0,53,149,0,149
10/06/2022 09:00,37,31,6,62,35,27,79,38,41,0,0,0,31,29,2,7,7,0,21,21,0,195,42,153,36,,46,0,46,111,1,110
10/06/2022 10:00,10,8,2,58,28,30,62,27,35,0,0,0,18,18,0,9,9,0,8,8,0,94,32,62,25,,32,0,32,71,0,71
10/06/2022 11:00,10,8,2,39,14,25,64,22,42,0,0,0,14,14,0,8,8,0,10,10,0,108,41,67,36,,56,0,56,77,1,76
10/06/2022 12:00,14,8,6,47,28,19,59,29,30,0,0,0,9,9,0,20,20,0,8,8,0,128,50,78,53,,98,1,97,106,0,106
10/06/2022 13:00,15,10,5,44,25,19,59,28,31,0,0,0,3,3,0,18,18,0,11,11,0,151,68,83,75,,96,2,94,97,0,97
10/06/2022 14:00,17,9,8,37,17,20,44,13,31,0,0,0,3,3,0,11,11,0,4,4,0,149,76,73,81,,62,0,62,62,2,60
10/06/2022 15:00,22,8,14,19,7,12,32,14,18,0,0,0,6,6,0,10,10,0,3,3,0,112,75,37,68,,81,2,79,79,0,79
10/06/2022 16:00,23,9,14,22,6,16,34,3,31,0,0,0,5,5,0,20,20,0,3,3,0,136,110,26,108,,113,0,113,57,0,57
10/06/2022 17:00,41,8,33,54,14,40,76,18,58,0,0,0,4,4,0,23,23,0,10,10,0,218,152,66,157,,166,0,166,113,2,111
10/06/2022 18:00,23,10,13,46,11,35,76,19,57,0,0,0,12,12,0,10,10,0,7,7,0,175,120,55,117,,148,1,147,95,1,94
10/06/2022 19:00,18,9,9,37,17,20,68,18,50,0,0,0,11,11,0,7,7,0,13,13,0,120,94,26,92,,124,1,123,81,0,81
10/06/2022 20:00,13,6,7,32,13,19,54,26,28,0,0,0,7,7,0,8,8,0,6,6,0,98,55,43,55,,100,2,98,80,0,80
10/06/2022 21:00,11,3,8,20,8,12,30,14,16,0,0,0,6,6,0,7,7,0,7,7,0,102,66,36,44,,69,0,69,79,1,78
10/06/2022 22:00,9,6,3,12,7,5,32,18,14,0,0,0,11,10,1,10,10,0,3,3,0,86,41,45,41,,55,1,54,56,0,56
10/06/2022 23:00,1,0,1,3,1,2,21,12,9,0,0,0,2,2,0,5,5,0,2,2,0,52,41,11,33,,43,0,43,38,1,37
11/06/2022 00:00,2,1,1,5,3,2,7,3,4,0,0,0,2,2,0,0,0,0,0,0,0,23,21,2,25,,23,0,23,15,0,15
11/06/2022 01:00,0,0,0,1,1,0,1,1,0,0,0,0,1,1,0,1,1,0,0,0,0,19,15,4,12,,8,0,8,1,0,1
11/06/2022 02:00,0,0,0,1,0,1,5,3,2,0,0,0,2,2,0,1,1,0,0,0,0,13,9,4,14,,13,0,13,4,0,4
11/06/2022 03:00,0,0,0,1,0,1,1,0,1,0,0,0,0,0,0,1,1,0,0,0,0,12,7,5,12,,10,0,10,5,0,5
11/06/2022 04:00,1,1,0,0,0,0,1,0,1,0,0,0,2,2,0,1,1,0,0,0,0,4,2,2,5,,4,0,4,2,0,2
11/06/2022 05:00,0,0,0,2,0,2,6,1,5,0,0,0,2,2,0,1,1,0,0,0,0,9,3,6,5,,3,0,3,4,0,4
11/06/2022 06:00,5,4,1,12,5,7,13,5,8,0,0,0,4,4,0,3,3,0,2,2,0,33,8,25,7,,4,0,4,11,0,11
11/06/2022 07:00,11,9,2,32,17,15,44,16,28,0,0,0,11,11,0,10,10,0,2,2,0,58,18,40,18,,12,0,12,17,0,17
11/06/2022 08:00,13,12,1,45,19,26,53,21,32,0,0,0,15,15,0,2,2,0,11,11,0,71,26,45,14,,22,0,22,38,0,38
11/06/2022 09:00,17,14,3,64,33,31,79,32,47,0,0,0,12,12,0,11,11,0,15,15,0,103,28,75,28,,23,0,23,73,0,73
11/06/2022 10:00,27,17,10,89,38,51,100,33,67,0,0,0,6,6,0,11,11,0,18,18,0,104,28,76,25,,36,0,36,75,0,75
11/06/2022 11:00,19,9,10,89,39,50,136,68,68,0,0,0,5,5,0,10,10,0,18,18,0,82,19,63,41,,52,1,51,70,0,70
11/06/2022 12:00,26,14,12,76,43,33,102,50,52,0,0,0,6,6,0,9,9,0,9,9,0,121,41,80,45,,59,0,59,91,0,91
11/06/2022 13:00,21,8,13,71,36,35,100,44,56,0,0,0,3,3,0,11,11,0,18,18,0,119,59,60,52,,84,0,84,101,0,101
11/06/2022 14:00,21,7,14,74,35,39,87,44,43,0,0,0,15,15,0,11,11,0,14,14,0,149,66,83,57,,78,0,78,115,3,112
11/06/2022 15:00,21,10,11,68,31,37,98,51,47,0,0,0,13,13,0,10,10,0,13,13,0,123,41,82,57,,66,1,65,104,2,102
11/06/2022 16:00,19,10,9,60,33,27,72,39,33,0,0,0,15,15,0,10,10,0,8,8,0,133,56,77,70,,96,0,96,85,0,85
11/06/2022 17:00,18,5,13,60,27,33,76,35,41,0,0,0,12,12,0,10,10,0,12,12,0,105,57,48,60,,91,0,91,84,0,84
11/06/2022 18:00,11,5,6,52,21,31,49,23,26,0,0,0,11,11,0,10,10,0,8,8,0,124,50,74,60,,80,0,80,89,0,89
11/06/2022 19:00,12,7,5,39,23,16,49,28,21,0,0,0,9,9,0,9,9,0,8,8,0,111,66,45,70,,78,3,75,121,2,119
11/06/2022 20:00,21,11,10,21,13,8,23,11,12,0,0,0,5,5,0,3,3,0,9,9,0,99,56,43,51,,75,0,75,74,0,74
11/06/2022 21:00,12,8,4,33,16,17,33,15,18,0,0,0,8,8,0,5,5,0,6,6,0,93,55,38,39,,45,1,44,62,0,62
11/06/2022 22:00,7,3,4,16,10,6,31,17,14,0,0,0,7,7,0,5,5,0,5,5,0,73,41,32,39,,51,0,51,55,0,55
11/06/2022 23:00,5,1,4,5,2,3,15,9,6,0,0,0,6,6,0,2,2,0,4,4,0,47,33,14,31,,29,1,28,35,1,34
12/06/2022 00:00,3,0,3,6,2,4,8,5,3,0,0,0,2,2,0,2,2,0,0,0,0,28,20,8,19,,17,0,17,11,1,10
12/06/2022 01:00,1,0,1,4,4,0,1,1,0,0,0,0,1,1,0,2,2,0,0,0,0,15,11,4,14,,6,1,5,1,0,1
12/06/2022 02:00,1,0,1,4,3,1,7,5,2,0,0,0,1,1,0,0,0,0,0,0,0,18,15,3,8,,18,0,18,4,0,4
12/06/2022 03:00,3,1,2,2,1,1,3,0,3,0,0,0,2,2,0,1,1,0,0,0,0,18,14,4,11,,13,0,13,7,2,5
12/06/2022 04:00,0,0,0,1,0,1,3,0,3,0,0,0,2,2,0,0,0,0,0,0,0,7,2,5,7,,8,0,8,5,0,5
12/06/2022 05:00,4,2,2,7,2,5,12,4,8,0,0,0,2,2,0,0,0,0,0,0,0,8,3,5,5,,7,0,7,3,0,3
12/06/2022 06:00,2,1,1,15,7,8,15,5,10,0,0,0,3,2,1,1,1,0,1,1,0,31,8,23,4,,7,0,7,9,0,9
12/06/2022 07:00,7,7,0,24,11,13,36,12,24,0,0,0,10,10,0,4,4,0,0,0,0,40,13,27,10,,5,0,5,11,0,11
12/06/2022 08:00,10,9,1,79,32,47,91,34,57,0,0,0,11,11,0,3,3,0,1,1,0,59,19,40,19,,15,0,15,19,0,19
12/06/2022 09:00,4,3,1,83,35,48,93,36,57,0,0,0,6,6,0,9,9,0,1,1,0,68,22,46,23,,17,0,17,23,0,23
12/06/2022 10:00,14,10,4,113,50,63,125,60,65,0,0,0,9,9,0,4,4,0,7,7,0,81,19,62,28,,24,0,24,50,0,50
12/06/2022 11:00,4,4,0,117,51,66,156,66,90,0,0,0,2,2,0,18,18,0,11,11,0,113,45,68,28,,20,0,20,81,0,81
12/06/2022 12:00,9,7,2,118,59,59,138,68,70,0,0,0,4,4,0,25,25,0,3,3,0,93,35,58,47,,57,0,57,67,0,67
12/06/2022 13:00,19,11,8,103,56,47,124,65,59,0,0,0,3,3,0,12,12,0,11,11,0,84,41,43,29,,65,1,64,83,0,83
12/06/2022 14:00,13,8,5,88,45,43,94,45,49,0,0,0,3,3,0,6,6,0,6,6,0,111,49,62,45,,64,0,64,106,0,106
12/06/2022 15:00,12,9,3,70,37,33,64,31,33,0,0,0,0,0,0,7,7,0,5,5,0,91,36,55,50,,65,2,63,69,0,69
12/06/2022 16:00,18,9,9,78,44,34,100,53,47,0,0,0,6,6,0,11,11,0,5,5,0,93,38,55,51,,63,0,63,69,1,68
12/06/2022 17:00,7,6,1,53,27,26,66,26,40,0,0,0,21,21,0,10,10,0,12,12,0,106,52,54,45,,96,0,96,103,0,103
12/06/2022 18:00,15,10,5,62,31,31,89,45,44,0,0,0,9,9,0,4,4,0,5,5,0,93,39,54,73,,73,0,73,91,1,90
12/06/2022 19:00,12,7,5,39,21,18,58,22,36,0,0,0,9,9,0,6,6,0,8,8,0,91,49,42,52,,97,1,96,90,0,90
12/06/2022 20:00,9,6,3,41,22,19,52,27,25,0,0,0,12,12,0,4,4,0,3,3,0,68,34,34,40,,72,1,71,90,0,90
12/06/2022 21:00,8,4,4,30,13,17,30,15,15,0,0,0,9,8,1,6,6,0,0,0,0,68,32,36,39,,40,0,40,70,0,70
12/06/2022 22:00,8,4,4,24,13,11,29,17,12,0,0,0,2,2,0,7,7,0,0,0,0,46,29,17,26,,12,0,12,31,0,31
12/06/2022 23:00,5,2,3,4,1,3,36,24,12,0,0,0,3,3,0,2,2,0,0,0,0,17,15,2,29,,0,0,0,17,0,17
13/06/2022 00:00,5,3,2,7,4,3,4,0,4,0,0,0,3,3,0,0,0,0,0,0,0,9,6,3,18,,16,0,16,7,0,7
13/06/2022 01:00,1,0,1,3,2,1,1,1,0,0,0,0,1,1,0,0,0,0,2,2,0,11,7,4,5,,6,0,6,0,0,0
13/06/2022 02:00,1,0,1,0,0,0,4,2,2,0,0,0,1,1,0,0,0,0,0,0,0,5,3,2,6,,6,0,6,1,0,1
13/06/2022 03:00,0,0,0,0,0,0,2,1,1,0,0,0,0,0,0,0,0,0,0,0,0,2,0,2,1,,1,0,1,3,0,3
13/06/2022 04:00,1,1,0,1,1,0,4,2,2,0,0,0,0,0,0,0,0,0,3,3,0,8,1,7,1,,3,0,3,3,0,3
13/06/2022 05:00,3,3,0,6,4,2,9,6,3,0,0,0,4,4,0,2,2,0,1,1,0,35,6,29,4,,1,0,1,5,0,5
13/06/2022 06:00,16,13,3,33,25,8,35,26,9,0,0,0,22,22,0,7,7,0,1,1,0,132,25,107,18,,11,0,11,36,0,36
13/06/2022 07:00,38,35,3,68,47,21,93,65,28,0,0,0,49,49,0,17,17,0,7,7,0,273,77,196,35,,28,0,28,98,0,98
13/06/2022 08:00,88,77,11,87,64,23,103,81,22,0,0,0,88,88,0,30,30,0,1,1,0,483,93,390,40,,53,0,53,190,1,189
13/06/2022 09:00,32,26,6,61,34,27,68,38,30,0,0,0,41,41,0,15,15,0,5,5,0,228,43,185,26,,40,0,40,116,0,116
13/06/2022 10:00,21,15,6,45,21,24,73,22,51,0,0,0,11,10,1,10,10,0,10,10,0,81,21,60,29,,36,0,36,53,0,53
13/06/2022 11:00,14,12,2,72,32,40,91,50,41,0,0,0,13,13,0,14,14,0,6,6,0,74,31,43,30,,45,1,44,70,1,69
13/06/2022 12:00,8,5,3,64,32,32,90,48,42,0,0,0,5,4,1,7,7,0,12,12,0,90,46,44,41,,63,0,63,85,1,84
13/06/2022 13:00,15,6,9,50,27,23,62,30,32,0,0,0,8,8,0,9,9,0,12,12,0,113,50,63,50,,79,2,77,102,1,101
13/06/2022 14:00,28,16,12,43,20,23,57,23,34,0,0,0,8,8,0,8,8,0,13,13,0,116,58,58,76,,69,0,69,63,0,63
13/06/2022 15:00,20,12,8,66,28,38,87,30,57,0,0,0,1,1,0,20,20,0,14,14,0,148,84,64,102,,73,1,72,82,0,82
13/06/2022 16:00,32,16,16,79,30,49,82,27,55,0,0,0,8,8,0,30,30,0,17,17,0,236,146,90,165,,118,1,117,83,0,83
13/06/2022 17:00,60,13,47,105,29,76,146,35,111,0,0,0,8,8,0,23,23,0,33,33,0,353,208,145,270,,219,0,219,116,0,116
13/06/2022 18:00,38,9,29,127,42,85,152,49,103,0,0,0,21,21,0,23,23,0,17,17,0,298,196,102,225,,207,2,205,125,0,125
13/06/2022 19:00,37,20,17,99,42,57,112,46,66,0,0,0,8,8,0,21,21,0,8,8,0,185,106,79,59,,114,1,113,108,0,108
13/06/2022 20:00,17,7,10,51,25,26,82,43,39,0,0,0,7,7,0,11,11,0,10,10,0,116,68,48,31,,9,0,9,71,1,70
13/06/2022 21:00,6,4,2,28,11,17,34,16,18,0,0,0,3,2,1,10,10,0,3,3,0,84,55,29,30,,0,0,0,51,0,51
13/06/2022 22:00,6,1,5,17,9,8,16,8,8,0,0,0,1,1,0,3,3,0,3,3,0,66,44,22,12,,37,0,37,40,0,40
13/06/2022 23:00,3,0,3,6,3,3,9,4,5,0,0,0,1,1,0,1,1,0,0,0,0,22,17,5,14,,22,0,22,20,0,20
14/06/2022 00:00,1,0,1,1,0,1,0,0,0,0,0,0,3,3,0,2,2,0,1,1,0,11,8,3,1,,12,0,12,6,0,6
14/06/2022 01:00,1,0,1,1,1,0,0,0,0,0,0,0,0,0,0,0,0,0,0,0,0,4,1,3,9,,0,0,0,1,0,1
14/06/2022 02:00,1,1,0,2,0,2,5,2,3,0,0,0,1,1,0,0,0,0,0,0,0,4,3,1,6,,9,0,9,1,0,1
14/06/2022 03:00,1,1,0,0,0,0,1,0,1,0,0,0,0,0,0,1,1,0,0,0,0,2,0,2,1,,0,0,0,2,0,2
14/06/2022 04:00,1,1,0,2,2,0,4,2,2,0,0,0,3,3,0,0,0,0,1,1,0,6,0,6,1,,0,0,0,3,0,3
14/06/2022 05:00,2,2,0,11,5,6,19,9,10,0,0,0,6,6,0,2,2,0,0,0,0,35,6,29,2,,2,0,2,5,0,5
14/06/2022 06:00,16,12,4,42,31,11,37,26,11,0,0,0,28,28,0,11,11,0,1,1,0,141,26,115,22,,8,0,8,43,0,43
14/06/2022 07:00,58,53,5,83,61,22,96,73,23,0,0,0,42,42,0,22,22,0,17,17,0,347,84,263,36,,33,0,33,98,0,98
14/06/2022 08:00,108,98,10,118,95,23,142,112,30,0,0,0,80,80,0,32,32,0,40,40,0,619,111,508,41,,80,1,79,230,2,228
14/06/2022 09:00,35,30,5,55,33,22,77,45,32,0,0,0,42,41,1,13,13,0,9,9,0,267,53,214,29,,42,0,42,151,2,149
14/06/2022 10:00,16,13,3,54,26,28,71,26,45,0,0,0,23,23,0,6,6,0,14,14,0,98,30,68,27,,28,1,27,59,0,59
14/06/2022 11:00,15,8,7,54,26,28,87,42,45,0,0,0,14,14,0,11,11,0,8,8,0,87,22,65,33,,47,0,47,68,0,68
14/06/2022 12:00,13,7,6,69,34,35,88,41,47,0,0,0,5,5,0,16,16,0,17,17,0,122,43,79,52,,54,0,54,107,0,107
14/06/2022 13:00,19,9,10,73,36,37,89,44,45,0,0,0,8,8,0,16,16,0,13,13,0,161,78,83,65,,86,0,86,95,3,92
14/06/2022 14:00,15,9,6,65,29,36,75,34,41,0,0,0,8,8,0,23,23,0,19,19,0,145,76,69,69,,80,0,80,77,0,77
14/06/2022 15:00,26,9,17,58,26,32,66,33,33,0,0,0,4,4,0,13,13,0,11,11,0,153,80,73,113,,65,1,64,78,0,78
14/06/2022 16:00,30,14,16,75,29,46,89,32,57,0,0,0,15,15,0,23,23,0,17,17,0,259,153,106,187,,147,1,146,73,1,72
14/06/2022 17:00,63,15,48,131,49,82,172,65,107,0,0,0,7,7,0,35,35,0,27,27,0,386,250,136,296,,244,3,241,150,2,148
14/06/2022 18:00,54,17,37,154,50,104,177,49,128,0,0,0,17,17,0,34,34,0,4,4,0,371,240,131,233,,252,1,251,122,1,121
14/06/2022 19:00,43,18,25,122,50,72,133,58,75,0,0,0,11,11,0,21,21,0,0,0,0,218,120,98,117,,148,0,148,122,2,120
14/06/2022 20:00,18,4,14,73,38,35,102,49,53,0,0,0,6,6,0,16,16,0,2,2,0,148,97,51,86,,109,0,109,82,0,82
14/06/2022 21:00,12,7,5,38,23,15,58,37,21,0,0,0,9,9,0,14,14,0,1,1,0,113,79,34,45,,87,0,87,58,0,58
14/06/2022 22:00,8,3,5,14,6,8,24,8,16,0,0,0,4,4,0,4,4,0,1,1,0,84,59,25,51,,17,0,17,38,0,38
14/06/2022 23:00,5,0,5,13,4,9,20,14,6,0,0,0,5,4,1,3,3,0,0,0,0,42,34,8,28,,4,0,4,36,0,36
15/06/2022 00:00,3,0,3,2,1,1,9,5,4,0,0,0,4,4,0,1,1,0,0,0,0,21,19,2,16,,16,1,15,22,0,22
15/06/2022 01:00,0,0,0,1,0,1,0,0,0,0,0,0,1,1,0,1,1,0,0,0,0,5,4,1,2,,6,0,6,1,0,1
15/06/2022 02:00,0,0,0,1,1,0,4,1,3,0,0,0,0,0,0,1,1,0,0,0,0,5,3,2,7,,9,0,9,4,0,4
15/06/2022 03:00,0,0,0,2,1,1,1,0,1,0,0,0,0,0,0,1,1,0,0,0,0,4,2,2,4,,5,0,5,0,0,0
15/06/2022 04:00,1,1,0,2,1,1,2,0,2,0,0,0,1,1,0,0,0,0,1,1,0,5,0,5,2,,0,0,0,1,0,1
15/06/2022 05:00,2,2,0,7,5,2,10,6,4,0,0,0,8,8,0,2,2,0,0,0,0,40,10,30,4,,1,0,1,6,0,6
15/06/2022 06:00,20,16,4,50,30,20,51,30,21,0,0,0,33,33,0,10,10,0,0,0,0,144,26,118,23,,14,0,14,44,0,44
15/06/2022 07:00,49,47,2,103,74,29,119,87,32,0,0,0,52,52,0,22,22,0,10,10,0,328,91,237,32,,40,0,40,105,0,105
15/06/2022 08:00,128,117,11,126,106,20,166,136,30,0,0,0,103,103,0,34,34,0,47,47,0,605,110,495,43,,74,0,74,214,0,214
15/06/2022 09:00,37,30,7,71,48,23,84,52,32,0,0,0,43,43,0,14,14,0,24,24,0,269,50,219,27,,42,0,42,158,0,158
15/06/2022 10:00,18,11,7,63,24,39,70,29,41,0,0,0,27,27,0,11,11,0,8,8,0,82,35,47,29,,33,0,33,80,0,80
15/06/2022 11:00,15,12,3,70,40,30,84,42,42,0,0,0,11,11,0,14,14,0,9,9,0,105,26,79,34,,49,0,49,59,1,58
15/06/2022 12:00,19,11,8,87,46,41,99,49,50,0,0,0,16,16,0,13,13,0,17,17,0,120,42,78,46,,62,0,62,104,0,104
15/06/2022 13:00,26,18,8,60,30,30,97,46,51,0,0,0,9,9,0,31,31,0,11,11,0,153,69,84,65,,91,0,91,103,0,103
15/06/2022 14:00,26,11,15,51,22,29,95,43,52,0,0,0,6,6,0,21,21,0,4,4,0,129,62,67,76,,104,1,103,103,0,103
15/06/2022 15:00,29,14,15,68,26,42,83,31,52,0,0,0,7,7,0,19,19,0,3,3,0,152,95,57,87,,73,1,72,76,0,76
15/06/2022 16:00,35,15,20,89,38,51,114,54,60,0,0,0,9,9,0,21,21,0,7,7,0,256,144,112,199,,140,1,139,72,0,72
15/06/2022 17:00,65,12,53,129,39,90,158,39,119,0,0,0,16,16,0,37,37,0,23,23,0,412,259,153,310,,270,2,268,142,0,142
15/06/2022 18:00,59,14,45,161,54,107,212,68,144,0,0,0,21,20,1,21,21,0,9,9,0,395,247,148,249,,205,1,204,146,1,145
15/06/2022 19:00,37,14,23,124,58,66,151,64,87,0,0,0,12,12,0,14,14,0,1,1,0,250,129,121,120,,139,1,138,124,0,124
15/06/2022 20:00,22,6,16,94,47,47,115,61,54,0,0,0,16,15,1,9,9,0,0,0,0,157,93,64,86,,103,1,102,107,0,107
15/06/2022 21:00,14,5,9,50,30,20,76,42,34,0,0,0,13,13,0,11,11,0,0,0,0,105,59,46,52,,87,0,87,79,0,79
15/06/2022 22:00,16,3,13,29,14,15,32,16,16,0,0,0,7,7,0,4,4,0,0,0,0,119,75,44,68,,60,1,59,44,1,43
15/06/2022 23:00,4,2,2,13,8,5,28,18,10,0,0,0,4,4,0,5,5,0,0,0,0,48,33,15,39,,52,0,52,31,0,31
16/06/2022 00:00,2,1,1,17,7,10,14,6,8,0,0,0,1,1,0,0,0,0,0,0,0,27,22,5,24,,25,1,24,17,0,17
16/06/2022 01:00,0,0,0,1,0,1,2,0,2,0,0,0,1,1,0,0,0,0,0,0,0,12,9,3,10,,0,0,0,0,0,0
16/06/2022 02:00,0,0,0,2,0,2,3,2,1,0,0,0,0,0,0,0,0,0,0,0,0,9,6,3,6,,8,1,7,5,0,5
16/06/2022 03:00,0,0,0,1,1,0,2,2,0,0,0,0,0,0,0,0,0,0,0,0,0,3,2,1,3,,3,0,3,0,0,0
16/06/2022 04:00,0,0,0,3,3,0,4,4,0,0,0,0,1,1,0,0,0,0,0,0,0,5,0,5,3,,0,0,0,2,0,2
16/06/2022 05:00,5,5,0,6,2,4,11,6,5,0,0,0,8,8,0,1,1,0,0,0,0,36,7,29,4,,2,0,2,7,0,7
16/06/2022 06:00,21,19,2,47,31,16,41,28,13,0,0,0,22,21,1,5,5,0,0,0,0,131,27,104,19,,12,0,12,41,0,41
16/06/2022 07:00,49,40,9,81,54,27,100,74,26,0,0,0,38,37,1,23,23,0,6,6,0,298,65,233,44,,35,2,33,100,0,100
16/06/2022 08:00,101,93,8,125,96,29,160,125,35,0,0,0,61,61,0,35,35,0,32,32,0,606,96,510,53,,59,0,59,204,1,203
16/06/2022 09:00,41,30,11,57,38,19,80,49,31,0,0,0,52,52,0,7,7,0,17,17,0,270,47,223,23,,50,0,50,143,0,143
16/06/2022 10:00,23,14,9,51,29,22,64,32,32,0,0,0,18,18,0,7,7,0,12,12,0,118,31,87,23,,16,0,16,83,1,82
16/06/2022 11:00,14,11,3,77,39,38,76,40,36,0,0,0,14,14,0,6,6,0,8,8,0,110,37,73,38,,0,0,0,73,0,73
16/06/2022 12:00,19,8,11,58,25,33,87,40,47,0,0,0,12,12,0,14,14,0,10,10,0,116,49,67,54,,56,0,56,116,1,115
16/06/2022 13:00,30,18,12,51,23,28,92,38,54,0,0,0,19,18,1,21,21,0,5,5,0,161,62,99,67,,105,2,103,124,1,123
16/06/2022 14:00,22,10,12,67,31,36,96,39,57,0,0,0,15,15,0,18,18,0,0,0,0,143,76,67,91,,87,1,86,92,2,90
16/06/2022 15:00,23,15,8,48,18,30,83,33,50,0,0,0,8,8,0,17,17,0,0,0,0,149,78,71,91,,83,1,82,76,0,76
16/06/2022 16:00,34,14,20,83,34,49,106,41,65,0,0,0,20,20,0,23,23,0,0,0,0,257,148,109,183,,131,1,130,105,0,105
16/06/2022 17:00,74,20,54,148,46,102,195,65,130,0,0,0,17,17,0,30,30,0,0,0,0,464,302,162,266,,204,0,204,140,1,139
16/06/2022 18:00,56,17,39,167,64,103,210,75,135,0,0,0,9,9,0,33,33,0,0,0,0,374,216,158,214,,208,1,207,163,1,162
16/06/2022 19:00,31,15,16,130,57,73,152,73,79,0,0,0,14,14,0,14,14,0,1,1,0,214,115,99,117,,116,0,116,138,0,138
16/06/2022 20:00,15,6,9,96,51,45,133,66,67,0,0,0,12,12,0,15,15,0,8,8,0,162,84,78,94,,118,3,115,122,2,120
16/06/2022 21:00,11,4,7,53,30,23,63,32,31,0,0,0,8,8,0,17,17,0,4,4,0,132,80,52,70,,107,1,106,77,0,77
16/06/2022 22:00,11,2,9,20,12,8,33,18,15,0,0,0,2,2,0,8,8,0,0,0,0,122,95,27,73,,79,0,79,56,0,56
16/06/2022 23:00,6,2,4,9,3,6,17,7,10,0,0,0,7,7,0,2,2,0,1,1,0,61,45,16,39,,40,0,40,33,1,32
17/06/2022 00:00,1,0,1,2,0,2,5,0,5,0,0,0,4,3,1,2,2,0,0,0,0,43,35,8,28,,38,0,38,20,0,20
17/06/2022 01:00,1,0,1,0,0,0,4,2,2,0,0,0,1,1,0,3,3,0,0,0,0,16,12,4,22,,3,0,3,1,0,1
17/06/2022 02:00,1,0,1,1,1,0,5,2,3,0,0,0,0,0,0,0,0,0,0,0,0,12,8,4,5,,12,0,12,3,0,3
17/06/2022 03:00,3,1,2,0,0,0,1,0,1,0,0,0,2,2,0,0,0,0,0,0,0,7,4,3,5,,5,0,5,1,0,1
17/06/2022 04:00,1,0,1,4,4,0,3,2,1,0,0,0,5,5,0,0,0,0,0,0,0,9,5,4,5,,2,0,2,2,1,1
17/06/2022 05:00,2,1,1,6,4,2,10,6,4,0,0,0,4,4,0,0,0,0,1,1,0,34,6,28,4,,1,0,1,8,0,8
17/06/2022 06:00,21,18,3,34,22,12,36,20,16,0,0,0,22,20,2,7,7,0,0,0,0,137,29,108,27,,14,0,14,44,0,44
17/06/2022 07:00,27,22,5,58,36,22,62,45,17,0,0,0,54,54,0,14,14,0,0,0,0,243,73,170,33,,35,0,35,75,0,75
17/06/2022 08:00,62,52,10,83,64,19,92,70,22,0,0,0,63,63,0,23,23,0,9,9,0,391,76,315,41,,55,1,54,116,0,116
17/06/2022 09:00,24,21,3,45,27,18,48,28,20,0,0,0,35,34,1,12,12,0,10,10,0,207,46,161,22,,52,1,51,139,0,139
17/06/2022 10:00,18,16,2,59,29,30,68,29,39,0,0,0,19,19,0,7,7,0,10,10,0,106,31,75,22,,35,0,35,83,0,83
17/06/2022 11:00,5,4,1,55,26,29,66,31,35,0,0,0,17,17,0,18,18,0,0,0,0,106,31,75,28,,47,2,45,74,0,74
17/06/2022 12:00,12,7,5,70,39,31,91,44,47,0,0,0,13,13,0,8,8,0,0,0,0,110,43,67,42,,88,1,87,124,0,124
17/06/2022 13:00,26,15,11,53,24,29,88,38,50,0,0,0,8,8,0,16,16,0,1,1,0,144,61,83,70,,111,0,111,117,1,116
17/06/2022 14:00,27,12,15,48,18,30,79,31,48,0,0,0,9,9,0,14,14,0,1,1,0,140,72,68,82,,89,0,89,80,0,80
17/06/2022 15:00,29,12,17,54,20,34,96,44,52,0,0,0,5,5,0,13,13,0,4,4,0,159,82,77,100,,79,0,79,102,0,102
17/06/2022 16:00,31,13,18,83,35,48,114,59,55,0,0,0,6,6,0,23,23,0,7,7,0,203,119,84,137,,132,2,130,104,0,104
17/06/2022 17:00,45,11,34,69,20,49,107,28,79,0,0,0,13,13,0,25,25,0,17,17,0,305,196,109,166,,187,1,186,117,0,117
17/06/2022 18:00,18,6,12,71,31,40,90,33,57,0,0,0,27,27,0,22,22,0,8,8,0,226,132,94,148,,158,3,155,153,1,152
17/06/2022 19:00,21,8,13,63,26,37,72,34,38,0,0,0,14,13,1,10,10,0,6,6,0,150,82,68,92,,127,1,126,135,2,133
17/06/2022 20:00,25,14,11,47,23,24,68,30,38,0,0,0,11,11,0,9,9,0,1,1,0,119,63,56,65,,86,0,86,115,0,115
17/06/2022 21:00,9,4,5,31,15,16,48,23,25,0,0,0,14,14,0,5,5,0,0,0,0,112,59,53,59,,76,0,76,79,0,79
17/06/2022 22:00,7,4,3,17,7,10,27,11,16,0,0,0,7,7,0,3,3,0,1,1,0,75,51,24,56,,67,1,66,72,1,71
17/06/2022 23:00,4,2,2,9,4,5,19,6,13,0,0,0,4,4,0,5,5,0,0,0,0,59,46,13,38,,35,0,35,30,0,30
18/06/2022 00:00,1,1,0,1,0,1,5,3,2,0,0,0,4,4,0,3,3,0,0,0,0,31,20,11,34,,40,0,40,16,0,16
18/06/2022 01:00,4,2,2,8,5,3,1,1,0,0,0,0,2,2,0,2,2,0,0,0,0,28,21,7,26,,14,0,14,0,0,0
18/06/2022 02:00,2,1,1,4,1,3,6,2,4,0,0,0,0,0,0,1,1,0,0,0,0,13,12,1,13,,31,0,31,10,1,9
18/06/2022 03:00,2,1,1,0,0,0,1,0,1,0,0,0,1,1,0,1,1,0,0,0,0,12,8,4,11,,9,0,9,6,0,6
18/06/2022 04:00,0,0,0,1,1,0,3,2,1,0,0,0,3,3,0,0,0,0,0,0,0,9,6,3,4,,6,0,6,4,0,4
18/06/2022 05:00,0,0,0,5,4,1,5,2,3,0,0,0,3,3,0,3,3,0,0,0,0,16,5,11,2,,1,0,1,5,0,5
18/06/2022 06:00,5,3,2,17,7,10,17,5,12,0,0,0,6,6,0,4,4,0,0,0,0,50,10,40,9,,8,0,8,13,0,13
18/06/2022 07:00,6,4,2,44,24,20,45,23,22,0,0,0,6,6,0,5,5,0,1,1,0,59,17,42,20,,18,0,18,18,0,18
18/06/2022 08:00,4,3,1,76,32,44,85,36,49,0,0,0,12,12,0,2,2,0,1,1,0,68,14,54,13,,23,0,23,40,0,40
18/06/2022 09:00,21,20,1,104,53,51,136,59,77,0,0,0,19,19,0,14,14,0,1,1,0,96,23,73,28,,23,0,23,64,0,64
18/06/2022 10:00,17,9,8,116,48,68,131,59,72,0,0,0,14,14,0,13,13,0,5,5,0,103,47,56,30,,28,0,28,82,0,82
18/06/2022 11:00,13,5,8,99,52,47,142,64,78,0,0,0,3,3,0,16,16,0,10,10,0,128,41,87,48,,45,0,45,92,0,92
18/06/2022 12:00,18,9,9,129,63,66,153,68,85,0,0,0,3,3,0,8,8,0,9,9,0,139,47,92,57,,66,0,66,109,0,109
18/06/2022 13:00,10,6,4,106,52,54,136,60,76,0,0,0,13,13,0,9,9,0,15,15,0,118,57,61,81,,99,0,99,109,0,109
18/06/2022 14:00,22,11,11,80,40,40,134,60,74,0,0,0,10,10,0,13,13,0,11,11,0,112,49,63,41,,82,0,82,133,0,133
18/06/2022 15:00,16,11,5,99,55,44,133,70,63,0,0,0,17,16,1,6,6,0,8,8,0,135,53,82,62,,101,0,101,139,0,139
18/06/2022 16:00,17,12,5,88,44,44,121,73,48,0,0,0,5,5,0,15,15,0,0,0,0,131,60,71,55,,110,1,109,106,1,105
18/06/2022 17:00,20,12,8,68,43,25,87,40,47,0,0,0,10,9,1,8,8,0,2,2,0,131,62,69,60,,78,0,78,94,0,94
18/06/2022 18:00,13,7,6,68,34,34,93,52,41,0,0,0,18,18,0,7,7,0,0,0,0,125,59,66,61,,93,2,91,100,0,100
18/06/2022 19:00,12,4,8,33,17,16,48,22,26,0,0,0,8,8,0,11,11,0,0,0,0,106,38,68,56,,93,1,92,109,0,109
18/06/2022 20:00,9,4,5,36,22,14,55,28,27,0,0,0,10,10,0,5,5,0,0,0,0,80,40,40,43,,91,0,91,90,1,89
18/06/2022 21:00,14,10,4,28,18,10,35,21,14,0,0,0,8,8,0,7,7,0,0,0,0,72,37,35,33,,51,2,49,85,0,85
18/06/2022 22:00,9,4,5,16,9,7,24,14,10,0,0,0,3,3,0,3,3,0,0,0,0,55,30,25,45,,48,0,48,48,0,48
18/06/2022 23:00,9,4,5,8,6,2,8,3,5,0,0,0,2,2,0,3,3,0,0,0,0,48,32,16,25,,50,1,49,35,0,35
19/06/2022 00:00,2,0,2,5,3,2,11,5,6,0,0,0,2,2,0,1,1,0,0,0,0,31,15,16,27,,35,0,35,24,1,23
19/06/2022 01:00,2,1,1,4,1,3,1,0,1,0,0,0,2,2,0,2,2,0,0,0,0,25,24,1,17,,18,1,17,1,0,1
19/06/2022 02:00,1,1,0,3,2,1,2,0,2,0,0,0,2,2,0,1,1,0,0,0,0,23,13,10,9,,15,1,14,10,0,10
19/06/2022 03:00,0,0,0,1,1,0,2,0,2,0,0,0,1,1,0,1,1,0,0,0,0,17,12,5,10,,9,0,9,2,0,2
19/06/2022 04:00,2,0,2,2,2,0,0,0,0,0,0,0,1,1,0,0,0,0,0,0,0,12,5,7,5,,5,1,4,3,0,3
19/06/2022 05:00,1,1,0,5,2,3,6,2,4,0,0,0,1,1,0,0,0,0,0,0,0,9,4,5,7,,2,0,2,3,0,3
19/06/2022 06:00,0,0,0,20,8,12,18,6,12,0,0,0,4,4,0,1,1,0,0,0,0,33,9,24,6,,4,0,4,13,0,13
19/06/2022 07:00,9,8,1,39,17,22,42,16,26,0,0,0,12,12,0,3,3,0,0,0,0,34,14,20,19,,13,0,13,14,0,14
19/06/2022 08:00,8,6,2,98,42,56,106,35,71,0,0,0,9,9,0,4,4,0,0,0,0,53,17,36,15,,14,0,14,14,0,14
19/06/2022 09:00,10,8,2,114,46,68,132,53,79,0,0,0,13,13,0,9,9,0,0,0,0,54,8,46,23,,9,0,9,42,0,42
19/06/2022 10:00,10,7,3,130,63,67,160,66,94,0,0,0,12,12,0,6,6,0,0,0,0,75,21,54,21,,23,0,23,59,0,59
19/06/2022 11:00,7,4,3,174,90,84,203,104,99,0,0,0,8,8,0,5,5,0,1,1,0,91,25,66,32,,43,0,43,55,0,55
19/06/2022 12:00,12,5,7,110,54,56,130,67,63,0,0,0,7,7,0,3,3,0,5,5,0,109,46,63,42,,62,0,62,82,0,82
19/06/2022 13:00,10,8,2,107,53,54,145,63,82,0,0,0,8,8,0,12,12,0,0,0,0,136,54,82,52,,81,0,81,106,1,105
19/06/2022 14:00,26,16,10,91,51,40,135,69,66,0,0,0,14,14,0,12,12,0,2,2,0,110,45,65,52,,70,0,70,105,2,103
19/06/2022 15:00,18,10,8,92,53,39,132,68,64,0,0,0,11,11,0,17,17,0,2,2,0,118,46,72,57,,79,0,79,98,0,98
19/06/2022 16:00,20,19,1,81,37,44,112,51,61,0,0,0,10,10,0,9,9,0,1,1,0,128,49,79,47,,79,0,79,96,0,96
19/06/2022 17:00,15,7,8,76,44,32,126,75,51,0,0,0,10,10,0,6,6,0,1,1,0,98,44,54,61,,94,0,94,96,0,96
19/06/2022 18:00,9,3,6,57,34,23,96,52,44,0,0,0,10,9,1,9,9,0,0,0,0,118,74,44,68,,84,0,84,95,1,94
19/06/2022 19:00,10,3,7,37,20,17,52,32,20,0,0,0,15,14,1,10,10,0,0,0,0,114,59,55,47,,103,0,103,86,2,84
19/06/2022 20:00,10,6,4,30,14,16,48,23,25,0,0,0,17,17,0,4,4,0,0,0,0,84,44,40,51,,60,1,59,78,0,78
19/06/2022 21:00,9,3,6,28,13,15,55,28,27,0,0,0,6,6,0,2,2,0,0,0,0,97,50,47,36,,63,0,63,75,0,75
19/06/2022 22:00,6,3,3,14,7,7,28,14,14,0,0,0,3,3,0,5,5,0,0,0,0,51,34,17,35,,0,0,0,47,0,47
19/06/2022 23:00,4,0,4,5,4,1,9,5,4,0,0,0,2,2,0,4,4,0,0,0,0,32,24,8,24,,1,0,1,24,1,23
20/06/2022 00:00,2,1,1,3,2,1,3,1,2,0,0,0,2,2,0,1,1,0,0,0,0,13,11,2,18,,1,0,1,12,0,12
20/06/2022 01:00,2,2,0,2,1,1,0,0,0,0,0,0,1,1,0,0,0,0,0,0,0,6,5,1,9,,3,0,3,0,0,0
20/06/2022 02:00,0,0,0,0,0,0,0,0,0,0,0,0,1,1,0,1,1,0,0,0,0,7,5,2,6,,5,0,5,0,0,0
20/06/2022 03:00,1,0,1,0,0,0,2,1,1,0,0,0,0,0,0,0,0,0,0,0,0,6,1,5,2,,4,0,4,2,0,2
20/06/2022 04:00,0,0,0,4,1,3,9,4,5,0,0,0,2,2,0,0,0,0,0,0,0,4,1,3,3,,2,0,2,4,0,4
20/06/2022 05:00,5,3,2,10,7,3,14,10,4,0,0,0,6,6,0,1,1,0,0,0,0,35,3,32,5,,7,0,7,7,2,5
20/06/2022 06:00,20,16,4,39,25,14,36,22,14,0,0,0,18,18,0,9,9,0,0,0,0,141,26,115,20,,14,0,14,43,0,43
20/06/2022 07:00,36,34,2,66,48,18,80,56,24,0,0,0,38,38,0,19,19,0,11,11,0,255,62,193,27,,37,0,37,83,0,83
20/06/2022 08:00,77,68,9,101,79,22,140,114,26,0,0,0,70,70,0,36,36,0,28,28,0,474,94,380,41,,52,0,52,183,0,183
20/06/2022 09:00,36,31,5,66,40,26,85,51,34,0,0,0,51,51,0,9,9,0,7,7,0,212,46,166,30,,48,0,48,133,1,132
20/06/2022 10:00,4,3,1,69,31,38,93,42,51,0,0,0,9,9,0,13,13,0,5,5,0,86,26,60,17,,29,0,29,56,0,56
20/06/2022 11:00,11,8,3,83,39,44,98,43,55,0,0,0,13,12,1,12,12,0,12,12,0,116,37,79,28,,42,0,42,68,0,68
20/06/2022 12:00,14,9,5,100,37,63,127,52,75,0,0,0,4,4,0,8,8,0,16,16,0,133,52,81,47,,63,0,63,76,2,74
20/06/2022 13:00,19,12,7,113,50,63,134,50,84,0,0,0,7,7,0,18,18,0,18,18,0,144,62,82,89,,87,1,86,85,0,85
20/06/2022 14:00,13,6,7,90,48,42,121,53,68,0,0,0,12,12,0,20,20,0,19,19,0,128,60,68,83,,77,1,76,86,0,86
20/06/2022 15:00,16,9,7,101,56,45,133,58,75,0,0,0,9,9,0,15,15,0,12,12,0,169,83,86,92,,78,1,77,87,0,87
20/06/2022 16:00,43,23,20,118,54,64,180,80,100,0,0,0,9,9,0,25,25,0,19,19,0,227,131,96,193,,130,0,130,102,0,102
20/06/2022 17:00,58,19,39,188,57,131,296,96,200,0,0,0,21,20,1,31,31,0,28,28,0,437,260,177,286,,246,1,245,123,1,122
20/06/2022 18:00,54,15,39,199,78,121,360,117,243,0,0,0,21,21,0,28,28,0,3,3,0,343,203,140,266,,187,1,186,138,0,138
20/06/2022 19:00,20,10,10,197,90,107,307,140,167,0,0,0,15,15,0,34,34,0,5,5,0,252,143,109,136,,113,0,113,102,1,101
20/06/2022 20:00,32,16,16,135,80,55,216,131,85,0,0,0,13,13,0,22,22,0,3,3,0,161,98,63,86,,49,1,48,75,0,75
20/06/2022 21:00,14,5,9,67,45,22,108,63,45,0,0,0,10,10,0,20,20,0,0,0,0,130,80,50,58,,0,0,0,60,0,60
20/06/2022 22:00,7,2,5,20,11,9,40,21,19,0,0,0,5,5,0,11,11,0,1,1,0,86,63,23,40,,38,0,38,39,1,38
20/06/2022 23:00,5,2,3,4,3,1,5,1,4,0,0,0,3,3,0,3,3,0,0,0,0,39,34,5,25,,30,0,30,25,0,25
21/06/2022 00:00,1,1,0,4,2,2,4,1,3,0,0,0,3,3,0,4,4,0,0,0,0,20,16,4,17,,23,0,23,20,1,19
21/06/2022 01:00,0,0,0,1,1,0,0,0,0,0,0,0,1,1,0,1,1,0,0,0,0,4,3,1,9,,1,0,1,0,0,0
21/06/2022 02:00,1,0,1,0,0,0,2,0,2,0,0,0,2,2,0,1,1,0,0,0,0,7,4,3,5,,7,0,7,3,0,3
21/06/2022 03:00,2,1,1,2,1,1,0,0,0,0,0,0,0,0,0,0,0,0,0,0,0,2,0,2,4,,1,0,1,2,0,2
21/06/2022 04:00,0,0,0,5,3,2,11,5,6,0,0,0,1,1,0,0,0,0,0,0,0,6,1,5,1,,0,0,0,1,0,1
21/06/2022 05:00,3,3,0,8,7,1,14,8,6,0,0,0,6,5,1,2,2,0,0,0,0,39,10,29,4,,3,0,3,9,0,9
21/06/2022 06:00,19,16,3,38,25,13,46,32,14,0,0,0,23,23,0,10,10,0,0,0,0,142,19,123,22,,12,0,12,50,0,50
21/06/2022 07:00,37,36,1,82,63,19,93,70,23,0,0,0,48,48,0,20,20,0,20,20,0,356,69,287,38,,37,0,37,94,0,94
21/06/2022 08:00,113,99,14,106,91,15,154,132,22,0,0,0,75,75,0,31,31,0,28,28,0,630,110,520,45,,74,1,73,197,0,197
21/06/2022 09:00,41,38,3,68,44,24,87,51,36,0,0,0,26,25,1,19,19,0,5,5,0,265,43,222,38,,45,0,45,174,0,174
21/06/2022 10:00,16,13,3,61,31,30,65,39,26,0,0,0,20,20,0,6,6,0,5,5,0,92,26,66,25,,34,0,34,75,0,75
21/06/2022 11:00,10,5,5,55,30,25,53,28,25,0,0,0,5,5,0,11,11,0,4,4,0,104,45,59,29,,52,1,51,60,1,59
21/06/2022 12:00,11,5,6,77,34,43,84,36,48,0,0,0,4,4,0,8,8,0,5,5,0,85,35,50,40,,66,0,66,73,1,72
21/06/2022 13:00,26,15,11,67,33,34,69,29,40,0,0,0,6,6,0,17,17,0,4,4,0,138,62,76,77,,98,1,97,108,0,108
21/06/2022 14:00,19,10,9,48,22,26,66,29,37,0,0,0,9,9,0,15,15,0,7,7,0,97,57,40,79,,67,0,67,64,0,64
21/06/2022 15:00,27,8,19,51,19,32,63,13,50,0,0,0,6,6,0,14,14,0,11,11,0,153,76,77,97,,56,0,56,81,0,81
21/06/2022 16:00,37,17,20,83,36,47,98,32,66,0,0,0,20,20,0,23,23,0,24,24,0,252,168,84,169,,142,0,142,88,1,87
21/06/2022 17:00,81,23,58,134,38,96,182,47,135,0,0,0,8,8,0,28,28,0,33,33,0,414,277,137,354,,250,2,248,122,0,122
21/06/2022 18:00,56,16,40,182,57,125,245,83,162,0,0,0,11,11,0,33,33,0,16,16,0,338,217,121,305,,205,2,203,133,0,133
21/06/2022 19:00,32,12,20,130,57,73,168,80,88,0,0,0,5,5,0,17,17,0,6,6,0,224,132,92,113,,117,0,117,102,0,102
21/06/2022 20:00,31,18,13,74,35,39,116,60,56,0,0,0,9,9,0,13,13,0,3,3,0,161,94,67,75,,80,0,80,85,0,85
21/06/2022 21:00,17,2,15,51,31,20,72,43,29,0,0,0,15,15,0,6,6,0,2,2,0,106,64,42,53,,85,0,85,71,2,69
21/06/2022 22:00,9,3,6,11,7,4,21,10,11,0,0,0,6,6,0,2,2,0,1,1,0,92,62,30,54,,13,0,13,37,0,37
21/06/2022 23:00,5,1,4,14,6,8,22,12,10,0,0,0,5,5,0,2,2,0,0,0,0,42,32,10,27,,0,0,0,25,0,25
22/06/2022 00:00,2,0,2,1,0,1,4,0,4,0,0,0,2,2,0,3,3,0,0,0,0,24,18,6,18,,6,0,6,14,0,14
22/06/2022 01:00,3,0,3,1,1,0,5,2,3,0,0,0,2,2,0,0,0,0,0,0,0,11,7,4,7,,1,0,1,1,0,1
22/06/2022 02:00,0,0,0,1,0,1,1,0,1,0,0,0,0,0,0,1,1,0,0,0,0,6,4,2,3,,2,0,2,4,0,4
22/06/2022 03:00,0,0,0,0,0,0,0,0,0,0,0,0,0,0,0,0,0,0,0,0,0,4,2,2,3,,0,0,0,3,0,3
22/06/2022 04:00,2,1,1,3,3,0,6,4,2,0,0,0,0,0,0,0,0,0,1,1,0,2,0,2,1,,1,0,1,2,0,2
22/06/2022 05:00,6,5,1,16,10,6,16,7,9,0,0,0,7,7,0,2,2,0,3,3,0,39,9,30,6,,1,0,1,15,0,15
22/06/2022 06:00,22,19,3,56,34,22,58,36,22,0,0,0,23,22,1,7,7,0,0,0,0,136,22,114,24,,14,0,14,57,0,57
22/06/2022 07:00,44,38,6,76,55,21,87,69,18,0,0,0,50,50,0,18,18,0,19,19,0,335,76,259,37,,40,1,39,105,0,105
22/06/2022 08:00,104,97,7,111,92,19,161,127,34,0,0,0,98,98,0,34,34,0,20,20,0,552,101,451,54,,61,0,61,201,0,201
22/06/2022 09:00,33,29,4,58,28,30,74,39,35,0,0,0,30,30,0,14,14,0,11,11,0,235,53,182,31,,47,1,46,158,0,158
22/06/2022 10:00,22,16,6,37,21,16,39,21,18,0,0,0,16,16,0,8,8,0,2,2,0,99,26,73,28,,29,2,27,87,0,87
22/06/2022 11:00,17,13,4,53,25,28,46,18,28,0,0,0,11,11,0,9,9,0,3,3,0,98,34,64,27,,27,0,27,61,0,61
22/06/2022 12:00,19,12,7,71,33,38,80,32,48,0,0,0,5,5,0,9,9,0,6,6,0,115,40,75,36,,70,0,70,79,1,78
22/06/2022 13:00,18,8,10,59,30,29,78,37,41,0,0,0,7,7,0,14,14,0,10,10,0,144,69,75,65,,101,1,100,98,0,98
22/06/2022 14:00,16,9,7,46,24,22,64,34,30,0,0,0,5,5,0,9,9,0,13,13,0,131,64,67,78,,98,0,98,90,0,90
22/06/2022 15:00,26,12,14,60,26,34,65,26,39,0,0,0,13,13,0,14,14,0,22,22,0,133,71,62,90,,72,1,71,69,1,68
22/06/2022 16:00,38,15,23,65,33,32,92,42,50,0,0,0,7,7,0,23,23,0,23,23,0,218,127,91,183,,127,0,127,81,1,80
22/06/2022 17:00,56,14,42,110,32,78,166,49,117,0,0,0,5,5,0,31,31,0,32,32,0,408,257,151,315,,248,0,248,103,0,103
22/06/2022 18:00,50,14,36,151,42,109,201,66,135,0,0,0,9,9,0,22,22,0,27,27,0,435,275,160,245,,222,0,222,152,0,152
22/06/2022 19:00,40,15,25,112,51,61,147,66,81,0,0,0,11,11,0,21,21,0,11,11,0,219,128,91,130,,136,0,136,139,0,139
22/06/2022 20:00,20,7,13,99,43,56,165,84,81,0,0,0,16,16,0,15,15,0,11,11,0,145,74,71,82,,105,0,105,104,0,104
22/06/2022 21:00,11,4,7,56,31,25,79,45,34,0,0,0,8,8,0,12,12,0,2,2,0,121,73,48,68,,87,1,86,71,0,71
22/06/2022 22:00,14,10,4,20,11,9,46,18,28,0,0,0,5,5,0,7,7,0,2,2,0,110,78,32,52,,60,0,60,54,0,54
22/06/2022 23:00,6,0,6,8,2,6,28,11,17,0,0,0,6,6,0,10,10,0,0,0,0,64,46,18,44,,39,0,39,30,0,30
23/06/2022 00:00,2,1,1,6,1,5,13,3,10,0,0,0,2,2,0,2,2,0,0,0,0,37,31,6,22,,25,1,24,19,0,19
23/06/2022 01:00,1,1,0,3,2,1,3,1,2,0,0,0,1,1,0,1,1,0,0,0,0,18,15,3,11,,8,0,8,1,0,1
23/06/2022 02:00,1,0,1,1,0,1,1,0,1,0,0,0,1,1,0,0,0,0,0,0,0,6,3,3,5,,13,0,13,2,0,2
23/06/2022 03:00,0,0,0,0,0,0,0,0,0,0,0,0,0,0,0,0,0,0,0,0,0,9,5,4,7,,6,0,6,3,0,3
23/06/2022 04:00,0,0,0,1,1,0,3,2,1,0,0,0,1,1,0,1,1,0,0,0,0,5,1,4,3,,1,0,1,4,0,4
23/06/2022 05:00,3,3,0,13,8,5,18,11,7,0,0,0,6,6,0,3,3,0,2,2,0,39,5,34,3,,8,0,8,12,0,12
23/06/2022 06:00,25,24,1,45,26,19,50,27,23,0,0,0,23,23,0,7,7,0,10,10,0,133,26,107,26,,11,0,11,51,0,51
23/06/2022 07:00,42,36,6,97,67,30,99,62,37,0,0,0,61,61,0,17,17,0,20,20,0,284,56,228,35,,47,1,46,88,0,88
23/06/2022 08:00,98,89,9,83,70,13,136,104,32,0,0,0,73,73,0,33,33,0,23,23,0,561,103,458,9,,66,1,65,225,4,221
23/06/2022 09:00,36,33,3,85,54,31,100,61,39,0,0,0,42,41,1,10,10,0,1,1,0,257,50,207,34,,38,0,38,152,0,152
23/06/2022 10:00,20,12,8,66,33,33,84,42,42,0,0,0,19,19,0,7,7,0,1,1,0,99,23,76,31,,34,1,33,68,0,68
23/06/2022 11:00,16,11,5,86,35,51,91,38,53,0,0,0,13,13,0,8,8,0,9,9,0,110,38,72,24,,42,0,42,81,0,81
23/06/2022 12:00,11,3,8,93,42,51,101,45,56,0,0,0,11,11,0,10,10,0,13,13,0,117,46,71,54,,74,1,73,84,1,83
23/06/2022 13:00,31,18,13,109,55,54,128,51,77,0,0,0,8,8,0,17,17,0,22,22,0,157,67,90,73,,120,1,119,113,0,113
23/06/2022 14:00,20,12,8,73,32,41,90,50,40,0,0,0,7,7,0,13,13,0,8,8,0,138,66,72,61,,96,1,95,93,0,93
23/06/2022 15:00,37,16,21,62,36,26,69,31,38,0,0,0,9,9,0,20,20,0,14,14,0,143,76,67,97,,82,0,82,86,1,85
23/06/2022 16:00,29,14,15,105,47,58,128,51,77,0,0,0,12,12,0,26,26,0,20,20,0,231,127,104,185,,97,0,97,85,0,85
23/06/2022 17:00,67,20,47,150,55,95,188,62,126,0,0,0,6,6,0,24,24,0,26,26,0,398,251,147,314,,205,0,205,152,0,152
23/06/2022 18:00,66,20,46,194,63,131,256,80,176,0,0,0,18,18,0,19,19,0,9,9,0,371,228,143,248,,207,0,207,163,1,162
23/06/2022 19:00,33,16,17,139,60,79,183,77,106,0,0,0,13,13,0,22,22,0,4,4,0,222,123,99,152,,154,1,153,124,0,124
23/06/2022 20:00,25,7,18,107,55,52,195,95,100,0,0,0,17,17,0,12,12,0,1,1,0,172,93,79,89,,92,0,92,107,1,106
23/06/2022 21:00,12,3,9,73,43,30,111,65,46,0,0,0,9,9,0,12,12,0,2,2,0,166,106,60,73,,80,2,78,84,0,84
23/06/2022 22:00,16,5,11,36,21,15,68,31,37,0,0,0,7,7,0,9,9,0,1,1,0,110,84,26,62,,79,0,79,57,0,57
23/06/2022 23:00,6,3,3,12,5,7,21,5,16,0,0,0,8,7,1,4,4,0,0,0,0,57,42,15,36,,45,0,45,40,2,38
24/06/2022 00:00,3,0,3,5,3,2,10,3,7,0,0,0,0,0,0,3,3,0,0,0,0,36,25,11,26,,32,1,31,14,0,14
24/06/2022 01:00,1,0,1,2,1,1,2,1,1,0,0,0,2,2,0,2,2,0,0,0,0,17,13,4,11,,7,0,7,2,0,2
24/06/2022 02:00,3,0,3,1,0,1,1,0,1,0,0,0,1,1,0,0,0,0,0,0,0,8,5,3,12,,9,1,8,4,0,4
24/06/2022 03:00,0,0,0,0,0,0,0,0,0,0,0,0,1,1,0,0,0,0,0,0,0,7,5,2,0,,7,0,7,6,0,6
24/06/2022 04:00,0,0,0,5,3,2,9,5,4,0,0,0,4,4,0,1,1,0,1,1,0,11,5,6,6,,1,0,1,3,0,3
24/06/2022 05:00,2,1,1,17,13,4,17,10,7,0,0,0,4,4,0,2,2,0,2,2,0,37,6,31,2,,3,0,3,8,0,8
24/06/2022 06:00,15,14,1,39,20,19,41,19,22,0,0,0,26,26,0,12,12,0,2,2,0,130,26,104,21,,13,0,13,46,1,45
24/06/2022 07:00,36,33,3,59,39,20,70,43,27,0,0,0,62,62,0,13,13,0,9,9,0,220,61,159,36,,38,0,38,83,0,83
24/06/2022 08:00,67,60,7,83,59,24,121,85,36,0,0,0,34,34,0,18,18,0,28,28,0,364,87,277,32,,46,0,46,138,1,137
24/06/2022 09:00,39,35,4,52,26,26,76,37,39,0,0,0,34,34,0,5,5,0,12,12,0,227,47,180,29,,44,2,42,117,0,117
24/06/2022 10:00,9,4,5,58,32,26,91,41,50,0,0,0,19,19,0,14,14,0,5,5,0,102,25,77,24,,37,0,37,77,0,77
24/06/2022 11:00,14,7,7,44,20,24,66,33,33,0,0,0,15,15,0,11,11,0,6,6,0,98,29,69,30,,54,0,54,73,2,71
24/06/2022 12:00,11,6,5,47,23,24,54,22,32,0,0,0,11,11,0,8,8,0,5,5,0,135,71,64,42,,85,1,84,108,0,108
24/06/2022 13:00,18,13,5,46,22,24,63,29,34,0,0,0,5,5,0,10,10,0,3,3,0,165,83,82,93,,85,0,85,113,1,112
24/06/2022 14:00,24,15,9,28,13,15,41,19,22,0,0,0,9,9,0,11,11,0,3,3,0,169,75,94,76,,74,2,72,92,0,92
24/06/2022 15:00,28,12,16,33,13,20,51,21,30,0,0,0,2,2,0,12,12,0,5,5,0,147,75,72,88,,98,0,98,107,0,107
24/06/2022 16:00,36,16,20,41,10,31,59,24,35,0,0,0,5,5,0,11,11,0,0,0,0,220,128,92,111,,128,4,124,70,0,70
24/06/2022 17:00,37,10,27,54,18,36,71,23,48,0,0,0,5,5,0,18,18,0,0,0,0,256,146,110,185,,161,0,161,135,0,135
24/06/2022 18:00,27,10,17,50,16,34,62,13,49,0,0,0,24,24,0,14,14,0,0,0,0,238,130,108,133,,154,1,153,130,0,130
24/06/2022 19:00,13,9,4,26,12,14,41,17,24,0,0,0,16,16,0,9,9,0,5,5,0,165,89,76,81,,104,0,104,108,0,108
24/06/2022 20:00,16,8,8,10,5,5,18,7,11,0,0,0,16,16,0,4,4,0,7,7,0,121,65,56,53,,87,0,87,129,1,128
24/06/2022 21:00,11,5,6,11,6,5,29,12,17,0,0,0,6,6,0,8,8,0,7,7,0,105,58,47,52,,86,1,85,86,2,84
24/06/2022 22:00,16,12,4,9,2,7,17,6,11,0,0,0,9,9,0,4,4,0,2,2,0,90,55,35,49,,44,0,44,60,0,60
24/06/2022 23:00,7,4,3,9,4,5,16,4,12,0,0,0,13,13,0,1,1,0,0,0,0,97,45,52,37,,41,1,40,40,2,38
25/06/2022 00:00,4,3,1,2,0,2,11,2,9,0,0,0,3,3,0,2,2,0,0,0,0,48,34,14,34,,28,0,28,17,0,17
25/06/2022 01:00,4,2,2,1,1,0,1,1,0,0,0,0,1,1,0,2,2,0,0,0,0,32,25,7,17,,15,0,15,1,0,1
25/06/2022 02:00,0,0,0,1,0,1,1,0,1,0,0,0,4,4,0,1,1,0,0,0,0,26,18,8,18,,21,0,21,9,0,9
25/06/2022 03:00,1,1,0,4,2,2,2,1,1,0,0,0,1,1,0,0,0,0,0,0,0,23,20,3,12,,13,0,13,4,0,4
25/06/2022 04:00,0,0,0,0,0,0,3,1,2,0,0,0,0,0,0,0,0,0,0,0,0,8,3,5,9,,4,0,4,1,0,1
25/06/2022 05:00,1,0,1,4,4,0,4,2,2,0,0,0,2,2,0,1,1,0,0,0,0,15,6,9,0,,4,0,4,6,2,4
25/06/2022 06:00,5,4,1,12,5,7,16,5,11,0,0,0,6,6,0,5,5,0,0,0,0,42,7,35,10,,4,0,4,12,0,12
25/06/2022 07:00,7,5,2,27,15,12,29,12,17,0,0,0,9,9,0,6,6,0,0,0,0,59,13,46,15,,9,0,9,25,0,25
25/06/2022 08:00,10,10,0,38,19,19,57,22,35,0,0,0,14,13,1,2,2,0,0,0,0,89,36,53,15,,22,1,21,31,0,31
25/06/2022 09:00,13,11,2,79,44,35,114,44,70,0,0,0,14,14,0,7,7,0,0,0,0,98,25,73,29,,26,0,26,85,0,85
25/06/2022 10:00,14,11,3,84,38,46,145,49,96,0,0,0,11,11,0,9,9,0,0,0,0,124,47,77,43,,24,0,24,83,0,83
25/06/2022 11:00,17,11,6,90,43,47,138,65,73,0,0,0,4,4,0,17,17,0,1,1,0,134,43,91,45,,73,1,72,106,0,106
25/06/2022 12:00,18,10,8,87,43,44,121,59,62,0,0,0,8,8,0,13,13,0,0,0,0,141,39,102,50,,59,1,58,127,0,127
25/06/2022 13:00,28,13,15,81,51,30,107,52,55,0,0,0,12,11,1,16,16,0,0,0,0,157,59,98,62,,95,1,94,110,2,108
25/06/2022 14:00,18,10,8,67,36,31,76,35,41,0,0,0,11,11,0,7,7,0,0,0,0,139,46,93,71,,59,0,59,98,0,98
25/06/2022 15:00,17,6,11,54,27,27,70,37,33,0,0,0,5,5,0,10,10,0,0,0,0,133,60,73,51,,77,1,76,94,1,93
25/06/2022 16:00,17,10,7,46,33,13,53,29,24,0,0,0,8,8,0,9,9,0,0,0,0,110,46,64,54,,84,0,84,72,1,71
25/06/2022 17:00,19,9,10,45,27,18,53,30,23,0,0,0,7,7,0,7,7,0,0,0,0,123,67,56,56,,78,0,78,78,2,76
25/06/2022 18:00,8,4,4,23,13,10,35,18,17,0,0,0,7,7,0,7,7,0,0,0,0,119,54,65,54,,76,0,76,85,0,85
25/06/2022 19:00,17,9,8,16,8,8,30,16,14,0,0,0,13,13,0,5,5,0,0,0,0,99,55,44,57,,73,1,72,74,0,74
25/06/2022 20:00,7,4,3,14,9,5,26,12,14,0,0,0,19,18,1,6,6,0,0,0,0,87,52,35,47,,60,1,59,68,0,68
25/06/2022 21:00,5,5,0,12,10,2,21,12,9,0,0,0,9,9,0,3,3,0,0,0,0,64,32,32,32,,45,2,43,45,0,45
25/06/2022 22:00,8,6,2,5,3,2,9,5,4,0,0,0,5,5,0,4,4,0,0,0,0,57,33,24,32,,32,1,31,44,0,44
25/06/2022 23:00,4,3,1,5,0,5,6,0,6,0,0,0,7,7,0,5,5,0,0,0,0,34,21,13,22,,36,0,36,22,1,21
26/06/2022 00:00,5,2,3,0,0,0,3,1,2,0,0,0,3,3,0,3,3,0,0,0,0,28,18,10,25,,26,0,26,18,0,18
26/06/2022 01:00,1,0,1,5,4,1,2,0,2,0,0,0,0,0,0,3,3,0,0,0,0,24,20,4,23,,8,0,8,0,0,0
26/06/2022 02:00,1,0,1,2,1,1,3,1,2,0,0,0,0,0,0,0,0,0,0,0,0,14,14,0,15,,21,0,21,3,0,3
26/06/2022 03:00,0,0,0,2,1,1,3,1,2,0,0,0,1,1,0,1,1,0,0,0,0,13,10,3,9,,15,0,15,7,0,7
26/06/2022 04:00,0,0,0,0,0,0,0,0,0,0,0,0,1,1,0,0,0,0,0,0,0,10,6,4,2,,9,0,9,3,0,3
26/06/2022 05:00,2,2,0,2,1,1,2,1,1,0,0,0,2,2,0,0,0,0,0,0,0,3,1,2,2,,4,0,4,1,0,1
26/06/2022 06:00,2,1,1,4,0,4,4,0,4,0,0,0,0,0,0,1,1,0,0,0,0,18,5,13,7,,5,0,5,6,0,6
26/06/2022 07:00,4,1,3,8,6,2,19,8,11,0,0,0,7,7,0,3,3,0,0,0,0,27,11,16,16,,10,0,10,8,0,8
26/06/2022 08:00,3,3,0,31,18,13,34,14,20,0,0,0,11,10,1,7,7,0,0,0,0,42,12,30,10,,16,0,16,12,0,12
26/06/2022 09:00,5,5,0,50,16,34,66,20,46,0,0,0,12,12,0,6,6,0,2,2,0,50,17,33,18,,9,0,9,36,0,36
26/06/2022 10:00,8,5,3,61,26,35,96,39,57,0,0,0,15,15,0,6,6,0,4,4,0,59,24,35,18,,14,0,14,42,0,42
26/06/2022 11:00,9,7,2,73,42,31,98,41,57,0,0,0,6,6,0,15,15,0,5,5,0,84,17,67,22,,33,0,33,57,3,54
26/06/2022 12:00,14,8,6,76,30,46,120,50,70,0,0,0,0,0,0,7,7,0,19,19,0,106,34,72,32,,61,0,61,88,0,88
26/06/2022 13:00,18,7,11,61,28,33,104,45,59,0,0,0,2,2,0,9,9,0,8,8,0,98,37,61,54,,58,0,58,74,0,74
26/06/2022 14:00,14,9,5,62,32,30,88,39,49,0,0,0,8,8,0,11,11,0,8,8,0,123,59,64,62,,57,0,57,78,0,78
26/06/2022 15:00,12,4,8,53,26,27,70,37,33,0,0,0,0,0,0,7,7,0,1,1,0,100,46,54,34,,55,1,54,69,1,68
26/06/2022 16:00,14,5,9,36,23,13,45,24,21,0,0,0,3,3,0,3,3,0,1,1,0,77,38,39,42,,62,2,60,52,0,52
26/06/2022 17:00,15,5,10,10,5,5,14,9,5,0,0,0,12,12,0,9,9,0,0,0,0,79,43,36,45,,49,0,49,44,1,43
26/06/2022 18:00,18,14,4,19,9,10,21,11,10,0,0,0,9,9,0,8,8,0,1,1,0,91,45,46,37,,62,0,62,64,1,63
26/06/2022 19:00,21,11,10,29,16,13,41,18,23,0,0,0,7,6,1,8,8,0,6,6,0,97,49,48,58,,58,0,58,73,1,72
26/06/2022 20:00,15,12,3,26,13,13,40,22,18,0,0,0,13,13,0,7,7,0,0,0,0,76,35,41,24,,48,1,47,55,0,55
26/06/2022 21:00,7,2,5,18,9,9,35,15,20,0,0,0,5,5,0,4,4,0,2,2,0,62,31,31,25,,38,1,37,47,0,47
26/06/2022 22:00,7,2,5,9,6,3,16,6,10,0,0,0,3,3,0,2,2,0,0,0,0,58,40,18,30,,5,0,5,42,0,42
26/06/2022 23:00,8,4,4,0,0,0,3,1,2,0,0,0,0,0,0,2,2,0,0,0,0,29,21,8,17,,7,0,7,23,1,22
27/06/2022 00:00,2,0,2,2,1,1,5,1,4,0,0,0,2,2,0,1,1,0,0,0,0,16,11,5,20,,12,0,12,11,1,10
27/06/2022 01:00,1,1,0,2,2,0,2,2,0,0,0,0,0,0,0,0,0,0,1,1,0,5,4,1,5,,3,0,3,0,0,0
27/06/2022 02:00,1,1,0,0,0,0,0,0,0,0,0,0,0,0,0,0,0,0,1,1,0,6,3,3,3,,3,0,3,1,0,1
27/06/2022 03:00,1,0,1,0,0,0,0,0,0,0,0,0,0,0,0,0,0,0,0,0,0,6,2,4,1,,2,0,2,0,0,0
27/06/2022 04:00,1,1,0,3,2,1,1,1,0,0,0,0,2,2,0,0,0,0,1,1,0,8,3,5,2,,1,0,1,2,0,2
27/06/2022 05:00,3,3,0,5,3,2,7,4,3,0,0,0,9,9,0,2,2,0,2,2,0,33,6,27,2,,3,0,3,10,0,10
27/06/2022 06:00,19,17,2,26,12,14,27,15,12,0,0,0,25,25,0,6,6,0,3,3,0,131,26,105,14,,18,0,18,43,0,43
27/06/2022 07:00,40,37,3,54,38,16,66,46,20,0,0,0,43,43,0,14,14,0,11,11,0,258,55,203,28,,37,0,37,90,0,90
27/06/2022 08:00,88,76,12,94,69,25,113,80,33,0,0,0,65,65,0,24,24,0,1,1,0,424,86,338,27,,54,0,54,172,1,171
27/06/2022 09:00,36,32,4,60,31,29,64,39,25,0,0,0,30,30,0,13,13,0,6,6,0,214,41,173,30,,39,0,39,120,0,120
27/06/2022 10:00,15,9,6,66,36,30,74,32,42,0,0,0,14,14,0,10,10,0,8,8,0,80,19,61,15,,34,0,34,61,1,60
27/06/2022 11:00,10,6,4,55,24,31,72,31,41,0,0,0,9,9,0,10,10,0,8,8,0,86,26,60,29,,44,0,44,72,0,72
27/06/2022 12:00,13,9,4,47,28,19,68,33,35,0,0,0,13,13,0,6,6,0,1,1,0,116,57,59,41,,73,0,73,96,1,95
27/06/2022 13:00,9,6,3,51,21,30,85,34,51,0,0,0,6,6,0,11,11,0,0,0,0,126,49,77,57,,98,0,98,85,0,85
27/06/2022 14:00,20,12,8,53,23,30,56,21,35,0,0,0,2,2,0,14,14,0,0,0,0,135,68,67,63,,72,0,72,95,0,95
27/06/2022 15:00,15,8,7,61,31,30,75,30,45,0,0,0,4,4,0,12,12,0,0,0,0,144,77,67,90,,69,0,69,78,2,76
27/06/2022 16:00,32,16,16,60,26,34,85,28,57,0,0,0,5,5,0,26,26,0,0,0,0,220,124,96,147,,129,3,126,77,0,77
27/06/2022 17:00,64,20,44,105,35,70,138,47,91,0,0,0,11,11,0,23,23,0,0,0,0,377,245,132,258,,196,1,195,130,0,130
27/06/2022 18:00,53,22,31,89,32,57,130,37,93,0,0,0,10,10,0,28,28,0,1,1,0,297,190,107,220,,179,1,178,119,0,119
27/06/2022 19:00,35,7,28,78,39,39,97,41,56,0,0,0,15,15,0,16,16,0,0,0,0,171,100,71,110,,122,1,121,123,1,122
27/06/2022 20:00,16,7,9,50,27,23,52,23,29,0,0,0,6,6,0,19,19,0,0,0,0,122,61,61,52,,106,1,105,85,0,85
27/06/2022 21:00,14,4,10,23,13,10,33,14,19,0,0,0,4,4,0,3,3,0,0,0,0,98,60,38,27,,77,1,76,52,0,52
27/06/2022 22:00,9,1,8,11,7,4,21,7,14,0,0,0,1,1,0,2,2,0,0,0,0,65,47,18,38,,47,2,45,46,2,44
27/06/2022 23:00,2,0,2,6,2,4,11,5,6,0,0,0,5,5,0,1,1,0,0,0,0,36,22,14,26,,38,0,38,19,0,19
28/06/2022 00:00,1,0,1,0,0,0,3,1,2,0,0,0,3,3,0,2,2,0,0,0,0,17,12,5,24,,21,0,21,9,0,9
28/06/2022 01:00,2,1,1,2,1,1,1,1,0,0,0,0,2,2,0,0,0,0,0,0,0,2,1,1,6,,6,0,6,0,0,0
28/06/2022 02:00,0,0,0,0,0,0,0,0,0,0,0,0,0,0,0,0,0,0,0,0,0,5,2,3,2,,5,0,5,2,0,2
28/06/2022 03:00,1,0,1,0,0,0,0,0,0,0,0,0,0,0,0,0,0,0,0,0,0,5,2,3,4,,1,0,1,2,0,2
28/06/2022 04:00,1,1,0,3,2,1,2,0,2,0,0,0,2,2,0,0,0,0,0,0,0,2,0,2,2,,0,0,0,1,0,1
28/06/2022 05:00,3,3,0,4,3,1,8,4,4,0,0,0,4,4,0,2,2,0,0,0,0,36,7,29,3,,3,0,3,7,0,7
28/06/2022 06:00,13,10,3,11,7,4,16,10,6,0,0,0,16,16,0,3,3,0,0,0,0,128,25,103,15,,15,1,14,47,1,46
28/06/2022 07:00,38,36,2,36,31,5,43,35,8,0,0,0,35,35,0,10,10,0,0,0,0,276,62,214,27,,22,1,21,77,0,77
28/06/2022 08:00,79,75,4,42,34,8,50,35,15,0,0,0,49,49,0,22,22,0,15,15,0,405,83,322,32,,47,0,47,145,2,143
28/06/2022 09:00,27,19,8,15,10,5,23,17,6,0,0,0,11,11,0,8,8,0,11,11,0,173,40,133,14,,27,0,27,108,0,108
28/06/2022 10:00,18,12,6,7,5,2,14,5,9,0,0,0,6,6,0,5,5,0,5,5,0,81,20,61,19,,16,0,16,54,0,54
28/06/2022 11:00,9,7,2,13,6,7,14,7,7,0,0,0,8,7,1,3,3,0,1,1,0,71,17,54,18,,24,0,24,57,0,57
28/06/2022 12:00,11,8,3,17,7,10,15,8,7,0,0,0,5,5,0,3,3,0,0,0,0,92,37,55,18,,31,0,31,57,0,57
28/06/2022 13:00,24,15,9,16,6,10,37,13,24,0,0,0,13,13,0,9,9,0,3,3,0,115,51,64,41,,80,1,79,72,0,72
28/06/2022 14:00,14,8,6,20,6,14,31,10,21,0,0,0,4,4,0,11,11,0,5,5,0,103,51,52,66,,66,0,66,83,1,82
28/06/2022 15:00,21,12,9,29,6,23,51,22,29,0,0,0,2,2,0,10,10,0,11,11,0,125,65,60,74,,56,0,56,73,0,73
28/06/2022 16:00,21,9,12,52,17,35,58,16,42,0,0,0,9,9,0,20,20,0,14,14,0,183,105,78,126,,95,2,93,78,0,78
28/06/2022 17:00,52,12,40,70,28,42,108,26,82,0,0,0,15,15,0,16,16,0,15,15,0,359,241,118,275,,201,0,201,116,0,116
28/06/2022 18:00,46,11,35,93,39,54,137,51,86,0,0,0,15,15,0,27,27,0,0,0,0,306,198,108,184,,177,0,177,125,0,125
28/06/2022 19:00,29,12,17,94,41,53,126,46,80,0,0,0,9,9,0,12,12,0,0,0,0,213,112,101,97,,123,1,122,112,1,111
28/06/2022 20:00,12,3,9,69,35,34,104,41,63,0,0,0,7,7,0,15,15,0,2,2,0,133,71,62,69,,112,1,111,76,0,76
28/06/2022 21:00,17,6,11,38,18,20,62,30,32,0,0,0,15,15,0,10,10,0,2,2,0,85,55,30,59,,69,0,69,50,0,50
28/06/2022 22:00,8,3,5,12,7,5,25,12,13,0,0,0,2,2,0,4,4,0,0,0,0,89,66,23,41,,11,0,11,29,0,29
28/06/2022 23:00,6,3,3,10,5,5,12,6,6,0,0,0,5,5,0,3,3,0,1,1,0,52,34,18,41,,0,0,0,24,0,24
29/06/2022 00:00,3,1,2,5,3,2,5,1,4,0,0,0,3,3,0,1,1,0,0,0,0,27,20,7,21,,6,0,6,11,0,11
29/06/2022 01:00,0,0,0,1,1,0,1,1,0,0,0,0,2,2,0,2,2,0,0,0,0,5,4,1,13,,4,1,3,0,0,0
29/06/2022 02:00,2,2,0,1,0,1,3,1,2,0,0,0,0,0,0,0,0,0,0,0,0,3,3,0,3,,5,0,5,6,0,6
29/06/2022 03:00,0,0,0,0,0,0,0,0,0,0,0,0,1,1,0,1,1,0,0,0,0,4,3,1,1,,2,0,2,1,0,1
29/06/2022 04:00,2,1,1,1,1,0,2,0,2,0,0,0,3,3,0,0,0,0,0,0,0,6,4,2,4,,1,0,1,2,1,1
29/06/2022 05:00,6,4,2,7,4,3,12,5,7,0,0,0,7,7,0,3,3,0,0,0,0,40,7,33,5,,1,0,1,13,1,12
29/06/2022 06:00,29,25,4,38,24,14,43,25,18,0,0,0,27,27,0,4,4,0,0,0,0,145,27,118,19,,20,0,20,48,0,48
29/06/2022 07:00,53,49,4,74,50,24,73,54,19,0,0,0,54,54,0,14,14,0,1,1,0,308,66,242,35,,45,0,45,74,1,73
29/06/2022 08:00,115,105,10,95,76,19,124,97,27,0,0,0,56,56,0,32,32,0,4,4,0,547,106,441,36,,52,0,52,190,0,190
29/06/2022 09:00,35,33,2,58,32,26,93,51,42,0,0,0,33,33,0,19,19,0,3,3,0,248,42,206,20,,31,0,31,154,1,153
29/06/2022 10:00,18,14,4,82,46,36,82,43,39,0,0,0,18,18,0,7,7,0,7,7,0,92,26,66,36,,29,0,29,56,0,56
29/06/2022 11:00,15,8,7,68,33,35,79,35,44,0,0,0,3,3,0,15,15,0,1,1,0,78,34,44,27,,40,0,40,73,0,73
29/06/2022 12:00,12,8,4,76,38,38,88,45,43,0,0,0,8,8,0,21,21,0,0,0,0,139,61,78,52,,69,0,69,105,0,105
29/06/2022 13:00,30,12,18,53,27,26,89,40,49,0,0,0,6,6,0,14,14,0,0,0,0,125,54,71,60,,97,0,97,120,0,120
29/06/2022 14:00,22,12,10,75,31,44,80,34,46,0,0,0,1,1,0,12,12,0,0,0,0,145,59,86,78,,94,2,92,86,0,86
29/06/2022 15:00,27,12,15,61,35,26,81,45,36,0,0,0,10,10,0,16,16,0,0,0,0,137,78,59,80,,71,0,71,78,0,78
29/06/2022 16:00,31,17,14,59,27,32,84,33,51,0,0,0,5,5,0,20,20,0,1,1,0,260,163,97,178,,126,0,126,91,1,90
29/06/2022 17:00,70,16,54,96,19,77,133,34,99,0,0,0,11,11,0,25,25,0,3,3,0,404,279,125,277,,245,0,245,103,0,103
29/06/2022 18:00,45,16,29,101,29,72,138,44,94,0,0,0,7,7,0,25,25,0,8,8,0,328,204,124,215,,221,0,221,128,0,128
29/06/2022 19:00,32,12,20,50,21,29,80,27,53,0,0,0,11,11,0,13,13,0,2,2,0,231,140,91,114,,150,2,148,132,0,132
29/06/2022 20:00,19,11,8,21,7,14,61,28,33,0,0,0,11,11,0,16,16,0,1,1,0,157,89,68,58,,96,1,95,95,0,95
29/06/2022 21:00,14,3,11,34,15,19,43,21,22,0,0,0,14,14,0,4,4,0,0,0,0,119,73,46,59,,76,0,76,84,1,83
29/06/2022 22:00,7,3,4,8,5,3,25,13,12,0,0,0,6,6,0,3,3,0,0,0,0,91,63,28,59,,60,0,60,45,1,44
29/06/2022 23:00,8,2,6,7,1,6,11,4,7,0,0,0,6,6,0,2,2,0,0,0,0,54,33,21,34,,31,0,31,40,0,40
30/06/2022 00:00,0,0,0,11,5,6,14,4,10,0,0,0,1,1,0,5,5,0,0,0,0,23,17,6,30,,21,1,20,16,0,16
30/06/2022 01:00,1,0,1,1,1,0,3,2,1,0,0,0,2,2,0,0,0,0,0,0,0,9,8,1,16,,4,0,4,0,0,0
30/06/2022 02:00,0,0,0,0,0,0,2,0,2,0,0,0,0,0,0,0,0,0,0,0,0,5,3,2,5,,14,1,13,4,0,4
30/06/2022 03:00,0,0,0,0,0,0,0,0,0,0,0,0,2,2,0,0,0,0,0,0,0,8,4,4,6,,7,0,7,5,1,4
30/06/2022 04:00,2,1,1,1,1,0,3,1,2,0,0,0,1,1,0,0,0,0,0,0,0,8,1,7,4,,4,0,4,2,0,2
30/06/2022 05:00,5,4,1,8,4,4,9,5,4,0,0,0,8,8,0,2,2,0,0,0,0,35,5,30,5,,5,0,5,10,0,10
30/06/2022 06:00,20,19,1,21,17,4,29,20,9,0,0,0,20,20,0,5,5,0,0,0,0,130,21,109,20,,18,0,18,42,0,42
30/06/2022 07:00,30,26,4,48,37,11,55,42,13,0,0,0,44,44,0,14,14,0,0,0,0,241,50,191,21,,36,0,36,72,0,72
30/06/2022 08:00,69,63,6,66,54,12,95,80,15,0,0,0,53,53,0,25,25,0,2,2,0,475,86,389,42,,54,0,54,150,0,150
30/06/2022 09:00,38,34,4,37,25,12,54,33,21,0,0,0,43,43,0,8,8,0,7,7,0,211,35,176,29,,40,1,39,106,0,106
30/06/2022 10:00,14,8,6,128,34,94,145,62,83,0,0,0,20,20,0,4,4,0,4,4,0,86,28,58,26,,29,0,29,49,0,49
30/06/2022 11:00,17,13,4,65,30,35,63,23,40,0,0,0,3,2,1,7,7,0,1,1,0,85,29,56,26,,33,0,33,63,0,63
30/06/2022 12:00,21,12,9,116,63,53,147,83,64,0,0,0,10,10,0,8,8,0,2,2,0,114,41,73,54,,71,2,69,102,0,102
30/06/2022 13:00,17,8,9,47,23,24,78,37,41,0,0,0,6,6,0,16,16,0,0,0,0,128,41,87,46,,83,2,81,118,0,118
30/06/2022 14:00,18,12,6,42,20,22,67,33,34,0,0,0,6,6,0,5,5,0,0,0,0,110,54,56,66,,58,1,57,91,0,91
30/06/2022 15:00,12,3,9,47,18,29,81,39,42,0,0,0,13,13,0,8,8,0,0,0,0,145,76,69,91,,63,1,62,77,0,77
30/06/2022 16:00,31,12,19,63,25,38,79,31,48,0,0,0,29,29,0,21,21,0,0,0,0,183,95,88,159,,120,0,120,86,1,85
30/06/2022 17:00,68,24,44,100,25,75,137,38,99,0,0,0,19,19,0,28,28,0,1,1,0,347,222,125,236,,178,0,178,138,1,137
30/06/2022 18:00,37,15,22,132,44,88,178,54,124,0,0,0,17,17,0,27,27,0,1,1,0,284,182,102,203,,192,2,190,145,0,145
30/06/2022 19:00,32,13,19,102,35,67,110,40,70,0,0,0,16,16,0,18,18,0,5,5,0,196,120,76,146,,165,0,165,129,1,128
30/06/2022 20:00,24,10,14,96,54,42,111,63,48,0,0,0,14,14,0,9,9,0,8,8,0,151,97,54,86,,94,0,94,117,0,117
30/06/2022 21:00,10,2,8,39,19,20,49,21,28,0,0,0,11,11,0,12,12,0,8,8,0,98,66,32,60,,77,0,77,74,0,74
30/06/2022 22:00,15,5,10,20,7,13,43,16,27,0,0,0,10,10,0,10,10,0,5,5,0,102,64,38,58,,53,0,53,39,1,38
30/06/2022 23:00,4,4,0,6,3,3,18,3,15,0,0,0,9,9,0,4,4,0,3,3,0,67,51,16,40,,63,0,63,21,2,19
01/07/2022 00:00,6,4,2,2,2,0,6,3,3,0,0,0,1,1,0,2,2,0,0,0,0,25,19,6,28,,29,0,29,19,0,19
01/07/2022 01:00,1,1,0,5,3,2,1,1,0,0,0,0,0,0,0,4,4,0,0,0,0,19,16,3,13,,6,0,6,1,0,1
01/07/2022 02:00,0,0,0,2,2,0,4,1,3,0,0,0,0,0,0,0,0,0,0,0,0,11,8,3,10,,13,0,13,5,0,5
01/07/2022 03:00,1,1,0,1,1,0,2,1,1,0,0,0,0,0,0,0,0,0,0,0,0,7,3,4,8,,9,0,9,0,0,0
01/07/2022 04:00,4,2,2,3,3,0,4,2,2,0,0,0,2,2,0,0,0,0,0,0,0,7,4,3,7,,3,0,3,3,0,3
01/07/2022 05:00,5,5,0,12,7,5,16,8,8,0,0,0,5,5,0,1,1,0,1,1,0,32,1,31,2,,6,0,6,9,0,9
01/07/2022 06:00,19,19,0,27,15,12,44,25,19,0,0,0,16,16,0,6,6,0,2,2,0,121,23,98,21,,15,0,15,45,0,45
01/07/2022 07:00,32,30,2,48,29,19,54,36,18,0,0,0,40,40,0,12,12,0,13,13,0,182,46,136,25,,28,0,28,71,0,71
01/07/2022 08:00,63,57,6,61,45,16,79,60,19,0,0,0,35,34,1,10,10,0,10,10,0,313,68,245,42,,50,1,49,124,0,124
01/07/2022 09:00,31,28,3,37,18,19,46,24,22,0,0,0,30,30,0,8,8,0,14,14,0,206,45,161,18,,35,0,35,102,0,102
01/07/2022 10:00,12,7,5,53,18,35,67,28,39,0,0,0,12,12,0,8,8,0,10,10,0,107,34,73,24,,34,0,34,53,0,53
01/07/2022 11:00,16,7,9,68,37,31,75,33,42,0,0,0,8,8,0,12,12,0,5,5,0,111,31,80,35,,39,0,39,93,0,93
01/07/2022 12:00,15,8,7,62,30,32,81,34,47,0,0,0,4,4,0,13,13,0,4,4,0,138,52,86,45,,89,0,89,95,0,95
01/07/2022 13:00,22,13,9,80,39,41,94,46,48,0,0,0,11,11,0,7,7,0,1,1,0,154,64,90,79,,98,1,97,114,4,110
01/07/2022 14:00,12,3,9,44,20,24,48,21,27,0,0,0,9,9,0,14,14,0,0,0,0,131,62,69,82,,75,1,74,102,2,100
01/07/2022 15:00,19,9,10,26,10,16,42,18,24,0,0,0,15,15,0,11,11,0,0,0,0,137,78,59,68,,71,1,70,83,0,83
01/07/2022 16:00,17,8,9,33,11,22,51,20,31,0,0,0,17,16,1,14,14,0,0,0,0,200,111,89,115,,121,2,119,101,0,101
01/07/2022 17:00,34,11,23,64,20,44,107,35,72,0,0,0,10,9,1,22,22,0,0,0,0,238,141,97,171,,141,1,140,124,1,123
01/07/2022 18:00,30,14,16,50,16,34,74,33,41,0,0,0,7,7,0,14,14,0,0,0,0,219,123,96,125,,127,0,127,105,0,105
01/07/2022 19:00,17,6,11,31,16,15,43,22,21,0,0,0,13,13,0,11,11,0,0,0,0,146,90,56,88,,124,3,121,117,1,116
01/07/2022 20:00,16,9,7,19,10,9,36,17,19,0,0,0,4,4,0,7,7,0,0,0,0,91,39,52,66,,71,1,70,96,1,95
01/07/2022 21:00,6,1,5,8,3,5,13,6,7,0,0,0,6,6,0,3,3,0,0,0,0,97,57,40,43,,62,0,62,57,1,56
01/07/2022 22:00,13,6,7,4,2,2,9,4,5,0,0,0,4,4,0,2,2,0,0,0,0,70,46,24,28,,50,0,50,25,0,25
01/07/2022 23:00,8,4,4,1,0,1,4,1,3,0,0,0,4,4,0,1,1,0,0,0,0,56,43,13,36,,35,1,34,38,0,38
02/07/2022 00:00,1,0,1,2,2,0,6,2,4,0,0,0,0,0,0,3,3,0,0,0,0,38,25,13,17,,39,1,38,13,0,13
02/07/2022 01:00,1,0,1,1,1,0,1,1,0,0,0,0,2,2,0,1,1,0,0,0,0,30,27,3,9,,14,0,14,2,0,2
02/07/2022 02:00,0,0,0,0,0,0,2,0,2,0,0,0,0,0,0,0,0,0,0,0,0,13,12,1,6,,17,1,16,8,0,8
02/07/2022 03:00,0,0,0,0,0,0,0,0,0,0,0,0,0,0,0,0,0,0,0,0,0,7,3,4,11,,10,0,10,5,0,5
02/07/2022 04:00,0,0,0,5,4,1,3,2,1,0,0,0,2,2,0,0,0,0,0,0,0,8,6,2,3,,6,0,6,5,0,5
02/07/2022 05:00,2,2,0,4,1,3,5,2,3,0,0,0,3,3,0,1,1,0,0,0,0,11,2,9,1,,2,0,2,5,1,4
02/07/2022 06:00,2,2,0,16,6,10,15,8,7,0,0,0,6,6,0,2,2,0,1,1,0,37,7,30,11,,6,0,6,12,0,12
02/07/2022 07:00,9,7,2,33,15,18,37,14,23,0,0,0,8,8,0,3,3,0,8,8,0,68,21,47,21,,14,0,14,22,1,21
02/07/2022 08:00,5,5,0,66,29,37,74,26,48,0,0,0,18,16,2,7,7,0,7,7,0,60,16,44,24,,14,0,14,32,0,32
02/07/2022 09:00,9,8,1,83,40,43,79,44,35,0,0,0,10,10,0,8,8,0,10,10,0,95,29,66,33,,35,0,35,59,0,59
02/07/2022 10:00,7,3,4,90,34,56,91,35,56,0,0,0,12,12,0,10,10,0,4,4,0,91,25,66,19,,32,0,32,55,0,55
02/07/2022 11:00,14,9,5,111,60,51,147,56,91,0,0,0,3,3,0,2,2,0,3,3,0,95,29,66,40,,62,1,61,87,1,86
02/07/2022 12:00,11,3,8,107,45,62,135,59,76,0,0,0,6,5,1,10,10,0,2,2,0,130,52,78,82,,69,0,69,81,0,81
02/07/2022 13:00,15,9,6,124,63,61,181,79,102,0,0,0,21,21,0,13,13,0,0,0,0,133,49,84,67,,80,1,79,107,0,107
02/07/2022 14:00,24,14,10,116,63,53,170,73,97,0,0,0,15,15,0,13,13,0,5,5,0,135,63,72,68,,71,0,71,123,0,123
02/07/2022 15:00,13,10,3,86,43,43,105,54,51,0,0,0,5,5,0,11,11,0,8,8,0,114,44,70,37,,82,0,82,95,1,94
02/07/2022 16:00,18,10,8,78,39,39,158,99,59,0,0,0,4,4,0,11,11,0,9,9,0,118,49,69,64,,93,0,93,99,0,99
02/07/2022 17:00,13,9,4,61,28,33,89,34,55,0,0,0,7,7,0,6,6,0,3,3,0,143,69,74,68,,78,1,77,105,0,105
02/07/2022 18:00,14,5,9,54,30,24,80,38,42,0,0,0,12,12,0,8,8,0,1,1,0,122,58,64,58,,93,0,93,108,0,108
02/07/2022 19:00,15,10,5,60,34,26,77,47,30,0,0,0,2,2,0,5,5,0,0,0,0,130,60,70,56,,73,0,73,121,0,121
02/07/2022 20:00,13,8,5,19,13,6,29,18,11,0,0,0,6,6,0,2,2,0,0,0,0,83,47,36,55,,49,0,49,81,0,81
02/07/2022 21:00,5,4,1,10,5,5,17,6,11,0,0,0,6,6,0,2,2,0,0,0,0,70,35,35,50,,44,0,44,51,1,50
02/07/2022 22:00,16,4,12,7,7,0,12,8,4,0,0,0,6,6,0,2,2,0,0,0,0,48,28,20,36,,38,0,38,47,0,47
02/07/2022 23:00,4,3,1,6,2,4,8,1,7,0,0,0,3,3,0,1,1,0,0,0,0,52,40,12,28,,36,1,35,38,1,37
03/07/2022 00:00,4,0,4,3,1,2,6,4,2,0,0,0,1,1,0,0,0,0,0,0,0,37,30,7,20,,27,1,26,19,1,18
03/07/2022 01:00,1,1,0,2,2,0,2,1,1,0,0,0,0,0,0,1,1,0,0,0,0,30,21,9,17,,3,0,3,0,0,0
03/07/2022 02:00,1,0,1,0,0,0,1,0,1,0,0,0,1,1,0,1,1,0,0,0,0,18,14,4,11,,24,0,24,7,2,5
03/07/2022 03:00,3,3,0,1,0,1,1,0,1,0,0,0,1,0,1,2,2,0,0,0,0,10,8,2,10,,9,0,9,3,0,3
03/07/2022 04:00,1,0,1,3,1,2,4,0,4,0,0,0,1,1,0,2,2,0,0,0,0,4,1,3,4,,5,0,5,5,0,5
03/07/2022 05:00,1,1,0,3,1,2,0,0,0,0,0,0,4,4,0,0,0,0,0,0,0,10,4,6,2,,6,0,6,5,0,5
03/07/2022 06:00,1,1,0,8,2,6,8,1,7,0,0,0,3,3,0,2,2,0,0,0,0,26,6,20,7,,5,0,5,7,0,7
03/07/2022 07:00,4,4,0,31,14,17,23,8,15,0,0,0,14,14,0,4,4,0,0,0,0,34,8,26,15,,13,0,13,12,0,12
03/07/2022 08:00,7,6,1,62,32,30,74,33,41,0,0,0,13,13,0,4,4,0,0,0,0,49,16,33,14,,14,0,14,30,0,30
03/07/2022 09:00,21,19,2,130,55,75,145,61,84,0,0,0,14,14,0,10,10,0,6,6,0,94,31,63,32,,20,0,20,33,0,33
03/07/2022 10:00,10,6,4,156,65,91,157,57,100,0,0,0,12,12,0,9,9,0,10,10,0,72,17,55,28,,26,0,26,49,0,49
03/07/2022 11:00,13,5,8,148,74,74,201,102,99,0,0,0,2,2,0,8,8,0,8,8,0,83,25,58,26,,36,1,35,46,1,45
03/07/2022 12:00,10,8,2,119,53,66,141,73,68,0,0,0,1,1,0,4,4,0,9,9,0,114,51,63,49,,41,0,41,75,0,75
03/07/2022 13:00,10,8,2,126,67,59,143,71,72,0,0,0,1,1,0,15,15,0,15,15,0,125,42,83,52,,60,1,59,99,0,99
03/07/2022 14:00,18,9,9,107,53,54,126,64,62,0,0,0,3,3,0,11,11,0,10,10,0,120,52,68,57,,74,1,73,96,0,96
03/07/2022 15:00,15,11,4,106,49,57,155,74,81,0,0,0,4,4,0,6,6,0,9,9,0,100,47,53,47,,73,0,73,98,0,98
03/07/2022 16:00,12,10,2,84,45,39,120,69,51,0,0,0,7,7,0,12,12,0,2,2,0,103,53,50,46,,89,0,89,86,0,86
03/07/2022 17:00,14,5,9,72,35,37,124,58,66,0,0,0,5,5,0,13,13,0,0,0,0,95,41,54,39,,81,0,81,107,1,106
03/07/2022 18:00,20,11,9,81,40,41,97,48,49,0,0,0,4,4,0,12,12,0,0,0,0,115,54,61,62,,86,1,85,91,1,90
03/07/2022 19:00,10,5,5,64,33,31,70,38,32,0,0,0,8,8,0,11,11,0,0,0,0,114,49,65,60,,79,1,78,103,0,103
03/07/2022 20:00,15,3,12,24,13,11,43,25,18,0,0,0,11,11,0,5,5,0,0,0,0,104,49,55,44,,62,0,62,91,0,91
03/07/2022 21:00,5,2,3,15,8,7,32,15,17,0,0,0,1,1,0,4,4,0,0,0,0,66,37,29,32,,46,0,46,50,1,49
03/07/2022 22:00,9,5,4,6,2,4,10,4,6,0,0,0,4,4,0,2,2,0,0,0,0,63,42,21,37,,10,0,10,42,0,42
03/07/2022 23:00,2,0,2,2,1,1,6,3,3,0,0,0,4,4,0,3,3,0,0,0,0,44,34,10,30,,3,0,3,26,1,25
04/07/2022 00:00,2,0,2,4,2,2,6,3,3,0,0,0,2,2,0,2,2,0,0,0,0,22,19,3,14,,7,0,7,10,0,10
04/07/2022 01:00,0,0,0,5,2,3,0,0,0,0,0,0,1,0,1,1,1,0,0,0,0,11,8,3,8,,5,0,5,0,0,0
04/07/2022 02:00,0,0,0,2,1,1,1,0,1,0,0,0,1,1,0,0,0,0,0,0,0,10,9,1,4,,10,0,10,1,0,1
04/07/2022 03:00,0,0,0,1,1,0,1,1,0,0,0,0,0,0,0,0,0,0,0,0,0,1,0,1,1,,3,0,3,4,0,4
04/07/2022 04:00,3,3,0,2,1,1,7,2,5,0,0,0,2,2,0,0,0,0,0,0,0,7,2,5,4,,1,0,1,2,0,2
04/07/2022 05:00,2,2,0,5,3,2,9,8,1,0,0,0,6,6,0,1,1,0,0,0,0,40,6,34,1,,3,0,3,9,0,9
04/07/2022 06:00,23,19,4,11,9,2,15,10,5,0,0,0,26,24,2,6,6,0,0,0,0,133,30,103,21,,17,0,17,44,0,44
04/07/2022 07:00,38,37,1,59,42,17,72,54,18,0,0,0,51,51,0,12,12,0,0,0,0,243,52,191,22,,35,0,35,96,1,95
04/07/2022 08:00,69,63,6,73,62,11,87,70,17,0,0,0,59,59,0,17,17,0,2,2,0,405,91,314,38,,56,0,56,137,0,137
04/07/2022 09:00,37,33,4,37,25,12,53,39,14,0,0,0,44,44,0,13,13,0,21,21,0,183,43,140,22,,45,0,45,95,0,95
04/07/2022 10:00,14,10,4,42,21,21,51,19,32,0,0,0,19,19,0,9,9,0,1,1,0,95,28,67,21,,32,0,32,50,0,50
04/07/2022 11:00,14,10,4,55,26,29,85,35,50,0,0,0,12,11,1,6,6,0,0,0,0,79,21,58,25,,31,0,31,68,1,67
04/07/2022 12:00,22,13,9,42,15,27,55,23,32,0,0,0,5,5,0,7,7,0,0,0,0,88,27,61,46,,68,1,67,64,0,64
04/07/2022 13:00,20,11,9,38,17,21,69,28,41,0,0,0,6,6,0,13,13,0,0,0,0,129,52,77,59,,82,0,82,97,0,97
04/07/2022 14:00,12,7,5,42,16,26,57,18,39,0,0,0,3,3,0,14,14,0,2,2,0,97,50,47,58,,71,0,71,61,0,61
04/07/2022 15:00,20,8,12,48,20,28,58,26,32,0,0,0,7,7,0,13,13,0,0,0,0,126,65,61,65,,65,1,64,81,1,80
04/07/2022 16:00,53,19,34,61,25,36,97,33,64,0,0,0,2,2,0,18,18,0,0,0,0,179,101,78,156,,113,1,112,80,1,79
04/07/2022 17:00,60,18,42,110,31,79,153,40,113,0,0,0,10,10,0,33,33,0,0,0,0,371,232,139,266,,183,2,181,111,0,111
04/07/2022 18:00,45,15,30,135,42,93,180,61,119,0,0,0,12,12,0,17,17,0,0,0,0,287,182,105,236,,178,4,174,107,1,106
04/07/2022 19:00,31,7,24,101,43,58,124,54,70,0,0,0,12,12,0,17,17,0,0,0,0,196,115,81,113,,111,1,110,95,0,95
04/07/2022 20:00,11,5,6,74,35,39,84,41,43,0,0,0,11,11,0,8,8,0,0,0,0,111,62,49,58,,110,0,110,69,1,68
04/07/2022 21:00,11,2,9,40,24,16,57,27,30,0,0,0,5,5,0,8,8,0,0,0,0,103,60,43,50,,72,0,72,64,0,64
04/07/2022 22:00,14,6,8,18,9,9,27,9,18,0,0,0,3,3,0,5,5,0,0,0,0,62,39,23,38,,52,0,52,30,0,30
04/07/2022 23:00,1,0,1,12,8,4,11,7,4,0,0,0,5,5,0,3,3,0,0,0,0,31,26,5,23,,27,0,27,15,1,14
05/07/2022 00:00,0,0,0,1,0,1,2,1,1,0,0,0,2,2,0,1,1,0,0,0,0,13,10,3,11,,12,0,12,8,0,8
05/07/2022 01:00,2,2,0,3,3,0,0,0,0,0,0,0,1,1,0,0,0,0,0,0,0,6,5,1,7,,0,0,0,0,0,0
05/07/2022 02:00,2,2,0,2,1,1,3,1,2,0,0,0,1,1,0,0,0,0,0,0,0,4,4,0,6,,6,0,6,0,0,0
05/07/2022 03:00,0,0,0,0,0,0,0,0,0,0,0,0,0,0,0,0,0,0,0,0,0,4,2,2,1,,1,0,1,1,0,1
05/07/2022 04:00,2,1,1,1,1,0,2,0,2,0,0,0,1,1,0,0,0,0,0,0,0,3,0,3,3,,1,0,1,2,0,2
05/07/2022 05:00,6,6,0,12,6,6,14,7,7,0,0,0,4,4,0,0,0,0,0,0,0,35,5,30,2,,2,0,2,10,0,10
05/07/2022 06:00,14,14,0,24,15,9,28,21,7,0,0,0,33,33,0,6,6,0,0,0,0,137,25,112,18,,12,0,12,57,0,57
05/07/2022 07:00,40,37,3,74,59,15,73,61,12,0,0,0,45,45,0,12,12,0,0,0,0,313,70,243,30,,37,0,37,106,1,105
05/07/2022 08:00,116,106,10,87,65,22,104,78,26,0,0,0,69,69,0,26,26,0,0,0,0,505,75,430,33,,76,0,76,202,0,202
05/07/2022 09:00,43,38,5,65,41,24,92,49,43,0,0,0,44,44,0,15,15,0,0,0,0,241,48,193,27,,31,0,31,134,1,133
05/07/2022 10:00,16,10,6,63,27,36,69,28,41,0,0,0,22,22,0,7,7,0,2,2,0,87,21,66,38,,28,0,28,66,0,66
05/07/2022 11:00,14,8,6,53,20,33,76,35,41,0,0,0,8,7,1,5,5,0,0,0,0,69,27,42,31,,36,0,36,67,0,67
05/07/2022 12:00,15,9,6,77,45,32,102,57,45,0,0,0,5,5,0,6,6,0,0,0,0,93,34,59,41,,62,0,62,81,0,81
05/07/2022 13:00,17,11,6,78,36,42,83,40,43,0,0,0,7,6,1,14,14,0,0,0,0,123,48,75,56,,75,1,74,101,0,101
05/07/2022 14:00,17,8,9,70,38,32,75,32,43,0,0,0,7,7,0,15,15,0,0,0,0,107,52,55,59,,60,0,60,79,1,78
05/07/2022 15:00,16,9,7,58,23,35,69,23,46,0,0,0,1,1,0,10,10,0,0,0,0,137,64,73,86,,71,0,71,63,1,62
05/07/2022 16:00,34,15,19,67,32,35,108,44,64,0,0,0,5,5,0,26,26,0,0,0,0,247,141,106,175,,119,0,119,103,0,103
05/07/2022 17:00,61,19,42,116,25,91,176,54,122,0,0,0,12,12,0,31,31,0,0,0,0,412,272,140,314,,260,0,260,126,0,126
05/07/2022 18:00,50,10,40,130,40,90,147,41,106,0,0,0,15,15,0,28,28,0,0,0,0,350,232,118,215,,202,1,201,132,1,131
05/07/2022 19:00,25,12,13,96,38,58,120,42,78,0,0,0,12,12,0,16,16,0,0,0,0,221,131,90,110,,123,0,123,112,1,111
05/07/2022 20:00,20,8,12,57,32,25,67,38,29,0,0,0,11,10,1,5,5,0,0,0,0,160,101,59,82,,91,0,91,77,1,76
05/07/2022 21:00,13,3,10,33,19,14,32,17,15,0,0,0,6,6,0,11,11,0,0,0,0,93,57,36,50,,76,2,74,42,1,41
05/07/2022 22:00,7,2,5,9,5,4,20,10,10,0,0,0,7,7,0,1,1,0,0,0,0,72,51,21,51,,44,0,44,34,0,34
05/07/2022 23:00,7,1,6,6,3,3,12,6,6,0,0,0,3,3,0,6,6,0,0,0,0,33,24,9,35,,31,0,31,15,0,15
06/07/2022 00:00,0,0,0,2,1,1,2,1,1,0,0,0,1,1,0,3,3,0,0,0,0,20,16,4,14,,22,1,21,12,0,12
06/07/2022 01:00,1,1,0,2,1,1,2,2,0,0,0,0,2,2,0,0,0,0,0,0,0,10,7,3,11,,2,0,2,1,0,1
06/07/2022 02:00,1,1,0,0,0,0,3,1,2,0,0,0,2,2,0,0,0,0,0,0,0,5,4,1,4,,13,0,13,1,0,1
06/07/2022 03:00,0,0,0,0,0,0,0,0,0,0,0,0,0,0,0,0,0,0,0,0,0,5,5,0,3,,5,0,5,5,0,5
06/07/2022 04:00,2,2,0,1,1,0,1,0,1,0,0,0,1,1,0,0,0,0,0,0,0,1,0,1,2,,2,0,2,2,0,2
06/07/2022 05:00,5,5,0,9,4,5,11,6,5,0,0,0,6,6,0,0,0,0,0,0,0,35,8,27,8,,2,0,2,9,0,9
06/07/2022 06:00,15,15,0,29,23,6,33,24,9,0,0,0,33,33,0,1,1,0,0,0,0,139,29,110,17,,14,0,14,51,0,51
06/07/2022 07:00,42,39,3,72,53,19,78,65,13,0,0,0,46,46,0,10,10,0,0,0,0,294,72,222,31,,38,0,38,77,0,77
06/07/2022 08:00,101,97,4,92,67,25,127,94,33,0,0,0,31,31,0,13,13,0,0,0,0,520,80,440,29,,82,1,81,187,0,187
06/07/2022 09:00,37,32,5,71,38,33,72,38,34,0,0,0,38,38,0,7,7,0,0,0,0,272,49,223,27,,36,0,36,134,0,134
06/07/2022 10:00,19,10,9,52,37,15,49,25,24,0,0,0,10,9,1,7,7,0,0,0,0,101,29,72,31,,39,1,38,77,2,75
06/07/2022 11:00,11,6,5,49,22,27,56,25,31,0,0,0,12,11,1,8,8,0,0,0,0,95,28,67,26,,40,0,40,77,1,76
06/07/2022 12:00,15,7,8,47,28,19,59,29,30,0,0,0,13,13,0,17,17,0,0,0,0,94,33,61,50,,51,0,51,82,0,82
06/07/2022 13:00,13,5,8,46,15,31,64,26,38,0,0,0,17,17,0,12,12,0,0,0,0,124,55,69,54,,73,0,73,98,1,97
06/07/2022 14:00,15,7,8,54,24,30,68,22,46,0,0,0,14,14,0,10,10,0,1,1,0,104,52,52,64,,80,0,80,75,0,75
06/07/2022 15:00,15,5,10,53,25,28,60,26,34,0,0,0,4,4,0,7,7,0,0,0,0,153,69,84,76,,72,0,72,81,0,81
06/07/2022 16:00,30,13,17,49,16,33,78,34,44,0,0,0,5,5,0,16,16,0,0,0,0,230,145,85,171,,99,1,98,80,0,80
06/07/2022 17:00,80,15,65,109,29,80,160,39,121,0,0,0,18,18,0,31,31,0,0,0,0,411,262,149,295,,246,0,246,123,0,123
06/07/2022 18:00,44,12,32,123,36,87,152,42,110,0,0,0,19,19,0,27,27,0,0,0,0,316,200,116,240,,231,2,229,149,1,148
06/07/2022 19:00,28,9,19,91,29,62,118,37,81,0,0,0,7,7,0,13,13,0,0,0,0,233,147,86,122,,143,1,142,121,0,121
06/07/2022 20:00,22,6,16,60,25,35,71,36,35,0,0,0,5,5,0,11,11,0,1,1,0,159,99,60,61,,103,0,103,66,0,66
06/07/2022 21:00,16,3,13,25,17,8,35,17,18,0,0,0,5,5,0,9,9,0,0,0,0,120,69,51,57,,61,1,60,72,0,72
06/07/2022 22:00,13,5,8,18,9,9,23,9,14,0,0,0,5,5,0,1,1,0,2,2,0,74,46,28,56,,59,0,59,41,0,41
06/07/2022 23:00,5,3,2,12,5,7,12,3,9,0,0,0,6,6,0,4,4,0,0,0,0,39,29,10,32,,36,0,36,21,1,20
07/07/2022 00:00,1,1,0,5,2,3,7,2,5,0,0,0,3,3,0,1,1,0,0,0,0,27,21,6,19,,29,1,28,12,0,12
07/07/2022 01:00,0,0,0,2,1,1,1,1,0,0,0,0,0,0,0,1,1,0,0,0,0,8,4,4,4,,9,0,9,1,0,1
07/07/2022 02:00,1,0,1,0,0,0,4,2,2,0,0,0,0,0,0,0,0,0,0,0,0,6,6,0,6,,10,0,10,3,0,3
07/07/2022 03:00,0,0,0,0,0,0,0,0,0,0,0,0,0,0,0,0,0,0,0,0,0,6,4,2,5,,2,1,1,2,0,2
07/07/2022 04:00,2,2,0,2,2,0,3,1,2,0,0,0,3,2,1,0,0,0,0,0,0,3,0,3,6,,3,0,3,2,0,2
07/07/2022 05:00,3,3,0,16,8,8,19,5,14,0,0,0,7,7,0,1,1,0,0,0,0,45,10,35,3,,2,0,2,8,0,8
07/07/2022 06:00,17,16,1,36,25,11,38,24,14,0,0,0,24,24,0,10,10,0,5,5,0,142,26,116,23,,15,0,15,43,0,43
07/07/2022 07:00,30,27,3,75,62,13,80,60,20,0,0,0,40,38,2,18,18,0,15,15,0,272,63,209,28,,32,0,32,90,1,89
07/07/2022 08:00,75,72,3,80,64,16,123,101,22,0,0,0,68,68,0,21,21,0,15,15,0,464,77,387,35,,66,0,66,170,0,170
07/07/2022 09:00,47,42,5,51,30,21,61,37,24,0,0,0,43,43,0,15,15,0,2,2,0,234,30,204,29,,38,1,37,142,0,142
07/07/2022 10:00,19,11,8,47,24,23,61,19,42,0,0,0,20,20,0,6,6,0,0,0,0,105,30,75,29,,40,0,40,70,0,70
07/07/2022 11:00,8,5,3,83,39,44,96,40,56,0,0,0,17,17,0,7,7,0,0,0,0,100,32,68,41,,34,0,34,95,0,95
07/07/2022 12:00,16,7,9,84,44,40,93,44,49,0,0,0,8,8,0,9,9,0,0,0,0,110,38,72,52,,65,1,64,112,1,111
07/07/2022 13:00,19,12,7,83,41,42,105,49,56,0,0,0,10,10,0,23,23,0,0,0,0,174,70,104,62,,100,0,100,117,0,117
07/07/2022 14:00,14,7,7,84,39,45,115,53,62,0,0,0,3,3,0,11,11,0,1,1,0,101,45,56,64,,54,0,54,77,2,75
07/07/2022 15:00,20,13,7,59,34,25,68,35,33,0,0,0,6,6,0,12,12,0,2,2,0,164,76,88,76,,72,1,71,83,0,83
07/07/2022 16:00,36,12,24,76,33,43,102,38,64,0,0,0,10,10,0,20,20,0,0,0,0,278,148,130,150,,111,1,110,114,0,114
07/07/2022 17:00,50,13,37,131,47,84,176,61,115,0,0,0,20,19,1,29,29,0,0,0,0,375,230,145,282,,203,1,202,129,0,129
07/07/2022 18:00,55,16,39,154,56,98,211,71,140,0,0,0,18,18,0,27,27,0,21,21,0,341,198,143,244,,203,1,202,170,0,170
07/07/2022 19:00,35,17,18,164,59,105,211,80,131,0,0,0,19,19,0,19,19,0,13,13,0,227,122,105,130,,126,0,126,118,1,117
07/07/2022 20:00,20,5,15,158,91,67,193,107,86,0,0,0,13,13,0,17,17,0,7,7,0,155,84,71,82,,123,1,122,108,0,108
07/07/2022 21:00,17,6,11,88,55,33,115,68,47,0,0,0,7,7,0,16,16,0,7,7,0,142,81,61,76,,84,0,84,96,1,95
07/07/2022 22:00,12,3,9,34,22,12,60,30,30,0,0,0,4,4,0,8,8,0,1,1,0,95,69,26,55,,71,0,71,46,0,46
07/07/2022 23:00,1,1,0,15,7,8,30,8,22,0,0,0,6,6,0,5,5,0,0,0,0,75,57,18,41,,36,0,36,40,0,40
08/07/2022 00:00,1,0,1,10,4,6,6,2,4,0,0,0,3,3,0,3,3,0,0,0,0,33,27,6,32,,35,0,35,23,0,23
08/07/2022 01:00,0,0,0,2,1,1,3,2,1,0,0,0,2,2,0,3,3,0,0,0,0,11,8,3,11,,5,0,5,1,0,1
08/07/2022 02:00,3,0,3,1,1,0,0,0,0,0,0,0,0,0,0,0,0,0,0,0,0,9,8,1,11,,5,0,5,3,0,3
08/07/2022 03:00,2,2,0,0,0,0,1,0,1,0,0,0,0,0,0,0,0,0,0,0,0,9,6,3,6,,7,0,7,4,1,3
08/07/2022 04:00,2,1,1,3,3,0,3,1,2,0,0,0,1,1,0,0,0,0,0,0,0,7,4,3,3,,3,0,3,3,0,3
08/07/2022 05:00,5,5,0,3,0,3,8,4,4,0,0,0,5,5,0,3,3,0,0,0,0,30,4,26,3,,5,0,5,11,0,11
08/07/2022 06:00,17,16,1,22,14,8,31,18,13,0,0,0,30,30,0,7,7,0,0,0,0,116,25,91,20,,18,0,18,38,1,37
08/07/2022 07:00,30,28,2,55,35,20,75,53,22,0,0,0,31,31,0,8,8,0,11,11,0,212,46,166,28,,28,0,28,72,0,72
08/07/2022 08:00,68,61,7,76,56,20,85,60,25,0,0,0,53,53,0,20,20,0,10,10,0,320,69,251,36,,56,0,56,149,1,148
08/07/2022 09:00,28,22,6,57,32,25,78,52,26,0,0,0,22,22,0,7,7,0,19,19,0,193,35,158,25,,42,0,42,115,0,115
08/07/2022 10:00,15,8,7,45,20,25,58,22,36,0,0,0,9,9,0,9,9,0,4,4,0,103,28,75,28,,34,0,34,63,0,63
08/07/2022 11:00,14,10,4,72,39,33,87,37,50,0,0,0,6,6,0,10,10,0,0,0,0,104,33,71,43,,44,0,44,95,0,95
08/07/2022 12:00,16,6,10,75,37,38,82,39,43,0,0,0,11,11,0,13,13,0,0,0,0,136,58,78,59,,83,1,82,101,1,100
08/07/2022 13:00,24,13,11,77,34,43,79,34,45,0,0,0,12,12,0,10,10,0,9,9,0,171,72,99,72,,115,0,115,123,0,123
08/07/2022 14:00,25,12,13,84,35,49,100,42,58,0,0,0,5,5,0,15,15,0,11,11,0,153,73,80,93,,74,0,74,84,0,84
08/07/2022 15:00,18,7,11,91,46,45,102,43,59,0,0,0,3,3,0,11,11,0,16,16,0,164,74,90,101,,78,1,77,98,0,98
08/07/2022 16:00,57,24,33,104,47,57,126,55,71,0,0,0,14,13,1,18,18,0,18,18,0,210,116,94,131,,132,0,132,93,0,93
08/07/2022 17:00,50,19,31,101,37,64,156,52,104,0,0,0,8,8,0,23,23,0,12,12,0,300,169,131,187,,167,2,165,142,1,141
08/07/2022 18:00,31,13,18,96,41,55,147,60,87,0,0,0,14,13,1,13,13,0,7,7,0,225,127,98,121,,139,0,139,130,1,129
08/07/2022 19:00,21,11,10,78,42,36,119,49,70,0,0,0,19,19,0,6,6,0,0,0,0,156,82,74,93,,101,0,101,131,0,131
08/07/2022 20:00,18,8,10,63,32,31,97,58,39,0,0,0,19,18,1,17,17,0,1,1,0,148,73,75,66,,80,1,79,116,0,116
08/07/2022 21:00,18,6,12,37,22,15,53,33,20,0,0,0,7,7,0,8,8,0,0,0,0,94,64,30,61,,62,2,60,86,2,84
08/07/2022 22:00,7,5,2,21,10,11,28,15,13,0,0,0,5,5,0,4,4,0,0,0,0,93,58,35,56,,66,0,66,55,0,55
08/07/2022 23:00,14,7,7,10,2,8,16,5,11,0,0,0,7,7,0,1,1,0,0,0,0,83,55,28,42,,39,0,39,37,0,37
09/07/2022 00:00,8,4,4,4,4,0,9,4,5,0,0,0,5,5,0,2,2,0,0,0,0,55,39,16,26,,37,0,37,24,0,24
09/07/2022 01:00,1,1,0,2,0,2,2,0,2,0,0,0,1,1,0,0,0,0,0,0,0,29,22,7,38,,8,0,8,2,0,2
09/07/2022 02:00,0,0,0,4,1,3,3,0,3,0,0,0,1,1,0,0,0,0,0,0,0,21,15,6,16,,27,1,26,3,0,3
09/07/2022 03:00,0,0,0,1,0,1,4,0,4,0,0,0,0,0,0,0,0,0,0,0,0,17,14,3,9,,12,0,12,10,0,10
09/07/2022 04:00,0,0,0,2,1,1,2,1,1,0,0,0,1,1,0,1,1,0,0,0,0,5,3,2,10,,8,0,8,6,0,6
09/07/2022 05:00,1,1,0,7,4,3,6,1,5,0,0,0,5,5,0,2,2,0,0,0,0,21,5,16,5,,5,0,5,4,0,4
09/07/2022 06:00,5,5,0,13,3,10,15,5,10,0,0,0,10,10,0,2,2,0,0,0,0,38,10,28,10,,9,0,9,12,0,12
09/07/2022 07:00,7,7,0,34,17,17,34,16,18,0,0,0,10,10,0,4,4,0,0,0,0,58,19,39,19,,10,1,9,22,0,22
09/07/2022 08:00,14,8,6,62,29,33,75,30,45,0,0,0,8,8,0,5,5,0,0,0,0,67,17,50,19,,18,0,18,33,0,33
09/07/2022 09:00,8,5,3,103,53,50,113,54,59,0,0,0,14,14,0,6,6,0,0,0,0,81,22,59,35,,21,0,21,54,0,54
09/07/2022 10:00,18,14,4,127,49,78,141,50,91,0,0,0,17,17,0,10,10,0,0,0,0,93,35,58,51,,35,0,35,66,0,66
09/07/2022 11:00,19,11,8,136,62,74,176,66,110,0,0,0,6,6,0,9,9,0,0,0,0,128,35,93,53,,40,0,40,103,0,103
09/07/2022 12:00,15,10,5,181,89,92,229,102,127,0,0,0,5,5,0,10,10,0,0,0,0,118,37,81,64,,82,0,82,110,1,109
09/07/2022 13:00,18,8,10,138,67,71,198,102,96,0,0,0,5,5,0,10,10,0,0,0,0,125,54,71,92,,97,0,97,126,0,126
09/07/2022 14:00,20,9,11,110,53,57,134,61,73,0,0,0,1,1,0,11,11,0,1,1,0,126,53,73,55,,82,0,82,95,0,95
09/07/2022 15:00,16,6,10,105,54,51,142,72,70,0,0,0,6,6,0,6,6,0,0,0,0,126,54,72,57,,89,1,88,92,0,92
09/07/2022 16:00,15,9,6,109,56,53,153,78,75,0,0,0,6,6,0,9,9,0,0,0,0,112,54,58,65,,95,0,95,97,0,97
09/07/2022 17:00,9,3,6,103,49,54,131,67,64,0,0,0,9,9,0,13,13,0,0,0,0,125,60,65,47,,77,0,77,75,0,75
09/07/2022 18:00,15,7,8,66,35,31,105,62,43,0,0,0,16,16,0,20,20,0,0,0,0,113,60,53,70,,91,0,91,89,1,88
09/07/2022 19:00,17,12,5,53,27,26,124,75,49,0,0,0,1,1,0,4,4,0,10,10,0,122,54,68,63,,86,1,85,91,0,91
09/07/2022 20:00,6,2,4,50,33,17,71,44,27,0,0,0,13,12,1,9,9,0,5,5,0,110,52,58,61,,72,0,72,87,3,84
09/07/2022 21:00,8,4,4,39,25,14,74,38,36,0,0,0,10,10,0,8,8,0,4,4,0,74,34,40,38,,48,0,48,66,1,65
09/07/2022 22:00,10,8,2,27,18,9,27,17,10,0,0,0,6,6,0,3,3,0,3,3,0,61,43,18,47,,53,0,53,59,0,59
09/07/2022 23:00,10,4,6,16,10,6,22,11,11,0,0,0,4,4,0,2,2,0,1,1,0,74,47,27,42,,40,0,40,46,0,46
10/07/2022 00:00,2,0,2,6,3,3,11,4,7,0,0,0,4,4,0,0,0,0,1,1,0,42,30,12,29,,27,0,27,28,0,28
10/07/2022 01:00,1,0,1,7,3,4,8,4,4,0,0,0,5,5,0,0,0,0,0,0,0,33,24,9,31,,5,0,5,0,0,0
10/07/2022 02:00,1,0,1,4,1,3,6,3,3,0,0,0,0,0,0,0,0,0,0,0,0,20,15,5,18,,23,0,23,7,0,7
10/07/2022 03:00,0,0,0,2,1,1,6,1,5,0,0,0,1,1,0,2,2,0,1,1,0,23,18,5,11,,19,0,19,2,0,2
10/07/2022 04:00,0,0,0,2,1,1,1,0,1,0,0,0,0,0,0,1,1,0,1,1,0,15,10,5,5,,8,0,8,2,0,2
10/07/2022 05:00,2,1,1,6,3,3,5,3,2,0,0,0,1,1,0,0,0,0,0,0,0,11,5,6,4,,7,0,7,6,0,6
10/07/2022 06:00,3,1,2,8,5,3,12,6,6,0,0,0,8,8,0,3,3,0,0,0,0,27,5,22,6,,5,0,5,13,0,13
10/07/2022 07:00,9,8,1,45,15,30,45,12,33,0,0,0,16,16,0,3,3,0,0,0,0,45,11,34,20,,9,0,9,15,0,15
10/07/2022 08:00,4,3,1,94,39,55,84,32,52,0,0,0,11,11,0,4,4,0,1,1,0,56,17,39,21,,10,0,10,30,0,30
10/07/2022 09:00,7,6,1,117,51,66,170,71,99,0,0,0,7,6,1,8,8,0,7,7,0,60,11,49,26,,17,0,17,42,0,42
10/07/2022 10:00,21,10,11,168,70,98,259,104,155,0,0,0,6,6,0,7,7,0,11,11,0,103,31,72,42,,36,1,35,66,0,66
10/07/2022 11:00,18,10,8,214,100,114,289,131,158,0,0,0,12,11,1,15,15,0,12,12,0,95,29,66,51,,57,0,57,66,1,65
10/07/2022 12:00,14,8,6,253,116,137,326,148,178,0,0,0,4,4,0,11,11,0,16,16,0,128,48,80,65,,55,2,53,84,0,84
10/07/2022 13:00,13,5,8,249,102,147,315,146,169,0,0,0,6,6,0,18,18,0,19,19,0,151,50,101,92,,79,1,78,117,1,116
10/07/2022 14:00,23,9,14,228,116,112,308,150,158,0,0,0,2,2,0,10,10,0,20,20,0,140,51,89,85,,80,0,80,91,3,88
10/07/2022 15:00,12,6,6,216,105,111,285,139,146,0,0,0,7,7,0,11,11,0,7,7,0,118,54,64,94,,57,1,56,75,0,75
10/07/2022 16:00,16,13,3,179,95,84,251,124,127,0,0,0,8,8,0,5,5,0,0,0,0,109,57,52,82,,73,1,72,90,1,89
10/07/2022 17:00,16,8,8,154,94,60,204,111,93,0,0,0,3,3,0,17,17,0,0,0,0,152,63,89,72,,78,0,78,104,0,104
10/07/2022 18:00,14,3,11,140,75,65,200,109,91,0,0,0,7,6,1,9,9,0,1,1,0,123,59,64,73,,87,1,86,85,1,84
10/07/2022 19:00,22,11,11,122,76,46,216,130,86,0,0,0,9,9,0,13,13,0,0,0,0,117,58,59,70,,85,0,85,115,1,114
10/07/2022 20:00,17,8,9,88,61,27,157,100,57,0,0,0,9,9,0,10,10,0,0,0,0,122,74,48,52,,77,0,77,73,0,73
10/07/2022 21:00,7,5,2,45,22,23,79,49,30,0,0,0,7,7,0,6,6,0,0,0,0,82,51,31,42,,57,2,55,44,0,44
10/07/2022 22:00,11,5,6,22,15,7,42,26,16,0,0,0,7,7,0,5,5,0,0,0,0,59,39,20,43,,7,0,7,39,0,39
10/07/2022 23:00,0,0,0,10,5,5,10,6,4,0,0,0,5,5,0,3,3,0,0,0,0,36,27,9,23,,30,0,30,26,0,26
11/07/2022 00:00,5,4,1,1,1,0,9,6,3,0,0,0,0,0,0,3,3,0,0,0,0,18,13,5,15,,29,1,28,10,1,9
11/07/2022 01:00,1,0,1,4,2,2,3,2,1,0,0,0,1,1,0,0,0,0,0,0,0,12,12,0,6,,5,0,5,2,0,2
11/07/2022 02:00,1,0,1,2,1,1,1,0,1,0,0,0,0,0,0,0,0,0,0,0,0,3,2,1,6,,5,0,5,2,0,2
11/07/2022 03:00,2,0,2,0,0,0,0,0,0,0,0,0,0,0,0,0,0,0,0,0,0,7,6,1,2,,3,0,3,1,0,1
11/07/2022 04:00,1,1,0,2,2,0,3,1,2,0,0,0,3,3,0,0,0,0,0,0,0,5,1,4,2,,2,0,2,1,0,1
11/07/2022 05:00,4,4,0,11,7,4,12,9,3,0,0,0,10,10,0,1,1,0,0,0,0,38,7,31,6,,3,0,3,9,0,9
11/07/2022 06:00,13,12,1,39,31,8,44,31,13,0,0,0,27,27,0,4,4,0,0,0,0,155,33,122,19,,6,0,6,34,0,34
11/07/2022 07:00,29,26,3,70,49,21,83,67,16,0,0,0,53,53,0,14,14,0,0,0,0,269,63,206,27,,21,0,21,73,0,73
11/07/2022 08:00,84,74,10,78,67,11,108,82,26,0,0,0,57,57,0,23,23,0,2,2,0,439,89,350,33,,53,0,53,160,0,160
11/07/2022 09:00,32,27,5,52,23,29,92,48,44,0,0,0,30,30,0,10,10,0,2,2,0,216,49,167,26,,37,0,37,113,1,112
11/07/2022 10:00,15,12,3,80,28,52,81,23,58,0,0,0,16,16,0,8,8,0,10,10,0,88,13,75,32,,23,0,23,64,0,64
11/07/2022 11:00,9,5,4,117,56,61,145,65,80,0,0,0,7,7,0,5,5,0,5,5,0,82,32,50,41,,37,0,37,51,0,51
11/07/2022 12:00,11,5,6,94,54,40,143,64,79,0,0,0,6,6,0,12,12,0,10,10,0,100,41,59,48,,61,0,61,82,0,82
11/07/2022 13:00,24,11,13,89,37,52,126,48,78,0,0,0,5,5,0,12,12,0,10,10,0,118,46,72,59,,82,1,81,80,0,80
11/07/2022 14:00,15,11,4,82,38,44,105,49,56,0,0,0,5,5,0,10,10,0,13,13,0,142,77,65,67,,77,0,77,76,0,76
11/07/2022 15:00,30,15,15,62,28,34,98,34,64,0,0,0,11,11,0,16,16,0,12,12,0,135,65,70,111,,62,0,62,87,1,86
11/07/2022 16:00,38,19,19,92,39,53,154,63,91,0,0,0,8,8,0,18,18,0,18,18,0,221,119,102,182,,106,0,106,85,0,85
11/07/2022 17:00,66,20,46,164,55,109,236,70,166,0,0,0,9,9,0,29,29,0,35,35,0,405,248,157,266,,188,0,188,107,1,106
11/07/2022 18:00,42,13,29,137,48,89,225,70,155,0,0,0,14,14,0,20,20,0,28,28,0,328,201,127,205,,176,0,176,137,0,137
11/07/2022 19:00,28,16,12,131,56,75,203,91,112,0,0,0,8,8,0,19,19,0,22,22,0,210,125,85,121,,121,0,121,107,1,106
11/07/2022 20:00,23,10,13,98,62,36,153,79,74,0,0,0,4,4,0,22,22,0,14,14,0,140,80,60,72,,76,0,76,68,0,68
11/07/2022 21:00,19,7,12,80,44,36,142,79,63,0,0,0,8,8,0,12,12,0,10,10,0,108,66,42,66,,52,0,52,59,1,58
11/07/2022 22:00,10,5,5,37,20,17,66,38,28,0,0,0,7,7,0,10,10,0,4,4,0,81,59,22,41,,58,0,58,46,2,44
11/07/2022 23:00,10,5,5,18,10,8,25,12,13,0,0,0,5,5,0,6,6,0,1,1,0,30,27,3,42,,30,0,30,16,0,16
12/07/2022 00:00,3,2,1,2,1,1,5,2,3,0,0,0,3,3,0,1,1,0,0,0,0,24,16,8,17,,11,0,11,5,0,5
12/07/2022 01:00,0,0,0,2,1,1,2,1,1,0,0,0,2,2,0,1,1,0,0,0,0,13,9,4,9,,7,0,7,0,0,0
12/07/2022 02:00,0,0,0,2,0,2,4,0,4,0,0,0,0,0,0,0,0,0,1,1,0,0,0,0,6,,6,0,6,5,0,5
12/07/2022 03:00,0,0,0,1,0,1,1,0,1,0,0,0,0,0,0,0,0,0,0,0,0,7,6,1,2,,6,0,6,2,0,2
12/07/2022 04:00,2,2,0,1,1,0,2,0,2,0,0,0,1,1,0,0,0,0,0,0,0,1,0,1,3,,0,0,0,3,0,3
12/07/2022 05:00,6,5,1,12,8,4,13,8,5,0,0,0,5,5,0,2,2,0,1,1,0,41,7,34,5,,3,0,3,10,0,10
12/07/2022 06:00,18,17,1,31,21,10,34,24,10,0,0,0,25,25,0,8,8,0,1,1,0,160,26,134,17,,10,0,10,44,0,44
12/07/2022 07:00,46,42,4,67,54,13,81,67,14,0,0,0,42,42,0,13,13,0,28,28,0,319,67,252,31,,34,1,33,75,0,75
12/07/2022 08:00,78,72,6,72,64,8,92,76,16,0,0,0,79,78,1,16,16,0,18,18,0,510,82,428,36,,55,1,54,191,0,191
12/07/2022 09:00,40,36,4,44,30,14,57,40,17,0,0,0,45,45,0,10,10,0,0,0,0,247,54,193,24,,31,0,31,133,1,132
12/07/2022 10:00,14,12,2,21,12,9,36,14,22,0,0,0,14,14,0,5,5,0,0,0,0,73,24,49,16,,40,0,40,72,0,72
12/07/2022 11:00,14,7,7,46,22,24,64,30,34,0,0,0,14,14,0,6,6,0,0,0,0,85,32,53,24,,37,0,37,63,0,63
12/07/2022 12:00,17,14,3,59,28,31,73,32,41,0,0,0,8,8,0,11,11,0,0,0,0,102,36,66,37,,66,0,66,96,2,94
12/07/2022 13:00,27,10,17,59,24,35,77,38,39,0,0,0,4,4,0,17,17,0,0,0,0,124,51,73,66,,73,1,72,107,1,106
12/07/2022 14:00,17,8,9,58,25,33,92,38,54,0,0,0,6,6,0,6,6,0,0,0,0,109,56,53,70,,63,0,63,66,0,66
12/07/2022 15:00,19,9,10,75,30,45,97,35,62,0,0,0,4,4,0,16,16,0,0,0,0,144,81,63,78,,71,0,71,70,0,70
12/07/2022 16:00,37,16,21,83,34,49,98,46,52,0,0,0,7,7,0,27,27,0,0,0,0,253,160,93,171,,138,0,138,103,0,103
12/07/2022 17:00,58,17,41,144,52,92,187,52,135,0,0,0,13,13,0,29,29,0,0,0,0,408,271,137,311,,220,1,219,147,0,147
12/07/2022 18:00,56,16,40,172,40,132,223,65,158,0,0,0,12,12,0,28,28,0,21,21,0,329,207,122,268,,200,1,199,140,1,139
12/07/2022 19:00,25,8,17,149,77,72,182,81,101,0,0,0,13,13,0,24,24,0,10,10,0,222,115,107,121,,143,2,141,124,0,124
12/07/2022 20:00,22,10,12,114,62,52,137,68,69,0,0,0,5,5,0,22,22,0,3,3,0,153,92,61,84,,109,1,108,110,1,109
12/07/2022 21:00,17,8,9,47,27,20,76,45,31,0,0,0,8,8,0,11,11,0,1,1,0,114,80,34,65,,68,0,68,60,0,60
12/07/2022 22:00,12,4,8,27,11,16,41,19,22,0,0,0,7,7,0,1,1,0,0,0,0,77,48,29,53,,8,0,8,39,0,39
12/07/2022 23:00,3,2,1,8,6,2,14,6,8,0,0,0,5,5,0,1,1,0,0,0,0,57,41,16,28,,13,0,13,28,1,27
13/07/2022 00:00,2,0,2,8,3,5,8,3,5,0,0,0,4,4,0,2,2,0,0,0,0,21,18,3,20,,23,0,23,9,0,9
13/07/2022 01:00,3,2,1,2,2,0,3,2,1,0,0,0,4,4,0,2,2,0,0,0,0,7,5,2,9,,2,0,2,1,0,1
13/07/2022 02:00,1,1,0,1,0,1,1,0,1,0,0,0,0,0,0,0,0,0,0,0,0,3,3,0,3,,5,0,5,2,0,2
13/07/2022 03:00,0,0,0,0,0,0,0,0,0,0,0,0,0,0,0,0,0,0,0,0,0,3,2,1,3,,2,0,2,3,0,3
13/07/2022 04:00,3,1,2,1,1,0,5,2,3,0,0,0,0,0,0,1,1,0,0,0,0,3,1,2,4,,1,0,1,1,0,1
13/07/2022 05:00,4,4,0,15,9,6,9,7,2,0,0,0,10,10,0,3,3,0,0,0,0,43,11,32,5,,3,0,3,9,1,8
13/07/2022 06:00,21,20,1,45,31,14,47,31,16,0,0,0,28,28,0,5,5,0,2,2,0,162,32,130,22,,15,0,15,52,0,52
13/07/2022 07:00,56,49,7,90,71,19,104,80,24,0,0,0,68,68,0,6,6,0,10,10,0,323,85,238,38,,45,0,45,85,1,84
13/07/2022 08:00,107,96,11,113,89,24,128,96,32,0,0,0,76,76,0,0,0,0,0,0,0,587,104,483,44,,75,0,75,223,0,223
13/07/2022 09:00,35,32,3,63,34,29,94,52,42,0,0,0,36,36,0,2,2,0,0,0,0,272,49,223,30,,30,0,30,155,1,154
13/07/2022 10:00,19,16,3,84,41,43,95,40,55,0,0,0,27,27,0,6,6,0,0,0,0,114,30,84,33,,38,0,38,80,0,80
13/07/2022 11:00,18,14,4,87,42,45,111,50,61,0,0,0,8,8,0,7,7,0,0,0,0,120,33,87,48,,50,1,49,89,1,88
13/07/2022 12:00,17,11,6,102,41,61,108,52,56,0,0,0,19,19,0,18,18,0,0,0,0,112,39,73,49,,79,2,77,103,0,103
13/07/2022 13:00,18,6,12,98,49,49,114,60,54,0,0,0,11,11,0,15,15,0,0,0,0,146,63,83,70,,100,0,100,116,1,115
13/07/2022 14:00,28,18,10,88,39,49,116,57,59,0,0,0,10,10,0,14,14,0,0,0,0,102,56,46,75,,70,0,70,68,0,68
13/07/2022 15:00,18,13,5,80,33,47,118,61,57,0,0,0,8,8,0,15,15,0,0,0,0,181,91,90,90,,103,0,103,77,0,77
13/07/2022 16:00,47,16,31,102,44,58,119,37,82,0,0,0,12,12,0,23,23,0,6,6,0,243,137,106,174,,132,0,132,106,0,106
13/07/2022 17:00,78,20,58,153,45,108,199,56,143,0,0,0,14,14,0,34,34,0,9,9,0,440,275,165,318,,233,2,231,124,0,124
13/07/2022 18:00,50,14,36,170,53,117,234,72,162,0,0,0,15,15,0,29,29,0,6,6,0,374,250,124,252,,222,1,221,123,0,123
13/07/2022 19:00,25,9,16,132,59,73,170,75,95,0,0,0,6,6,0,15,15,0,28,28,0,241,161,80,141,,144,1,143,153,1,152
13/07/2022 20:00,29,13,16,118,58,60,157,74,83,0,0,0,19,19,0,10,10,0,11,11,0,167,106,61,88,,117,0,117,118,0,118
13/07/2022 21:00,13,6,7,64,35,29,84,42,42,0,0,0,11,11,0,12,12,0,2,2,0,114,72,42,58,,80,0,80,76,1,75
13/07/2022 22:00,12,9,3,36,19,17,69,34,35,0,0,0,3,3,0,5,5,0,0,0,0,89,62,27,67,,58,1,57,51,0,51
13/07/2022 23:00,7,5,2,19,9,10,35,20,15,0,0,0,5,5,0,4,4,0,0,0,0,66,53,13,54,,38,0,38,30,1,29
14/07/2022 00:00,1,0,1,4,2,2,17,9,8,0,0,0,2,2,0,3,3,0,1,1,0,22,18,4,22,,34,0,34,12,0,12
14/07/2022 01:00,3,1,2,2,2,0,2,2,0,0,0,0,2,2,0,0,0,0,0,0,0,14,14,0,12,,3,0,3,1,0,1
14/07/2022 02:00,3,1,2,2,1,1,0,0,0,0,0,0,0,0,0,0,0,0,0,0,0,11,9,2,7,,8,0,8,3,0,3
14/07/2022 03:00,1,0,1,0,0,0,1,0,1,0,0,0,0,0,0,1,1,0,0,0,0,6,4,2,3,,6,0,6,2,0,2
14/07/2022 04:00,4,2,2,2,2,0,3,2,1,0,0,0,2,2,0,1,1,0,0,0,0,8,3,5,4,,5,0,5,1,0,1
14/07/2022 05:00,3,3,0,13,7,6,14,5,9,0,0,0,5,5,0,1,1,0,3,3,0,45,11,34,3,,1,0,1,10,0,10
14/07/2022 06:00,17,17,0,36,27,9,42,28,14,0,0,0,25,25,0,9,9,0,10,10,0,140,25,115,22,,14,0,14,47,0,47
14/07/2022 07:00,31,28,3,72,52,20,86,64,22,0,0,0,54,54,0,11,11,0,6,6,0,321,76,245,44,,46,0,46,86,0,86
14/07/2022 08:00,101,95,6,87,70,17,121,100,21,0,0,0,67,67,0,21,21,0,1,1,0,564,102,462,33,,69,0,69,191,1,190
14/07/2022 09:00,48,40,8,53,30,23,71,47,24,0,0,0,40,40,0,10,10,0,1,1,0,229,36,193,34,,51,1,50,141,0,141
14/07/2022 10:00,18,15,3,64,31,33,74,31,43,0,0,0,23,23,0,11,11,0,0,0,0,99,34,65,27,,39,0,39,85,1,84
14/07/2022 11:00,20,15,5,68,34,34,86,42,44,0,0,0,17,17,0,10,10,0,0,0,0,119,37,82,30,,41,1,40,76,1,75
14/07/2022 12:00,21,14,7,70,33,37,98,50,48,0,0,0,11,11,0,14,14,0,0,0,0,93,43,50,42,,63,2,61,110,0,110
14/07/2022 13:00,20,8,12,56,26,30,91,48,43,0,0,0,7,7,0,16,16,0,0,0,0,119,54,65,65,,101,0,101,119,1,118
14/07/2022 14:00,20,10,10,59,29,30,66,28,38,0,0,0,3,3,0,8,8,0,0,0,0,129,55,74,71,,77,0,77,79,2,77
14/07/2022 15:00,13,7,6,49,23,26,86,40,46,0,0,0,7,7,0,11,11,0,0,0,0,154,82,72,90,,68,0,68,77,1,76
14/07/2022 16:00,39,18,21,85,31,54,106,32,74,0,0,0,6,6,0,23,23,0,0,0,0,220,126,94,144,,118,0,118,89,1,88
14/07/2022 17:00,69,16,53,118,36,82,159,50,109,0,0,0,10,10,0,30,30,0,1,1,0,375,238,137,298,,227,3,224,130,0,130
14/07/2022 18:00,48,15,33,171,49,122,200,67,133,0,0,0,30,30,0,33,33,0,0,0,0,349,202,147,221,,186,0,186,162,1,161
14/07/2022 19:00,23,12,11,133,61,72,157,65,92,0,0,0,15,15,0,17,17,0,4,4,0,251,149,102,129,,153,2,151,135,0,135
14/07/2022 20:00,10,2,8,90,47,43,126,67,59,0,0,0,16,16,0,14,14,0,4,4,0,119,72,47,80,,100,2,98,114,0,114
14/07/2022 21:00,7,1,6,45,24,21,54,24,30,0,0,0,7,7,0,7,7,0,9,9,0,117,71,46,54,,88,0,88,82,0,82
14/07/2022 22:00,8,4,4,29,13,16,30,15,15,0,0,0,4,4,0,7,7,0,5,5,0,98,76,22,62,,67,0,67,56,2,54
14/07/2022 23:00,6,4,2,12,4,8,16,2,14,0,0,0,4,4,0,2,2,0,1,1,0,77,58,19,50,,48,0,48,31,1,30
15/07/2022 00:00,3,1,2,7,2,5,14,7,7,0,0,0,4,4,0,3,3,0,0,0,0,43,34,9,28,,33,0,33,12,0,12
15/07/2022 01:00,1,1,0,7,2,5,2,1,1,0,0,0,1,1,0,1,1,0,0,0,0,10,8,2,20,,5,0,5,0,0,0
15/07/2022 02:00,0,0,0,2,1,1,3,1,2,0,0,0,0,0,0,0,0,0,0,0,0,6,6,0,6,,10,1,9,3,0,3
15/07/2022 03:00,1,0,1,2,1,1,2,1,1,0,0,0,0,0,0,0,0,0,2,2,0,6,5,1,9,,9,0,9,3,0,3
15/07/2022 04:00,1,1,0,1,1,0,3,2,1,0,0,0,2,2,0,0,0,0,1,1,0,2,2,0,6,,1,0,1,2,0,2
15/07/2022 05:00,5,2,3,8,5,3,10,5,5,0,0,0,8,8,0,1,1,0,3,3,0,37,5,32,1,,6,0,6,8,0,8
15/07/2022 06:00,17,16,1,24,15,9,26,18,8,0,0,0,24,24,0,6,6,0,7,7,0,134,29,105,22,,11,0,11,54,0,54
15/07/2022 07:00,22,18,4,54,37,17,48,37,11,0,0,0,37,37,0,15,15,0,1,1,0,246,59,187,29,,28,1,27,66,0,66
15/07/2022 08:00,60,53,7,59,43,16,86,61,25,0,0,0,61,61,0,18,18,0,5,5,0,337,76,261,35,,54,0,54,137,0,137
15/07/2022 09:00,28,23,5,54,30,24,70,40,30,0,0,0,31,31,0,10,10,0,7,7,0,194,49,145,33,,53,0,53,127,1,126
15/07/2022 10:00,16,13,3,72,36,36,76,40,36,0,0,0,17,17,0,9,9,0,9,9,0,96,34,62,27,,30,0,30,62,0,62
15/07/2022 11:00,8,6,2,74,39,35,81,39,42,0,0,0,21,21,0,11,11,0,5,5,0,113,40,73,28,,57,0,57,80,0,80
15/07/2022 12:00,22,13,9,64,28,36,102,46,56,0,0,0,3,3,0,12,12,0,7,7,0,135,66,69,58,,76,0,76,100,0,100
15/07/2022 13:00,18,10,8,88,40,48,85,34,51,0,0,0,5,5,0,17,17,0,5,5,0,185,84,101,75,,78,1,77,112,2,110
15/07/2022 14:00,15,8,7,82,35,47,105,41,64,0,0,0,9,9,0,12,12,0,4,4,0,142,57,85,89,,85,2,83,84,0,84
15/07/2022 15:00,22,16,6,93,38,55,116,46,70,0,0,0,16,16,0,12,12,0,6,6,0,152,76,76,93,,69,2,67,96,0,96
15/07/2022 16:00,37,16,21,93,44,49,122,54,68,0,0,0,13,12,1,17,17,0,18,18,0,236,134,102,142,,132,2,130,99,1,98
15/07/2022 17:00,41,9,32,135,52,83,172,73,99,0,0,0,12,12,0,31,31,0,3,3,0,281,155,126,199,,159,1,158,133,0,133
15/07/2022 18:00,26,17,9,128,53,75,150,64,86,0,0,0,20,20,0,19,19,0,10,10,0,222,112,110,149,,160,1,159,140,0,140
15/07/2022 19:00,24,9,15,106,61,45,134,72,62,0,0,0,16,15,1,18,18,0,9,9,0,168,83,85,107,,112,1,111,110,0,110
15/07/2022 20:00,16,4,12,78,37,41,89,44,45,0,0,0,10,10,0,14,14,0,4,4,0,145,83,62,84,,97,1,96,102,0,102
15/07/2022 21:00,11,4,7,32,18,14,53,29,24,0,0,0,9,9,0,8,8,0,3,3,0,127,65,62,57,,57,1,56,93,0,93
15/07/2022 22:00,12,7,5,23,14,9,35,19,16,0,0,0,9,9,0,3,3,0,6,6,0,84,57,27,46,,61,0,61,62,2,60
15/07/2022 23:00,3,2,1,12,4,8,20,8,12,0,0,0,7,7,0,3,3,0,3,3,0,73,49,24,52,,54,2,52,30,0,30
16/07/2022 00:00,1,0,1,5,3,2,5,1,4,0,0,0,9,9,0,4,4,0,1,1,0,28,23,5,39,,28,0,28,26,0,26
16/07/2022 01:00,1,0,1,1,0,1,2,2,0,0,0,0,4,4,0,1,1,0,0,0,0,36,25,11,20,,18,1,17,1,0,1
16/07/2022 02:00,2,1,1,6,2,4,8,3,5,0,0,0,0,0,0,0,0,0,3,3,0,22,17,5,13,,32,0,32,8,1,7
16/07/2022 03:00,0,0,0,1,1,0,3,1,2,0,0,0,1,1,0,1,1,0,0,0,0,12,10,2,11,,14,0,14,3,0,3
16/07/2022 04:00,1,0,1,0,0,0,2,0,2,0,0,0,1,1,0,0,0,0,0,0,0,8,3,5,11,,5,0,5,3,0,3
16/07/2022 05:00,3,1,2,12,4,8,7,2,5,0,0,0,3,3,0,2,2,0,2,2,0,10,3,7,5,,7,0,7,5,0,5
16/07/2022 06:00,2,2,0,11,5,6,18,7,11,0,0,0,11,11,0,4,4,0,2,2,0,46,10,36,14,,6,0,6,15,0,15
16/07/2022 07:00,8,6,2,58,25,33,49,20,29,0,0,0,11,11,0,6,6,0,2,2,0,82,19,63,16,,13,0,13,19,0,19
16/07/2022 08:00,10,9,1,86,40,46,87,39,48,0,0,0,17,17,0,7,7,0,3,3,0,77,26,51,20,,17,0,17,47,0,47
16/07/2022 09:00,15,11,4,115,52,63,132,59,73,0,0,0,14,13,1,12,12,0,5,5,0,82,16,66,32,,28,0,28,56,0,56
16/07/2022 10:00,25,20,5,135,70,65,159,68,91,0,0,0,12,12,0,7,7,0,1,1,0,96,41,55,44,,46,0,46,81,0,81
16/07/2022 11:00,21,18,3,223,85,138,235,67,168,0,0,0,1,1,0,9,9,0,2,2,0,142,64,78,65,,60,0,60,93,0,93
16/07/2022 12:00,21,14,7,179,83,96,249,96,153,0,0,0,3,3,0,8,8,0,8,8,0,124,40,84,75,,69,0,69,105,2,103
16/07/2022 13:00,16,8,8,197,84,113,300,124,176,0,0,0,1,1,0,15,15,0,2,2,0,151,54,97,87,,67,0,67,96,0,96
16/07/2022 14:00,33,20,13,190,86,104,344,127,217,0,0,0,4,4,0,16,16,0,4,4,0,152,56,96,99,,64,1,63,88,0,88
16/07/2022 15:00,21,10,11,202,94,108,309,154,155,0,0,0,13,13,0,13,13,0,3,3,0,149,64,85,74,,108,1,107,105,0,105
16/07/2022 16:00,25,17,8,194,107,87,312,195,117,0,0,0,16,15,1,23,23,0,5,5,0,152,81,71,76,,90,1,89,106,0,106
16/07/2022 17:00,15,6,9,139,75,64,253,154,99,0,0,0,10,10,0,16,16,0,3,3,0,140,76,64,69,,93,0,93,117,0,117
16/07/2022 18:00,13,9,4,133,80,53,195,122,73,0,0,0,11,11,0,27,27,0,9,9,0,148,75,73,89,,106,1,105,117,0,117
16/07/2022 19:00,7,3,4,97,54,43,126,80,46,0,0,0,7,7,0,8,8,0,9,9,0,134,75,59,56,,86,0,86,94,0,94
16/07/2022 20:00,14,5,9,55,36,19,86,48,38,0,0,0,7,7,0,14,14,0,4,4,0,109,54,55,53,,65,1,64,119,0,119
16/07/2022 21:00,10,4,6,40,26,14,56,38,18,0,0,0,6,6,0,7,7,0,3,3,0,81,43,38,44,,54,2,52,82,0,82
16/07/2022 22:00,11,8,3,27,12,15,34,23,11,0,0,0,5,5,0,2,2,0,2,2,0,53,29,24,46,,40,1,39,49,0,49
16/07/2022 23:00,8,5,3,23,12,11,25,15,10,0,0,0,7,7,0,3,3,0,0,0,0,51,35,16,38,,41,0,41,37,0,37
17/07/2022 00:00,1,0,1,1,0,1,11,5,6,0,0,0,2,2,0,0,0,0,0,0,0,37,29,8,30,,36,0,36,19,0,19
17/07/2022 01:00,0,0,0,8,4,4,2,1,1,0,0,0,3,3,0,1,1,0,1,1,0,31,20,11,28,,13,0,13,2,0,2
17/07/2022 02:00,1,0,1,4,3,1,7,2,5,0,0,0,1,1,0,0,0,0,0,0,0,18,14,4,15,,26,1,25,8,0,8
17/07/2022 03:00,1,0,1,4,3,1,4,1,3,0,0,0,0,0,0,0,0,0,0,0,0,16,9,7,14,,15,0,15,4,0,4
17/07/2022 04:00,1,0,1,0,0,0,1,0,1,0,0,0,0,0,0,2,2,0,1,1,0,9,5,4,3,,8,0,8,5,0,5
17/07/2022 05:00,1,1,0,3,1,2,6,1,5,0,0,0,2,2,0,1,1,0,1,1,0,5,1,4,5,,1,0,1,2,0,2
17/07/2022 06:00,3,1,2,16,8,8,9,5,4,0,0,0,5,5,0,2,2,0,3,3,0,25,4,21,7,,4,0,4,7,0,7
17/07/2022 07:00,5,3,2,55,24,31,49,16,33,0,0,0,17,17,0,3,3,0,11,11,0,34,9,25,16,,14,0,14,12,0,12
17/07/2022 08:00,5,5,0,106,46,60,116,43,73,0,0,0,11,11,0,2,2,0,7,7,0,69,29,40,19,,17,0,17,21,0,21
17/07/2022 09:00,9,5,4,120,50,70,140,58,82,0,0,0,13,13,0,8,8,0,13,13,0,67,17,50,31,,21,0,21,35,0,35
17/07/2022 10:00,5,3,2,180,68,112,195,69,126,0,0,0,14,14,0,8,8,0,7,7,0,89,27,62,43,,34,0,34,60,0,60
17/07/2022 11:00,16,12,4,193,93,100,263,103,160,0,0,0,8,8,0,11,11,0,15,15,0,92,23,69,58,,47,2,45,73,0,73
17/07/2022 12:00,6,4,2,214,100,114,265,110,155,0,0,0,4,3,1,16,16,0,10,10,0,142,55,87,92,,56,0,56,100,0,100
17/07/2022 13:00,24,11,13,171,75,96,282,119,163,0,0,0,1,1,0,15,15,0,12,12,0,124,50,74,89,,67,0,67,92,0,92
17/07/2022 14:00,22,12,10,162,70,92,284,113,171,0,0,0,0,0,0,19,19,0,13,13,0,130,45,85,87,,61,0,61,90,0,90
17/07/2022 15:00,21,11,10,160,74,86,283,117,166,0,0,0,7,7,0,14,14,0,12,12,0,109,42,67,62,,66,1,65,69,0,69
17/07/2022 16:00,11,4,7,125,70,55,287,148,139,0,0,0,11,11,0,15,15,0,6,6,0,102,48,54,71,,57,0,57,76,0,76
17/07/2022 17:00,24,13,11,119,67,52,277,189,88,0,0,0,2,2,0,15,15,0,15,15,0,108,58,50,90,,93,0,93,90,1,89
17/07/2022 18:00,13,3,10,134,81,53,187,107,80,0,0,0,6,5,1,12,12,0,6,6,0,108,46,62,67,,88,0,88,71,0,71
17/07/2022 19:00,20,10,10,104,59,45,144,76,68,0,0,0,5,5,0,19,19,0,8,8,0,122,63,59,58,,62,1,61,60,0,60
17/07/2022 20:00,11,3,8,87,50,37,128,85,43,0,0,0,11,11,0,12,12,0,3,3,0,124,64,60,59,,54,0,54,62,0,62
17/07/2022 21:00,16,10,6,37,21,16,66,35,31,0,0,0,5,5,0,8,8,0,7,7,0,107,62,45,51,,77,1,76,62,0,62
17/07/2022 22:00,13,5,8,27,21,6,34,21,13,0,0,0,1,1,0,5,5,0,4,4,0,69,45,24,36,,12,1,11,66,0,66
17/07/2022 23:00,6,4,2,11,7,4,24,11,13,0,0,0,4,3,1,6,6,0,1,1,0,33,27,6,33,,0,0,0,24,1,23
18/07/2022 00:00,0,0,0,9,7,2,9,3,6,0,0,0,3,3,0,1,1,0,2,2,0,29,20,9,12,,24,0,24,13,0,13
18/07/2022 01:00,3,2,1,2,1,1,1,0,1,0,0,0,1,1,0,0,0,0,0,0,0,8,7,1,17,,6,0,6,0,0,0
18/07/2022 02:00,1,0,1,3,2,1,3,0,3,0,0,0,0,0,0,0,0,0,1,1,0,7,6,1,4,,11,0,11,5,1,4
18/07/2022 03:00,2,1,1,0,0,0,0,0,0,0,0,0,0,0,0,0,0,0,0,0,0,3,0,3,3,,0,0,0,1,0,1
18/07/2022 04:00,2,1,1,1,1,0,5,3,2,0,0,0,2,2,0,0,0,0,3,3,0,8,3,5,1,,4,0,4,3,0,3
18/07/2022 05:00,5,5,0,13,9,4,17,9,8,0,0,0,5,5,0,2,2,0,4,4,0,45,9,36,2,,3,0,3,11,0,11
18/07/2022 06:00,17,16,1,31,26,5,40,27,13,0,0,0,24,24,0,6,6,0,7,7,0,136,29,107,27,,15,0,15,37,0,37
18/07/2022 07:00,38,29,9,96,68,28,113,80,33,0,0,0,59,59,0,11,11,0,18,18,0,252,65,187,42,,29,0,29,77,1,76
18/07/2022 08:00,74,67,7,100,78,22,134,101,33,0,0,0,56,56,0,20,20,0,30,30,0,410,87,323,37,,69,0,69,153,1,152
18/07/2022 09:00,28,25,3,73,42,31,87,47,40,0,0,0,28,28,0,15,15,0,14,14,0,196,36,160,32,,37,0,37,109,0,109
18/07/2022 10:00,16,11,5,121,57,64,126,50,76,0,0,0,6,6,0,12,12,0,4,4,0,88,26,62,32,,35,0,35,81,1,80
18/07/2022 11:00,12,8,4,98,43,55,144,66,78,0,0,0,7,7,0,10,10,0,8,8,0,88,27,61,45,,41,0,41,68,0,68
18/07/2022 12:00,18,10,8,139,54,85,159,60,99,0,0,0,6,6,0,10,10,0,7,7,0,130,43,87,54,,77,1,76,94,1,93
18/07/2022 13:00,17,12,5,114,55,59,200,93,107,0,0,0,11,11,0,17,17,0,15,15,0,145,64,81,72,,80,0,80,91,1,90
18/07/2022 14:00,20,14,6,133,52,81,200,71,129,0,0,0,5,5,0,14,14,0,15,15,0,131,68,63,82,,79,0,79,69,1,68
18/07/2022 15:00,16,11,5,142,65,77,212,74,138,0,0,0,6,6,0,28,28,0,10,10,0,160,73,87,109,,64,1,63,80,0,80
18/07/2022 16:00,36,17,19,147,56,91,279,126,153,0,0,0,5,5,0,38,38,0,17,17,0,221,129,92,174,,118,0,118,80,1,79
18/07/2022 17:00,66,21,45,197,73,124,381,143,238,0,0,0,15,15,0,33,33,0,23,23,0,376,224,152,294,,205,0,205,127,1,126
18/07/2022 18:00,30,12,18,223,92,131,379,164,215,0,0,0,16,16,0,22,22,0,22,22,0,312,180,132,197,,169,2,167,108,0,108
18/07/2022 19:00,36,14,22,157,79,78,302,160,142,0,0,0,8,8,0,17,17,0,11,11,0,187,118,69,131,,110,0,110,82,0,82
18/07/2022 20:00,21,5,16,115,62,53,188,102,86,0,0,0,4,4,0,19,19,0,10,10,0,137,84,53,60,,87,0,87,72,2,70
18/07/2022 21:00,11,5,6,77,50,27,119,70,49,0,0,0,6,6,0,14,14,0,6,6,0,134,92,42,52,,73,1,72,62,1,61
18/07/2022 22:00,7,5,2,41,24,17,67,44,23,0,0,0,4,4,0,7,7,0,3,3,0,74,55,19,39,,57,1,56,48,0,48
18/07/2022 23:00,3,2,1,18,13,5,26,14,12,0,0,0,5,5,0,8,8,0,2,2,0,56,40,16,30,,33,0,33,22,0,22
19/07/2022 00:00,3,2,1,10,7,3,4,3,1,0,0,0,2,2,0,3,3,0,1,1,0,23,23,0,11,,19,0,19,8,0,8
19/07/2022 01:00,1,0,1,1,1,0,2,1,1,0,0,0,1,1,0,0,0,0,0,0,0,8,5,3,14,,2,0,2,0,0,0
19/07/2022 02:00,0,0,0,3,1,2,3,1,2,0,0,0,1,1,0,1,1,0,1,1,0,4,3,1,4,,6,0,6,3,0,3
19/07/2022 03:00,0,0,0,0,0,0,1,1,0,0,0,0,1,1,0,0,0,0,0,0,0,6,3,3,2,,1,0,1,1,0,1
19/07/2022 04:00,1,1,0,3,2,1,6,2,4,0,0,0,1,1,0,0,0,0,0,0,0,1,0,1,4,,1,0,1,4,1,3
19/07/2022 05:00,4,3,1,12,8,4,19,8,11,0,0,0,5,5,0,3,3,0,3,3,0,40,11,29,3,,4,0,4,10,0,10
19/07/2022 06:00,13,11,2,51,35,16,53,36,17,0,0,0,31,30,1,12,12,0,5,5,0,133,24,109,16,,10,0,10,39,0,39
19/07/2022 07:00,42,36,6,103,79,24,114,81,33,0,0,0,60,60,0,15,15,0,16,16,0,314,72,242,47,,33,1,32,94,1,93
19/07/2022 08:00,103,92,11,120,91,29,163,119,44,0,0,0,83,83,0,31,31,0,26,26,0,499,76,423,45,,66,1,65,205,0,205
19/07/2022 09:00,43,39,4,75,48,27,100,61,39,0,0,0,24,24,0,11,11,0,20,20,0,230,29,201,38,,42,0,42,126,0,126
19/07/2022 10:00,13,7,6,72,36,36,96,42,54,0,0,0,12,12,0,16,16,0,8,8,0,89,26,63,19,,32,0,32,65,0,65
19/07/2022 11:00,14,10,4,96,47,49,106,51,55,0,0,0,4,4,0,6,6,0,8,8,0,112,32,80,27,,41,0,41,59,0,59
19/07/2022 12:00,17,8,9,79,39,40,98,48,50,0,0,0,12,12,0,9,9,0,10,10,0,111,43,68,37,,54,0,54,97,0,97
19/07/2022 13:00,13,4,9,57,24,33,88,44,44,0,0,0,4,4,0,9,9,0,9,9,0,114,48,66,68,,79,1,78,90,1,89
19/07/2022 14:00,13,6,7,46,20,26,68,30,38,0,0,0,12,12,0,14,14,0,10,10,0,121,55,66,77,,77,1,76,72,0,72
19/07/2022 15:00,21,11,10,88,38,50,107,51,56,0,0,0,8,8,0,13,13,0,12,12,0,160,84,76,88,,71,0,71,74,1,73
19/07/2022 16:00,44,24,20,90,42,48,160,62,98,0,0,0,11,10,1,19,19,0,21,21,0,230,124,106,188,,139,1,138,105,0,105
19/07/2022 17:00,68,22,46,175,59,116,309,96,213,0,0,0,6,6,0,35,35,0,33,33,0,412,258,154,351,,231,0,231,139,1,138
19/07/2022 18:00,64,18,46,202,67,135,339,134,205,0,0,0,19,19,0,34,34,0,22,22,0,381,240,141,246,,199,0,199,131,1,130
19/07/2022 19:00,32,14,18,162,75,87,269,146,123,0,0,0,14,13,1,25,25,0,9,9,0,229,136,93,130,,115,1,114,119,1,118
19/07/2022 20:00,17,3,14,101,50,51,144,83,61,0,0,0,9,9,0,22,22,0,7,7,0,158,81,77,86,,119,0,119,111,0,111
19/07/2022 21:00,15,4,11,47,29,18,74,45,29,0,0,0,12,12,0,15,15,0,4,4,0,126,82,44,61,,90,0,90,69,0,69
19/07/2022 22:00,6,3,3,23,12,11,29,19,10,0,0,0,4,4,0,4,4,0,2,2,0,79,65,14,50,,62,1,61,45,2,43
19/07/2022 23:00,6,3,3,5,2,3,7,1,6,0,0,0,3,3,0,0,0,0,0,0,0,45,35,10,30,,29,0,29,22,0,22
20/07/2022 00:00,8,2,6,4,2,2,5,1,4,0,0,0,2,2,0,1,1,0,1,1,0,18,17,1,19,,16,0,16,4,0,4
20/07/2022 01:00,0,0,0,2,1,1,2,1,1,0,0,0,0,0,0,1,1,0,0,0,0,6,5,1,7,,4,0,4,1,0,1
20/07/2022 02:00,1,0,1,1,0,1,2,0,2,0,0,0,0,0,0,0,0,0,0,0,0,3,3,0,4,,7,0,7,4,0,4
20/07/2022 03:00,0,0,0,0,0,0,0,0,0,0,0,0,1,1,0,0,0,0,0,0,0,2,2,0,3,,2,0,2,0,0,0
20/07/2022 04:00,2,2,0,1,1,0,3,2,1,0,0,0,1,1,0,0,0,0,0,0,0,5,4,1,3,,4,0,4,2,0,2
20/07/2022 05:00,6,6,0,9,5,4,12,5,7,0,0,0,7,7,0,0,0,0,0,0,0,37,5,32,4,,5,0,5,9,0,9
20/07/2022 06:00,19,18,1,48,33,15,56,34,22,0,0,0,33,33,0,5,5,0,2,2,0,155,32,123,15,,15,0,15,50,0,50
20/07/2022 07:00,53,45,8,103,76,27,105,76,29,0,0,0,51,51,0,16,16,0,16,16,0,307,80,227,35,,43,0,43,89,0,89
20/07/2022 08:00,102,90,12,106,82,24,149,117,32,0,0,0,105,105,0,20,20,0,26,26,0,555,106,449,43,,78,1,77,213,1,212
20/07/2022 09:00,49,41,8,75,47,28,79,54,25,0,0,0,33,33,0,14,14,0,23,23,0,251,44,207,28,,50,0,50,144,0,144
20/07/2022 10:00,15,10,5,50,19,31,63,29,34,0,0,0,24,24,0,9,9,0,17,17,0,93,27,66,29,,22,0,22,69,0,69
20/07/2022 11:00,9,7,2,60,30,30,69,37,32,0,0,0,4,4,0,11,11,0,11,11,0,86,22,64,27,,19,0,19,70,2,68
20/07/2022 12:00,4,3,1,67,37,30,96,47,49,0,0,0,7,7,0,17,17,0,10,10,0,104,34,70,58,,63,1,62,109,1,108
20/07/2022 13:00,13,9,4,55,24,31,73,32,41,0,0,0,16,16,0,13,13,0,14,14,0,124,62,62,63,,65,1,64,87,0,87
20/07/2022 14:00,7,4,3,42,21,21,57,24,33,0,0,0,5,5,0,15,15,0,13,13,0,121,53,68,60,,82,3,79,80,0,80
20/07/2022 15:00,15,6,9,50,24,26,75,35,40,0,0,0,2,2,0,22,22,0,14,14,0,146,78,68,76,,68,0,68,78,0,78
20/07/2022 16:00,32,14,18,61,24,37,93,30,63,0,0,0,5,5,0,17,17,0,19,19,0,240,144,96,191,,134,0,134,84,0,84
20/07/2022 17:00,63,20,43,138,41,97,186,53,133,0,0,0,16,15,1,29,29,0,29,29,0,420,275,145,304,,222,0,222,131,1,130
20/07/2022 18:00,53,23,30,137,36,101,187,49,138,0,0,0,21,21,0,25,25,0,25,25,0,340,226,114,265,,225,2,223,121,1,120
20/07/2022 19:00,31,8,23,129,56,73,169,74,95,0,0,0,19,19,0,23,23,0,12,12,0,203,126,77,99,,141,1,140,131,1,130
20/07/2022 20:00,29,13,16,103,52,51,125,68,57,0,0,0,11,10,1,18,18,0,16,16,0,168,104,64,80,,102,0,102,90,0,90
20/07/2022 21:00,14,9,5,45,20,25,61,28,33,0,0,0,10,10,0,9,9,0,8,8,0,131,68,63,61,,77,0,77,66,0,66
20/07/2022 22:00,8,3,5,17,6,11,24,6,18,0,0,0,6,6,0,10,10,0,7,7,0,94,53,41,70,,52,0,52,44,0,44
20/07/2022 23:00,1,1,0,2,1,1,12,3,9,0,0,0,8,8,0,3,3,0,3,3,0,46,36,10,35,,48,0,48,25,0,25
21/07/2022 00:00,2,1,1,7,3,4,8,2,6,0,0,0,5,5,0,1,1,0,0,0,0,37,30,7,30,,27,0,27,7,0,7
21/07/2022 01:00,0,0,0,1,1,0,1,1,0,0,0,0,1,1,0,1,1,0,0,0,0,12,8,4,5,,2,0,2,0,0,0
21/07/2022 02:00,1,1,0,1,0,1,2,1,1,0,0,0,0,0,0,0,0,0,1,1,0,3,2,1,7,,11,0,11,3,0,3
21/07/2022 03:00,1,0,1,0,0,0,0,0,0,0,0,0,0,0,0,0,0,0,0,0,0,6,4,2,3,,4,0,4,3,0,3
21/07/2022 04:00,2,2,0,0,0,0,4,2,2,0,0,0,3,3,0,0,0,0,0,0,0,3,1,2,4,,3,0,3,2,0,2
21/07/2022 05:00,3,3,0,13,5,8,16,8,8,0,0,0,8,8,0,2,2,0,1,1,0,30,5,25,6,,5,0,5,7,0,7
21/07/2022 06:00,21,19,2,48,28,20,50,33,17,0,0,0,27,27,0,6,6,0,4,4,0,154,34,120,22,,13,0,13,49,0,49
21/07/2022 07:00,50,39,11,72,58,14,90,68,22,0,0,0,32,31,1,22,22,0,24,24,0,318,64,254,24,,36,0,36,88,0,88
21/07/2022 08:00,85,78,7,109,82,27,132,104,28,0,0,0,107,106,1,14,14,0,24,24,0,567,84,483,43,,83,0,83,196,0,196
21/07/2022 09:00,38,29,9,65,47,18,72,51,21,0,0,0,31,31,0,17,17,0,22,22,0,248,36,212,28,,31,2,29,140,0,140
21/07/2022 10:00,21,15,6,58,30,28,72,39,33,0,0,0,17,17,0,6,6,0,5,5,0,90,27,63,26,,31,0,31,69,0,69
21/07/2022 11:00,14,10,4,59,26,33,62,29,33,0,0,0,18,18,0,10,10,0,5,5,0,105,36,69,35,,48,1,47,96,0,96
21/07/2022 12:00,16,8,8,48,23,25,83,44,39,0,0,0,4,4,0,11,11,0,5,5,0,109,44,65,63,,74,1,73,113,1,112
21/07/2022 13:00,15,11,4,48,23,25,65,29,36,0,0,0,4,4,0,11,11,0,8,8,0,129,49,80,64,,89,2,87,120,1,119
21/07/2022 14:00,14,5,9,56,26,30,78,33,45,0,0,0,6,6,0,15,15,0,4,4,0,115,52,63,58,,118,0,118,91,0,91
21/07/2022 15:00,23,7,16,64,31,33,85,41,44,0,0,0,3,3,0,13,13,0,4,4,0,139,66,73,89,,60,0,60,95,0,95
21/07/2022 16:00,31,15,16,78,33,45,82,29,53,0,0,0,9,8,1,24,24,0,6,6,0,230,121,109,173,,114,2,112,98,0,98
21/07/2022 17:00,52,13,39,111,40,71,167,44,123,0,0,0,9,9,0,21,21,0,17,17,0,392,257,135,276,,211,0,211,150,0,150
21/07/2022 18:00,43,8,35,163,44,119,212,59,153,0,0,0,10,10,0,35,35,0,11,11,0,339,214,125,233,,218,0,218,132,1,131
21/07/2022 19:00,24,8,16,122,57,65,168,67,101,0,0,0,15,15,0,26,26,0,8,8,0,202,119,83,123,,149,2,147,138,0,138
21/07/2022 20:00,20,8,12,107,59,48,118,59,59,0,0,0,17,17,0,13,13,0,13,13,0,152,93,59,69,,116,0,116,113,0,113
21/07/2022 21:00,18,9,9,50,30,20,62,31,31,0,0,0,12,12,0,9,9,0,4,4,0,131,88,43,90,,103,1,102,90,0,90
21/07/2022 22:00,13,8,5,18,4,14,29,7,22,0,0,0,5,5,0,5,5,0,12,12,0,81,67,14,72,,71,1,70,54,0,54
21/07/2022 23:00,3,3,0,8,4,4,17,4,13,0,0,0,2,2,0,2,2,0,2,2,0,55,43,12,39,,52,1,51,24,1,23
22/07/2022 00:00,1,0,1,8,4,4,10,3,7,0,0,0,4,4,0,2,2,0,1,1,0,30,28,2,31,,31,0,31,10,0,10
22/07/2022 01:00,1,0,1,1,1,0,1,1,0,0,0,0,0,0,0,1,1,0,0,0,0,11,9,2,6,,11,0,11,0,0,0
22/07/2022 02:00,0,0,0,2,1,1,3,2,1,0,0,0,1,1,0,0,0,0,0,0,0,10,8,2,11,,8,0,8,4,0,4
22/07/2022 03:00,1,0,1,1,1,0,2,0,2,0,0,0,0,0,0,0,0,0,1,1,0,8,6,2,6,,9,0,9,1,0,1
22/07/2022 04:00,3,1,2,1,1,0,3,1,2,0,0,0,2,2,0,1,1,0,0,0,0,9,4,5,5,,1,0,1,3,0,3
22/07/2022 05:00,3,2,1,14,9,5,16,11,5,0,0,0,5,5,0,1,1,0,1,1,0,31,8,23,2,,4,0,4,8,0,8
22/07/2022 06:00,18,16,2,27,14,13,33,21,12,0,0,0,31,30,1,7,7,0,8,8,0,148,30,118,15,,11,0,11,40,0,40
22/07/2022 07:00,30,24,6,75,50,25,71,49,22,0,0,0,46,46,0,9,9,0,9,9,0,243,65,178,28,,29,0,29,75,0,75
22/07/2022 08:00,56,50,6,66,48,18,106,69,37,0,0,0,66,66,0,13,13,0,26,26,0,341,67,274,39,,56,0,56,129,1,128
22/07/2022 09:00,29,25,4,66,34,32,96,54,42,0,0,0,28,28,0,11,11,0,13,13,0,177,40,137,26,,41,0,41,119,1,118
22/07/2022 10:00,14,10,4,71,32,39,104,56,48,0,0,0,27,27,0,13,13,0,9,9,0,110,34,76,28,,32,1,31,60,0,60
22/07/2022 11:00,10,6,4,85,38,47,106,50,56,0,0,0,18,18,0,11,11,0,5,5,0,109,43,66,36,,56,1,55,79,0,79
22/07/2022 12:00,17,10,7,83,41,42,116,54,62,0,0,0,2,2,0,16,16,0,9,9,0,122,54,68,69,,68,1,67,127,0,127
22/07/2022 13:00,16,8,8,82,43,39,123,62,61,0,0,0,5,5,0,18,18,0,15,15,0,139,61,78,89,,97,0,97,127,1,126
22/07/2022 14:00,12,9,3,92,44,48,117,56,61,0,0,0,6,6,0,16,16,0,3,3,0,137,71,66,81,,99,2,97,97,0,97
22/07/2022 15:00,22,11,11,109,58,51,121,59,62,0,0,0,7,7,0,11,11,0,9,9,0,157,74,83,86,,79,0,79,105,1,104
22/07/2022 16:00,32,16,16,104,39,65,144,54,90,0,0,0,6,6,0,22,22,0,27,27,0,231,120,111,150,,162,1,161,94,1,93
22/07/2022 17:00,42,19,23,136,53,83,167,62,105,0,0,0,14,14,0,33,33,0,24,24,0,305,176,129,185,,181,2,179,156,0,156
22/07/2022 18:00,33,12,21,111,43,68,211,81,130,0,0,0,17,17,0,30,30,0,25,25,0,252,142,110,148,,164,1,163,141,0,141
22/07/2022 19:00,20,10,10,94,54,40,151,83,68,0,0,0,14,14,0,15,15,0,14,14,0,160,86,74,85,,113,2,111,140,2,138
22/07/2022 20:00,15,4,11,73,40,33,98,51,47,0,0,0,13,13,0,13,13,0,5,5,0,124,59,65,60,,98,0,98,125,2,123
22/07/2022 21:00,21,8,13,34,17,17,49,28,21,0,0,0,11,11,0,13,13,0,10,10,0,119,72,47,57,,83,2,81,116,0,116
22/07/2022 22:00,4,3,1,18,8,10,24,11,13,0,0,0,8,8,0,3,3,0,2,2,0,77,47,30,54,,55,0,55,59,1,58
22/07/2022 23:00,7,4,3,7,2,5,13,6,7,0,0,0,6,6,0,4,4,0,2,2,0,51,44,7,45,,45,2,43,53,1,52
23/07/2022 00:00,4,0,4,4,2,2,1,1,0,0,0,0,4,4,0,2,2,0,2,2,0,34,20,14,33,,37,1,36,16,0,16
23/07/2022 01:00,2,1,1,2,1,1,4,2,2,0,0,0,1,1,0,1,1,0,1,1,0,36,28,8,20,,9,0,9,1,0,1
23/07/2022 02:00,0,0,0,4,2,2,2,1,1,0,0,0,1,1,0,1,1,0,1,1,0,25,21,4,16,,13,0,13,6,0,6
23/07/2022 03:00,0,0,0,1,0,1,1,0,1,0,0,0,0,0,0,0,0,0,1,1,0,14,12,2,8,,26,0,26,4,0,4
23/07/2022 04:00,2,0,2,0,0,0,2,1,1,0,0,0,2,2,0,0,0,0,0,0,0,10,5,5,5,,3,0,3,4,0,4
23/07/2022 05:00,0,0,0,3,1,2,3,0,3,0,0,0,2,2,0,1,1,0,0,0,0,18,10,8,6,,2,0,2,0,0,0
23/07/2022 06:00,3,3,0,7,1,6,14,6,8,0,0,0,6,6,0,1,1,0,2,2,0,29,5,24,11,,10,1,9,12,0,12
23/07/2022 07:00,4,3,1,14,9,5,10,2,8,0,0,0,8,8,0,3,3,0,3,3,0,42,9,33,8,,8,0,8,8,1,7
23/07/2022 08:00,3,3,0,25,13,12,21,9,12,0,0,0,10,9,1,3,3,0,2,2,0,56,17,39,16,,10,0,10,23,0,23
23/07/2022 09:00,8,6,2,40,16,24,54,19,35,0,0,0,13,13,0,5,5,0,8,8,0,69,25,44,12,,18,0,18,60,0,60
23/07/2022 10:00,18,16,2,36,17,19,51,24,27,0,0,0,8,8,0,1,1,0,4,4,0,92,26,66,25,,50,1,49,56,0,56
23/07/2022 11:00,10,5,5,57,23,34,61,22,39,0,0,0,4,4,0,6,6,0,4,4,0,94,37,57,33,,45,0,45,81,1,80
23/07/2022 12:00,9,6,3,67,33,34,79,36,43,0,0,0,2,2,0,5,5,0,11,11,0,86,31,55,50,,52,1,51,95,1,94
23/07/2022 13:00,14,8,6,72,34,38,91,36,55,0,0,0,6,6,0,8,8,0,10,10,0,112,43,69,44,,63,1,62,102,0,102
23/07/2022 14:00,12,9,3,99,42,57,117,44,73,0,0,0,7,7,0,6,6,0,15,15,0,108,46,62,74,,76,0,76,106,0,106
23/07/2022 15:00,13,5,8,92,44,48,139,72,67,0,0,0,14,14,0,11,11,0,8,8,0,129,54,75,51,,87,1,86,118,0,118
23/07/2022 16:00,22,10,12,83,42,41,105,63,42,0,0,0,14,12,2,15,15,0,11,11,0,105,38,67,37,,72,0,72,97,0,97
23/07/2022 17:00,12,5,7,62,28,34,99,42,57,0,0,0,13,13,0,12,12,0,13,13,0,115,56,59,47,,100,0,100,83,0,83
23/07/2022 18:00,16,9,7,62,31,31,74,30,44,0,0,0,13,13,0,11,11,0,9,9,0,95,46,49,62,,102,1,101,96,2,94
23/07/2022 19:00,16,7,9,28,19,9,43,23,20,0,0,0,4,4,0,5,5,0,4,4,0,110,57,53,57,,75,0,75,89,1,88
23/07/2022 20:00,9,6,3,29,16,13,38,16,22,0,0,0,14,14,0,5,5,0,3,3,0,75,39,36,50,,55,0,55,97,0,97
23/07/2022 21:00,9,5,4,17,7,10,20,10,10,0,0,0,9,9,0,3,3,0,4,4,0,79,42,37,34,,57,1,56,61,0,61
23/07/2022 22:00,7,4,3,6,3,3,13,7,6,0,0,0,9,9,0,5,5,0,2,2,0,53,39,14,27,,48,0,48,56,0,56
23/07/2022 23:00,6,4,2,3,2,1,20,7,13,0,0,0,9,9,0,2,2,0,1,1,0,53,41,12,25,,36,0,36,34,0,34
24/07/2022 00:00,3,1,2,3,2,1,7,4,3,0,0,0,4,4,0,4,4,0,0,0,0,32,22,10,32,,23,0,23,19,0,19
24/07/2022 01:00,2,1,1,4,0,4,0,0,0,0,0,0,2,2,0,1,1,0,0,0,0,30,18,12,18,,6,0,6,0,0,0
24/07/2022 02:00,0,0,0,8,7,1,6,3,3,0,0,0,1,1,0,0,0,0,1,1,0,11,11,0,8,,20,1,19,2,0,2
24/07/2022 03:00,2,0,2,2,1,1,6,2,4,0,0,0,1,1,0,0,0,0,1,1,0,22,17,5,9,,19,1,18,6,1,5
24/07/2022 04:00,0,0,0,1,0,1,2,1,1,0,0,0,1,1,0,0,0,0,0,0,0,16,9,7,5,,13,0,13,7,0,7
24/07/2022 05:00,1,1,0,5,1,4,6,2,4,0,0,0,2,2,0,0,0,0,0,0,0,5,1,4,3,,3,0,3,3,0,3
24/07/2022 06:00,3,2,1,7,3,4,12,5,7,0,0,0,12,12,0,0,0,0,2,2,0,27,7,20,8,,5,0,5,7,0,7
24/07/2022 07:00,6,4,2,46,17,29,53,17,36,0,0,0,12,12,0,6,6,0,2,2,0,49,12,37,17,,8,0,8,13,0,13
24/07/2022 08:00,10,6,4,81,33,48,97,34,63,0,0,0,12,12,0,4,4,0,4,4,0,58,18,40,29,,20,0,20,23,1,22
24/07/2022 09:00,8,6,2,114,51,63,161,60,101,0,0,0,11,11,0,8,8,0,7,7,0,81,15,66,28,,2,0,2,42,0,42
24/07/2022 10:00,17,12,5,162,80,82,203,85,118,0,0,0,11,11,0,9,9,0,15,15,0,93,30,63,31,,8,0,8,57,2,55
24/07/2022 11:00,9,5,4,188,92,96,231,100,131,0,0,0,2,2,0,13,13,0,21,21,0,110,38,72,52,,53,2,51,66,0,66
24/07/2022 12:00,9,5,4,157,82,75,216,107,109,0,0,0,1,1,0,20,20,0,8,8,0,117,47,70,48,,55,0,55,102,0,102
24/07/2022 13:00,15,8,7,135,67,68,168,87,81,0,0,0,2,2,0,23,23,0,8,8,0,137,54,83,47,,66,0,66,109,0,109
24/07/2022 14:00,24,6,18,71,42,29,145,70,75,0,0,0,2,2,0,15,15,0,13,13,0,101,50,51,75,,86,2,84,118,2,116
24/07/2022 15:00,12,8,4,78,37,41,126,67,59,0,0,0,2,2,0,12,12,0,4,4,0,92,42,50,63,,77,1,76,92,1,91
24/07/2022 16:00,19,8,11,63,35,28,82,45,37,0,0,0,2,1,1,12,12,0,3,3,0,100,41,59,37,,70,0,70,105,0,105
24/07/2022 17:00,15,12,3,58,30,28,68,33,35,0,0,0,0,0,0,5,5,0,2,2,0,96,48,48,65,,94,1,93,83,0,83
24/07/2022 18:00,20,9,11,40,23,17,58,27,31,0,0,0,2,1,1,12,12,0,1,1,0,121,54,67,53,,77,0,77,99,0,99
24/07/2022 19:00,17,6,11,43,25,18,58,27,31,0,0,0,10,10,0,10,10,0,3,3,0,104,57,47,51,,72,0,72,65,0,65
24/07/2022 20:00,10,4,6,31,15,16,51,23,28,0,0,0,6,6,0,5,5,0,5,5,0,104,71,33,42,,79,0,79,55,2,53
24/07/2022 21:00,8,4,4,17,6,11,21,7,14,0,0,0,8,8,0,5,5,0,3,3,0,73,41,32,30,,58,0,58,52,0,52
24/07/2022 22:00,7,6,1,5,3,2,10,4,6,0,0,0,4,4,0,3,3,0,0,0,0,53,42,11,31,,43,1,42,38,1,37
24/07/2022 23:00,5,2,3,6,4,2,5,3,2,0,0,0,3,3,0,0,0,0,1,1,0,34,24,10,20,,21,1,20,21,0,21
25/07/2022 00:00,2,1,1,4,3,1,11,3,8,0,0,0,3,3,0,3,3,0,1,1,0,12,9,3,17,,17,0,17,12,0,12
25/07/2022 01:00,0,0,0,1,1,0,1,1,0,0,0,0,1,1,0,0,0,0,1,1,0,14,12,2,9,,7,0,7,3,0,3
25/07/2022 02:00,0,0,0,0,0,0,1,0,1,0,0,0,0,0,0,0,0,0,2,2,0,8,7,1,3,,4,0,4,3,0,3
25/07/2022 03:00,2,0,2,1,1,0,1,1,0,0,0,0,1,1,0,1,1,0,0,0,0,8,4,4,2,,10,0,10,1,0,1
25/07/2022 04:00,4,2,2,6,4,2,5,2,3,0,0,0,2,2,0,0,0,0,5,5,0,4,1,3,1,,1,0,1,2,0,2
25/07/2022 05:00,4,3,1,6,4,2,11,8,3,0,0,0,6,6,0,2,2,0,3,3,0,39,8,31,8,,6,0,6,6,0,6
25/07/2022 06:00,20,17,3,18,12,6,28,17,11,0,0,0,25,25,0,10,10,0,5,5,0,145,31,114,18,,12,0,12,38,1,37
25/07/2022 07:00,32,27,5,54,43,11,59,44,15,0,0,0,47,46,1,13,13,0,19,19,0,246,51,195,26,,36,0,36,75,0,75
25/07/2022 08:00,79,71,8,69,51,18,96,69,27,0,0,0,63,63,0,16,16,0,21,21,0,413,87,326,30,,71,0,71,152,1,151
25/07/2022 09:00,37,30,7,33,22,11,48,29,19,0,0,0,39,39,0,17,17,0,18,18,0,179,44,135,34,,50,1,49,129,0,129
25/07/2022 10:00,19,15,4,50,23,27,59,22,37,0,0,0,14,14,0,5,5,0,6,6,0,67,14,53,17,,20,0,20,53,0,53
25/07/2022 11:00,9,4,5,31,12,19,48,24,24,0,0,0,14,14,0,5,5,0,4,4,0,93,30,63,31,,31,0,31,56,0,56
25/07/2022 12:00,12,5,7,40,21,19,58,33,25,0,0,0,7,7,0,3,3,0,7,7,0,106,36,70,53,,63,1,62,85,1,84
25/07/2022 13:00,10,2,8,46,22,24,63,25,38,0,0,0,8,8,0,15,15,0,8,8,0,99,38,61,65,,83,1,82,87,0,87
25/07/2022 14:00,21,8,13,32,11,21,42,21,21,0,0,0,4,4,0,10,10,0,3,3,0,96,41,55,56,,68,2,66,65,1,64
25/07/2022 15:00,17,9,8,38,18,20,56,26,30,0,0,0,11,11,0,11,11,0,7,7,0,117,65,52,68,,81,0,81,75,0,75
25/07/2022 16:00,31,12,19,53,17,36,59,21,38,0,0,0,11,11,0,20,20,0,14,14,0,220,132,88,174,,111,0,111,86,1,85
25/07/2022 17:00,50,12,38,103,29,74,137,38,99,0,0,0,10,10,0,32,32,0,22,22,0,395,256,139,250,,199,2,197,129,1,128
25/07/2022 18:00,53,16,37,114,43,71,150,49,101,0,0,0,22,21,1,14,14,0,18,18,0,325,198,127,199,,209,2,207,136,1,135
25/07/2022 19:00,32,14,18,82,35,47,105,49,56,0,0,0,10,10,0,12,12,0,17,17,0,188,108,80,114,,134,2,132,108,0,108
25/07/2022 20:00,10,8,2,56,21,35,73,31,42,0,0,0,10,10,0,15,15,0,12,12,0,139,72,67,63,,95,0,95,74,0,74
25/07/2022 21:00,5,0,5,29,16,13,53,24,29,0,0,0,7,7,0,14,14,0,2,2,0,109,62,47,41,,79,1,78,64,0,64
25/07/2022 22:00,8,6,2,9,5,4,20,7,13,0,0,0,5,5,0,5,5,0,0,0,0,58,36,22,34,,48,0,48,37,0,37
25/07/2022 23:00,4,2,2,6,3,3,6,2,4,0,0,0,5,5,0,5,5,0,1,1,0,32,22,10,32,,39,0,39,12,0,12
26/07/2022 00:00,1,1,0,6,4,2,5,1,4,0,0,0,6,6,0,1,1,0,0,0,0,16,12,4,19,,14,0,14,12,0,12
26/07/2022 01:00,0,0,0,2,2,0,1,1,0,0,0,0,1,1,0,0,0,0,0,0,0,6,5,1,1,,2,1,1,0,0,0
26/07/2022 02:00,1,0,1,0,0,0,7,4,3,0,0,0,0,0,0,0,0,0,0,0,0,1,1,0,1,,7,0,7,3,0,3
26/07/2022 03:00,0,0,0,0,0,0,0,0,0,0,0,0,1,1,0,1,1,0,1,1,0,3,2,1,1,,2,0,2,1,0,1
26/07/2022 04:00,4,4,0,2,2,0,2,1,1,0,0,0,4,4,0,0,0,0,2,2,0,1,0,1,5,,4,0,4,3,0,3
26/07/2022 05:00,3,3,0,18,10,8,17,10,7,0,0,0,3,3,0,1,1,0,3,3,0,42,8,34,3,,5,0,5,9,0,9
26/07/2022 06:00,23,21,2,43,31,12,42,28,14,0,0,0,24,24,0,6,6,0,7,7,0,143,29,114,22,,9,0,9,32,0,32
26/07/2022 07:00,43,39,4,84,65,19,91,69,22,0,0,0,66,66,0,17,17,0,17,17,0,323,69,254,35,,37,0,37,93,0,93
26/07/2022 08:00,105,99,6,105,85,20,146,115,31,0,0,0,92,92,0,17,17,0,19,19,0,611,106,505,39,,63,0,63,232,2,230
26/07/2022 09:00,43,36,7,64,36,28,88,50,38,0,0,0,42,42,0,16,16,0,16,16,0,247,43,204,23,,40,0,40,141,0,141
26/07/2022 10:00,11,6,5,57,27,30,88,43,45,0,0,0,21,21,0,6,6,0,11,11,0,118,36,82,23,,44,1,43,70,0,70
26/07/2022 11:00,16,15,1,58,30,28,80,40,40,0,0,0,16,16,0,10,10,0,10,10,0,86,34,52,31,,49,0,49,66,0,66
26/07/2022 12:00,19,7,12,61,27,34,84,42,42,0,0,0,3,3,0,19,19,0,7,7,0,106,38,68,45,,71,1,70,127,0,127
26/07/2022 13:00,22,14,8,77,41,36,94,54,40,0,0,0,7,7,0,19,19,0,11,11,0,116,56,60,53,,87,1,86,102,0,102
26/07/2022 14:00,15,9,6,52,27,25,71,32,39,0,0,0,7,7,0,14,14,0,4,4,0,99,50,49,72,,83,2,81,78,1,77
26/07/2022 15:00,20,7,13,75,28,47,86,27,59,0,0,0,5,5,0,8,8,0,6,6,0,155,79,76,87,,76,0,76,84,1,83
26/07/2022 16:00,44,16,28,93,38,55,125,51,74,0,0,0,8,8,0,25,25,0,11,11,0,251,162,89,175,,127,0,127,87,0,87
26/07/2022 17:00,51,14,37,149,52,97,175,59,116,0,0,0,6,6,0,32,32,0,38,38,0,455,279,176,349,,264,2,262,133,1,132
26/07/2022 18:00,63,16,47,149,45,104,176,57,119,0,0,0,20,20,0,29,29,0,20,20,0,368,257,111,257,,220,0,220,136,1,135
26/07/2022 19:00,29,7,22,130,59,71,150,54,96,0,0,0,12,12,0,27,27,0,15,15,0,197,132,65,144,,135,1,134,114,0,114
26/07/2022 20:00,25,9,16,87,47,40,124,69,55,0,0,0,11,11,0,17,17,0,14,14,0,186,98,88,71,,99,0,99,102,1,101
26/07/2022 21:00,12,6,6,63,29,34,72,36,36,0,0,0,3,3,0,15,15,0,12,12,0,107,67,40,58,,75,0,75,68,0,68
26/07/2022 22:00,5,2,3,16,7,9,19,8,11,0,0,0,9,9,0,3,3,0,5,5,0,75,59,16,39,,68,1,67,37,0,37
26/07/2022 23:00,0,0,0,6,1,5,13,4,9,0,0,0,6,6,0,3,3,0,1,1,0,44,32,12,20,,36,1,35,29,0,29
27/07/2022 00:00,3,0,3,2,1,1,2,1,1,0,0,0,3,3,0,1,1,0,1,1,0,28,22,6,0,,21,0,21,12,0,12
27/07/2022 01:00,1,1,0,6,2,4,3,1,2,0,0,0,3,3,0,0,0,0,1,1,0,10,6,4,0,,2,0,2,0,0,0
27/07/2022 02:00,0,0,0,1,1,0,2,0,2,0,0,0,2,2,0,0,0,0,0,0,0,4,3,1,0,,6,0,6,3,0,3
27/07/2022 03:00,0,0,0,2,1,1,0,0,0,0,0,0,0,0,0,0,0,0,0,0,0,2,2,0,0,,3,0,3,1,0,1
27/07/2022 04:00,0,0,0,4,3,1,5,2,3,0,0,0,2,2,0,0,0,0,1,1,0,6,2,4,0,,6,0,6,4,0,4
27/07/2022 05:00,5,5,0,12,8,4,12,8,4,0,0,0,7,7,0,1,1,0,3,3,0,37,11,26,0,,3,0,3,7,0,7
27/07/2022 06:00,20,16,4,45,32,13,52,34,18,0,0,0,32,31,1,9,9,0,4,4,0,153,29,124,0,,12,0,12,49,0,49
27/07/2022 07:00,48,43,5,88,65,23,93,66,27,0,0,0,55,55,0,14,14,0,19,19,0,317,75,242,0,,34,0,34,74,0,74
27/07/2022 08:00,102,97,5,108,80,28,135,102,33,0,0,0,93,92,1,15,15,0,25,25,0,538,81,457,0,,72,0,72,206,1,205
27/07/2022 09:00,41,35,6,75,43,32,88,50,38,0,0,0,46,46,0,12,12,0,22,22,0,241,39,202,0,,47,0,47,149,0,149
27/07/2022 10:00,22,17,5,71,39,32,89,45,44,0,0,0,29,29,0,12,12,0,11,11,0,92,23,69,0,,32,0,32,72,1,71
27/07/2022 11:00,15,12,3,70,35,35,77,38,39,0,0,0,19,19,0,7,7,0,11,11,0,95,29,66,0,,44,0,44,75,1,74
27/07/2022 12:00,16,13,3,80,47,33,99,53,46,0,0,0,6,5,1,14,14,0,11,11,0,90,32,58,0,,74,0,74,96,0,96
27/07/2022 13:00,22,17,5,67,36,31,99,50,49,0,0,0,6,6,0,11,11,0,9,9,0,121,48,73,0,,89,0,89,100,0,100
27/07/2022 14:00,10,4,6,65,28,37,86,45,41,0,0,0,4,4,0,12,12,0,4,4,0,101,48,53,0,,89,1,88,70,0,70
27/07/2022 15:00,12,2,10,71,28,43,71,28,43,0,0,0,5,5,0,7,7,0,15,15,0,132,75,57,0,,79,1,78,69,0,69
27/07/2022 16:00,29,10,19,83,42,41,90,46,44,0,0,0,5,5,0,31,31,0,14,14,0,215,131,84,0,,114,0,114,91,1,90
27/07/2022 17:00,70,18,52,125,42,83,163,47,116,0,0,0,5,5,0,25,25,0,31,31,0,432,285,147,0,,196,2,194,151,1,150
27/07/2022 18:00,46,18,28,139,37,102,158,39,119,0,0,0,20,20,0,26,26,0,21,21,0,332,214,118,0,,229,1,228,128,1,127
27/07/2022 19:00,21,9,12,94,29,65,106,38,68,0,0,0,11,11,0,17,17,0,12,12,0,192,114,78,0,,129,0,129,115,0,115
27/07/2022 20:00,17,7,10,62,31,31,87,40,47,0,0,0,11,11,0,18,18,0,7,7,0,165,100,65,0,,98,2,96,107,3,104
27/07/2022 21:00,14,6,8,46,29,17,55,29,26,0,0,0,7,7,0,11,11,0,8,8,0,89,54,35,0,,79,0,79,68,0,68
27/07/2022 22:00,6,2,4,10,6,4,19,9,10,0,0,0,8,8,0,6,6,0,8,8,0,79,59,20,0,,52,0,52,45,0,45
27/07/2022 23:00,11,7,4,7,2,5,13,3,10,0,0,0,6,6,0,3,3,0,0,0,0,53,41,12,0,,47,0,47,22,0,22
28/07/2022 00:00,4,2,2,3,1,2,8,3,5,0,0,0,2,2,0,3,3,0,1,1,0,21,15,6,0,,16,0,16,10,0,10
28/07/2022 01:00,3,0,3,2,2,0,4,2,2,0,0,0,2,2,0,0,0,0,0,0,0,12,8,4,0,,10,0,10,2,1,1
28/07/2022 02:00,0,0,0,4,2,2,3,2,1,0,0,0,1,1,0,0,0,0,1,1,0,2,2,0,0,,11,1,10,1,0,1
28/07/2022 03:00,0,0,0,0,0,0,3,1,2,0,0,0,0,0,0,0,0,0,0,0,0,5,3,2,0,,5,0,5,3,0,3
28/07/2022 04:00,2,1,1,2,2,0,3,1,2,0,0,0,2,2,0,0,0,0,1,1,0,6,2,4,0,,2,0,2,5,0,5
28/07/2022 05:00,3,3,0,15,8,7,18,10,8,0,0,0,9,9,0,1,1,0,3,3,0,40,8,32,0,,4,0,4,8,0,8
28/07/2022 06:00,16,13,3,35,24,11,41,32,9,0,0,0,31,31,0,10,10,0,6,6,0,136,24,112,0,,11,1,10,41,0,41
28/07/2022 07:00,38,34,4,84,59,25,87,61,26,0,0,0,64,64,0,16,16,0,22,22,0,290,67,223,0,,28,0,28,71,0,71
28/07/2022 08:00,85,78,7,97,71,26,124,95,29,0,0,0,82,81,1,20,20,0,32,32,0,528,83,445,0,,71,0,71,168,1,167
28/07/2022 09:00,51,45,6,48,29,19,78,51,27,0,0,0,37,37,0,4,4,0,15,15,0,215,34,181,0,,37,0,37,138,0,138
28/07/2022 10:00,20,15,5,48,25,23,70,35,35,0,0,0,19,19,0,5,5,0,8,8,0,95,23,72,0,,34,0,34,76,0,76
28/07/2022 11:00,11,6,5,70,31,39,91,43,48,0,0,0,7,7,0,13,13,0,10,10,0,98,28,70,0,,36,0,36,93,1,92
28/07/2022 12:00,17,9,8,64,29,35,82,41,41,0,0,0,5,5,0,16,16,0,7,7,0,114,41,73,0,,75,0,75,113,0,113
28/07/2022 13:00,24,13,11,66,33,33,77,41,36,0,0,0,6,6,0,11,11,0,26,26,0,119,52,67,0,,104,1,103,116,0,116
28/07/2022 14:00,17,7,10,60,29,31,72,36,36,0,0,0,9,9,0,20,20,0,15,15,0,117,53,64,0,,75,1,74,78,1,77
28/07/2022 15:00,15,7,8,53,22,31,73,34,39,0,0,0,9,9,0,17,17,0,18,18,0,151,81,70,0,,90,0,90,73,0,73
28/07/2022 16:00,34,16,18,71,31,40,79,35,44,0,0,0,10,9,1,24,24,0,22,22,0,205,126,79,0,,101,2,99,109,0,109
28/07/2022 17:00,66,15,51,119,41,78,144,43,101,0,0,0,31,31,0,29,29,0,35,35,0,382,250,132,0,,246,1,245,130,0,130
28/07/2022 18:00,45,13,32,151,55,96,170,57,113,0,0,0,29,29,0,30,30,0,20,20,0,353,218,135,0,,180,0,180,146,0,146
28/07/2022 19:00,29,12,17,115,55,60,132,57,75,0,0,0,16,15,1,17,17,0,10,10,0,215,123,92,0,,179,0,179,144,1,143
28/07/2022 20:00,28,13,15,93,47,46,99,48,51,0,0,0,7,7,0,18,18,0,16,16,0,137,74,63,0,,98,0,98,96,1,95
28/07/2022 21:00,9,3,6,34,14,20,49,17,32,0,0,0,14,14,0,9,9,0,6,6,0,120,72,48,0,,82,3,79,65,0,65
28/07/2022 22:00,9,5,4,22,12,10,19,9,10,0,0,0,4,4,0,1,1,0,6,6,0,95,70,25,0,,80,1,79,66,0,66
28/07/2022 23:00,6,4,2,7,3,4,8,1,7,0,0,0,6,6,0,4,4,0,2,2,0,63,48,15,0,,37,0,37,23,0,23
29/07/2022 00:00,2,1,1,2,1,1,6,1,5,0,0,0,3,3,0,0,0,0,2,2,0,38,32,6,0,,39,0,39,12,0,12
29/07/2022 01:00,2,0,2,3,2,1,1,0,1,0,0,0,0,0,0,1,1,0,1,1,0,17,13,4,0,,14,0,14,2,0,2
29/07/2022 02:00,0,0,0,1,1,0,3,0,3,0,0,0,4,4,0,0,0,0,0,0,0,13,9,4,0,,12,0,12,2,0,2
29/07/2022 03:00,1,0,1,0,0,0,1,1,0,0,0,0,4,4,0,0,0,0,0,0,0,10,7,3,0,,11,0,11,2,0,2
29/07/2022 04:00,3,2,1,2,1,1,7,2,5,0,0,0,2,2,0,1,1,0,1,1,0,10,4,6,0,,3,0,3,2,0,2
29/07/2022 05:00,4,4,0,13,8,5,19,10,9,0,0,0,4,4,0,0,0,0,2,2,0,37,11,26,0,,3,0,3,10,0,10
29/07/2022 06:00,19,15,4,23,12,11,32,20,12,0,0,0,17,17,0,10,10,0,6,6,0,136,21,115,0,,13,0,13,41,0,41
29/07/2022 07:00,27,22,5,62,39,23,71,43,28,0,0,0,44,43,1,11,11,0,15,15,0,193,48,145,0,,32,0,32,63,1,62
29/07/2022 08:00,60,51,9,90,58,32,102,74,28,0,0,0,43,43,0,17,17,0,24,24,0,334,80,254,0,,45,0,45,124,0,124
29/07/2022 09:00,31,26,5,43,26,17,55,27,28,0,0,0,40,39,1,17,17,0,18,18,0,176,35,141,0,,46,0,46,108,1,107
29/07/2022 10:00,16,13,3,69,36,33,61,28,33,0,0,0,23,23,0,14,14,0,16,16,0,107,30,77,0,,36,0,36,75,0,75
29/07/2022 11:00,9,5,4,84,37,47,106,39,67,0,0,0,22,22,0,13,13,0,21,21,0,99,36,63,0,,40,0,40,78,2,76
29/07/2022 12:00,18,12,6,83,37,46,90,42,48,0,0,0,15,15,0,11,11,0,8,8,0,116,48,68,0,,64,0,64,99,2,97
29/07/2022 13:00,23,13,10,76,33,43,79,39,40,0,0,0,8,8,0,23,23,0,15,15,0,141,57,84,0,,95,1,94,133,0,133
29/07/2022 14:00,25,11,14,74,35,39,110,47,63,0,0,0,8,8,0,10,10,0,16,16,0,124,61,63,0,,80,1,79,77,0,77
29/07/2022 15:00,26,10,16,62,30,32,73,35,38,0,0,0,12,12,0,11,11,0,14,14,0,147,82,65,0,,79,1,78,70,0,70
29/07/2022 16:00,44,21,23,79,39,40,102,39,63,0,0,0,17,17,0,25,25,0,14,14,0,235,129,106,0,,97,0,97,107,3,104
29/07/2022 17:00,48,16,32,92,35,57,111,43,68,0,0,0,17,17,0,22,22,0,23,23,0,263,161,102,0,,143,1,142,120,0,120
29/07/2022 18:00,27,14,13,93,41,52,105,36,69,0,0,0,24,24,0,18,18,0,21,21,0,211,122,89,0,,137,1,136,130,0,130
29/07/2022 19:00,31,14,17,48,20,28,60,20,40,0,0,0,15,15,0,13,13,0,10,10,0,167,90,77,0,,110,2,108,112,0,112
29/07/2022 20:00,12,8,4,37,19,18,41,20,21,0,0,0,8,8,0,4,4,0,2,2,0,125,71,54,0,,77,0,77,81,1,80
29/07/2022 21:00,9,5,4,18,9,9,30,15,15,0,0,0,7,7,0,7,7,0,6,6,0,94,47,47,0,,78,1,77,86,0,86
29/07/2022 22:00,4,2,2,12,6,6,21,10,11,0,0,0,12,11,1,3,3,0,2,2,0,67,49,18,0,,65,1,64,65,0,65
29/07/2022 23:00,12,6,6,5,1,4,9,1,8,0,0,0,4,4,0,2,2,0,3,3,0,55,44,11,0,,39,0,39,33,1,32
30/07/2022 00:00,2,2,0,6,2,4,10,6,4,0,0,0,5,5,0,2,2,0,0,0,0,33,22,11,0,,31,0,31,19,0,19
30/07/2022 01:00,1,0,1,2,1,1,4,3,1,0,0,0,2,2,0,4,4,0,0,0,0,27,24,3,0,,14,0,14,1,0,1
30/07/2022 02:00,5,2,3,2,2,0,3,1,2,0,0,0,1,1,0,0,0,0,0,0,0,12,10,2,0,,29,0,29,8,1,7
30/07/2022 03:00,0,0,0,0,0,0,2,0,2,0,0,0,4,4,0,1,1,0,0,0,0,16,12,4,0,,22,0,22,5,0,5
30/07/2022 04:00,2,0,2,1,1,0,1,1,0,0,0,0,2,2,0,1,1,0,3,3,0,12,9,3,0,,4,0,4,3,0,3
30/07/2022 05:00,0,0,0,5,2,3,7,4,3,0,0,0,1,1,0,0,0,0,1,1,0,13,4,9,0,,9,0,9,1,0,1
30/07/2022 06:00,2,2,0,10,4,6,13,6,7,0,0,0,7,7,0,4,4,0,2,2,0,32,3,29,0,,6,0,6,11,0,11
30/07/2022 07:00,5,5,0,25,14,11,30,15,15,0,0,0,15,15,0,2,2,0,6,6,0,48,7,41,0,,14,0,14,17,0,17
30/07/2022 08:00,11,8,3,38,23,15,31,16,15,0,0,0,6,6,0,3,3,0,3,3,0,46,19,27,0,,14,0,14,26,0,26
30/07/2022 09:00,5,5,0,55,23,32,58,20,38,0,0,0,6,6,0,4,4,0,7,7,0,49,17,32,0,,16,0,16,43,0,43
30/07/2022 10:00,8,4,4,34,20,14,47,25,22,0,0,0,4,4,0,5,5,0,10,10,0,60,20,40,0,,31,0,31,48,0,48
30/07/2022 11:00,11,4,7,40,16,24,52,22,30,0,0,0,2,2,0,8,8,0,8,8,0,73,31,42,0,,27,0,27,63,0,63
30/07/2022 12:00,12,6,6,55,28,27,62,25,37,0,0,0,2,2,0,5,5,0,7,7,0,91,27,64,0,,50,0,50,101,0,101
30/07/2022 13:00,5,4,1,74,38,36,100,46,54,0,0,0,7,7,0,11,11,0,14,14,0,100,41,59,0,,66,1,65,84,0,84
30/07/2022 14:00,18,7,11,74,34,40,97,44,53,0,0,0,8,7,1,9,9,0,7,7,0,106,43,63,0,,61,2,59,102,1,101
30/07/2022 15:00,15,10,5,87,35,52,104,46,58,0,0,0,10,10,0,10,10,0,6,6,0,99,43,56,0,,66,1,65,94,0,94
30/07/2022 16:00,23,15,8,95,55,40,104,55,49,0,0,0,12,12,0,13,13,0,10,10,0,107,54,53,0,,69,1,68,91,0,91
30/07/2022 17:00,16,8,8,55,36,19,58,35,23,0,0,0,8,8,0,7,7,0,3,3,0,77,44,33,0,,75,0,75,61,0,61
30/07/2022 18:00,20,6,14,24,14,10,34,23,11,0,0,0,8,8,0,9,9,0,2,2,0,71,35,36,0,,65,1,64,62,0,62
30/07/2022 19:00,8,4,4,14,7,7,14,8,6,0,0,0,5,5,0,2,2,0,2,2,0,73,42,31,0,,72,1,71,83,0,83
30/07/2022 20:00,9,1,8,6,3,3,15,6,9,0,0,0,7,6,1,1,1,0,1,1,0,57,37,20,0,,42,0,42,52,0,52
30/07/2022 21:00,2,2,0,5,3,2,10,5,5,0,0,0,4,4,0,4,4,0,4,4,0,22,18,4,0,,48,0,48,38,0,38
30/07/2022 22:00,5,3,2,3,0,3,5,2,3,0,0,0,4,4,0,0,0,0,0,0,0,27,22,5,0,,30,2,28,40,1,39
30/07/2022 23:00,8,4,4,3,1,2,2,0,2,0,0,0,5,5,0,2,2,0,0,0,0,22,18,4,0,,22,3,19,18,0,18
31/07/2022 00:00,3,2,1,0,0,0,2,0,2,0,0,0,3,3,0,2,2,0,0,0,0,18,15,3,0,,12,1,11,11,0,11
31/07/2022 01:00,2,2,0,2,2,0,2,1,1,0,0,0,1,1,0,2,2,0,0,0,0,10,9,1,0,,8,0,8,1,0,1
31/07/2022 02:00,1,0,1,1,0,1,1,0,1,0,0,0,1,1,0,0,0,0,0,0,0,8,6,2,0,,12,0,12,3,0,3
31/07/2022 03:00,0,0,0,0,0,0,2,1,1,0,0,0,0,0,0,0,0,0,0,0,0,7,7,0,0,,11,1,10,5,0,5
31/07/2022 04:00,0,0,0,1,1,0,2,1,1,0,0,0,0,0,0,0,0,0,2,2,0,7,5,2,0,,3,0,3,3,0,3
31/07/2022 05:00,0,0,0,2,1,1,1,1,0,0,0,0,3,3,0,0,0,0,0,0,0,8,6,2,0,,2,0,2,4,0,4
31/07/2022 06:00,3,2,1,3,2,1,4,3,1,0,0,0,1,1,0,1,1,0,2,2,0,17,4,13,0,,4,0,4,5,0,5
31/07/2022 07:00,3,1,2,14,4,10,20,8,12,0,0,0,7,7,0,0,0,0,9,9,0,24,7,17,0,,5,0,5,8,0,8
31/07/2022 08:00,8,8,0,38,19,19,42,16,26,0,0,0,7,7,0,3,3,0,2,2,0,35,9,26,0,,12,0,12,14,0,14
31/07/2022 09:00,2,2,0,65,25,40,58,24,34,0,0,0,8,8,0,6,6,0,13,13,0,42,6,36,0,,9,1,8,28,0,28
31/07/2022 10:00,13,11,2,80,37,43,76,32,44,0,0,0,11,11,0,7,7,0,2,2,0,73,26,47,0,,22,1,21,43,0,43
31/07/2022 11:00,5,3,2,107,49,58,141,54,87,0,0,0,7,7,0,7,7,0,5,5,0,59,17,42,0,,28,2,26,68,0,68
31/07/2022 12:00,6,4,2,107,54,53,143,64,79,0,0,0,1,1,0,10,10,0,5,5,0,62,28,34,0,,54,0,54,63,0,63
31/07/2022 13:00,15,10,5,133,65,68,158,75,83,0,0,0,3,3,0,7,7,0,6,6,0,94,31,63,0,,60,0,60,101,1,100
31/07/2022 14:00,8,4,4,106,51,55,160,68,92,0,0,0,4,4,0,7,7,0,3,3,0,105,46,59,0,,49,0,49,83,2,81
31/07/2022 15:00,18,13,5,138,69,69,146,74,72,0,0,0,1,1,0,11,11,0,2,2,0,86,41,45,0,,62,1,61,90,0,90
31/07/2022 16:00,20,13,7,115,59,56,158,81,77,0,0,0,8,8,0,15,15,0,16,16,0,95,41,54,0,,67,0,67,86,1,85
31/07/2022 17:00,20,10,10,107,55,52,129,69,60,0,0,0,2,2,0,12,12,0,10,10,0,94,41,53,0,,81,0,81,87,0,87
31/07/2022 18:00,17,6,11,86,45,41,110,63,47,0,0,0,7,7,0,13,13,0,9,9,0,83,35,48,0,,67,0,67,75,0,75
31/07/2022 19:00,14,10,4,72,42,30,82,49,33,0,0,0,15,15,0,9,9,0,11,11,0,90,44,46,0,,74,0,74,64,0,64
31/07/2022 20:00,4,3,1,50,22,28,54,25,29,0,0,0,20,20,0,9,9,0,7,7,0,75,33,42,0,,49,1,48,76,0,76
31/07/2022 21:00,8,4,4,27,18,9,39,23,16,0,0,0,8,8,0,4,4,0,5,5,0,84,39,45,0,,59,1,58,58,0,58
31/07/2022 22:00,8,6,2,21,10,11,18,7,11,0,0,0,5,5,0,2,2,0,3,3,0,45,28,17,0,,34,1,33,65,0,65
31/07/2022 23:00,6,2,4,3,2,1,5,2,3,0,0,0,2,2,0,2,2,0,1,1,0,28,19,9,0,,26,0,26,23,0,23
01/08/2022 00:00,5,4,1,5,1,4,7,0,7,0,0,0,2,2,0,2,2,0,1,1,0,16,16,0,0,,16,0,16,14,0,14
01/08/2022 01:00,3,3,0,5,3,2,1,1,0,0,0,0,2,2,0,1,1,0,0,0,0,14,12,2,0,,4,0,4,1,0,1
01/08/2022 02:00,1,0,1,4,2,2,3,0,3,0,0,0,2,2,0,0,0,0,1,1,0,10,8,2,0,,13,0,13,9,1,8
01/08/2022 03:00,0,0,0,0,0,0,0,0,0,0,0,0,0,0,0,0,0,0,1,1,0,7,4,3,0,,9,0,9,2,0,2
01/08/2022 04:00,0,0,0,3,3,0,4,2,2,0,0,0,1,1,0,1,1,0,0,0,0,6,4,2,0,,9,0,9,4,0,4
01/08/2022 05:00,1,1,0,5,4,1,5,4,1,0,0,0,4,4,0,1,1,0,0,0,0,7,3,4,0,,4,0,4,10,0,10
01/08/2022 06:00,2,2,0,12,5,7,12,6,6,0,0,0,7,7,0,0,0,0,3,3,0,37,10,27,0,,7,0,7,10,0,10
01/08/2022 07:00,8,7,1,45,17,28,44,18,26,0,0,0,10,10,0,2,2,0,2,2,0,60,19,41,0,,8,0,8,15,0,15
01/08/2022 08:00,7,6,1,77,39,38,66,26,40,0,0,0,14,14,0,3,3,0,9,9,0,69,17,52,0,,15,0,15,16,0,16
01/08/2022 09:00,14,7,7,159,57,102,188,79,109,0,0,0,12,12,0,11,11,0,9,9,0,76,27,49,0,,15,0,15,36,0,36
01/08/2022 10:00,17,12,5,208,87,121,218,88,130,0,0,0,10,10,0,9,9,0,13,13,0,83,23,60,0,,20,0,20,59,0,59
01/08/2022 11:00,14,10,4,260,115,145,267,120,147,0,0,0,11,11,0,15,15,0,17,17,0,98,40,58,0,,43,0,43,73,0,73
01/08/2022 12:00,20,14,6,226,118,108,277,135,142,0,0,0,1,1,0,9,9,0,23,23,0,87,34,53,0,,51,0,51,76,1,75
01/08/2022 13:00,19,11,8,148,76,72,209,96,113,0,0,0,2,2,0,20,20,0,7,7,0,108,48,60,0,,60,0,60,63,0,63
01/08/2022 14:00,16,9,7,101,60,41,133,82,51,0,0,0,6,6,0,11,11,0,10,10,0,100,50,50,0,,63,2,61,82,0,82
01/08/2022 15:00,22,13,9,58,36,22,92,61,31,0,0,0,9,9,0,6,6,0,3,3,0,85,46,39,0,,54,0,54,71,1,70
01/08/2022 16:00,21,11,10,38,20,18,43,27,16,0,0,0,4,4,0,10,10,0,2,2,0,91,44,47,0,,57,1,56,56,2,54
01/08/2022 17:00,17,10,7,24,15,9,21,13,8,0,0,0,5,5,0,6,6,0,2,2,0,103,52,51,0,,66,2,64,71,0,71
01/08/2022 18:00,11,6,5,28,12,16,28,13,15,0,0,0,6,6,0,7,7,0,2,2,0,92,55,37,0,,86,4,82,78,0,78
01/08/2022 19:00,7,2,5,34,20,14,32,11,21,0,0,0,6,6,0,8,8,0,9,9,0,69,37,32,0,,71,0,71,50,0,50
01/08/2022 20:00,8,4,4,28,15,13,45,22,23,0,0,0,3,3,0,11,11,0,6,6,0,67,44,23,0,,59,0,59,64,0,64
01/08/2022 21:00,13,9,4,10,5,5,19,6,13,0,0,0,5,5,0,5,5,0,2,2,0,51,27,24,0,,46,0,46,38,0,38
01/08/2022 22:00,6,3,3,9,5,4,15,7,8,0,0,0,3,3,0,2,2,0,0,0,0,40,28,12,0,,32,0,32,31,0,31
01/08/2022 23:00,2,2,0,1,0,1,6,4,2,0,0,0,1,1,0,1,1,0,0,0,0,26,14,12,0,,28,0,28,18,0,18
02/08/2022 00:00,2,1,1,1,1,0,3,0,3,0,0,0,1,1,0,0,0,0,0,0,0,13,8,5,0,,9,0,9,13,0,13
02/08/2022 01:00,0,0,0,2,1,1,0,0,0,0,0,0,3,3,0,2,2,0,0,0,0,10,7,3,0,,0,0,0,0,0,0
02/08/2022 02:00,1,0,1,0,0,0,3,1,2,0,0,0,0,0,0,0,0,0,1,1,0,4,1,3,0,,9,0,9,3,0,3
02/08/2022 03:00,1,1,0,0,0,0,0,0,0,0,0,0,0,0,0,0,0,0,0,0,0,3,1,2,0,,1,0,1,3,0,3
02/08/2022 04:00,2,1,1,1,1,0,4,2,2,0,0,0,5,5,0,0,0,0,0,0,0,6,0,6,0,,1,0,1,1,0,1
02/08/2022 05:00,5,5,0,8,5,3,8,6,2,0,0,0,9,9,0,2,2,0,0,0,0,33,9,24,0,,2,0,2,11,0,11
02/08/2022 06:00,15,13,2,22,19,3,21,18,3,0,0,0,22,22,0,6,6,0,3,3,0,124,33,91,0,,10,0,10,30,0,30
02/08/2022 07:00,43,39,4,32,22,10,38,32,6,0,0,0,40,40,0,10,10,0,3,3,0,243,56,187,0,,29,0,29,68,1,67
02/08/2022 08:00,67,62,5,56,49,7,77,66,11,0,0,0,63,62,1,15,15,0,16,16,0,418,73,345,0,,63,1,62,164,0,164
02/08/2022 09:00,32,30,2,30,21,9,40,25,15,0,0,0,27,27,0,9,9,0,2,2,0,171,17,154,0,,33,0,33,117,0,117
02/08/2022 10:00,14,11,3,50,24,26,56,25,31,0,0,0,17,17,0,4,4,0,4,4,0,86,35,51,0,,34,0,34,49,1,48
02/08/2022 11:00,8,6,2,57,31,26,60,24,36,0,0,0,8,8,0,6,6,0,0,0,0,94,21,73,0,,42,1,41,70,0,70
02/08/2022 12:00,12,7,5,44,21,23,58,24,34,0,0,0,15,15,0,7,7,0,0,0,0,81,33,48,0,,76,0,76,102,0,102
02/08/2022 13:00,12,7,5,52,23,29,61,24,37,0,0,0,14,14,0,13,13,0,0,0,0,108,43,65,0,,93,3,90,93,0,93
02/08/2022 14:00,13,6,7,59,21,38,76,18,58,0,0,0,6,6,0,10,10,0,0,0,0,99,51,48,0,,53,1,52,72,0,72
02/08/2022 15:00,19,7,12,78,37,41,116,45,71,0,0,0,9,9,0,11,11,0,0,0,0,127,66,61,0,,66,0,66,60,0,60
02/08/2022 16:00,37,17,20,86,38,48,106,45,61,0,0,0,18,18,0,20,20,0,3,3,0,204,114,90,0,,110,4,106,85,0,85
02/08/2022 17:00,53,15,38,121,44,77,183,63,120,0,0,0,18,18,0,22,22,0,16,16,0,367,224,143,0,,214,1,213,119,0,119
02/08/2022 18:00,59,14,45,165,62,103,215,77,138,0,0,0,11,11,0,26,26,0,5,5,0,296,186,110,0,,188,1,187,129,2,127
02/08/2022 19:00,27,11,16,125,59,66,169,75,94,0,0,0,17,17,0,24,24,0,7,7,0,205,122,83,0,,125,0,125,115,0,115
02/08/2022 20:00,26,14,12,110,69,41,162,84,78,0,0,0,14,14,0,10,10,0,6,6,0,148,84,64,0,,99,1,98,74,1,73
02/08/2022 21:00,17,6,11,71,38,33,86,46,40,0,0,0,19,19,0,11,11,0,4,4,0,133,80,53,0,,61,1,60,63,0,63
02/08/2022 22:00,7,3,4,23,17,6,27,17,10,0,0,0,6,6,0,8,8,0,0,0,0,75,55,20,0,,12,0,12,36,0,36
02/08/2022 23:00,7,1,6,10,5,5,14,5,9,0,0,0,4,4,0,2,2,0,0,0,0,26,23,3,0,,0,0,0,13,0,13
03/08/2022 00:00,2,1,1,3,1,2,1,0,1,0,0,0,2,2,0,0,0,0,0,0,0,22,18,4,0,,10,0,10,6,0,6
03/08/2022 01:00,1,0,1,6,4,2,3,1,2,0,0,0,0,0,0,4,4,0,0,0,0,4,4,0,0,,2,0,2,0,0,0
03/08/2022 02:00,0,0,0,2,1,1,3,0,3,0,0,0,1,1,0,0,0,0,0,0,0,2,2,0,0,,7,0,7,4,0,4
03/08/2022 03:00,0,0,0,0,0,0,1,1,0,0,0,0,1,1,0,0,0,0,0,0,0,4,2,2,0,,3,0,3,1,0,1
03/08/2022 04:00,1,1,0,4,4,0,5,2,3,0,0,0,3,3,0,0,0,0,0,0,0,5,1,4,0,,2,0,2,2,0,2
03/08/2022 05:00,6,6,0,8,6,2,12,7,5,0,0,0,10,10,0,0,0,0,0,0,0,44,9,35,0,,4,0,4,11,0,11
03/08/2022 06:00,25,21,4,36,25,11,37,24,13,0,0,0,23,23,0,11,11,0,0,0,0,160,44,116,0,,20,0,20,41,0,41
03/08/2022 07:00,47,40,7,73,50,23,90,65,25,0,0,0,70,70,0,12,12,0,5,5,0,308,60,248,0,,38,1,37,78,0,78
03/08/2022 08:00,100,94,6,95,73,22,113,89,24,0,0,0,85,84,1,9,9,0,1,1,0,526,96,430,0,,82,0,82,201,1,200
03/08/2022 09:00,45,38,7,58,33,25,72,40,32,0,0,0,27,27,0,12,12,0,0,0,0,222,38,184,0,,41,0,41,127,1,126
03/08/2022 10:00,19,15,4,43,19,24,50,19,31,0,0,0,23,23,0,2,2,0,0,0,0,82,30,52,0,,29,1,28,71,0,71
03/08/2022 11:00,17,11,6,57,25,32,65,29,36,0,0,0,18,18,0,4,4,0,0,0,0,88,29,59,0,,49,0,49,62,0,62
03/08/2022 12:00,17,7,10,63,29,34,62,27,35,0,0,0,14,14,0,7,7,0,0,0,0,110,35,75,0,,61,0,61,98,0,98
03/08/2022 13:00,17,13,4,56,30,26,86,42,44,0,0,0,10,10,0,4,4,0,0,0,0,129,59,70,0,,87,2,85,78,0,78
03/08/2022 14:00,13,8,5,52,23,29,66,30,36,0,0,0,6,6,0,4,4,0,0,0,0,93,54,39,0,,88,0,88,53,0,53
03/08/2022 15:00,22,11,11,46,21,25,73,32,41,0,0,0,9,9,0,9,9,0,0,0,0,150,73,77,0,,74,0,74,82,1,81
03/08/2022 16:00,38,12,26,66,18,48,110,36,74,0,0,0,11,11,0,26,26,0,1,1,0,238,126,112,0,,141,1,140,100,0,100
03/08/2022 17:00,74,18,56,113,30,83,152,39,113,0,0,0,22,21,1,29,29,0,11,11,0,406,260,146,0,,239,0,239,148,0,148
03/08/2022 18:00,56,19,37,153,54,99,171,53,118,0,0,0,24,23,1,27,27,0,6,6,0,366,236,130,0,,205,0,205,126,1,125
03/08/2022 19:00,29,8,21,90,41,49,116,44,72,0,0,0,11,10,1,21,21,0,3,3,0,203,128,75,0,,134,0,134,101,0,101
03/08/2022 20:00,15,8,7,70,35,35,82,42,40,0,0,0,13,13,0,12,12,0,0,0,0,130,73,57,0,,108,0,108,78,0,78
03/08/2022 21:00,9,2,7,36,16,20,46,21,25,0,0,0,10,10,0,7,7,0,0,0,0,92,48,44,0,,65,1,64,57,0,57
03/08/2022 22:00,7,3,4,7,3,4,12,3,9,0,0,0,14,14,0,8,8,0,0,0,0,71,51,20,0,,60,1,59,33,0,33
03/08/2022 23:00,4,1,3,7,2,5,9,1,8,0,0,0,5,5,0,4,4,0,0,0,0,32,29,3,0,,30,0,30,18,0,18
04/08/2022 00:00,2,2,0,3,1,2,7,3,4,0,0,0,5,5,0,3,3,0,0,0,0,12,12,0,0,,20,0,20,15,0,15
04/08/2022 01:00,1,0,1,2,2,0,1,1,0,0,0,0,0,0,0,0,0,0,0,0,0,9,7,2,0,,4,0,4,0,0,0
04/08/2022 02:00,1,1,0,3,1,2,5,0,5,0,0,0,2,2,0,0,0,0,0,0,0,4,3,1,0,,5,0,5,0,0,0
04/08/2022 03:00,1,0,1,0,0,0,0,0,0,0,0,0,0,0,0,0,0,0,0,0,0,2,2,0,0,,7,0,7,1,0,1
04/08/2022 04:00,3,2,1,3,3,0,4,2,2,0,0,0,1,1,0,0,0,0,0,0,0,6,1,5,0,,3,0,3,2,0,2
04/08/2022 05:00,3,3,0,11,6,5,17,8,9,0,0,0,10,10,0,1,1,0,0,0,0,47,8,39,0,,4,0,4,11,0,11
04/08/2022 06:00,24,19,5,39,23,16,50,33,17,0,0,0,28,27,1,13,13,0,2,2,0,136,24,112,0,,16,0,16,44,0,44
04/08/2022 07:00,51,41,10,91,65,26,89,62,27,0,0,0,62,62,0,15,15,0,0,0,0,284,67,217,0,,29,0,29,75,0,75
04/08/2022 08:00,95,89,6,97,74,23,135,98,37,0,0,0,91,91,0,11,11,0,0,0,0,567,95,472,0,,77,1,76,189,0,189
04/08/2022 09:00,43,39,4,61,32,29,71,43,28,0,0,0,43,43,0,11,11,0,2,2,0,230,40,190,0,,43,0,43,141,0,141
04/08/2022 10:00,16,12,4,67,32,35,62,28,34,0,0,0,19,19,0,8,8,0,0,0,0,95,30,65,0,,33,0,33,49,0,49
04/08/2022 11:00,19,16,3,67,32,35,71,30,41,0,0,0,14,14,0,12,12,0,0,0,0,105,43,62,0,,52,0,52,63,0,63
04/08/2022 12:00,19,8,11,74,38,36,93,50,43,0,0,0,2,2,0,7,7,0,0,0,0,123,63,60,0,,84,1,83,83,0,83
04/08/2022 13:00,15,6,9,75,33,42,96,36,60,0,0,0,5,5,0,17,17,0,0,0,0,128,67,61,0,,109,0,109,107,0,107
04/08/2022 14:00,24,11,13,70,26,44,78,32,46,0,0,0,4,4,0,10,10,0,0,0,0,103,64,39,0,,77,1,76,69,0,69
04/08/2022 15:00,18,9,9,83,43,40,85,51,34,0,0,0,10,10,0,13,13,0,0,0,0,135,65,70,0,,83,0,83,79,0,79
04/08/2022 16:00,37,14,23,84,31,53,118,45,73,0,0,0,7,7,0,25,25,0,1,1,0,217,120,97,0,,111,0,111,107,0,107
04/08/2022 17:00,73,19,54,126,35,91,165,51,114,0,0,0,15,15,0,24,24,0,2,2,0,373,247,126,0,,206,3,203,146,0,146
04/08/2022 18:00,44,11,33,144,45,99,187,58,129,0,0,0,13,13,0,22,22,0,2,2,0,286,175,111,0,,185,0,185,143,0,143
04/08/2022 19:00,21,6,15,111,53,58,142,60,82,0,0,0,17,17,0,20,20,0,3,3,0,212,135,77,0,,141,1,140,133,2,131
04/08/2022 20:00,26,13,13,83,36,47,136,75,61,0,0,0,9,9,0,14,14,0,11,11,0,140,77,63,0,,84,0,84,93,0,93
04/08/2022 21:00,11,5,6,32,15,17,50,24,26,0,0,0,13,13,0,14,14,0,6,6,0,126,79,47,0,,69,0,69,81,1,80
04/08/2022 22:00,7,4,3,18,9,9,20,6,14,0,0,0,6,6,0,6,6,0,1,1,0,86,61,25,0,,83,1,82,48,0,48
04/08/2022 23:00,6,2,4,12,5,7,16,3,13,0,0,0,5,5,0,2,2,0,0,0,0,50,36,14,0,,54,1,53,25,1,24
05/08/2022 00:00,1,0,1,7,4,3,8,3,5,0,0,0,2,2,0,1,1,0,1,1,0,29,26,3,0,,29,0,29,14,2,12
05/08/2022 01:00,0,0,0,4,4,0,1,1,0,0,0,0,0,0,0,1,1,0,0,0,0,11,9,2,0,,10,0,10,1,0,1
05/08/2022 02:00,1,0,1,0,0,0,0,0,0,0,0,0,2,2,0,0,0,0,0,0,0,7,7,0,0,,10,0,10,4,0,4
05/08/2022 03:00,0,0,0,3,2,1,3,1,2,0,0,0,0,0,0,0,0,0,0,0,0,3,2,1,0,,5,0,5,4,0,4
05/08/2022 04:00,2,0,2,1,1,0,2,2,0,0,0,0,3,3,0,0,0,0,0,0,0,7,1,6,0,,3,0,3,2,0,2
05/08/2022 05:00,5,3,2,12,5,7,14,6,8,0,0,0,8,8,0,1,1,0,2,2,0,31,6,25,0,,5,0,5,9,0,9
05/08/2022 06:00,22,18,4,32,18,14,32,21,11,0,0,0,26,26,0,10,10,0,2,2,0,121,23,98,0,,10,0,10,40,0,40
05/08/2022 07:00,38,34,4,67,51,16,76,55,21,0,0,0,37,37,0,11,11,0,0,0,0,235,67,168,0,,29,0,29,78,0,78
05/08/2022 08:00,65,56,9,64,37,27,85,60,25,0,0,0,64,64,0,14,14,0,0,0,0,316,71,245,0,,57,0,57,119,1,118
05/08/2022 09:00,38,34,4,47,29,18,59,30,29,0,0,0,18,18,0,4,4,0,0,0,0,167,34,133,0,,43,0,43,115,0,115
05/08/2022 10:00,10,6,4,61,28,33,81,34,47,0,0,0,12,11,1,5,5,0,0,0,0,81,14,67,0,,26,1,25,68,0,68
05/08/2022 11:00,12,9,3,63,27,36,60,22,38,0,0,0,8,8,0,10,10,0,0,0,0,87,31,56,0,,36,1,35,67,1,66
05/08/2022 12:00,12,5,7,68,28,40,63,32,31,0,0,0,8,8,0,14,14,0,0,0,0,104,47,57,0,,81,0,81,107,0,107
05/08/2022 13:00,21,5,16,73,31,42,66,28,38,0,0,0,8,8,0,9,9,0,0,0,0,125,50,75,0,,113,1,112,125,0,125
05/08/2022 14:00,18,8,10,67,25,42,79,37,42,0,0,0,11,11,0,7,7,0,0,0,0,123,59,64,0,,88,0,88,104,0,104
05/08/2022 15:00,25,9,16,86,41,45,82,29,53,0,0,0,14,14,0,8,8,0,0,0,0,135,62,73,0,,105,0,105,84,1,83
05/08/2022 16:00,29,10,19,85,36,49,110,42,68,0,0,0,11,10,1,8,8,0,0,0,0,251,141,110,0,,128,0,128,98,0,98
05/08/2022 17:00,47,19,28,120,39,81,155,53,102,0,0,0,9,9,0,23,23,0,0,0,0,275,164,111,0,,183,5,178,138,0,138
05/08/2022 18:00,31,10,21,122,52,70,148,66,82,0,0,0,16,16,0,25,25,0,0,0,0,223,117,106,0,,156,1,155,121,0,121
05/08/2022 19:00,27,16,11,66,34,32,104,48,56,0,0,0,16,16,0,13,13,0,0,0,0,152,85,67,0,,117,1,116,125,0,125
05/08/2022 20:00,17,9,8,54,23,31,68,32,36,0,0,0,13,13,0,11,11,0,0,0,0,129,73,56,0,,104,3,101,112,0,112
05/08/2022 21:00,7,2,5,28,18,10,34,17,17,0,0,0,8,8,0,4,4,0,0,0,0,98,57,41,0,,70,0,70,87,2,85
05/08/2022 22:00,4,2,2,15,7,8,23,10,13,0,0,0,11,11,0,7,7,0,0,0,0,66,48,18,0,,57,1,56,61,1,60
05/08/2022 23:00,1,0,1,7,3,4,13,4,9,0,0,0,3,3,0,2,2,0,0,0,0,55,43,12,0,,45,0,45,35,2,33
06/08/2022 00:00,3,1,2,2,1,1,4,3,1,0,0,0,6,6,0,6,6,0,0,0,0,37,24,13,0,,25,0,25,16,0,16
06/08/2022 01:00,3,0,3,3,2,1,2,2,0,0,0,0,3,3,0,0,0,0,0,0,0,23,17,6,0,,13,0,13,1,0,1
06/08/2022 02:00,0,0,0,4,3,1,5,1,4,0,0,0,1,1,0,0,0,0,0,0,0,8,7,1,0,,14,1,13,6,1,5
06/08/2022 03:00,0,0,0,1,1,0,2,0,2,0,0,0,5,5,0,0,0,0,0,0,0,17,10,7,0,,17,0,17,11,0,11
06/08/2022 04:00,1,1,0,1,0,1,1,1,0,0,0,0,1,1,0,0,0,0,0,0,0,5,3,2,0,,9,0,9,3,0,3
06/08/2022 05:00,0,0,0,6,2,4,14,4,10,0,0,0,3,3,0,3,3,0,0,0,0,12,7,5,0,,2,0,2,4,0,4
06/08/2022 06:00,2,0,2,19,7,12,25,11,14,0,0,0,6,6,0,5,5,0,0,0,0,37,8,29,0,,6,0,6,10,0,10
06/08/2022 07:00,2,1,1,42,21,21,47,26,21,0,0,0,7,7,0,2,2,0,1,1,0,62,20,42,0,,16,0,16,33,1,32
06/08/2022 08:00,4,2,2,80,38,42,93,31,62,0,0,0,8,8,0,4,4,0,0,0,0,75,28,47,0,,21,0,21,46,0,46
06/08/2022 09:00,0,0,0,122,41,81,150,54,96,0,0,0,12,12,0,3,3,0,0,0,0,89,23,66,0,,23,0,23,64,1,63
06/08/2022 10:00,7,3,4,142,47,95,156,50,106,0,0,0,12,12,0,7,7,0,0,0,0,98,26,72,0,,45,0,45,82,0,82
06/08/2022 11:00,6,2,4,174,86,88,182,75,107,0,0,0,5,5,0,11,11,0,0,0,0,121,42,79,0,,51,0,51,102,1,101
06/08/2022 12:00,13,7,6,185,94,91,220,120,100,0,0,0,2,2,0,8,8,0,0,0,0,105,34,71,0,,70,1,69,117,0,117
06/08/2022 13:00,10,3,7,138,74,64,205,103,102,0,0,0,2,2,0,10,10,0,0,0,0,157,75,82,0,,75,1,74,117,1,116
06/08/2022 14:00,25,10,15,122,61,61,170,85,85,0,0,0,12,12,0,9,9,0,0,0,0,103,48,55,0,,73,0,73,97,0,97
06/08/2022 15:00,17,9,8,111,54,57,134,60,74,0,0,0,5,5,0,6,6,0,0,0,0,133,57,76,0,,79,0,79,89,0,89
06/08/2022 16:00,20,10,10,103,56,47,124,68,56,0,0,0,16,15,1,7,7,0,1,1,0,122,51,71,0,,96,2,94,94,1,93
06/08/2022 17:00,15,6,9,82,45,37,124,62,62,0,0,0,8,8,0,9,9,0,0,0,0,121,62,59,0,,79,0,79,93,2,91
06/08/2022 18:00,19,15,4,72,38,34,83,49,34,0,0,0,17,17,0,9,9,0,0,0,0,94,45,49,0,,85,0,85,88,0,88
06/08/2022 19:00,24,14,10,50,26,24,77,41,36,0,0,0,10,10,0,8,8,0,0,0,0,104,53,51,0,,78,1,77,98,2,96
06/08/2022 20:00,18,9,9,44,24,20,60,32,28,0,0,0,17,17,0,11,11,0,0,0,0,83,36,47,0,,65,0,65,94,0,94
06/08/2022 21:00,6,1,5,31,19,12,54,23,31,0,0,0,13,13,0,6,6,0,0,0,0,55,29,26,0,,39,0,39,67,0,67
06/08/2022 22:00,11,8,3,12,7,5,15,9,6,0,0,0,2,2,0,7,7,0,0,0,0,45,33,12,0,,40,2,38,58,0,58
06/08/2022 23:00,2,2,0,9,5,4,13,6,7,0,0,0,2,2,0,2,2,0,0,0,0,43,33,10,0,,43,0,43,33,0,33
07/08/2022 00:00,2,1,1,6,2,4,6,1,5,0,0,0,4,4,0,4,4,0,0,0,0,29,19,10,0,,29,0,29,12,1,11
07/08/2022 01:00,0,0,0,3,3,0,4,1,3,0,0,0,1,1,0,3,3,0,0,0,0,25,15,10,0,,10,0,10,1,0,1
07/08/2022 02:00,1,1,0,1,1,0,2,0,2,0,0,0,2,2,0,1,1,0,0,0,0,15,12,3,0,,20,0,20,3,0,3
07/08/2022 03:00,2,1,1,0,0,0,1,0,1,0,0,0,2,2,0,0,0,0,0,0,0,18,13,5,0,,20,2,18,3,0,3
07/08/2022 04:00,0,0,0,2,2,0,3,1,2,0,0,0,1,1,0,0,0,0,0,0,0,8,5,3,0,,11,0,11,4,0,4
07/08/2022 05:00,4,1,3,4,1,3,5,2,3,0,0,0,3,3,0,0,0,0,0,0,0,2,1,1,0,,7,0,7,3,0,3
07/08/2022 06:00,4,2,2,12,5,7,16,7,9,0,0,0,9,9,0,1,1,0,1,1,0,29,11,18,0,,6,0,6,4,0,4
07/08/2022 07:00,3,2,1,62,27,35,68,30,38,0,0,0,12,12,0,3,3,0,0,0,0,47,14,33,0,,11,0,11,12,1,11
07/08/2022 08:00,4,4,0,99,42,57,120,41,79,0,0,0,6,6,0,3,3,0,0,0,0,49,13,36,0,,10,0,10,23,0,23
07/08/2022 09:00,11,6,5,136,65,71,151,64,87,0,0,0,9,9,0,10,10,0,0,0,0,67,16,51,0,,22,0,22,44,0,44
07/08/2022 10:00,17,12,5,195,91,104,219,93,126,0,0,0,9,9,0,9,9,0,0,0,0,92,29,63,0,,23,0,23,53,0,53
07/08/2022 11:00,22,15,7,173,83,90,231,102,129,0,0,0,10,10,0,11,11,0,0,0,0,83,24,59,0,,35,2,33,60,0,60
07/08/2022 12:00,18,8,10,199,93,106,228,115,113,0,0,0,1,1,0,10,10,0,0,0,0,106,40,66,0,,59,1,58,82,1,81
07/08/2022 13:00,16,8,8,220,106,114,249,107,142,0,0,0,13,13,0,7,7,0,0,0,0,135,58,77,0,,83,0,83,108,0,108
07/08/2022 14:00,25,20,5,203,91,112,227,89,138,0,0,0,5,5,0,8,8,0,0,0,0,122,60,62,0,,76,0,76,97,1,96
07/08/2022 15:00,29,13,16,171,91,80,234,116,118,0,0,0,4,4,0,11,11,0,0,0,0,114,45,69,0,,80,0,80,96,1,95
07/08/2022 16:00,24,9,15,199,112,87,256,151,105,0,0,0,7,7,0,18,18,0,0,0,0,119,38,81,0,,71,0,71,101,0,101
07/08/2022 17:00,19,11,8,161,87,74,211,122,89,0,0,0,6,6,0,8,8,0,0,0,0,133,59,74,0,,96,2,94,91,1,90
07/08/2022 18:00,15,5,10,130,76,54,177,94,83,0,0,0,5,5,0,13,13,0,0,0,0,137,76,61,0,,88,1,87,103,0,103
07/08/2022 19:00,11,5,6,115,67,48,168,95,73,0,0,0,5,5,0,10,10,0,2,2,0,120,55,65,0,,116,2,114,81,0,81
07/08/2022 20:00,14,6,8,76,45,31,141,79,62,0,0,0,10,10,0,7,7,0,5,5,0,80,42,38,0,,67,1,66,81,1,80
07/08/2022 21:00,9,3,6,31,18,13,42,25,17,0,0,0,3,3,0,5,5,0,4,4,0,69,37,32,0,,61,0,61,61,1,60
07/08/2022 22:00,12,3,9,15,8,7,22,9,13,0,0,0,7,7,0,4,4,0,5,5,0,48,27,21,0,,14,0,14,48,1,47
07/08/2022 23:00,3,2,1,7,4,3,13,5,8,0,0,0,7,7,0,2,2,0,0,0,0,46,38,8,0,,1,0,1,23,0,23
08/08/2022 00:00,3,1,2,7,4,3,7,3,4,0,0,0,4,4,0,1,1,0,0,0,0,16,14,2,0,,10,1,9,17,1,16
08/08/2022 01:00,1,1,0,1,1,0,0,0,0,0,0,0,0,0,0,0,0,0,0,0,0,6,5,1,0,,2,0,2,1,0,1
08/08/2022 02:00,3,1,2,0,0,0,0,0,0,0,0,0,2,2,0,0,0,0,0,0,0,8,7,1,0,,14,0,14,2,0,2
08/08/2022 03:00,1,0,1,1,0,1,1,0,1,0,0,0,0,0,0,0,0,0,0,0,0,3,1,2,0,,3,0,3,2,0,2
08/08/2022 04:00,0,0,0,2,2,0,2,1,1,0,0,0,0,0,0,1,1,0,0,0,0,4,0,4,0,,6,0,6,2,0,2
08/08/2022 05:00,2,2,0,13,7,6,15,11,4,0,0,0,10,10,0,3,3,0,2,2,0,33,7,26,0,,3,0,3,3,0,3
08/08/2022 06:00,27,22,5,35,24,11,51,35,16,0,0,0,27,27,0,7,7,0,9,9,0,136,23,113,0,,11,0,11,32,0,32
08/08/2022 07:00,42,36,6,87,61,26,105,71,34,0,0,0,59,59,0,10,10,0,19,19,0,288,77,211,0,,36,1,35,83,0,83
08/08/2022 08:00,73,65,8,110,86,24,143,104,39,0,0,0,58,58,0,23,23,0,15,15,0,398,81,317,0,,60,0,60,129,0,129
08/08/2022 09:00,29,26,3,86,47,39,93,46,47,0,0,0,23,23,0,15,15,0,12,12,0,195,40,155,0,,38,0,38,119,0,119
08/08/2022 10:00,26,20,6,105,38,67,126,49,77,0,0,0,6,6,0,4,4,0,14,14,0,89,25,64,0,,32,0,32,61,0,61
08/08/2022 11:00,14,10,4,69,37,32,132,69,63,0,0,0,6,6,0,7,7,0,3,3,0,93,31,62,0,,46,0,46,63,0,63
08/08/2022 12:00,19,12,7,118,64,54,115,59,56,0,0,0,5,5,0,17,17,0,7,7,0,109,39,70,0,,68,0,68,112,0,112
08/08/2022 13:00,18,15,3,120,59,61,170,76,94,0,0,0,2,2,0,20,20,0,11,11,0,139,62,77,0,,102,2,100,102,0,102
08/08/2022 14:00,17,9,8,96,44,52,100,43,57,0,0,0,4,4,0,13,13,0,5,5,0,136,70,66,0,,69,1,68,81,0,81
08/08/2022 15:00,15,8,7,105,57,48,109,47,62,0,0,0,6,6,0,18,18,0,12,12,0,160,79,81,0,,76,1,75,93,1,92
08/08/2022 16:00,32,10,22,118,42,76,142,61,81,0,0,0,7,6,1,18,18,0,15,15,0,220,118,102,0,,149,2,147,91,0,91
08/08/2022 17:00,57,17,40,165,56,109,245,83,162,0,0,0,8,8,0,27,27,0,24,24,0,399,251,148,0,,213,2,211,149,1,148
08/08/2022 18:00,61,26,35,226,111,115,302,125,177,0,0,0,11,10,1,24,24,0,29,29,0,326,197,129,0,,182,0,182,115,0,115
08/08/2022 19:00,30,12,18,186,83,103,296,122,174,0,0,0,10,10,0,26,26,0,20,20,0,214,123,91,0,,122,0,122,122,1,121
08/08/2022 20:00,27,13,14,137,84,53,219,124,95,0,0,0,5,5,0,18,18,0,8,8,0,128,76,52,0,,104,0,104,84,0,84
08/08/2022 21:00,8,4,4,55,37,18,109,67,42,0,0,0,3,3,0,22,22,0,14,14,0,115,53,62,0,,65,0,65,55,0,55
08/08/2022 22:00,8,4,4,18,11,7,30,16,14,0,0,0,9,9,0,5,5,0,9,9,0,72,52,20,0,,53,2,51,34,0,34
08/08/2022 23:00,4,2,2,9,4,5,7,3,4,0,0,0,5,5,0,4,4,0,0,0,0,21,17,4,0,,36,1,35,22,0,22
09/08/2022 00:00,3,0,3,1,0,1,6,1,5,0,0,0,0,0,0,1,1,0,0,0,0,17,13,4,0,,22,0,22,7,1,6
09/08/2022 01:00,1,0,1,3,3,0,1,1,0,0,0,0,1,1,0,1,1,0,1,1,0,9,9,0,0,,4,0,4,0,0,0
09/08/2022 02:00,0,0,0,1,1,0,4,2,2,0,0,0,2,2,0,0,0,0,0,0,0,7,6,1,0,,6,0,6,3,0,3
09/08/2022 03:00,0,0,0,0,0,0,0,0,0,0,0,0,1,1,0,0,0,0,0,0,0,1,0,1,0,,1,0,1,3,0,3
09/08/2022 04:00,0,0,0,3,3,0,2,1,1,0,0,0,1,1,0,0,0,0,0,0,0,4,1,3,0,,2,0,2,1,0,1
09/08/2022 05:00,5,4,1,16,11,5,12,7,5,0,0,0,9,9,0,3,3,0,0,0,0,37,7,30,0,,5,0,5,12,0,12
09/08/2022 06:00,17,16,1,54,37,17,60,40,20,0,0,0,31,31,0,9,9,0,6,6,0,142,30,112,0,,13,0,13,40,0,40
09/08/2022 07:00,54,49,5,114,84,30,122,89,33,0,0,0,60,60,0,11,11,0,5,5,0,338,73,265,0,,40,0,40,93,0,93
09/08/2022 08:00,96,90,6,123,97,26,163,125,38,0,0,0,55,55,0,30,30,0,1,1,0,619,97,522,0,,85,1,84,220,2,218
09/08/2022 09:00,54,51,3,76,47,29,111,63,48,0,0,0,37,37,0,13,13,0,0,0,0,247,42,205,0,,44,0,44,152,2,150
09/08/2022 10:00,15,10,5,89,36,53,106,42,64,0,0,0,17,17,0,6,6,0,0,0,0,100,34,66,0,,30,0,30,69,0,69
09/08/2022 11:00,16,10,6,85,43,42,129,65,64,0,0,0,11,11,0,9,9,0,0,0,0,88,23,65,0,,54,0,54,78,1,77
09/08/2022 12:00,12,10,2,131,62,69,146,63,83,0,0,0,12,12,0,14,14,0,0,0,0,116,42,74,0,,79,1,78,102,0,102
09/08/2022 13:00,20,13,7,131,61,70,147,77,70,0,0,0,11,10,1,17,17,0,8,8,0,110,46,64,0,,91,1,90,108,0,108
09/08/2022 14:00,23,12,11,92,44,48,119,51,68,0,0,0,10,10,0,14,14,0,11,11,0,120,65,55,0,,80,0,80,87,0,87
09/08/2022 15:00,31,14,17,126,55,71,138,65,73,0,0,0,9,9,0,18,18,0,10,10,0,147,79,68,0,,71,0,71,78,0,78
09/08/2022 16:00,36,10,26,131,46,85,191,69,122,0,0,0,14,14,0,21,21,0,17,17,0,270,151,119,0,,138,0,138,81,0,81
09/08/2022 17:00,72,24,48,244,87,157,317,104,213,0,0,0,14,14,0,40,40,0,18,18,0,484,328,156,0,,271,0,271,138,1,137
09/08/2022 18:00,61,21,40,263,91,172,325,119,206,0,0,0,12,12,0,40,40,0,8,8,0,387,228,159,0,,209,0,209,134,1,133
09/08/2022 19:00,35,9,26,224,108,116,324,137,187,0,0,0,13,13,0,27,27,0,18,18,0,227,143,84,0,,130,1,129,129,0,129
09/08/2022 20:00,23,9,14,156,84,72,224,132,92,0,0,0,13,13,0,18,18,0,12,12,0,170,105,65,0,,110,0,110,94,1,93
09/08/2022 21:00,19,4,15,62,37,25,133,73,60,0,0,0,5,5,0,14,14,0,12,12,0,148,92,56,0,,58,0,58,27,0,27
09/08/2022 22:00,18,7,11,23,15,8,37,21,16,0,0,0,0,0,0,4,4,0,9,9,0,92,67,25,0,,18,0,18,57,0,57
09/08/2022 23:00,4,2,2,7,2,5,12,4,8,0,0,0,7,7,0,3,3,0,0,0,0,40,30,10,0,,3,0,3,24,0,24
10/08/2022 00:00,0,0,0,2,1,1,7,3,4,0,0,0,3,3,0,1,1,0,0,0,0,19,16,3,0,,24,0,24,12,0,12
10/08/2022 01:00,1,0,1,1,1,0,2,1,1,0,0,0,2,2,0,1,1,0,1,1,0,7,4,3,0,,2,0,2,1,0,1
10/08/2022 02:00,2,1,1,1,1,0,1,0,1,0,0,0,1,1,0,1,1,0,1,1,0,4,3,1,0,,11,1,10,3,0,3
10/08/2022 03:00,1,0,1,1,0,1,1,0,1,0,0,0,0,0,0,1,1,0,0,0,0,3,1,2,0,,4,0,4,1,0,1
10/08/2022 04:00,2,1,1,3,1,2,5,3,2,0,0,0,0,0,0,0,0,0,1,1,0,4,1,3,0,,2,0,2,2,0,2
10/08/2022 05:00,5,5,0,17,10,7,17,10,7,0,0,0,6,6,0,0,0,0,3,3,0,35,7,28,0,,6,0,6,8,0,8
10/08/2022 06:00,20,17,3,54,30,24,62,41,21,0,0,0,20,20,0,10,10,0,12,12,0,155,35,120,0,,17,0,17,36,0,36
10/08/2022 07:00,44,41,3,121,91,30,139,105,34,0,0,0,50,50,0,12,12,0,19,19,0,351,85,266,0,,41,2,39,87,0,87
10/08/2022 08:00,113,101,12,130,94,36,165,120,45,0,0,0,46,46,0,21,21,0,25,25,0,534,100,434,0,,74,1,73,212,0,212
10/08/2022 09:00,55,46,9,88,47,41,120,65,55,0,0,0,34,34,0,12,12,0,16,16,0,241,34,207,0,,47,1,46,136,0,136
10/08/2022 10:00,18,15,3,99,51,48,141,53,88,0,0,0,22,22,0,5,5,0,6,6,0,83,27,56,0,,30,0,30,65,1,64
10/08/2022 11:00,14,10,4,132,58,74,156,67,89,0,0,0,9,9,0,7,7,0,14,14,0,107,33,74,0,,42,0,42,64,0,64
10/08/2022 12:00,24,15,9,127,70,57,179,91,88,0,0,0,23,21,2,13,13,0,15,15,0,143,57,86,0,,80,1,79,101,1,100
10/08/2022 13:00,24,13,11,117,54,63,171,77,94,0,0,0,9,9,0,14,14,0,20,20,0,138,54,84,0,,99,0,99,97,0,97
10/08/2022 14:00,20,7,13,122,54,68,181,83,98,0,0,0,10,10,0,15,15,0,10,10,0,105,41,64,0,,64,2,62,64,0,64
10/08/2022 15:00,23,8,15,110,44,66,145,65,80,0,0,0,5,5,0,9,9,0,12,12,0,180,88,92,0,,77,1,76,89,0,89
10/08/2022 16:00,50,17,33,130,63,67,163,74,89,0,0,0,19,19,0,25,25,0,20,20,0,267,139,128,0,,137,0,137,100,1,99
10/08/2022 17:00,76,10,66,226,86,140,282,106,176,0,0,0,7,7,0,38,38,0,29,29,0,434,258,176,0,,225,0,225,129,0,129
10/08/2022 18:00,58,17,41,247,85,162,323,105,218,0,0,0,20,20,0,33,33,0,24,24,0,377,216,161,0,,198,0,198,139,1,138
10/08/2022 19:00,28,9,19,209,102,107,327,163,164,0,0,0,16,16,0,25,25,0,15,15,0,265,156,109,0,,132,0,132,126,0,126
10/08/2022 20:00,35,13,22,179,100,79,270,154,116,0,0,0,10,10,0,19,19,0,21,21,0,190,116,74,0,,101,0,101,100,2,98
10/08/2022 21:00,17,3,14,92,62,30,198,117,81,0,0,0,10,10,0,23,23,0,10,10,0,145,97,48,0,,60,3,57,80,0,80
10/08/2022 22:00,7,4,3,22,12,10,50,23,27,0,0,0,7,7,0,10,10,0,8,8,0,114,75,39,0,,45,0,45,45,0,45
10/08/2022 23:00,7,2,5,18,9,9,32,15,17,0,0,0,4,4,0,2,2,0,2,2,0,53,36,17,0,,47,0,47,31,1,30
11/08/2022 00:00,0,0,0,5,2,3,13,3,10,0,0,0,2,2,0,6,6,0,2,2,0,37,26,11,0,,25,1,24,15,0,15
11/08/2022 01:00,2,1,1,1,1,0,2,1,1,0,0,0,1,1,0,1,1,0,0,0,0,9,8,1,0,,9,1,8,1,0,1
11/08/2022 02:00,2,1,1,0,0,0,0,0,0,0,0,0,2,2,0,0,0,0,0,0,0,6,6,0,0,,11,0,11,2,0,2
11/08/2022 03:00,0,0,0,1,0,1,4,1,3,0,0,0,1,1,0,0,0,0,0,0,0,5,3,2,0,,3,0,3,1,0,1
11/08/2022 04:00,1,1,0,3,3,0,3,2,1,0,0,0,1,1,0,0,0,0,2,2,0,4,1,3,0,,4,0,4,3,0,3
11/08/2022 05:00,5,4,1,12,6,6,19,9,10,0,0,0,7,7,0,1,1,0,1,1,0,33,3,30,0,,7,0,7,10,0,10
11/08/2022 06:00,28,26,2,47,29,18,43,27,16,0,0,0,27,27,0,7,7,0,3,3,0,149,27,122,0,,13,0,13,40,0,40
11/08/2022 07:00,40,35,5,123,86,37,132,92,40,0,0,0,43,43,0,11,11,0,17,17,0,318,80,238,0,,32,1,31,84,0,84
11/08/2022 08:00,93,83,10,129,97,32,170,122,48,0,0,0,72,72,0,21,21,0,13,13,0,526,91,435,0,,60,0,60,189,0,189
11/08/2022 09:00,40,37,3,98,61,37,94,57,37,0,0,0,39,39,0,9,9,0,8,8,0,236,40,196,0,,26,0,26,132,0,132
11/08/2022 10:00,18,12,6,88,35,53,116,45,71,0,0,0,2,2,0,5,5,0,5,5,0,107,31,76,0,,32,0,32,86,1,85
11/08/2022 11:00,9,6,3,107,56,51,148,66,82,0,0,0,7,7,0,8,8,0,9,9,0,100,32,68,0,,46,0,46,67,0,67
11/08/2022 12:00,15,13,2,112,55,57,146,59,87,0,0,0,4,4,0,11,11,0,9,9,0,107,34,73,0,,72,0,72,94,0,94
11/08/2022 13:00,18,8,10,115,51,64,165,80,85,0,0,0,8,8,0,19,19,0,9,9,0,155,66,89,0,,94,1,93,98,3,95
11/08/2022 14:00,18,10,8,103,53,50,154,72,82,0,0,0,7,7,0,9,9,0,1,1,0,130,71,59,0,,94,1,93,95,1,94
11/08/2022 15:00,24,10,14,110,48,62,162,79,83,0,0,0,6,6,0,17,17,0,8,8,0,165,75,90,0,,85,1,84,89,0,89
11/08/2022 16:00,37,16,21,138,58,80,202,75,127,0,0,0,8,8,0,21,21,0,22,22,0,277,159,118,0,,128,0,128,82,1,81
11/08/2022 17:00,71,22,49,213,79,134,280,105,175,0,0,0,8,7,1,28,28,0,33,33,0,412,266,146,0,,237,0,237,118,0,118
11/08/2022 18:00,42,11,31,257,96,161,355,116,239,0,0,0,9,9,0,29,29,0,22,22,0,360,207,153,0,,177,0,177,151,0,151
11/08/2022 19:00,24,17,7,211,111,100,309,153,156,0,0,0,8,8,0,26,26,0,13,13,0,214,118,96,0,,144,1,143,98,0,98
11/08/2022 20:00,13,3,10,155,89,66,254,135,119,0,0,0,7,7,0,17,17,0,10,10,0,153,100,53,0,,102,0,102,117,0,117
11/08/2022 21:00,16,5,11,76,51,25,155,94,61,0,0,0,10,10,0,13,13,0,2,2,0,151,103,48,0,,84,3,81,72,1,71
11/08/2022 22:00,11,1,10,23,11,12,86,49,37,0,0,0,5,5,0,7,7,0,2,2,0,108,79,29,0,,60,2,58,37,0,37
11/08/2022 23:00,2,1,1,7,4,3,29,11,18,0,0,0,1,1,0,5,5,0,0,0,0,64,53,11,0,,51,0,51,30,0,30
12/08/2022 00:00,2,1,1,5,0,5,15,5,10,0,0,0,1,1,0,3,3,0,1,1,0,40,26,14,0,,30,1,29,25,0,25
12/08/2022 01:00,4,0,4,1,1,0,2,2,0,0,0,0,1,1,0,2,2,0,0,0,0,23,17,6,0,,6,0,6,0,0,0
12/08/2022 02:00,0,0,0,4,2,2,4,1,3,0,0,0,1,1,0,0,0,0,0,0,0,5,4,1,0,,13,1,12,3,0,3
12/08/2022 03:00,0,0,0,1,1,0,1,0,1,0,0,0,1,1,0,0,0,0,0,0,0,10,7,3,0,,6,0,6,3,0,3
12/08/2022 04:00,1,0,1,2,2,0,3,2,1,0,0,0,2,2,0,1,1,0,0,0,0,6,4,2,0,,2,0,2,1,0,1
12/08/2022 05:00,3,3,0,8,5,3,11,5,6,0,0,0,6,6,0,1,1,0,1,1,0,35,5,30,0,,6,0,6,15,0,15
12/08/2022 06:00,17,13,4,32,22,10,33,24,9,0,0,0,28,28,0,14,14,0,10,10,0,146,26,120,0,,15,1,14,38,0,38
12/08/2022 07:00,37,32,5,87,62,25,91,62,29,0,0,0,32,32,0,8,8,0,17,17,0,243,62,181,0,,28,0,28,62,0,62
12/08/2022 08:00,57,47,10,98,58,40,112,71,41,0,0,0,19,18,1,15,15,0,17,17,0,345,80,265,0,,65,0,65,132,1,131
12/08/2022 09:00,26,20,6,82,43,39,93,45,48,0,0,0,19,19,0,10,10,0,20,20,0,189,46,143,0,,39,0,39,123,0,123
12/08/2022 10:00,19,13,6,85,31,54,121,49,72,0,0,0,20,20,0,7,7,0,17,17,0,100,25,75,0,,37,0,37,62,1,61
12/08/2022 11:00,17,14,3,103,47,56,132,63,69,0,0,0,12,12,0,14,14,0,14,14,0,117,33,84,0,,56,0,56,83,0,83
12/08/2022 12:00,19,13,6,119,54,65,170,67,103,0,0,0,6,6,0,16,16,0,11,11,0,139,54,85,0,,83,0,83,104,0,104
12/08/2022 13:00,28,11,17,117,56,61,185,92,93,0,0,0,4,4,0,12,12,0,7,7,0,145,67,78,0,,90,1,89,120,1,119
12/08/2022 14:00,18,12,6,121,54,67,193,84,109,0,0,0,8,8,0,12,12,0,11,11,0,149,61,88,0,,85,3,82,111,1,110
12/08/2022 15:00,33,14,19,130,64,66,189,84,105,0,0,0,3,3,0,26,26,0,12,12,0,189,109,80,0,,96,0,96,77,1,76
12/08/2022 16:00,35,15,20,150,71,79,229,120,109,0,0,0,4,4,0,15,15,0,5,5,0,255,136,119,0,,113,0,113,107,0,107
12/08/2022 17:00,43,16,27,190,73,117,277,110,167,0,0,0,8,8,0,31,31,0,4,4,0,266,155,111,0,,169,0,169,147,0,147
12/08/2022 18:00,31,18,13,176,80,96,244,113,131,0,0,0,13,13,0,19,19,0,6,6,0,250,123,127,0,,122,0,122,117,2,115
12/08/2022 19:00,16,10,6,150,74,76,215,100,115,0,0,0,8,8,0,14,14,0,12,12,0,177,94,83,0,,100,1,99,108,0,108
12/08/2022 20:00,12,5,7,96,48,48,157,79,78,0,0,0,11,11,0,12,12,0,9,9,0,157,78,79,0,,96,0,96,111,2,109
12/08/2022 21:00,10,6,4,55,34,21,104,56,48,0,0,0,11,11,0,7,7,0,4,4,0,138,80,58,0,,64,2,62,68,0,68
12/08/2022 22:00,9,3,6,27,17,10,57,37,20,0,0,0,4,4,0,3,3,0,4,4,0,110,73,37,0,,62,0,62,49,0,49
12/08/2022 23:00,7,4,3,19,13,6,29,18,11,0,0,0,2,2,0,5,5,0,1,1,0,64,50,14,0,,52,1,51,40,1,39
13/08/2022 00:00,1,0,1,8,5,3,14,6,8,0,0,0,0,0,0,5,5,0,0,0,0,38,26,12,0,,36,0,36,19,0,19
13/08/2022 01:00,2,1,1,7,3,4,1,1,0,0,0,0,1,1,0,1,1,0,0,0,0,22,11,11,0,,9,0,9,0,0,0
13/08/2022 02:00,3,0,3,3,2,1,10,3,7,0,0,0,4,4,0,1,1,0,0,0,0,22,19,3,0,,25,0,25,7,0,7
13/08/2022 03:00,2,2,0,3,2,1,3,0,3,0,0,0,0,0,0,0,0,0,0,0,0,8,7,1,0,,15,0,15,7,0,7
13/08/2022 04:00,1,0,1,3,1,2,8,4,4,0,0,0,0,0,0,0,0,0,0,0,0,11,7,4,0,,3,0,3,3,0,3
13/08/2022 05:00,0,0,0,11,4,7,8,2,6,0,0,0,8,8,0,2,2,0,0,0,0,12,5,7,0,,4,0,4,1,0,1
13/08/2022 06:00,4,4,0,17,8,9,25,16,9,0,0,0,7,7,0,2,2,0,0,0,0,47,7,40,0,,6,0,6,7,0,7
13/08/2022 07:00,10,10,0,58,25,33,69,31,38,0,0,0,15,15,0,3,3,0,0,0,0,72,16,56,0,,12,1,11,23,0,23
13/08/2022 08:00,16,14,2,109,46,63,117,52,65,0,0,0,9,9,0,6,6,0,1,1,0,78,17,61,0,,25,0,25,36,0,36
13/08/2022 09:00,11,6,5,132,52,80,177,62,115,0,0,0,12,12,0,9,9,0,17,17,0,105,35,70,0,,30,0,30,73,0,73
13/08/2022 10:00,23,19,4,209,95,114,253,107,146,0,0,0,7,7,0,17,17,0,17,17,0,111,32,79,0,,36,0,36,70,0,70
13/08/2022 11:00,24,13,11,228,91,137,308,114,194,0,0,0,8,8,0,14,14,0,19,19,0,144,44,100,0,,55,0,55,95,1,94
13/08/2022 12:00,16,11,5,240,87,153,335,108,227,0,0,0,2,2,0,17,17,0,14,14,0,167,51,116,0,,66,0,66,98,0,98
13/08/2022 13:00,34,25,9,285,133,152,375,157,218,0,0,0,5,5,0,16,16,0,16,16,0,163,66,97,0,,75,1,74,104,0,104
13/08/2022 14:00,17,9,8,248,113,135,350,149,201,0,0,0,12,12,0,19,19,0,5,5,0,133,54,79,0,,77,1,76,79,1,78
13/08/2022 15:00,25,12,13,208,97,111,360,181,179,0,0,0,13,12,1,15,15,0,0,0,0,125,57,68,0,,62,1,61,98,0,98
13/08/2022 16:00,17,10,7,213,119,94,328,178,150,0,0,0,13,13,0,11,11,0,4,4,0,131,68,63,0,,75,1,74,92,0,92
13/08/2022 17:00,19,5,14,170,98,72,263,155,108,0,0,0,11,11,0,14,14,0,0,0,0,140,64,76,0,,90,0,90,109,0,109
13/08/2022 18:00,18,10,8,135,87,48,230,150,80,0,0,0,3,3,0,10,10,0,1,1,0,143,69,74,0,,68,0,68,94,0,94
13/08/2022 19:00,19,7,12,127,88,39,187,130,57,0,0,0,9,9,0,22,22,0,2,2,0,146,61,85,0,,81,0,81,88,0,88
13/08/2022 20:00,12,7,5,88,55,33,131,89,42,0,0,0,9,8,1,11,11,0,1,1,0,116,68,48,0,,63,1,62,95,1,94
13/08/2022 21:00,4,4,0,38,24,14,50,36,14,0,0,0,10,10,0,5,5,0,0,0,0,80,44,36,0,,49,1,48,74,0,74
13/08/2022 22:00,12,7,5,23,13,10,39,25,14,0,0,0,9,9,0,8,8,0,0,0,0,74,45,29,0,,55,0,55,48,1,47
13/08/2022 23:00,3,2,1,7,4,3,11,6,5,0,0,0,2,2,0,4,4,0,0,0,0,52,42,10,0,,39,0,39,31,0,31
14/08/2022 00:00,1,0,1,12,7,5,11,5,6,0,0,0,8,8,0,0,0,0,0,0,0,39,29,10,0,,29,1,28,23,0,23
14/08/2022 01:00,3,3,0,8,4,4,6,1,5,0,0,0,2,2,0,1,1,0,0,0,0,27,19,8,0,,14,0,14,2,0,2
14/08/2022 02:00,0,0,0,9,6,3,5,1,4,0,0,0,0,0,0,0,0,0,0,0,0,12,7,5,0,,30,0,30,8,1,7
14/08/2022 03:00,1,0,1,3,1,2,10,4,6,0,0,0,0,0,0,0,0,0,0,0,0,24,20,4,0,,17,0,17,6,0,6
14/08/2022 04:00,1,1,0,5,4,1,2,1,1,0,0,0,2,2,0,0,0,0,0,0,0,9,6,3,0,,8,0,8,4,0,4
14/08/2022 05:00,1,0,1,4,1,3,4,0,4,0,0,0,1,1,0,1,1,0,0,0,0,13,7,6,0,,7,0,7,3,0,3
14/08/2022 06:00,5,3,2,14,5,9,15,7,8,0,0,0,4,4,0,3,3,0,0,0,0,36,7,29,0,,6,0,6,9,0,9
14/08/2022 07:00,5,5,0,42,19,23,39,14,25,0,0,0,14,14,0,3,3,0,0,0,0,39,9,30,0,,8,0,8,12,0,12
14/08/2022 08:00,10,10,0,128,49,79,117,45,72,0,0,0,8,8,0,6,6,0,1,1,0,59,20,39,0,,13,0,13,18,0,18
14/08/2022 09:00,10,7,3,141,56,85,140,60,80,0,0,0,0,0,0,11,11,0,6,6,0,80,26,54,0,,20,0,20,46,1,45
14/08/2022 10:00,26,14,12,175,69,106,196,86,110,0,0,0,1,0,1,15,15,0,14,14,0,120,38,82,0,,31,0,31,47,2,45
14/08/2022 11:00,17,13,4,210,106,104,254,101,153,0,0,0,1,0,1,12,12,0,13,13,0,116,40,76,0,,40,1,39,77,0,77
14/08/2022 12:00,12,10,2,202,93,109,275,113,162,0,0,0,0,0,0,14,14,0,11,11,0,128,39,89,0,,60,0,60,95,0,95
14/08/2022 13:00,27,12,15,188,101,87,286,129,157,0,0,0,2,2,0,21,21,0,10,10,0,134,34,100,0,,58,0,58,174,0,174
14/08/2022 14:00,18,10,8,181,100,81,313,152,161,0,0,0,0,0,0,12,12,0,5,5,0,130,52,78,0,,59,2,57,118,0,118
14/08/2022 15:00,21,15,6,157,68,89,255,134,121,0,0,0,0,0,0,11,11,0,3,3,0,117,42,75,0,,69,0,69,89,0,89
14/08/2022 16:00,22,17,5,135,74,61,254,141,113,0,0,0,2,1,1,17,17,0,4,4,0,144,80,64,0,,87,0,87,98,1,97
14/08/2022 17:00,19,6,13,141,76,65,202,113,89,0,0,0,2,2,0,22,22,0,0,0,0,131,76,55,0,,109,1,108,81,0,81
14/08/2022 18:00,15,6,9,107,60,47,133,86,47,0,0,0,7,7,0,12,12,0,1,1,0,121,64,57,0,,109,1,108,85,0,85
14/08/2022 19:00,13,7,6,69,44,25,117,72,45,0,0,0,4,4,0,13,13,0,2,2,0,128,76,52,0,,86,2,84,71,0,71
14/08/2022 20:00,24,11,13,45,27,18,69,42,27,0,0,0,10,10,0,3,3,0,0,0,0,113,68,45,0,,71,0,71,73,0,73
14/08/2022 21:00,13,8,5,28,18,10,31,16,15,0,0,0,3,3,0,7,7,0,0,0,0,69,42,27,0,,58,0,58,73,0,73
14/08/2022 22:00,10,4,6,11,6,5,18,8,10,0,0,0,0,0,0,0,0,0,0,0,0,47,37,10,0,,8,0,8,34,0,34
14/08/2022 23:00,5,2,3,11,5,6,16,4,12,0,0,0,4,4,0,5,5,0,0,0,0,35,30,5,0,,0,0,0,22,0,22
15/08/2022 00:00,2,1,1,10,4,6,6,2,4,0,0,0,2,2,0,2,2,0,0,0,0,20,18,2,0,,15,0,15,11,0,11
15/08/2022 01:00,3,2,1,3,2,1,1,1,0,0,0,0,0,0,0,2,2,0,0,0,0,7,4,3,0,,0,0,0,0,0,0
15/08/2022 02:00,0,0,0,1,0,1,4,1,3,0,0,0,0,0,0,0,0,0,0,0,0,11,8,3,0,,8,0,8,8,0,8
15/08/2022 03:00,0,0,0,1,1,0,1,0,1,0,0,0,0,0,0,0,0,0,1,1,0,1,1,0,0,,3,0,3,0,0,0
15/08/2022 04:00,1,1,0,1,1,0,2,2,0,0,0,0,1,1,0,0,0,0,1,1,0,8,2,6,0,,1,0,1,3,0,3
15/08/2022 05:00,2,2,0,8,5,3,9,5,4,0,0,0,3,3,0,2,2,0,1,1,0,29,5,24,0,,5,0,5,7,0,7
15/08/2022 06:00,14,13,1,20,11,9,27,17,10,0,0,0,16,16,0,11,11,0,0,0,0,134,26,108,0,,12,0,12,29,0,29
15/08/2022 07:00,28,28,0,62,50,12,69,58,11,0,0,0,23,23,0,11,11,0,16,16,0,201,56,145,0,,24,0,24,59,0,59
15/08/2022 08:00,61,55,6,41,35,6,62,51,11,0,0,0,51,51,0,11,11,0,12,12,0,340,75,265,0,,42,0,42,104,0,104
15/08/2022 09:00,22,20,2,30,20,10,35,23,12,0,0,0,20,20,0,17,17,0,6,6,0,175,30,145,0,,31,0,31,102,1,101
15/08/2022 10:00,15,11,4,33,12,21,46,17,29,0,0,0,9,9,0,10,10,0,9,9,0,72,25,47,0,,31,1,30,62,0,62
15/08/2022 11:00,10,6,4,37,16,21,40,17,23,0,0,0,13,13,0,5,5,0,7,7,0,86,36,50,0,,36,0,36,79,0,79
15/08/2022 12:00,8,4,4,53,25,28,69,36,33,0,0,0,2,2,0,9,9,0,7,7,0,79,25,54,0,,60,0,60,82,0,82
15/08/2022 13:00,17,11,6,33,18,15,43,18,25,0,0,0,6,6,0,6,6,0,6,6,0,80,38,42,0,,75,2,73,61,0,61
15/08/2022 14:00,18,9,9,37,16,21,48,27,21,0,0,0,3,3,0,5,5,0,4,4,0,105,38,67,0,,57,1,56,78,0,78
15/08/2022 15:00,18,5,13,45,18,27,76,32,44,0,0,0,8,8,0,8,8,0,6,6,0,113,62,51,0,,67,0,67,67,1,66
15/08/2022 16:00,36,17,19,59,29,30,91,38,53,0,0,0,5,5,0,16,16,0,1,1,0,193,109,84,0,,107,4,103,79,0,79
15/08/2022 17:00,42,12,30,66,24,42,86,32,54,0,0,0,8,8,0,15,15,0,0,0,0,260,173,87,0,,170,0,170,94,0,94
15/08/2022 18:00,35,10,25,66,18,48,83,22,61,0,0,0,9,9,0,13,13,0,0,0,0,243,152,91,0,,154,0,154,100,2,98
15/08/2022 19:00,20,9,11,43,20,23,57,16,41,0,0,0,9,9,0,8,8,0,0,0,0,147,88,59,0,,90,1,89,84,1,83
15/08/2022 20:00,12,5,7,23,11,12,40,16,24,0,0,0,7,7,0,6,6,0,0,0,0,90,51,39,0,,76,1,75,77,1,76
15/08/2022 21:00,7,2,5,19,9,10,20,5,15,0,0,0,6,6,0,3,3,0,0,0,0,72,40,32,0,,47,0,47,37,0,37
15/08/2022 22:00,8,4,4,8,4,4,11,4,7,0,0,0,1,1,0,2,2,0,0,0,0,40,32,8,0,,37,1,36,27,2,25
15/08/2022 23:00,5,2,3,6,2,4,10,3,7,0,0,0,0,0,0,1,1,0,0,0,0,21,18,3,0,,20,0,20,14,0,14
16/08/2022 00:00,1,1,0,0,0,0,6,1,5,0,0,0,0,0,0,1,1,0,0,0,0,12,9,3,0,,13,0,13,11,0,11
16/08/2022 01:00,0,0,0,2,2,0,0,0,0,0,0,0,2,2,0,0,0,0,0,0,0,9,5,4,0,,0,0,0,0,0,0
16/08/2022 02:00,0,0,0,1,1,0,2,1,1,0,0,0,0,0,0,0,0,0,0,0,0,5,3,2,0,,4,0,4,6,0,6
16/08/2022 03:00,0,0,0,1,0,1,0,0,0,0,0,0,1,1,0,0,0,0,1,1,0,2,1,1,0,,1,0,1,1,0,1
16/08/2022 04:00,0,0,0,1,1,0,2,1,1,0,0,0,2,2,0,0,0,0,1,1,0,3,0,3,0,,2,0,2,1,0,1
16/08/2022 05:00,3,3,0,8,4,4,11,6,5,0,0,0,8,8,0,1,1,0,0,0,0,32,8,24,0,,4,0,4,5,0,5
16/08/2022 06:00,22,15,7,31,21,10,37,28,9,0,0,0,22,22,0,8,8,0,0,0,0,148,33,115,0,,13,0,13,44,0,44
16/08/2022 07:00,37,35,2,74,59,15,92,74,18,0,0,0,43,43,0,18,18,0,10,10,0,351,77,274,0,,37,0,37,92,0,92
16/08/2022 08:00,97,88,9,100,78,22,116,91,25,0,0,0,65,64,1,20,20,0,0,0,0,568,91,477,0,,73,2,71,200,0,200
16/08/2022 09:00,29,24,5,58,41,17,69,46,23,0,0,0,31,31,0,18,18,0,5,5,0,220,34,186,0,,53,2,51,126,0,126
16/08/2022 10:00,18,13,5,51,26,25,65,27,38,0,0,0,15,15,0,7,7,0,0,0,0,94,24,70,0,,26,0,26,61,1,60
16/08/2022 11:00,14,7,7,69,36,33,49,28,21,0,0,0,11,11,0,8,8,0,1,1,0,87,22,65,0,,46,0,46,81,1,80
16/08/2022 12:00,11,7,4,57,28,29,78,39,39,0,0,0,6,6,0,12,12,0,3,3,0,87,32,55,0,,69,0,69,110,0,110
16/08/2022 13:00,18,9,9,58,29,29,75,38,37,0,0,0,6,6,0,15,15,0,9,9,0,106,48,58,0,,95,1,94,93,1,92
16/08/2022 14:00,14,8,6,48,19,29,56,23,33,0,0,0,1,1,0,10,10,0,4,4,0,112,61,51,0,,71,0,71,84,1,83
16/08/2022 15:00,11,4,7,59,27,32,83,35,48,0,0,0,2,2,0,12,12,0,11,11,0,144,75,69,0,,59,0,59,73,0,73
16/08/2022 16:00,32,11,21,98,38,60,103,39,64,0,0,0,3,3,0,29,29,0,0,0,0,246,165,81,0,,140,3,137,96,0,96
16/08/2022 17:00,68,18,50,112,30,82,169,51,118,0,0,0,11,11,0,31,31,0,0,0,0,418,290,128,0,,240,1,239,126,1,125
16/08/2022 18:00,47,14,33,145,41,104,169,46,123,0,0,0,15,15,0,21,21,0,0,0,0,343,219,124,0,,207,0,207,132,0,132
16/08/2022 19:00,30,12,18,92,36,56,123,44,79,0,0,0,7,7,0,17,17,0,1,1,0,198,130,68,0,,135,2,133,121,1,120
16/08/2022 20:00,16,9,7,67,33,34,74,36,38,0,0,0,7,7,0,12,12,0,3,3,0,131,83,48,0,,88,0,88,78,0,78
16/08/2022 21:00,7,3,4,30,18,12,45,26,19,0,0,0,8,8,0,3,3,0,0,0,0,96,63,33,0,,67,0,67,48,0,48
16/08/2022 22:00,5,1,4,17,9,8,22,8,14,0,0,0,6,6,0,1,1,0,0,0,0,82,59,23,0,,52,0,52,46,0,46
16/08/2022 23:00,1,0,1,6,4,2,7,2,5,0,0,0,1,1,0,0,0,0,0,0,0,35,30,5,0,,33,1,32,25,0,25
17/08/2022 00:00,2,2,0,2,1,1,6,2,4,0,0,0,0,0,0,3,3,0,0,0,0,20,17,3,0,,29,0,29,10,2,8
17/08/2022 01:00,0,0,0,2,2,0,4,1,3,0,0,0,2,2,0,3,3,0,1,1,0,10,7,3,0,,4,0,4,0,0,0
17/08/2022 02:00,1,0,1,4,2,2,1,0,1,0,0,0,0,0,0,0,0,0,0,0,0,4,3,1,0,,13,0,13,4,1,3
17/08/2022 03:00,0,0,0,1,0,1,1,0,1,0,0,0,2,2,0,0,0,0,0,0,0,3,0,3,0,,4,0,4,1,0,1
17/08/2022 04:00,1,0,1,2,2,0,3,2,1,0,0,0,0,0,0,0,0,0,0,0,0,5,2,3,0,,2,0,2,1,0,1
17/08/2022 05:00,4,4,0,6,2,4,13,9,4,0,0,0,4,4,0,1,1,0,0,0,0,28,5,23,0,,4,0,4,5,0,5
17/08/2022 06:00,22,17,5,46,27,19,49,34,15,0,0,0,22,22,0,7,7,0,0,0,0,156,30,126,0,,10,0,10,44,0,44
17/08/2022 07:00,42,37,5,78,68,10,88,73,15,0,0,0,64,64,0,12,12,0,5,5,0,318,64,254,0,,29,1,28,92,0,92
17/08/2022 08:00,106,100,6,92,71,21,134,105,29,0,0,0,79,78,1,14,14,0,6,6,0,549,82,467,0,,86,0,86,199,0,199
17/08/2022 09:00,45,37,8,50,33,17,65,43,22,0,0,0,37,36,1,15,15,0,13,13,0,239,41,198,0,,42,0,42,130,0,130
17/08/2022 10:00,14,11,3,42,17,25,32,14,18,0,0,0,16,16,0,5,5,0,4,4,0,84,30,54,0,,35,1,34,66,2,64
17/08/2022 11:00,9,6,3,46,24,22,61,31,30,0,0,0,7,7,0,6,6,0,5,5,0,76,22,54,0,,28,0,28,51,0,51
17/08/2022 12:00,18,8,10,37,18,19,47,21,26,0,0,0,6,6,0,7,7,0,7,7,0,114,47,67,0,,60,0,60,103,0,103
17/08/2022 13:00,13,5,8,18,11,7,30,11,19,0,0,0,7,6,1,3,3,0,8,8,0,105,47,58,0,,78,0,78,97,2,95
17/08/2022 14:00,17,10,7,29,14,15,47,14,33,0,0,0,5,5,0,9,9,0,8,8,0,100,52,48,0,,63,1,62,84,0,84
17/08/2022 15:00,16,9,7,52,21,31,68,27,41,0,0,0,4,4,0,12,12,0,7,7,0,134,69,65,0,,83,0,83,67,1,66
17/08/2022 16:00,43,13,30,70,27,43,93,34,59,0,0,0,5,5,0,20,20,0,18,18,0,246,154,92,0,,132,0,132,101,0,101
17/08/2022 17:00,59,14,45,128,30,98,178,48,130,0,0,0,12,12,0,33,33,0,25,25,0,446,308,138,0,,230,1,229,138,2,136
17/08/2022 18:00,53,15,38,171,54,117,213,64,149,0,0,0,29,29,0,33,33,0,7,7,0,386,243,143,0,,187,1,186,145,0,145
17/08/2022 19:00,34,13,21,142,71,71,160,73,87,0,0,0,8,8,0,21,21,0,4,4,0,213,127,86,0,,143,0,143,121,0,121
17/08/2022 20:00,24,11,13,77,42,35,92,43,49,0,0,0,8,8,0,8,8,0,19,19,0,123,68,55,0,,91,0,91,105,0,105
17/08/2022 21:00,11,8,3,27,13,14,42,22,20,0,0,0,6,6,0,13,13,0,6,6,0,96,69,27,0,,87,0,87,57,1,56
17/08/2022 22:00,11,6,5,17,8,9,21,9,12,0,0,0,5,5,0,3,3,0,3,3,0,87,61,26,0,,57,1,56,47,0,47
17/08/2022 23:00,5,0,5,4,1,3,11,3,8,0,0,0,6,6,0,3,3,0,1,1,0,32,24,8,0,,34,0,34,22,1,21
18/08/2022 00:00,1,0,1,4,2,2,8,4,4,0,0,0,1,1,0,3,3,0,0,0,0,21,17,4,0,,27,0,27,19,0,19
18/08/2022 01:00,0,0,0,3,2,1,2,1,1,0,0,0,2,2,0,0,0,0,0,0,0,15,11,4,0,,5,0,5,0,0,0
18/08/2022 02:00,0,0,0,3,3,0,4,1,3,0,0,0,1,1,0,0,0,0,0,0,0,5,4,1,0,,7,0,7,4,0,4
18/08/2022 03:00,1,0,1,0,0,0,0,0,0,0,0,0,2,2,0,0,0,0,0,0,0,8,6,2,0,,7,0,7,1,0,1
18/08/2022 04:00,3,2,1,1,1,0,3,2,1,0,0,0,0,0,0,1,1,0,0,0,0,5,2,3,0,,1,0,1,0,0,0
18/08/2022 05:00,4,3,1,8,4,4,11,4,7,0,0,0,3,3,0,2,2,0,0,0,0,38,6,32,0,,3,0,3,8,0,8
18/08/2022 06:00,25,21,4,26,17,9,34,23,11,0,0,0,30,29,1,10,10,0,0,0,0,148,28,120,0,,10,0,10,35,0,35
18/08/2022 07:00,42,37,5,61,45,16,61,46,15,0,0,0,42,42,0,18,18,0,0,0,0,311,75,236,0,,31,0,31,80,0,80
18/08/2022 08:00,98,89,9,84,62,22,118,97,21,0,0,0,84,81,3,15,15,0,0,0,0,567,90,477,0,,78,0,78,185,0,185
18/08/2022 09:00,49,38,11,35,25,10,57,41,16,0,0,0,34,34,0,11,11,0,0,0,0,257,41,216,0,,40,1,39,126,0,126
18/08/2022 10:00,23,18,5,48,22,26,50,21,29,0,0,0,9,9,0,2,2,0,0,0,0,110,42,68,0,,29,1,28,71,0,71
18/08/2022 11:00,14,10,4,45,24,21,50,27,23,0,0,0,4,4,0,9,9,0,0,0,0,101,36,65,0,,43,0,43,66,0,66
18/08/2022 12:00,21,13,8,52,26,26,55,24,31,0,0,0,6,6,0,8,8,0,0,0,0,100,40,60,0,,68,0,68,96,3,93
18/08/2022 13:00,15,10,5,38,23,15,54,31,23,0,0,0,12,12,0,17,17,0,0,0,0,108,43,65,0,,89,0,89,107,1,106
18/08/2022 14:00,22,12,10,46,17,29,66,24,42,0,0,0,7,7,0,13,13,0,0,0,0,118,57,61,0,,71,0,71,89,0,89
18/08/2022 15:00,35,15,20,43,16,27,81,32,49,0,0,0,5,5,0,10,10,0,0,0,0,120,70,50,0,,60,0,60,80,0,80
18/08/2022 16:00,37,10,27,74,29,45,110,40,70,0,0,0,6,6,0,18,18,0,1,1,0,250,144,106,0,,108,0,108,94,0,94
18/08/2022 17:00,74,26,48,108,33,75,157,47,110,0,0,0,17,16,1,26,26,0,1,1,0,392,271,121,0,,228,1,227,118,0,118
18/08/2022 18:00,61,13,48,150,45,105,193,46,147,0,0,0,11,11,0,28,28,0,0,0,0,322,208,114,0,,178,0,178,144,1,143
18/08/2022 19:00,31,17,14,93,36,57,128,54,74,0,0,0,11,10,1,11,11,0,0,0,0,185,101,84,0,,143,1,142,127,1,126
18/08/2022 20:00,17,9,8,85,41,44,112,62,50,0,0,0,9,9,0,16,16,0,1,1,0,148,81,67,0,,99,0,99,106,1,105
18/08/2022 21:00,10,3,7,24,11,13,33,16,17,0,0,0,4,4,0,8,8,0,0,0,0,114,73,41,0,,66,1,65,75,1,74
18/08/2022 22:00,9,3,6,14,7,7,26,7,19,0,0,0,4,4,0,8,8,0,0,0,0,84,56,28,0,,69,1,68,46,0,46
18/08/2022 23:00,5,2,3,7,3,4,16,4,12,0,0,0,8,8,0,0,0,0,0,0,0,57,47,10,0,,50,0,50,24,0,24
19/08/2022 00:00,0,0,0,2,1,1,5,3,2,0,0,0,5,5,0,2,2,0,0,0,0,27,21,6,0,,35,0,35,16,0,16
19/08/2022 01:00,2,0,2,5,3,2,1,1,0,0,0,0,0,0,0,1,1,0,0,0,0,16,14,2,0,,8,0,8,0,0,0
19/08/2022 02:00,0,0,0,0,0,0,0,0,0,0,0,0,2,2,0,0,0,0,0,0,0,5,3,2,0,,10,1,9,4,0,4
19/08/2022 03:00,0,0,0,0,0,0,2,0,2,0,0,0,3,3,0,2,2,0,0,0,0,11,10,1,0,,15,0,15,3,0,3
19/08/2022 04:00,0,0,0,1,1,0,2,1,1,0,0,0,0,0,0,0,0,0,0,0,0,7,3,4,0,,2,0,2,2,0,2
19/08/2022 05:00,3,2,1,9,7,2,12,8,4,0,0,0,7,7,0,1,1,0,0,0,0,29,6,23,0,,4,0,4,5,0,5
19/08/2022 06:00,20,17,3,27,16,11,41,21,20,0,0,0,27,27,0,11,11,0,0,0,0,127,19,108,0,,13,0,13,34,0,34
19/08/2022 07:00,25,20,5,66,43,23,70,43,27,0,0,0,50,50,0,8,8,0,0,0,0,232,63,169,0,,40,0,40,70,2,68
19/08/2022 08:00,66,58,8,91,60,31,94,65,29,0,0,0,43,43,0,17,17,0,0,0,0,328,67,261,0,,52,1,51,123,0,123
19/08/2022 09:00,26,21,5,52,27,25,60,37,23,0,0,0,15,15,0,11,11,0,0,0,0,191,39,152,0,,37,0,37,118,0,118
19/08/2022 10:00,20,13,7,60,28,32,65,28,37,0,0,0,23,23,0,7,7,0,0,0,0,98,33,65,0,,29,0,29,65,0,65
19/08/2022 11:00,24,13,11,60,24,36,59,27,32,0,0,0,4,4,0,8,8,0,0,0,0,114,41,73,0,,62,0,62,77,0,77
19/08/2022 12:00,18,11,7,68,35,33,68,31,37,0,0,0,9,9,0,10,10,0,0,0,0,138,49,89,0,,70,1,69,117,0,117
19/08/2022 13:00,28,15,13,48,22,26,64,28,36,0,0,0,8,8,0,13,13,0,0,0,0,155,65,90,0,,81,1,80,132,0,132
19/08/2022 14:00,8,4,4,46,24,22,59,19,40,0,0,0,8,8,0,8,8,0,0,0,0,132,70,62,0,,98,1,97,97,0,97
19/08/2022 15:00,29,16,13,55,19,36,86,33,53,0,0,0,9,9,0,8,8,0,0,0,0,153,77,76,0,,52,0,52,75,0,75
19/08/2022 16:00,26,13,13,84,39,45,98,45,53,0,0,0,9,9,0,21,21,0,0,0,0,205,113,92,0,,109,1,108,88,0,88
19/08/2022 17:00,47,14,33,101,34,67,143,45,98,0,0,0,18,18,0,15,15,0,0,0,0,310,181,129,0,,184,2,182,127,0,127
19/08/2022 18:00,30,14,16,86,43,43,135,60,75,0,0,0,23,22,1,16,16,0,0,0,0,225,123,102,0,,140,2,138,121,0,121
19/08/2022 19:00,21,12,9,76,32,44,95,39,56,0,0,0,14,14,0,8,8,0,0,0,0,189,102,87,0,,106,1,105,104,1,103
19/08/2022 20:00,9,3,6,41,22,19,61,35,26,0,0,0,13,13,0,9,9,0,0,0,0,146,65,81,0,,80,0,80,73,1,72
19/08/2022 21:00,10,5,5,24,13,11,30,9,21,0,0,0,1,1,0,7,7,0,0,0,0,93,50,43,0,,65,0,65,82,0,82
19/08/2022 22:00,6,4,2,8,3,5,13,5,8,0,0,0,12,12,0,9,9,0,0,0,0,84,58,26,0,,53,2,51,46,0,46
19/08/2022 23:00,0,0,0,7,3,4,7,1,6,0,0,0,10,10,0,3,3,0,0,0,0,63,46,17,0,,46,0,46,32,0,32
20/08/2022 00:00,2,0,2,3,2,1,7,5,2,0,0,0,3,3,0,3,3,0,0,0,0,47,37,10,0,,44,0,44,21,1,20
20/08/2022 01:00,1,1,0,8,3,5,7,4,3,0,0,0,4,4,0,3,3,0,0,0,0,29,22,7,0,,11,1,10,3,0,3
20/08/2022 02:00,0,0,0,3,2,1,4,2,2,0,0,0,0,0,0,0,0,0,0,0,0,13,9,4,0,,30,0,30,6,0,6
20/08/2022 03:00,0,0,0,3,1,2,2,0,2,0,0,0,0,0,0,0,0,0,0,0,0,19,18,1,0,,14,0,14,5,0,5
20/08/2022 04:00,0,0,0,3,1,2,4,2,2,0,0,0,3,3,0,1,1,0,0,0,0,8,5,3,0,,12,0,12,3,0,3
20/08/2022 05:00,0,0,0,5,3,2,5,3,2,0,0,0,5,5,0,0,0,0,0,0,0,11,6,5,0,,2,0,2,3,0,3
20/08/2022 06:00,2,2,0,17,10,7,19,12,7,0,0,0,17,17,0,2,2,0,0,0,0,47,12,35,0,,10,0,10,4,0,4
20/08/2022 07:00,5,4,1,27,10,17,30,12,18,0,0,0,10,10,0,10,10,0,1,1,0,51,12,39,0,,7,0,7,16,0,16
20/08/2022 08:00,29,10,19,60,24,36,58,23,35,0,0,0,16,16,0,4,4,0,0,0,0,70,20,50,0,,18,0,18,40,0,40
20/08/2022 09:00,13,7,6,60,21,39,73,28,45,0,0,0,19,19,0,5,5,0,0,0,0,90,30,60,0,,31,0,31,64,1,63
20/08/2022 10:00,11,8,3,67,34,33,93,37,56,0,0,0,15,15,0,7,7,0,0,0,0,98,33,65,0,,19,1,18,73,1,72
20/08/2022 11:00,7,5,2,81,37,44,113,38,75,0,0,0,6,6,0,17,17,0,0,0,0,117,40,77,0,,43,0,43,78,0,78
20/08/2022 12:00,11,7,4,80,35,45,119,59,60,0,0,0,9,8,1,12,12,0,0,0,0,143,62,81,0,,67,1,66,91,0,91
20/08/2022 13:00,21,12,9,79,38,41,127,58,69,0,0,0,10,10,0,12,12,0,1,1,0,134,46,88,0,,79,0,79,123,1,122
20/08/2022 14:00,13,5,8,77,35,42,101,45,56,0,0,0,14,14,0,12,12,0,1,1,0,144,70,74,0,,73,0,73,109,1,108
20/08/2022 15:00,18,7,11,73,33,40,89,47,42,0,0,0,9,9,0,7,7,0,3,3,0,120,56,64,0,,95,0,95,119,1,118
20/08/2022 16:00,23,15,8,64,39,25,80,37,43,0,0,0,12,12,0,10,10,0,0,0,0,114,53,61,0,,94,0,94,102,0,102
20/08/2022 17:00,16,5,11,89,52,37,90,49,41,0,0,0,14,14,0,10,10,0,0,0,0,113,49,64,0,,87,0,87,91,0,91
20/08/2022 18:00,21,11,10,56,33,23,83,49,34,0,0,0,9,9,0,10,10,0,0,0,0,139,57,82,0,,73,1,72,94,1,93
20/08/2022 19:00,15,8,7,33,10,23,38,10,28,0,0,0,9,9,0,7,7,0,0,0,0,104,57,47,0,,105,1,104,101,1,100
20/08/2022 20:00,7,2,5,23,11,12,37,15,22,0,0,0,4,4,0,7,7,0,4,4,0,100,52,48,0,,70,2,68,82,0,82
20/08/2022 21:00,5,3,2,12,5,7,19,9,10,0,0,0,6,6,0,10,10,0,4,4,0,56,32,24,0,,45,2,43,62,2,60
20/08/2022 22:00,9,5,4,10,4,6,11,5,6,0,0,0,9,9,0,4,4,0,8,8,0,49,33,16,0,,58,0,58,47,0,47
20/08/2022 23:00,5,2,3,4,2,2,14,4,10,0,0,0,4,4,0,2,2,0,1,1,0,45,32,13,0,,32,1,31,29,0,29
21/08/2022 00:00,3,1,2,1,0,1,3,1,2,0,0,0,3,3,0,4,4,0,3,3,0,40,31,9,0,,23,0,23,17,0,17
21/08/2022 01:00,0,0,0,6,6,0,3,3,0,0,0,0,1,1,0,3,3,0,0,0,0,25,19,6,0,,9,1,8,1,0,1
21/08/2022 02:00,0,0,0,2,1,1,4,1,3,0,0,0,1,1,0,0,0,0,0,0,0,11,9,2,0,,23,1,22,8,0,8
21/08/2022 03:00,2,2,0,1,0,1,1,1,0,0,0,0,0,0,0,0,0,0,1,1,0,8,6,2,0,,24,0,24,5,1,4
21/08/2022 04:00,0,0,0,4,2,2,2,1,1,0,0,0,0,0,0,0,0,0,0,0,0,8,4,4,0,,8,0,8,3,0,3
21/08/2022 05:00,1,0,1,2,1,1,4,3,1,0,0,0,0,0,0,0,0,0,0,0,0,10,5,5,0,,2,0,2,6,0,6
21/08/2022 06:00,2,2,0,12,8,4,16,10,6,0,0,0,7,7,0,2,2,0,1,1,0,30,9,21,0,,4,1,3,8,0,8
21/08/2022 07:00,6,5,1,33,14,19,43,19,24,0,0,0,14,13,1,5,5,0,2,2,0,40,7,33,0,,8,0,8,13,0,13
21/08/2022 08:00,6,5,1,88,36,52,94,26,68,0,0,0,12,12,0,4,4,0,0,0,0,56,25,31,0,,15,0,15,22,0,22
21/08/2022 09:00,7,5,2,139,52,87,158,64,94,0,0,0,10,10,0,12,12,0,1,1,0,64,16,48,0,,13,0,13,44,0,44
21/08/2022 10:00,9,7,2,176,69,107,206,74,132,0,0,0,7,7,0,13,13,0,3,3,0,88,30,58,0,,25,0,25,38,0,38
21/08/2022 11:00,21,12,9,248,109,139,264,121,143,0,0,0,9,9,0,15,15,0,3,3,0,118,40,78,0,,35,0,35,82,0,82
21/08/2022 12:00,17,7,10,222,107,115,243,120,123,0,0,0,8,8,0,18,18,0,5,5,0,147,37,110,0,,67,0,67,102,0,102
21/08/2022 13:00,15,8,7,218,115,103,251,120,131,0,0,0,7,6,1,13,13,0,5,5,0,139,57,82,0,,67,0,67,105,1,104
21/08/2022 14:00,16,5,11,219,116,103,240,106,134,0,0,0,9,9,0,18,18,0,2,2,0,119,50,69,0,,71,0,71,113,1,112
21/08/2022 15:00,18,9,9,168,91,77,200,107,93,0,0,0,8,8,0,8,8,0,0,0,0,129,51,78,0,,56,2,54,95,2,93
21/08/2022 16:00,17,5,12,133,80,53,187,102,85,0,0,0,15,15,0,0,0,0,0,0,0,133,54,79,0,,97,0,97,94,0,94
21/08/2022 17:00,10,3,7,104,61,43,142,70,72,0,0,0,13,13,0,0,0,0,0,0,0,151,79,72,0,,108,0,108,77,0,77
21/08/2022 18:00,8,3,5,113,62,51,167,98,69,0,0,0,12,12,0,0,0,0,0,0,0,108,48,60,0,,97,2,95,77,1,76
21/08/2022 19:00,7,2,5,76,45,31,133,76,57,0,0,0,8,8,0,0,0,0,0,0,0,142,75,67,0,,87,0,87,70,0,70
21/08/2022 20:00,11,4,7,41,24,17,81,41,40,0,0,0,6,6,0,0,0,0,0,0,0,85,40,45,0,,55,0,55,75,0,75
21/08/2022 21:00,7,2,5,18,12,6,32,13,19,0,0,0,10,9,1,0,0,0,0,0,0,90,52,38,0,,60,1,59,69,0,69
21/08/2022 22:00,6,1,5,10,6,4,12,6,6,0,0,0,10,10,0,0,0,0,0,0,0,51,34,17,0,,27,2,25,43,2,41
21/08/2022 23:00,2,0,2,3,1,2,7,3,4,0,0,0,1,1,0,0,0,0,0,0,0,34,26,8,0,,46,0,46,15,0,15
22/08/2022 00:00,0,0,0,2,2,0,5,2,3,0,0,0,1,1,0,0,0,0,0,0,0,23,18,5,0,,15,0,15,21,0,21
22/08/2022 01:00,0,0,0,2,2,0,2,1,1,0,0,0,1,1,0,0,0,0,0,0,0,6,5,1,0,,1,0,1,0,0,0
22/08/2022 02:00,0,0,0,1,1,0,1,0,1,0,0,0,1,1,0,0,0,0,0,0,0,2,0,2,0,,7,0,7,4,0,4
22/08/2022 03:00,3,1,2,1,0,1,0,0,0,0,0,0,0,0,0,0,0,0,0,0,0,2,0,2,0,,3,0,3,1,0,1
22/08/2022 04:00,0,0,0,2,2,0,5,2,3,0,0,0,2,2,0,0,0,0,0,0,0,7,2,5,0,,2,0,2,1,0,1
22/08/2022 05:00,1,1,0,8,6,2,13,8,5,0,0,0,6,6,0,0,0,0,0,0,0,24,7,17,0,,1,0,1,5,0,5
22/08/2022 06:00,6,5,1,24,18,6,20,13,7,0,0,0,23,22,1,0,0,0,0,0,0,138,32,106,0,,12,0,12,28,0,28
22/08/2022 07:00,10,2,8,67,48,19,74,57,17,0,0,0,45,45,0,0,0,0,0,0,0,288,71,217,0,,31,0,31,85,0,85
22/08/2022 08:00,13,8,5,65,50,15,102,79,23,0,0,0,56,56,0,0,0,0,0,0,0,399,64,335,0,,49,1,48,142,0,142
22/08/2022 09:00,8,6,2,36,23,13,52,31,21,0,0,0,24,24,0,0,0,0,0,0,0,194,47,147,0,,34,1,33,110,0,110
22/08/2022 10:00,8,5,3,47,24,23,60,27,33,0,0,0,19,19,0,0,0,0,0,0,0,71,24,47,0,,26,0,26,74,0,74
22/08/2022 11:00,6,1,5,35,20,15,55,33,22,0,0,0,6,6,0,0,0,0,0,0,0,90,31,59,0,,40,0,40,63,0,63
22/08/2022 12:00,10,6,4,40,20,20,31,18,13,0,0,0,7,7,0,0,0,0,0,0,0,110,41,69,0,,54,0,54,80,1,79
22/08/2022 13:00,12,1,11,43,21,22,83,35,48,0,0,0,17,17,0,0,0,0,0,0,0,183,40,143,0,,66,0,66,100,0,100
22/08/2022 14:00,11,2,9,59,24,35,58,21,37,0,0,0,13,13,0,0,0,0,0,0,0,178,47,131,0,,62,1,61,79,0,79
22/08/2022 15:00,17,7,10,52,25,27,71,33,38,0,0,0,9,9,0,0,0,0,0,0,0,152,70,82,0,,75,0,75,78,0,78
22/08/2022 16:00,27,9,18,68,25,43,106,38,68,0,0,0,10,10,0,0,0,0,0,0,0,206,115,91,0,,127,1,126,70,0,70
22/08/2022 17:00,68,24,44,150,50,100,192,62,130,0,0,0,19,19,0,0,0,0,0,0,0,394,257,137,0,,198,1,197,114,1,113
22/08/2022 18:00,39,11,28,162,65,97,213,81,132,0,0,0,11,11,0,0,0,0,0,0,0,289,176,113,0,,180,0,180,95,0,95
22/08/2022 19:00,28,10,18,135,67,68,158,73,85,0,0,0,4,4,0,0,0,0,0,0,0,200,125,75,0,,146,1,145,109,0,109
22/08/2022 20:00,17,10,7,73,38,35,100,42,58,0,0,0,11,11,0,0,0,0,0,0,0,118,70,48,0,,98,1,97,76,0,76
22/08/2022 21:00,9,5,4,24,15,9,42,22,20,0,0,0,9,9,0,0,0,0,0,0,0,90,45,45,0,,66,1,65,49,1,48
22/08/2022 22:00,6,4,2,13,5,8,27,13,14,0,0,0,4,4,0,0,0,0,0,0,0,57,43,14,0,,57,0,57,28,0,28
22/08/2022 23:00,7,4,3,6,3,3,6,1,5,0,0,0,2,2,0,0,0,0,0,0,0,41,30,11,0,,31,0,31,17,0,17
23/08/2022 00:00,2,1,1,4,1,3,5,1,4,0,0,0,1,1,0,0,0,0,0,0,0,21,16,5,0,,21,0,21,12,0,12
23/08/2022 01:00,1,1,0,2,1,1,0,0,0,0,0,0,0,0,0,0,0,0,0,0,0,5,3,2,0,,5,0,5,3,0,3
23/08/2022 02:00,1,1,0,1,1,0,2,0,2,0,0,0,1,1,0,0,0,0,0,0,0,6,4,2,0,,3,0,3,2,0,2
23/08/2022 03:00,1,1,0,0,0,0,1,0,1,0,0,0,0,0,0,0,0,0,0,0,0,6,3,3,0,,8,0,8,3,0,3
23/08/2022 04:00,3,0,3,2,1,1,5,2,3,0,0,0,2,2,0,0,0,0,0,0,0,3,1,2,0,,2,0,2,3,0,3
23/08/2022 05:00,3,3,0,12,9,3,12,10,2,0,0,0,9,9,0,0,0,0,0,0,0,39,10,29,0,,1,0,1,4,0,4
23/08/2022 06:00,17,13,4,38,27,11,37,25,12,0,0,0,23,23,0,0,0,0,0,0,0,163,33,130,0,,10,0,10,34,0,34
23/08/2022 07:00,59,51,8,105,79,26,106,77,29,0,0,0,67,67,0,0,0,0,0,0,0,342,67,275,0,,32,0,32,98,0,98
23/08/2022 08:00,130,111,19,125,98,27,152,121,31,0,0,0,93,93,0,0,0,0,0,0,0,588,95,493,0,,70,1,69,222,2,220
23/08/2022 09:00,39,34,5,67,43,24,89,53,36,0,0,0,45,45,0,0,0,0,0,0,0,269,47,222,0,,28,0,28,123,1,122
23/08/2022 10:00,17,13,4,68,32,36,80,35,45,0,0,0,21,21,0,0,0,0,0,0,0,93,31,62,0,,36,0,36,59,0,59
23/08/2022 11:00,12,10,2,80,35,45,105,46,59,0,0,0,15,15,0,0,0,0,0,0,0,92,37,55,0,,43,0,43,77,1,76
23/08/2022 12:00,15,9,6,79,43,36,87,44,43,0,0,0,6,6,0,0,0,0,0,0,0,121,37,84,0,,58,2,56,105,1,104
23/08/2022 13:00,29,12,17,65,35,30,82,39,43,0,0,0,6,6,0,0,0,0,0,0,0,115,59,56,0,,92,0,92,84,1,83
23/08/2022 14:00,23,10,13,66,30,36,99,39,60,0,0,0,1,1,0,0,0,0,0,0,0,126,63,63,0,,58,0,58,90,0,90
23/08/2022 15:00,19,7,12,71,28,43,111,50,61,0,0,0,7,7,0,0,0,0,0,0,0,149,84,65,0,,76,0,76,65,0,65
23/08/2022 16:00,34,15,19,108,37,71,130,41,89,0,0,0,2,2,0,0,0,0,0,0,0,257,150,107,0,,125,2,123,98,0,98
23/08/2022 17:00,91,23,68,151,42,109,214,56,158,0,0,0,17,17,0,0,0,0,0,0,0,471,323,148,0,,231,1,230,122,2,120
23/08/2022 18:00,49,10,39,178,62,116,225,78,147,0,0,0,11,11,0,0,0,0,0,0,0,359,234,125,0,,203,1,202,128,0,128
23/08/2022 19:00,31,19,12,182,73,109,200,82,118,0,0,0,12,12,0,0,0,0,0,0,0,251,160,91,0,,119,1,118,103,0,103
23/08/2022 20:00,24,7,17,133,76,57,173,96,77,0,0,0,1,1,0,0,0,0,0,0,0,144,75,69,0,,89,0,89,81,0,81
23/08/2022 21:00,17,7,10,30,19,11,55,36,19,0,0,0,8,8,0,0,0,0,0,0,0,121,76,45,0,,64,0,64,65,1,64
23/08/2022 22:00,11,6,5,15,9,6,28,12,16,0,0,0,9,9,0,0,0,0,0,0,0,73,45,28,0,,16,0,16,37,1,36
23/08/2022 23:00,3,1,2,5,2,3,14,4,10,0,0,0,4,4,0,0,0,0,0,0,0,36,24,12,0,,0,0,0,14,0,14
24/08/2022 00:00,6,2,4,3,2,1,5,3,2,0,0,0,1,1,0,0,0,0,0,0,0,26,22,4,0,,2,0,2,9,0,9
24/08/2022 01:00,2,0,2,3,1,2,4,1,3,0,0,0,1,1,0,0,0,0,0,0,0,3,1,2,0,,2,0,2,0,0,0
24/08/2022 02:00,0,0,0,0,0,0,0,0,0,0,0,0,1,1,0,0,0,0,0,0,0,6,4,2,0,,9,0,9,3,0,3
24/08/2022 03:00,1,1,0,1,0,1,0,0,0,0,0,0,0,0,0,0,0,0,0,0,0,2,1,1,0,,7,0,7,3,0,3
24/08/2022 04:00,1,0,1,2,0,2,3,1,2,0,0,0,3,3,0,0,0,0,0,0,0,5,0,5,0,,1,0,1,5,0,5
24/08/2022 05:00,4,4,0,10,8,2,16,11,5,0,0,0,4,4,0,0,0,0,0,0,0,29,2,27,0,,5,0,5,4,0,4
24/08/2022 06:00,17,13,4,40,26,14,50,31,19,0,0,0,28,28,0,0,0,0,0,0,0,168,34,134,0,,12,0,12,42,0,42
24/08/2022 07:00,54,50,4,83,68,15,84,67,17,0,0,0,68,68,0,0,0,0,0,0,0,312,78,234,0,,36,2,34,91,0,91
24/08/2022 08:00,129,117,12,137,102,35,174,138,36,0,0,0,77,76,1,0,0,0,0,0,0,626,108,518,0,,70,1,69,197,1,196
24/08/2022 09:00,36,29,7,71,44,27,104,61,43,0,0,0,50,49,1,0,0,0,0,0,0,251,49,202,0,,55,1,54,140,0,140
24/08/2022 10:00,20,16,4,73,35,38,77,27,50,0,0,0,17,17,0,0,0,0,0,0,0,90,27,63,0,,27,0,27,67,0,67
24/08/2022 11:00,14,12,2,49,25,24,72,33,39,0,0,0,7,7,0,0,0,0,0,0,0,88,31,57,0,,45,0,45,66,0,66
24/08/2022 12:00,28,16,12,72,38,34,79,37,42,0,0,0,11,10,1,0,0,0,0,0,0,101,33,68,0,,69,1,68,114,1,113
24/08/2022 13:00,15,7,8,69,25,44,87,28,59,0,0,0,18,18,0,0,0,0,0,0,0,141,73,68,0,,80,0,80,101,0,101
24/08/2022 14:00,17,8,9,64,32,32,67,27,40,0,0,0,12,12,0,0,0,0,0,0,0,112,52,60,0,,77,1,76,89,0,89
24/08/2022 15:00,28,13,15,53,26,27,94,42,52,0,0,0,10,10,0,0,0,0,0,0,0,159,83,76,0,,76,0,76,74,0,74
24/08/2022 16:00,36,12,24,82,35,47,100,47,53,0,0,0,11,10,1,0,0,0,0,0,0,253,154,99,0,,144,2,142,90,0,90
24/08/2022 17:00,77,20,57,148,34,114,196,39,157,0,0,0,17,17,0,0,0,0,0,0,0,443,308,135,0,,245,3,242,136,1,135
24/08/2022 18:00,61,20,41,152,45,107,188,52,136,0,0,0,13,12,1,0,0,0,0,0,0,354,228,126,0,,216,1,215,123,1,122
24/08/2022 19:00,39,15,24,162,75,87,168,73,95,0,0,0,15,15,0,0,0,0,0,0,0,240,147,93,0,,161,1,160,126,0,126
24/08/2022 20:00,24,9,15,123,71,52,122,60,62,0,0,0,13,13,0,0,0,0,0,0,0,167,95,72,0,,120,0,120,127,1,126
24/08/2022 21:00,10,3,7,48,25,23,66,33,33,0,0,0,4,4,0,0,0,0,0,0,0,98,56,42,0,,82,1,81,58,0,58
24/08/2022 22:00,8,4,4,18,9,9,31,12,19,0,0,0,5,5,0,0,0,0,0,0,0,78,53,25,0,,66,0,66,42,0,42
24/08/2022 23:00,5,1,4,8,4,4,9,2,7,0,0,0,4,4,0,0,0,0,0,0,0,43,35,8,0,,44,0,44,29,0,29
25/08/2022 00:00,3,2,1,4,2,2,7,5,2,0,0,0,1,1,0,0,0,0,0,0,0,27,21,6,0,,30,0,30,12,0,12
25/08/2022 01:00,0,0,0,1,1,0,0,0,0,0,0,0,2,2,0,0,0,0,0,0,0,9,6,3,0,,6,0,6,1,0,1
25/08/2022 02:00,1,0,1,1,0,1,3,1,2,0,0,0,1,1,0,0,0,0,0,0,0,5,3,2,0,,16,0,16,4,0,4
25/08/2022 03:00,0,0,0,0,0,0,0,0,0,0,0,0,1,1,0,0,0,0,0,0,0,4,2,2,0,,5,0,5,1,0,1
25/08/2022 04:00,0,0,0,1,0,1,2,0,2,0,0,0,0,0,0,0,0,0,0,0,0,4,1,3,0,,2,0,2,2,0,2
25/08/2022 05:00,3,3,0,10,7,3,19,10,9,0,0,0,4,4,0,0,0,0,0,0,0,30,8,22,0,,3,0,3,7,0,7
25/08/2022 06:00,21,18,3,31,21,10,32,20,12,0,0,0,41,40,1,0,0,0,0,0,0,141,22,119,0,,9,1,8,45,0,45
25/08/2022 07:00,54,48,6,89,66,23,105,77,28,0,0,0,67,67,0,0,0,0,0,0,0,349,83,266,0,,42,0,42,93,0,93
25/08/2022 08:00,98,90,8,113,89,24,146,117,29,0,0,0,70,70,0,0,0,0,0,0,0,609,103,506,0,,83,1,82,204,0,204
25/08/2022 09:00,32,29,3,74,41,33,84,47,37,0,0,0,13,13,0,0,0,0,0,0,0,253,47,206,0,,39,0,39,150,0,150
25/08/2022 10:00,19,16,3,82,43,39,116,34,82,0,0,0,18,18,0,0,0,0,0,0,0,128,30,98,0,,38,2,36,99,0,99
25/08/2022 11:00,19,14,5,88,47,41,97,48,49,0,0,0,11,11,0,0,0,0,0,0,0,104,34,70,0,,50,0,50,83,0,83
25/08/2022 12:00,21,13,8,80,34,46,109,49,60,0,0,0,1,0,1,0,0,0,0,0,0,113,37,76,0,,57,1,56,95,1,94
25/08/2022 13:00,19,9,10,86,46,40,102,47,55,0,0,0,5,5,0,0,0,0,0,0,0,140,66,74,0,,104,0,104,104,0,104
25/08/2022 14:00,12,5,7,59,24,35,84,42,42,0,0,0,5,5,0,0,0,0,0,0,0,138,67,71,0,,70,1,69,75,1,74
25/08/2022 15:00,22,7,15,65,34,31,92,40,52,0,0,0,8,8,0,0,0,0,0,0,0,156,75,81,0,,81,1,80,80,0,80
25/08/2022 16:00,28,8,20,85,33,52,114,45,69,0,0,0,7,7,0,0,0,0,0,0,0,238,136,102,0,,107,0,107,109,1,108
25/08/2022 17:00,57,18,39,135,38,97,178,49,129,0,0,0,22,22,0,0,0,0,0,0,0,438,296,142,0,,224,4,220,132,0,132
25/08/2022 18:00,47,13,34,159,47,112,189,57,132,0,0,0,18,18,0,0,0,0,0,0,0,350,220,130,0,,203,2,201,139,0,139
25/08/2022 19:00,28,13,15,113,52,61,126,55,71,0,0,0,17,17,0,0,0,0,0,0,0,222,128,94,0,,129,1,128,100,0,100
25/08/2022 20:00,19,4,15,78,39,39,101,52,49,0,0,0,11,11,0,0,0,0,0,0,0,155,87,68,0,,101,0,101,97,0,97
25/08/2022 21:00,9,2,7,34,19,15,47,20,27,0,0,0,9,9,0,0,0,0,0,0,0,103,73,30,0,,91,0,91,75,1,74
25/08/2022 22:00,8,3,5,11,4,7,27,12,15,0,0,0,9,8,1,0,0,0,0,0,0,91,64,27,0,,76,3,73,38,0,38
25/08/2022 23:00,3,1,2,15,6,9,18,3,15,0,0,0,2,2,0,0,0,0,0,0,0,56,40,16,0,,50,1,49,27,0,27
26/08/2022 00:00,4,2,2,12,4,8,10,4,6,0,0,0,0,0,0,0,0,0,0,0,0,34,28,6,0,,36,0,36,15,1,14
26/08/2022 01:00,0,0,0,2,2,0,2,2,0,0,0,0,1,1,0,0,0,0,0,0,0,10,6,4,0,,4,0,4,2,0,2
26/08/2022 02:00,0,0,0,1,0,1,1,0,1,0,0,0,0,0,0,0,0,0,0,0,0,9,7,2,0,,10,0,10,8,0,8
26/08/2022 03:00,0,0,0,0,0,0,2,0,2,0,0,0,0,0,0,0,0,0,0,0,0,6,5,1,0,,14,1,13,5,0,5
26/08/2022 04:00,0,0,0,1,0,1,2,0,2,0,0,0,0,0,0,0,0,0,0,0,0,11,9,2,0,,7,0,7,3,0,3
26/08/2022 05:00,5,5,0,8,6,2,15,10,5,0,0,0,8,8,0,0,0,0,0,0,0,35,7,28,0,,3,0,3,8,0,8
26/08/2022 06:00,20,17,3,35,23,12,35,25,10,0,0,0,22,22,0,0,0,0,0,0,0,127,27,100,0,,7,0,7,37,0,37
26/08/2022 07:00,34,29,5,48,30,18,59,42,17,0,0,0,46,46,0,0,0,0,0,0,0,248,66,182,0,,26,0,26,69,0,69
26/08/2022 08:00,63,53,10,71,54,17,84,63,21,0,0,0,62,62,0,0,0,0,0,0,0,357,79,278,0,,51,0,51,131,2,129
26/08/2022 09:00,30,27,3,52,35,17,58,40,18,0,0,0,27,27,0,0,0,0,0,0,0,150,33,117,0,,42,0,42,129,0,129
26/08/2022 10:00,12,11,1,45,20,25,62,23,39,0,0,0,16,15,1,0,0,0,0,0,0,101,28,73,0,,32,1,31,72,1,71
26/08/2022 11:00,13,7,6,39,17,22,56,27,29,0,0,0,5,5,0,0,0,0,0,0,0,91,29,62,0,,42,0,42,54,0,54
26/08/2022 12:00,15,9,6,49,27,22,56,30,26,0,0,0,7,7,0,0,0,0,0,0,0,117,43,74,0,,66,0,66,99,1,98
26/08/2022 13:00,25,10,15,46,23,23,70,28,42,0,0,0,6,6,0,0,0,0,0,0,0,163,84,79,0,,94,0,94,120,0,120
26/08/2022 14:00,20,10,10,38,18,20,49,21,28,0,0,0,7,7,0,0,0,0,0,0,0,128,68,60,0,,75,0,75,96,1,95
26/08/2022 15:00,22,12,10,52,20,32,59,22,37,0,0,0,8,8,0,0,0,0,0,0,0,173,91,82,0,,86,0,86,78,0,78
26/08/2022 16:00,31,12,19,87,35,52,101,41,60,0,0,0,5,5,0,0,0,0,0,0,0,202,114,88,0,,136,0,136,108,0,108
26/08/2022 17:00,42,13,29,81,35,46,122,50,72,0,0,0,11,11,0,0,0,0,0,0,0,260,149,111,0,,170,0,170,117,0,117
26/08/2022 18:00,34,9,25,91,39,52,123,51,72,0,0,0,23,23,0,0,0,0,0,0,0,203,122,81,0,,134,0,134,122,0,122
26/08/2022 19:00,17,11,6,92,43,49,109,45,64,0,0,0,18,18,0,0,0,0,0,0,0,171,92,79,0,,108,1,107,108,0,108
26/08/2022 20:00,12,4,8,64,35,29,75,36,39,0,0,0,13,12,1,0,0,0,0,0,0,123,59,64,0,,87,1,86,107,1,106
26/08/2022 21:00,9,4,5,23,13,10,26,14,12,0,0,0,11,11,0,0,0,0,0,0,0,93,52,41,0,,61,2,59,92,0,92
26/08/2022 22:00,5,1,4,10,5,5,17,6,11,0,0,0,4,3,1,0,0,0,0,0,0,56,31,25,0,,58,0,58,54,0,54
26/08/2022 23:00,4,2,2,7,4,3,8,3,5,0,0,0,6,6,0,0,0,0,0,0,0,56,41,15,0,,53,0,53,40,0,40
27/08/2022 00:00,6,3,3,7,2,5,11,4,7,0,0,0,1,1,0,0,0,0,0,0,0,38,22,16,0,,46,0,46,26,3,23
27/08/2022 01:00,1,0,1,7,4,3,3,1,2,0,0,0,2,2,0,0,0,0,0,0,0,29,24,5,0,,13,0,13,1,0,1
27/08/2022 02:00,0,0,0,1,1,0,2,0,2,0,0,0,2,2,0,0,0,0,0,0,0,20,14,6,0,,25,2,23,3,0,3
27/08/2022 03:00,0,0,0,2,1,1,2,0,2,0,0,0,1,1,0,0,0,0,0,0,0,13,11,2,0,,18,0,18,5,0,5
27/08/2022 04:00,0,0,0,0,0,0,2,0,2,0,0,0,2,2,0,0,0,0,0,0,0,8,5,3,0,,8,1,7,6,1,5
27/08/2022 05:00,0,0,0,5,3,2,3,0,3,0,0,0,2,2,0,0,0,0,0,0,0,12,3,9,0,,7,0,7,3,0,3
27/08/2022 06:00,2,1,1,18,7,11,16,7,9,0,0,0,8,8,0,0,0,0,0,0,0,42,8,34,0,,8,0,8,6,0,6
27/08/2022 07:00,8,5,3,34,11,23,46,17,29,0,0,0,17,17,0,0,0,0,0,0,0,52,12,40,0,,12,0,12,15,0,15
27/08/2022 08:00,10,8,2,95,45,50,110,52,58,0,0,0,12,12,0,0,0,0,0,0,0,73,22,51,0,,12,1,11,38,0,38
27/08/2022 09:00,7,6,1,153,70,83,164,72,92,0,0,0,17,17,0,0,0,0,0,0,0,99,28,71,0,,21,0,21,79,0,79
27/08/2022 10:00,19,15,4,171,81,90,204,94,110,0,0,0,8,8,0,0,0,0,0,0,0,121,49,72,0,,39,0,39,79,0,79
27/08/2022 11:00,15,8,7,163,70,93,203,77,126,0,0,0,5,5,0,0,0,0,0,0,0,147,53,94,0,,41,1,40,97,0,97
27/08/2022 12:00,18,16,2,185,84,101,241,91,150,0,0,0,8,7,1,0,0,0,0,0,0,168,50,118,0,,57,0,57,114,1,113
27/08/2022 13:00,21,13,8,174,90,84,244,131,113,0,0,0,6,6,0,0,0,0,0,0,0,159,65,94,0,,62,0,62,119,0,119
27/08/2022 14:00,23,13,10,139,65,74,196,95,101,0,0,0,13,13,0,0,0,0,0,0,0,156,67,89,0,,86,0,86,115,0,115
27/08/2022 15:00,21,15,6,147,76,71,209,111,98,0,0,0,12,12,0,0,0,0,0,0,0,147,51,96,0,,80,1,79,125,0,125
27/08/2022 16:00,27,17,10,147,85,62,189,110,79,0,0,0,14,14,0,0,0,0,0,0,0,151,71,80,0,,87,0,87,105,0,105
27/08/2022 17:00,23,11,12,131,72,59,170,109,61,0,0,0,13,12,1,0,0,0,0,0,0,134,62,72,0,,96,0,96,105,1,104
27/08/2022 18:00,23,9,14,70,42,28,102,57,45,0,0,0,9,9,0,0,0,0,0,0,0,133,72,61,0,,84,0,84,93,0,93
27/08/2022 19:00,14,6,8,72,47,25,88,57,31,0,0,0,10,10,0,0,0,0,0,0,0,128,71,57,0,,67,0,67,79,0,79
27/08/2022 20:00,6,3,3,42,21,21,60,30,30,0,0,0,3,3,0,0,0,0,0,0,0,113,49,64,0,,61,2,59,104,0,104
27/08/2022 21:00,9,5,4,12,9,3,17,13,4,0,0,0,5,5,0,0,0,0,0,0,0,86,53,33,0,,51,0,51,70,0,70
27/08/2022 22:00,6,2,4,10,6,4,16,4,12,0,0,0,6,6,0,0,0,0,0,0,0,100,40,60,0,,43,0,43,70,0,70
27/08/2022 23:00,4,2,2,4,2,2,6,2,4,0,0,0,6,6,0,0,0,0,0,0,0,64,43,21,0,,24,0,24,33,0,33
28/08/2022 00:00,0,0,0,6,3,3,11,5,6,0,0,0,3,3,0,0,0,0,0,0,0,41,32,9,0,,33,0,33,22,0,22
28/08/2022 01:00,4,2,2,4,2,2,3,2,1,0,0,0,2,2,0,0,0,0,0,0,0,21,17,4,0,,9,0,9,3,0,3
28/08/2022 02:00,2,0,2,3,3,0,6,2,4,0,0,0,0,0,0,0,0,0,0,0,0,16,14,2,0,,24,2,22,7,0,7
28/08/2022 03:00,0,0,0,3,2,1,3,2,1,0,0,0,1,1,0,0,0,0,0,0,0,25,15,10,0,,13,0,13,2,1,1
28/08/2022 04:00,0,0,0,1,0,1,1,0,1,0,0,0,0,0,0,0,0,0,0,0,0,6,6,0,0,,6,0,6,8,0,8
28/08/2022 05:00,2,0,2,4,2,2,5,2,3,0,0,0,5,5,0,0,0,0,0,0,0,8,6,2,0,,3,0,3,4,0,4
28/08/2022 06:00,5,3,2,10,5,5,9,3,6,0,0,0,5,5,0,0,0,0,0,0,0,42,11,31,0,,5,0,5,9,0,9
28/08/2022 07:00,7,6,1,34,17,17,44,20,24,0,0,0,13,13,0,0,0,0,0,0,0,47,24,23,0,,5,0,5,14,0,14
28/08/2022 08:00,3,2,1,77,32,45,71,35,36,0,0,0,10,10,0,0,0,0,0,0,0,60,16,44,0,,18,0,18,24,0,24
28/08/2022 09:00,15,12,3,124,55,69,143,59,84,0,0,0,15,15,0,0,0,0,0,0,0,59,17,42,0,,12,0,12,36,1,35
28/08/2022 10:00,6,3,3,174,72,102,200,73,127,0,0,0,13,12,1,0,0,0,0,0,0,69,22,47,0,,21,0,21,44,0,44
28/08/2022 11:00,13,8,5,181,89,92,233,109,124,0,0,0,10,10,0,0,0,0,0,0,0,96,27,69,0,,46,0,46,79,0,79
28/08/2022 12:00,11,7,4,163,78,85,214,112,102,0,0,0,6,6,0,0,0,0,0,0,0,117,46,71,0,,56,0,56,87,1,86
28/08/2022 13:00,13,8,5,140,83,57,178,103,75,0,0,0,4,4,0,0,0,0,0,0,0,131,53,78,0,,74,3,71,106,1,105
28/08/2022 14:00,18,11,7,105,55,50,161,64,97,0,0,0,8,7,1,0,0,0,0,0,0,132,50,82,0,,62,1,61,94,0,94
28/08/2022 15:00,16,7,9,91,43,48,154,81,73,0,0,0,8,8,0,0,0,0,0,0,0,133,54,79,0,,61,1,60,88,2,86
28/08/2022 16:00,15,8,7,92,51,41,107,60,47,0,0,0,6,6,0,0,0,0,0,0,0,108,42,66,0,,76,0,76,80,0,80
28/08/2022 17:00,13,8,5,60,36,24,98,48,50,0,0,0,5,5,0,0,0,0,0,0,0,134,77,57,0,,70,0,70,84,1,83
28/08/2022 18:00,20,14,6,54,26,28,85,51,34,0,0,0,11,11,0,0,0,0,0,0,0,126,60,66,0,,77,1,76,79,0,79
28/08/2022 19:00,10,4,6,49,24,25,71,39,32,0,0,0,8,8,0,0,0,0,0,0,0,116,61,55,0,,81,1,80,93,0,93
28/08/2022 20:00,9,2,7,34,19,15,43,22,21,0,0,0,8,8,0,0,0,0,0,0,0,99,52,47,0,,68,0,68,77,0,77
28/08/2022 21:00,6,5,1,9,4,5,18,9,9,0,0,0,9,9,0,0,0,0,0,0,0,75,48,27,0,,66,1,65,62,1,61
28/08/2022 22:00,3,1,2,10,7,3,9,3,6,0,0,0,6,5,1,0,0,0,0,0,0,59,44,15,0,,39,0,39,44,0,44
28/08/2022 23:00,1,0,1,3,2,1,11,6,5,0,0,0,3,3,0,0,0,0,0,0,0,33,24,9,0,,26,0,26,19,0,19
29/08/2022 00:00,3,1,2,3,2,1,1,0,1,0,0,0,1,1,0,0,0,0,0,0,0,21,17,4,0,,22,1,21,7,0,7
29/08/2022 01:00,0,0,0,4,3,1,4,2,2,0,0,0,0,0,0,0,0,0,0,0,0,4,3,1,0,,4,0,4,0,0,0
29/08/2022 02:00,0,0,0,2,0,2,1,0,1,0,0,0,0,0,0,0,0,0,0,0,0,5,4,1,0,,9,0,9,2,0,2
29/08/2022 03:00,0,0,0,0,0,0,1,1,0,0,0,0,0,0,0,0,0,0,0,0,0,4,1,3,0,,2,0,2,1,0,1
29/08/2022 04:00,1,1,0,3,3,0,2,1,1,0,0,0,1,1,0,0,0,0,0,0,0,5,0,5,0,,1,0,1,3,0,3
29/08/2022 05:00,4,4,0,11,8,3,14,10,4,0,0,0,6,6,0,0,0,0,0,0,0,32,7,25,0,,1,0,1,5,0,5
29/08/2022 06:00,15,10,5,29,23,6,30,24,6,0,0,0,26,26,0,0,0,0,0,0,0,137,32,105,0,,14,0,14,32,0,32
29/08/2022 07:00,42,33,9,75,54,21,74,54,20,0,0,0,61,61,0,0,0,0,0,0,0,278,74,204,0,,32,1,31,85,0,85
29/08/2022 08:00,93,87,6,111,84,27,144,111,33,0,0,0,82,81,1,0,0,0,0,0,0,466,80,386,0,,60,1,59,178,0,178
29/08/2022 09:00,42,36,6,80,49,31,92,59,33,0,0,0,35,34,1,0,0,0,0,0,0,223,42,181,0,,40,0,40,117,0,117
29/08/2022 10:00,19,9,10,59,28,31,87,40,47,0,0,0,15,15,0,0,0,0,0,0,0,95,20,75,0,,30,0,30,46,0,46
29/08/2022 11:00,11,11,0,77,44,33,89,42,47,0,0,0,11,11,0,0,0,0,0,0,0,81,32,49,0,,48,0,48,43,1,42
29/08/2022 12:00,15,7,8,73,33,40,111,44,67,0,0,0,10,10,0,0,0,0,0,0,0,127,46,81,0,,52,1,51,100,0,100
29/08/2022 13:00,32,22,10,107,50,57,146,71,75,0,0,0,6,6,0,0,0,0,0,0,0,128,58,70,0,,79,1,78,111,0,111
29/08/2022 14:00,26,13,13,94,50,44,135,61,74,0,0,0,10,10,0,0,0,0,0,0,0,117,55,62,0,,62,1,61,77,1,76
29/08/2022 15:00,25,10,15,79,35,44,137,60,77,0,0,0,9,9,0,0,0,0,0,0,0,153,84,69,0,,83,1,82,87,0,87
29/08/2022 16:00,32,13,19,80,33,47,137,64,73,0,0,0,8,8,0,0,0,0,0,0,0,224,136,88,0,,129,1,128,98,1,97
29/08/2022 17:00,61,11,50,143,46,97,220,79,141,0,0,0,12,12,0,0,0,0,0,0,0,392,239,153,0,,247,0,247,127,0,127
29/08/2022 18:00,46,13,33,143,47,96,217,71,146,0,0,0,17,17,0,0,0,0,0,0,0,335,221,114,0,,173,0,173,114,0,114
29/08/2022 19:00,24,10,14,131,63,68,168,82,86,0,0,0,10,10,0,0,0,0,0,0,0,163,97,66,0,,123,1,122,102,1,101
29/08/2022 20:00,15,8,7,76,39,37,82,45,37,0,0,0,7,7,0,0,0,0,0,0,0,113,72,41,0,,105,1,104,81,1,80
29/08/2022 21:00,3,1,2,23,9,14,36,18,18,0,0,0,9,9,0,0,0,0,0,0,0,75,47,28,0,,33,1,32,55,0,55
29/08/2022 22:00,5,4,1,11,7,4,12,6,6,0,0,0,3,3,0,0,0,0,0,0,0,57,39,18,0,,0,0,0,35,1,34
29/08/2022 23:00,6,1,5,6,3,3,12,4,8,0,0,0,4,4,0,0,0,0,0,0,0,24,20,4,0,,0,0,0,10,0,10
30/08/2022 00:00,0,0,0,4,4,0,10,3,7,0,0,0,0,0,0,0,0,0,0,0,0,22,16,6,0,,2,0,2,8,0,8
30/08/2022 01:00,1,1,0,3,3,0,1,1,0,0,0,0,0,0,0,0,0,0,0,0,0,4,4,0,0,,1,0,1,0,0,0
30/08/2022 02:00,0,0,0,1,0,1,1,0,1,0,0,0,1,1,0,0,0,0,0,0,0,5,3,2,0,,7,0,7,2,0,2
30/08/2022 03:00,0,0,0,0,0,0,1,0,1,0,0,0,2,2,0,0,0,0,0,0,0,1,0,1,0,,4,0,4,2,0,2
30/08/2022 04:00,0,0,0,0,0,0,2,1,1,0,0,0,3,3,0,0,0,0,0,0,0,6,0,6,0,,1,0,1,2,0,2
30/08/2022 05:00,4,4,0,8,7,1,16,10,6,0,0,0,7,7,0,0,0,0,0,0,0,31,5,26,0,,4,0,4,11,0,11
30/08/2022 06:00,15,14,1,42,30,12,45,32,13,0,0,0,28,27,1,0,0,0,0,0,0,144,31,113,0,,8,0,8,46,0,46
30/08/2022 07:00,68,54,14,97,79,18,107,82,25,0,0,0,80,79,1,0,0,0,0,0,0,362,79,283,0,,54,1,53,123,0,123
30/08/2022 08:00,118,106,12,126,92,34,164,123,41,0,0,0,92,92,0,0,0,0,0,0,0,643,99,544,0,,86,0,86,202,0,202
30/08/2022 09:00,44,41,3,70,42,28,90,53,37,0,0,0,43,43,0,0,0,0,0,0,0,288,62,226,0,,36,0,36,136,3,133
30/08/2022 10:00,27,19,8,64,37,27,78,38,40,0,0,0,15,15,0,0,0,0,0,0,0,93,28,65,0,,33,0,33,82,0,82
30/08/2022 11:00,14,10,4,72,31,41,84,37,47,0,0,0,9,9,0,0,0,0,0,0,0,113,40,73,0,,37,0,37,63,0,63
30/08/2022 12:00,23,11,12,108,63,45,111,63,48,0,0,0,12,12,0,0,0,0,0,0,0,89,34,55,0,,61,1,60,111,2,109
30/08/2022 13:00,15,7,8,87,37,50,129,55,74,0,0,0,8,8,0,0,0,0,0,0,0,140,65,75,0,,95,0,95,112,0,112
30/08/2022 14:00,18,11,7,75,35,40,111,48,63,0,0,0,9,9,0,0,0,0,0,0,0,116,53,63,0,,66,0,66,90,1,89
30/08/2022 15:00,23,13,10,92,43,49,111,51,60,0,0,0,8,8,0,0,0,0,0,0,0,172,99,73,0,,77,2,75,74,0,74
30/08/2022 16:00,42,16,26,90,37,53,141,73,68,0,0,0,3,3,0,0,0,0,0,0,0,240,134,106,0,,170,1,169,93,0,93
30/08/2022 17:00,99,31,68,154,50,104,220,82,138,0,0,0,10,10,0,0,0,0,0,0,0,461,307,154,0,,253,3,250,130,0,130
30/08/2022 18:00,59,17,42,188,60,128,256,83,173,0,0,0,1,1,0,0,0,0,0,0,0,410,264,146,0,,208,2,206,160,0,160
30/08/2022 19:00,35,10,25,154,71,83,202,88,114,0,0,0,0,0,0,0,0,0,0,0,0,249,139,110,0,,129,0,129,111,2,109
30/08/2022 20:00,12,3,9,86,45,41,112,55,57,0,0,0,0,0,0,0,0,0,0,0,0,136,77,59,0,,86,1,85,95,1,94
30/08/2022 21:00,9,1,8,35,18,17,37,11,26,0,0,0,1,1,0,0,0,0,0,0,0,116,76,40,0,,66,0,66,72,2,70
30/08/2022 22:00,5,3,2,18,10,8,26,8,18,0,0,0,4,4,0,0,0,0,0,0,0,96,75,21,0,,41,0,41,38,0,38
30/08/2022 23:00,2,1,1,5,1,4,10,1,9,0,0,0,4,4,0,0,0,0,0,0,0,49,38,11,0,,45,0,45,19,0,19
31/08/2022 00:00,1,1,0,4,2,2,6,1,5,0,0,0,2,2,0,0,0,0,0,0,0,22,18,4,0,,19,0,19,13,0,13
31/08/2022 01:00,0,0,0,1,0,1,0,0,0,0,0,0,0,0,0,0,0,0,0,0,0,8,5,3,0,,4,0,4,1,0,1
31/08/2022 02:00,0,0,0,0,0,0,1,1,0,0,0,0,2,2,0,0,0,0,0,0,0,9,8,1,0,,8,0,8,2,0,2
31/08/2022 03:00,1,0,1,0,0,0,0,0,0,0,0,0,0,0,0,0,0,0,0,0,0,6,5,1,0,,3,0,3,1,0,1
31/08/2022 04:00,0,0,0,1,1,0,2,1,1,0,0,0,0,0,0,0,0,0,0,0,0,5,2,3,0,,2,0,2,2,0,2
31/08/2022 05:00,4,4,0,12,8,4,11,8,3,0,0,0,10,10,0,0,0,0,0,0,0,39,5,34,0,,4,1,3,5,0,5
31/08/2022 06:00,23,19,4,25,17,8,43,30,13,0,0,0,26,25,1,0,0,0,0,0,0,136,29,107,0,,11,1,10,48,0,48
31/08/2022 07:00,61,53,8,88,65,23,100,73,27,0,0,0,60,59,1,0,0,0,0,0,0,327,67,260,0,,43,0,43,97,1,96
31/08/2022 08:00,132,120,12,129,92,37,164,123,41,0,0,0,92,92,0,0,0,0,0,0,0,641,100,541,0,,89,1,88,196,0,196
31/08/2022 09:00,51,48,3,67,41,26,90,52,38,0,0,0,36,35,1,0,0,0,0,0,0,254,47,207,0,,46,1,45,135,0,135
31/08/2022 10:00,9,7,2,73,39,34,85,41,44,0,0,0,19,19,0,0,0,0,0,0,0,99,37,62,0,,37,0,37,87,0,87
31/08/2022 11:00,17,12,5,74,37,37,99,53,46,0,0,0,12,12,0,0,0,0,0,0,0,99,30,69,0,,43,1,42,71,2,69
31/08/2022 12:00,14,8,6,78,35,43,79,43,36,0,0,0,20,19,1,0,0,0,0,0,0,112,46,66,0,,72,0,72,104,0,104
31/08/2022 13:00,31,11,20,79,39,40,107,46,61,0,0,0,18,17,1,0,0,0,0,0,0,155,79,76,0,,100,0,100,117,0,117
31/08/2022 14:00,22,13,9,77,41,36,122,48,74,0,0,0,14,13,1,0,0,0,0,0,0,138,65,73,0,,86,0,86,83,0,83
31/08/2022 15:00,37,22,15,59,29,30,103,52,51,0,0,0,4,4,0,0,0,0,0,0,0,194,105,89,0,,75,0,75,52,3,49
31/08/2022 16:00,40,18,22,71,32,39,110,48,62,0,0,0,8,8,0,0,0,0,0,0,0,265,163,102,0,,143,2,141,97,0,97
31/08/2022 17:00,80,26,54,114,31,83,177,51,126,0,0,0,20,20,0,0,0,0,0,0,0,445,298,147,0,,255,1,254,138,0,138
31/08/2022 18:00,67,22,45,153,55,98,183,56,127,0,0,0,21,21,0,0,0,0,0,0,0,372,232,140,0,,235,1,234,133,0,133
31/08/2022 19:00,33,12,21,100,39,61,135,51,84,0,0,0,15,15,0,0,0,0,0,0,0,208,132,76,0,,156,1,155,114,0,114
31/08/2022 20:00,23,8,15,86,43,43,127,57,70,0,0,0,9,9,0,0,0,0,0,0,0,175,113,62,0,,111,0,111,104,0,104
31/08/2022 21:00,14,3,11,29,19,10,35,23,12,0,0,0,5,5,0,0,0,0,0,0,0,105,61,44,0,,74,1,73,66,1,65
31/08/2022 22:00,11,5,6,11,5,6,15,7,8,0,0,0,8,8,0,0,0,0,0,0,0,72,48,24,0,,52,2,50,44,1,43
31/08/2022 23:00,4,0,4,5,4,1,12,4,8,0,0,0,10,10,0,0,0,0,0,0,0,55,43,12,0,,40,0,40,28,0,28
01/09/2022 00:00,2,0,2,6,3,3,8,2,6,0,0,0,1,1,0,0,0,0,0,0,0,33,28,5,0,,25,0,25,8,0,8
01/09/2022 01:00,2,1,1,1,1,0,2,1,1,0,0,0,1,1,0,0,0,0,0,0,0,8,6,2,0,,3,0,3,1,0,1
01/09/2022 02:00,0,0,0,1,0,1,2,1,1,0,0,0,0,0,0,0,0,0,0,0,0,5,5,0,0,,7,0,7,6,0,6
01/09/2022 03:00,0,0,0,0,0,0,0,0,0,0,0,0,1,1,0,0,0,0,0,0,0,6,5,1,0,,7,0,7,3,0,3
01/09/2022 04:00,2,1,1,1,1,0,3,2,1,0,0,0,1,1,0,0,0,0,0,0,0,2,2,0,0,,2,0,2,2,0,2
01/09/2022 05:00,4,3,1,21,12,9,26,10,16,0,0,0,6,6,0,0,0,0,0,0,0,39,8,31,0,,2,0,2,9,0,9
01/09/2022 06:00,23,17,6,30,21,9,44,33,11,0,0,0,29,29,0,0,0,0,0,0,0,132,20,112,0,,9,0,9,40,0,40
01/09/2022 07:00,42,37,5,89,67,22,111,86,25,0,0,0,75,75,0,0,0,0,0,0,0,324,89,235,0,,43,1,42,88,0,88
01/09/2022 08:00,120,101,19,123,92,31,170,129,41,0,0,0,92,92,0,0,0,0,0,0,0,619,111,508,0,,81,1,80,228,1,227
01/09/2022 09:00,52,47,5,67,35,32,90,47,43,0,0,0,31,31,0,0,0,0,0,0,0,287,58,229,0,,42,0,42,153,2,151
01/09/2022 10:00,18,11,7,51,27,24,86,45,41,0,0,0,13,13,0,0,0,0,0,0,0,112,27,85,0,,12,0,12,84,0,84
01/09/2022 11:00,13,7,6,53,23,30,75,34,41,0,0,0,10,10,0,0,0,0,0,0,0,100,36,64,0,,49,0,49,86,1,85
01/09/2022 12:00,19,13,6,59,26,33,79,34,45,0,0,0,7,6,1,0,0,0,0,0,0,110,37,73,0,,64,0,64,91,2,89
01/09/2022 13:00,24,11,13,54,26,28,82,41,41,0,0,0,13,13,0,0,0,0,0,0,0,141,64,77,0,,89,0,89,103,0,103
01/09/2022 14:00,23,12,11,60,21,39,80,31,49,0,0,0,6,6,0,0,0,0,0,0,0,119,52,67,0,,71,1,70,95,0,95
01/09/2022 15:00,19,12,7,74,32,42,107,48,59,0,0,0,17,17,0,0,0,0,0,0,0,165,90,75,0,,72,0,72,95,0,95
01/09/2022 16:00,47,21,26,76,31,45,137,61,76,0,0,0,28,27,1,0,0,0,0,0,0,252,145,107,0,,117,1,116,93,0,93
01/09/2022 17:00,77,23,54,147,47,100,185,58,127,0,0,0,13,13,0,0,0,0,0,0,0,429,292,137,0,,263,0,263,131,0,131
01/09/2022 18:00,51,12,39,174,53,121,222,53,169,0,0,0,21,20,1,0,0,0,0,0,0,368,229,139,0,,205,1,204,118,0,118
01/09/2022 19:00,28,13,15,113,59,54,123,61,62,0,0,0,30,28,2,0,0,0,0,0,0,214,128,86,0,,125,0,125,111,0,111
01/09/2022 20:00,16,5,11,78,41,37,107,64,43,0,0,0,14,14,0,0,0,0,0,0,0,168,92,76,0,,117,0,117,110,0,110
01/09/2022 21:00,13,7,6,23,12,11,36,17,19,0,0,0,0,0,0,0,0,0,0,0,0,112,80,32,0,,71,0,71,70,0,70
01/09/2022 22:00,4,1,3,12,6,6,21,6,15,0,0,0,1,1,0,0,0,0,0,0,0,72,51,21,0,,64,0,64,37,0,37
01/09/2022 23:00,6,3,3,4,2,2,15,6,9,0,0,0,7,7,0,0,0,0,0,0,0,60,44,16,0,,50,1,49,25,0,25
02/09/2022 00:00,2,1,1,2,0,2,4,2,2,0,0,0,2,2,0,0,0,0,0,0,0,44,36,8,0,,23,1,22,15,0,15
02/09/2022 01:00,1,0,1,5,3,2,0,0,0,0,0,0,1,1,0,0,0,0,0,0,0,12,11,1,0,,8,0,8,0,0,0
02/09/2022 02:00,0,0,0,0,0,0,0,0,0,0,0,0,0,0,0,0,0,0,0,0,0,10,9,1,0,,10,0,10,6,0,6
02/09/2022 03:00,0,0,0,2,1,1,1,0,1,0,0,0,1,1,0,0,0,0,0,0,0,8,7,1,0,,11,0,11,2,0,2
02/09/2022 04:00,0,0,0,3,2,1,4,2,2,0,0,0,2,2,0,0,0,0,0,0,0,10,5,5,0,,3,0,3,1,0,1
02/09/2022 05:00,4,2,2,5,4,1,10,7,3,0,0,0,3,3,0,0,0,0,0,0,0,32,7,25,0,,3,0,3,7,0,7
02/09/2022 06:00,14,12,2,17,12,5,30,23,7,0,0,0,21,21,0,0,0,0,0,0,0,130,28,102,0,,13,0,13,42,0,42
02/09/2022 07:00,34,30,4,65,45,20,75,58,17,0,0,0,47,47,0,0,0,0,0,0,0,246,69,177,0,,36,0,36,78,0,78
02/09/2022 08:00,70,58,12,92,64,28,123,82,41,0,0,0,59,59,0,0,0,0,0,0,0,420,101,319,0,,52,0,52,145,0,145
02/09/2022 09:00,36,32,4,63,35,28,72,44,28,0,0,0,39,39,0,0,0,0,0,0,0,203,43,160,0,,42,0,42,123,0,123
02/09/2022 10:00,15,12,3,80,35,45,100,46,54,0,0,0,23,23,0,0,0,0,0,0,0,96,31,65,0,,15,0,15,62,0,62
02/09/2022 11:00,11,8,3,72,36,36,92,50,42,0,0,0,10,10,0,0,0,0,0,0,0,99,35,64,0,,54,0,54,83,0,83
02/09/2022 12:00,13,7,6,71,43,28,85,47,38,0,0,0,7,7,0,0,0,0,0,0,0,119,53,66,0,,80,0,80,108,0,108
02/09/2022 13:00,19,7,12,57,30,27,79,37,42,0,0,0,5,5,0,0,0,0,0,0,0,147,71,76,0,,98,0,98,121,0,121
02/09/2022 14:00,16,5,11,41,18,23,59,26,33,0,0,0,5,5,0,0,0,0,0,0,0,136,63,73,0,,95,0,95,80,0,80
02/09/2022 15:00,20,9,11,44,24,20,56,26,30,0,0,0,5,5,0,0,0,0,0,0,0,171,96,75,0,,83,0,83,84,0,84
02/09/2022 16:00,38,18,20,40,11,29,59,14,45,0,0,0,14,14,0,0,0,0,0,0,0,224,132,92,0,,100,0,100,105,0,105
02/09/2022 17:00,38,13,25,113,49,64,147,63,84,0,0,0,6,6,0,0,0,0,0,0,0,259,157,102,0,,165,1,164,126,0,126
02/09/2022 18:00,19,7,12,77,23,54,109,37,72,0,0,0,16,16,0,0,0,0,0,0,0,233,129,104,0,,147,0,147,116,0,116
02/09/2022 19:00,24,12,12,39,20,19,72,35,37,0,0,0,7,6,1,0,0,0,0,0,0,161,89,72,0,,117,0,117,114,1,113
02/09/2022 20:00,11,5,6,25,13,12,53,24,29,0,0,0,12,12,0,0,0,0,0,0,0,97,56,41,0,,84,0,84,102,0,102
02/09/2022 21:00,8,4,4,20,9,11,27,11,16,0,0,0,10,10,0,0,0,0,0,0,0,81,46,35,0,,72,1,71,85,0,85
02/09/2022 22:00,5,3,2,6,3,3,15,7,8,0,0,0,7,7,0,0,0,0,0,0,0,68,50,18,0,,55,0,55,48,1,47
02/09/2022 23:00,2,1,1,5,1,4,9,2,7,0,0,0,7,7,0,0,0,0,0,0,0,47,27,20,0,,41,0,41,18,0,18
03/09/2022 00:00,6,3,3,4,1,3,10,3,7,0,0,0,2,2,0,0,0,0,0,0,0,33,21,12,0,,33,0,33,30,1,29
03/09/2022 01:00,1,1,0,4,2,2,3,1,2,0,0,0,1,0,1,0,0,0,0,0,0,22,19,3,0,,4,0,4,1,0,1
03/09/2022 02:00,3,1,2,2,2,0,1,0,1,0,0,0,0,0,0,0,0,0,0,0,0,19,16,3,0,,18,1,17,8,0,8
03/09/2022 03:00,0,0,0,0,0,0,0,0,0,0,0,0,3,3,0,0,0,0,0,0,0,9,8,1,0,,17,1,16,4,0,4
03/09/2022 04:00,0,0,0,1,1,0,2,1,1,0,0,0,0,0,0,0,0,0,0,0,0,7,5,2,0,,5,0,5,6,0,6
03/09/2022 05:00,1,0,1,2,1,1,2,0,2,0,0,0,2,2,0,0,0,0,0,0,0,10,3,7,0,,8,0,8,2,0,2
03/09/2022 06:00,6,4,2,9,3,6,7,3,4,0,0,0,6,6,0,0,0,0,0,0,0,34,5,29,0,,2,0,2,10,0,10
03/09/2022 07:00,5,2,3,14,8,6,20,9,11,0,0,0,10,10,0,0,0,0,0,0,0,41,10,31,0,,15,0,15,16,0,16
03/09/2022 08:00,4,3,1,24,12,12,31,16,15,0,0,0,8,8,0,0,0,0,0,0,0,47,13,34,0,,7,0,7,27,1,26
03/09/2022 09:00,3,2,1,33,16,17,33,14,19,0,0,0,9,9,0,0,0,0,0,0,0,52,13,39,0,,18,0,18,40,0,40
03/09/2022 10:00,8,7,1,24,10,14,21,8,13,0,0,0,2,2,0,0,0,0,0,0,0,48,17,31,0,,27,0,27,42,0,42
03/09/2022 11:00,14,12,2,25,11,14,25,12,13,0,0,0,1,1,0,0,0,0,0,0,0,76,28,48,0,,40,0,40,60,0,60
03/09/2022 12:00,7,4,3,19,9,10,24,9,15,0,0,0,2,2,0,0,0,0,0,0,0,76,31,45,0,,35,1,34,49,0,49
03/09/2022 13:00,12,9,3,7,6,1,13,8,5,0,0,0,7,7,0,0,0,0,0,0,0,58,20,38,0,,54,1,53,56,0,56
03/09/2022 14:00,7,5,2,11,5,6,11,4,7,0,0,0,4,4,0,0,0,0,0,0,0,61,33,28,0,,62,0,62,59,1,58
03/09/2022 15:00,7,5,2,12,8,4,15,11,4,0,0,0,0,0,0,0,0,0,0,0,0,76,50,26,0,,48,0,48,63,1,62
03/09/2022 16:00,9,8,1,5,1,4,13,6,7,0,0,0,3,3,0,0,0,0,0,0,0,63,28,35,0,,57,1,56,64,1,63
03/09/2022 17:00,3,0,3,9,4,5,10,3,7,0,0,0,4,4,0,0,0,0,0,0,0,65,35,30,0,,53,0,53,35,0,35
03/09/2022 18:00,8,7,1,9,3,6,8,3,5,0,0,0,4,4,0,0,0,0,0,0,0,77,40,37,0,,63,0,63,44,0,44
03/09/2022 19:00,4,3,1,12,8,4,18,8,10,0,0,0,5,5,0,0,0,0,0,0,0,89,48,41,0,,66,0,66,79,0,79
03/09/2022 20:00,9,4,5,12,5,7,16,6,10,0,0,0,3,3,0,0,0,0,0,0,0,65,37,28,0,,48,0,48,72,0,72
03/09/2022 21:00,4,1,3,9,5,4,12,5,7,0,0,0,4,4,0,0,0,0,0,0,0,47,29,18,0,,30,1,29,50,0,50
03/09/2022 22:00,4,1,3,5,2,3,5,1,4,0,0,0,5,5,0,0,0,0,0,0,0,34,22,12,0,,28,1,27,38,0,38
03/09/2022 23:00,2,2,0,2,2,0,8,3,5,0,0,0,6,6,0,0,0,0,0,0,0,26,20,6,0,,24,0,24,24,0,24
04/09/2022 00:00,3,1,2,3,1,2,2,0,2,0,0,0,0,0,0,0,0,0,0,0,0,21,14,7,0,,23,0,23,18,0,18
04/09/2022 01:00,0,0,0,4,3,1,6,2,4,0,0,0,0,0,0,0,0,0,0,0,0,14,12,2,0,,6,0,6,0,0,0
04/09/2022 02:00,0,0,0,2,1,1,0,0,0,0,0,0,0,0,0,0,0,0,0,0,0,2,1,1,0,,13,1,12,3,0,3
04/09/2022 03:00,0,0,0,1,0,1,1,0,1,0,0,0,0,0,0,0,0,0,0,0,0,9,9,0,0,,8,0,8,2,0,2
04/09/2022 04:00,0,0,0,0,0,0,1,1,0,0,0,0,0,0,0,0,0,0,0,0,0,4,4,0,0,,7,0,7,3,0,3
04/09/2022 05:00,1,0,1,2,1,1,1,0,1,0,0,0,0,0,0,0,0,0,0,0,0,3,0,3,0,,2,0,2,0,0,0
04/09/2022 06:00,2,2,0,2,0,2,5,2,3,0,0,0,7,7,0,0,0,0,0,0,0,27,3,24,0,,6,0,6,6,0,6
04/09/2022 07:00,5,4,1,11,3,8,12,3,9,0,0,0,8,8,0,0,0,0,0,0,0,26,9,17,0,,10,0,10,7,0,7
04/09/2022 08:00,7,5,2,68,32,36,66,27,39,0,0,0,8,8,0,0,0,0,0,0,0,38,6,32,0,,11,0,11,19,0,19
04/09/2022 09:00,8,5,3,116,50,66,113,43,70,0,0,0,8,8,0,0,0,0,0,0,0,54,16,38,0,,12,0,12,38,0,38
04/09/2022 10:00,10,8,2,134,64,70,169,65,104,0,0,0,12,12,0,0,0,0,0,0,0,85,20,65,0,,25,0,25,50,0,50
04/09/2022 11:00,14,10,4,179,83,96,207,97,110,0,0,0,8,8,0,0,0,0,0,0,0,103,34,69,0,,41,0,41,60,0,60
04/09/2022 12:00,13,6,7,164,82,82,221,106,115,0,0,0,4,4,0,0,0,0,0,0,0,117,44,73,0,,48,0,48,84,0,84
04/09/2022 13:00,23,13,10,130,70,60,174,84,90,0,0,0,6,6,0,0,0,0,0,0,0,121,42,79,0,,64,0,64,97,1,96
04/09/2022 14:00,28,19,9,125,59,66,166,68,98,0,0,0,8,8,0,0,0,0,0,0,0,83,36,47,0,,63,0,63,99,0,99
04/09/2022 15:00,27,10,17,102,62,40,132,76,56,0,0,0,7,7,0,0,0,0,0,0,0,107,51,56,0,,78,0,78,117,1,116
04/09/2022 16:00,23,11,12,114,71,43,131,73,58,0,0,0,9,9,0,0,0,0,0,0,0,109,43,66,0,,78,1,77,83,0,83
04/09/2022 17:00,13,8,5,98,50,48,144,71,73,0,0,0,9,9,0,0,0,0,0,0,0,125,60,65,0,,89,2,87,78,0,78
04/09/2022 18:00,24,11,13,88,50,38,111,63,48,0,0,0,9,9,0,0,0,0,0,0,0,126,61,65,0,,94,0,94,74,0,74
04/09/2022 19:00,7,2,5,61,37,24,78,50,28,0,0,0,7,7,0,0,0,0,0,0,0,100,49,51,0,,80,0,80,69,0,69
04/09/2022 20:00,8,4,4,30,19,11,38,22,16,0,0,0,6,6,0,0,0,0,0,0,0,85,43,42,0,,59,0,59,68,0,68
04/09/2022 21:00,6,3,3,4,3,1,13,8,5,0,0,0,3,3,0,0,0,0,0,0,0,65,40,25,0,,52,0,52,63,0,63
04/09/2022 22:00,4,0,4,5,5,0,6,0,6,0,0,0,6,6,0,0,0,0,0,0,0,46,33,13,0,,4,0,4,26,0,26
04/09/2022 23:00,1,1,0,2,1,1,4,1,3,0,0,0,3,3,0,0,0,0,0,0,0,21,17,4,0,,0,0,0,25,0,25
05/09/2022 00:00,1,0,1,3,2,1,5,2,3,0,0,0,1,1,0,0,0,0,0,0,0,12,12,0,0,,12,0,12,9,0,9
05/09/2022 01:00,1,0,1,1,0,1,0,0,0,0,0,0,0,0,0,0,0,0,0,0,0,3,3,0,0,,2,0,2,1,0,1
05/09/2022 02:00,0,0,0,1,1,0,1,0,1,0,0,0,0,0,0,0,0,0,0,0,0,6,4,2,0,,7,0,7,1,0,1
05/09/2022 03:00,0,0,0,2,1,1,1,1,0,0,0,0,0,0,0,0,0,0,0,0,0,8,4,4,0,,5,0,5,3,0,3
05/09/2022 04:00,0,0,0,3,3,0,2,0,2,0,0,0,2,2,0,0,0,0,0,0,0,2,1,1,0,,1,0,1,2,0,2
05/09/2022 05:00,4,4,0,5,3,2,11,9,2,0,0,0,1,1,0,0,0,0,0,0,0,32,6,26,0,,4,0,4,5,0,5
05/09/2022 06:00,13,10,3,33,21,12,35,23,12,0,0,0,29,28,1,0,0,0,0,0,0,123,19,104,0,,9,0,9,35,0,35
05/09/2022 07:00,35,31,4,59,48,11,80,60,20,0,0,0,42,42,0,0,0,0,0,0,0,271,69,202,0,,41,0,41,90,1,89
05/09/2022 08:00,104,89,15,111,84,27,145,110,35,0,0,0,71,69,2,0,0,0,0,0,0,533,89,444,0,,73,0,73,166,0,166
05/09/2022 09:00,30,29,1,62,38,24,82,46,36,0,0,0,33,33,0,0,0,0,0,0,0,194,39,155,0,,43,1,42,130,0,130
05/09/2022 10:00,11,7,4,64,27,37,96,37,59,0,0,0,23,23,0,0,0,0,0,0,0,89,35,54,0,,22,0,22,76,2,74
05/09/2022 11:00,12,11,1,55,25,30,67,31,36,0,0,0,15,15,0,0,0,0,0,0,0,82,22,60,0,,34,0,34,77,0,77
05/09/2022 12:00,13,10,3,35,15,20,51,24,27,0,0,0,8,8,0,0,0,0,0,0,0,117,47,70,0,,66,0,66,110,0,110
05/09/2022 13:00,19,11,8,60,32,28,70,36,34,0,0,0,19,19,0,0,0,0,0,0,0,101,49,52,0,,103,0,103,90,0,90
05/09/2022 14:00,16,7,9,31,14,17,47,19,28,0,0,0,5,5,0,0,0,0,0,0,0,105,48,57,0,,79,1,78,89,0,89
05/09/2022 15:00,18,10,8,46,26,20,48,24,24,0,0,0,14,14,0,0,0,0,0,0,0,166,96,70,0,,78,0,78,70,0,70
05/09/2022 16:00,26,7,19,46,18,28,64,28,36,0,0,0,16,16,0,0,0,0,0,0,0,223,147,76,0,,114,1,113,77,0,77
05/09/2022 17:00,66,19,47,68,17,51,89,24,65,0,0,0,2,2,0,0,0,0,0,0,0,355,247,108,0,,191,0,191,97,3,94
05/09/2022 18:00,43,11,32,70,19,51,84,19,65,0,0,0,10,10,0,0,0,0,0,0,0,284,186,98,0,,167,0,167,80,0,80
05/09/2022 19:00,16,9,7,26,5,21,48,11,37,0,0,0,6,6,0,0,0,0,0,0,0,162,104,58,0,,138,0,138,96,0,96
05/09/2022 20:00,14,5,9,21,10,11,22,8,14,0,0,0,6,5,1,0,0,0,0,0,0,83,51,32,0,,86,0,86,66,0,66
05/09/2022 21:00,4,3,1,3,0,3,6,3,3,0,0,0,1,1,0,0,0,0,0,0,0,63,45,18,0,,57,0,57,45,0,45
05/09/2022 22:00,4,2,2,10,5,5,8,3,5,0,0,0,6,6,0,0,0,0,0,0,0,49,35,14,0,,34,1,33,20,0,20
05/09/2022 23:00,5,3,2,1,0,1,2,0,2,0,0,0,1,1,0,0,0,0,0,0,0,23,19,4,0,,22,0,22,12,0,12
06/09/2022 00:00,3,1,2,1,0,1,1,0,1,0,0,0,0,0,0,0,0,0,0,0,0,8,5,3,0,,17,0,17,7,1,6
06/09/2022 01:00,0,0,0,0,0,0,0,0,0,0,0,0,0,0,0,0,0,0,0,0,0,3,1,2,0,,0,0,0,0,0,0
06/09/2022 02:00,0,0,0,0,0,0,0,0,0,0,0,0,1,1,0,0,0,0,0,0,0,1,1,0,0,,6,0,6,1,0,1
06/09/2022 03:00,0,0,0,1,0,1,1,0,1,0,0,0,0,0,0,0,0,0,0,0,0,1,1,0,0,,4,0,4,5,0,5
06/09/2022 04:00,0,0,0,2,2,0,1,0,1,0,0,0,4,4,0,0,0,0,0,0,0,3,1,2,0,,2,0,2,0,0,0
06/09/2022 05:00,5,5,0,6,5,1,14,8,6,0,0,0,2,2,0,0,0,0,0,0,0,36,8,28,0,,4,0,4,7,0,7
06/09/2022 06:00,18,14,4,31,22,9,33,24,9,0,0,0,21,21,0,0,0,0,0,0,0,125,25,100,0,,11,0,11,32,0,32
06/09/2022 07:00,46,42,4,81,64,17,91,73,18,0,0,0,34,34,0,0,0,0,0,0,0,334,75,259,0,,34,0,34,93,0,93
06/09/2022 08:00,130,118,12,98,72,26,122,96,26,0,0,0,107,106,1,0,0,0,0,0,0,628,95,533,0,,60,0,60,193,2,191
06/09/2022 09:00,35,31,4,51,33,18,62,40,22,0,0,0,36,36,0,0,0,0,0,0,0,261,50,211,0,,31,1,30,134,1,133
06/09/2022 10:00,14,11,3,27,15,12,47,24,23,0,0,0,17,17,0,0,0,0,0,0,0,85,28,57,0,,30,0,30,69,0,69
06/09/2022 11:00,13,9,4,28,14,14,27,14,13,0,0,0,9,9,0,0,0,0,0,0,0,62,25,37,0,,35,0,35,48,0,48
06/09/2022 12:00,14,9,5,24,19,5,30,17,13,0,0,0,9,9,0,0,0,0,0,0,0,67,22,45,0,,48,0,48,62,0,62
06/09/2022 13:00,10,4,6,18,11,7,22,13,9,0,0,0,4,4,0,0,0,0,0,0,0,84,39,45,0,,36,0,36,54,2,52
06/09/2022 14:00,9,4,5,19,8,11,16,4,12,0,0,0,0,0,0,0,0,0,0,0,0,75,41,34,0,,44,0,44,58,0,58
06/09/2022 15:00,19,7,12,33,11,22,33,9,24,0,0,0,7,7,0,0,0,0,0,0,0,149,78,71,0,,61,2,59,65,0,65
06/09/2022 16:00,38,10,28,27,9,18,44,15,29,0,0,0,19,19,0,0,0,0,0,0,0,223,148,75,0,,91,0,91,71,0,71
06/09/2022 17:00,77,17,60,105,27,78,134,30,104,0,0,0,11,11,0,0,0,0,0,0,0,401,275,126,0,,230,0,230,133,2,131
06/09/2022 18:00,45,13,32,93,27,66,137,31,106,0,0,0,6,6,0,0,0,0,0,0,0,368,260,108,0,,189,3,186,120,0,120
06/09/2022 19:00,17,4,13,73,29,44,91,34,57,0,0,0,7,7,0,0,0,0,0,0,0,177,110,67,0,,113,0,113,117,2,115
06/09/2022 20:00,7,4,3,24,11,13,42,21,21,0,0,0,7,7,0,0,0,0,0,0,0,127,87,40,0,,71,0,71,82,1,81
06/09/2022 21:00,8,4,4,13,5,8,19,4,15,0,0,0,4,4,0,0,0,0,0,0,0,63,51,12,0,,47,0,47,53,0,53
06/09/2022 22:00,8,3,5,5,3,2,10,4,6,0,0,0,3,3,0,0,0,0,0,0,0,63,44,19,0,,38,0,38,36,1,35
06/09/2022 23:00,4,2,2,4,2,2,5,1,4,0,0,0,0,0,0,0,0,0,0,0,0,30,22,8,0,,26,0,26,30,0,30
07/09/2022 00:00,0,0,0,0,0,0,2,1,1,0,0,0,1,1,0,0,0,0,0,0,0,13,10,3,0,,21,0,21,7,0,7
07/09/2022 01:00,2,0,2,1,1,0,1,1,0,0,0,0,1,1,0,0,0,0,0,0,0,7,6,1,0,,2,0,2,0,0,0
07/09/2022 02:00,0,0,0,0,0,0,0,0,0,0,0,0,1,1,0,0,0,0,0,0,0,4,3,1,0,,9,1,8,3,0,3
07/09/2022 03:00,0,0,0,0,0,0,1,0,1,0,0,0,0,0,0,0,0,0,0,0,0,3,2,1,0,,3,0,3,1,0,1
07/09/2022 04:00,0,0,0,2,1,1,1,0,1,0,0,0,0,0,0,0,0,0,0,0,0,5,1,4,0,,5,0,5,0,0,0
07/09/2022 05:00,6,4,2,8,4,4,11,5,6,0,0,0,5,5,0,0,0,0,0,0,0,34,7,27,0,,4,0,4,10,0,10
07/09/2022 06:00,14,11,3,31,25,6,39,29,10,0,0,0,15,15,0,0,0,0,0,0,0,124,24,100,0,,8,0,8,40,0,40
07/09/2022 07:00,40,34,6,66,52,14,70,55,15,0,0,0,81,81,0,0,0,0,0,0,0,335,76,259,0,,37,0,37,83,0,83
07/09/2022 08:00,122,109,13,92,71,21,120,96,24,0,0,0,84,83,1,0,0,0,0,0,0,578,97,481,0,,68,1,67,205,1,204
07/09/2022 09:00,43,35,8,15,13,2,45,30,15,0,0,0,8,8,0,0,0,0,0,0,0,213,39,174,0,,31,0,31,117,0,117
07/09/2022 10:00,11,7,4,17,9,8,25,14,11,0,0,0,6,6,0,0,0,0,0,0,0,64,23,41,0,,35,0,35,61,0,61
07/09/2022 11:00,11,7,4,29,15,14,29,17,12,0,0,0,5,5,0,0,0,0,0,0,0,86,34,52,0,,32,1,31,54,0,54
07/09/2022 12:00,4,3,1,20,14,6,31,11,20,0,0,0,2,2,0,0,0,0,0,0,0,99,34,65,0,,52,1,51,83,0,83
07/09/2022 13:00,20,11,9,27,11,16,34,16,18,0,0,0,1,1,0,0,0,0,0,0,0,128,54,74,0,,67,1,66,95,2,93
07/09/2022 14:00,16,9,7,16,6,10,20,8,12,0,0,0,3,3,0,0,0,0,0,0,0,120,62,58,0,,79,2,77,69,0,69
07/09/2022 15:00,19,10,9,34,12,22,54,13,41,0,0,0,2,2,0,0,0,0,0,0,0,154,79,75,0,,56,0,56,68,0,68
07/09/2022 16:00,33,10,23,39,10,29,55,21,34,0,0,0,6,6,0,0,0,0,0,0,0,220,131,89,0,,139,0,139,85,2,83
07/09/2022 17:00,66,14,52,76,13,63,114,27,87,0,0,0,3,3,0,0,0,0,0,0,0,393,279,114,0,,231,0,231,132,1,131
07/09/2022 18:00,42,14,28,133,48,85,149,42,107,0,0,0,11,10,1,0,0,0,0,0,0,359,246,113,0,,181,1,180,152,1,151
07/09/2022 19:00,21,7,14,80,40,40,90,33,57,0,0,0,1,1,0,0,0,0,0,0,0,194,123,71,0,,139,0,139,110,0,110
07/09/2022 20:00,8,3,5,49,25,24,66,31,35,0,0,0,9,9,0,0,0,0,0,0,0,133,73,60,0,,83,1,82,86,2,84
07/09/2022 21:00,2,1,1,22,10,12,35,14,21,0,0,0,6,6,0,0,0,0,0,0,0,84,53,31,0,,77,1,76,58,0,58
07/09/2022 22:00,8,4,4,2,1,1,8,2,6,0,0,0,3,3,0,0,0,0,0,0,0,71,51,20,0,,49,1,48,37,1,36
07/09/2022 23:00,2,1,1,5,2,3,12,5,7,0,0,0,4,4,0,0,0,0,0,0,0,37,32,5,0,,37,0,37,20,1,19
08/09/2022 00:00,0,0,0,5,0,5,10,2,8,0,0,0,2,2,0,0,0,0,0,0,0,16,13,3,0,,23,1,22,13,0,13
08/09/2022 01:00,0,0,0,2,1,1,1,1,0,0,0,0,4,4,0,0,0,0,0,0,0,13,11,2,0,,3,0,3,1,0,1
08/09/2022 02:00,0,0,0,0,0,0,2,0,2,0,0,0,1,1,0,0,0,0,0,0,0,5,5,0,0,,10,0,10,2,0,2
08/09/2022 03:00,0,0,0,1,0,1,1,0,1,0,0,0,1,1,0,0,0,0,0,0,0,7,5,2,0,,8,0,8,1,0,1
08/09/2022 04:00,3,2,1,3,1,2,2,0,2,0,0,0,2,2,0,0,0,0,0,0,0,7,2,5,0,,7,0,7,1,0,1
08/09/2022 05:00,5,3,2,7,4,3,10,4,6,0,0,0,4,4,0,0,0,0,0,0,0,31,5,26,0,,2,0,2,9,0,9
08/09/2022 06:00,17,13,4,32,25,7,30,25,5,0,0,0,27,27,0,0,0,0,0,0,0,131,28,103,0,,13,0,13,31,0,31
08/09/2022 07:00,40,36,4,74,61,13,88,73,15,0,0,0,56,56,0,0,0,0,0,0,0,303,64,239,0,,41,1,40,77,0,77
08/09/2022 08:00,103,89,14,100,80,20,135,101,34,0,0,0,71,71,0,0,0,0,0,0,0,594,89,505,0,,63,0,63,192,1,191
08/09/2022 09:00,49,43,6,40,29,11,65,46,19,0,0,0,21,21,0,0,0,0,0,0,0,260,42,218,0,,34,0,34,147,0,147
08/09/2022 10:00,22,18,4,45,24,21,57,29,28,0,0,0,15,15,0,0,0,0,0,0,0,92,15,77,0,,29,0,29,70,0,70
08/09/2022 11:00,14,8,6,46,25,21,49,26,23,0,0,0,13,13,0,0,0,0,0,0,0,80,30,50,0,,49,0,49,71,1,70
08/09/2022 12:00,14,8,6,41,17,24,65,29,36,0,0,0,13,13,0,0,0,0,0,0,0,114,46,68,0,,61,0,61,78,0,78
08/09/2022 13:00,26,15,11,38,19,19,56,29,27,0,0,0,3,3,0,0,0,0,0,0,0,114,50,64,0,,87,1,86,97,0,97
08/09/2022 14:00,12,6,6,37,21,16,53,26,27,0,0,0,3,3,0,0,0,0,0,0,0,117,58,59,0,,82,0,82,82,2,80
08/09/2022 15:00,24,16,8,35,8,27,34,6,28,0,0,0,5,5,0,0,0,0,0,0,0,156,87,69,0,,71,0,71,79,0,79
08/09/2022 16:00,37,15,22,51,21,30,71,27,44,0,0,0,3,3,0,0,0,0,0,0,0,202,121,81,0,,119,0,119,103,0,103
08/09/2022 17:00,55,12,43,100,30,70,133,43,90,0,0,0,8,8,0,0,0,0,0,0,0,430,298,132,0,,225,0,225,137,1,136
08/09/2022 18:00,56,17,39,133,43,90,168,46,122,0,0,0,23,22,1,0,0,0,0,0,0,335,220,115,0,,194,1,193,133,1,132
08/09/2022 19:00,29,17,12,74,30,44,96,42,54,0,0,0,9,9,0,0,0,0,0,0,0,215,123,92,0,,120,0,120,105,0,105
08/09/2022 20:00,12,4,8,51,23,28,75,32,43,0,0,0,15,15,0,0,0,0,0,0,0,164,96,68,0,,106,0,106,111,0,111
08/09/2022 21:00,9,4,5,15,8,7,23,11,12,0,0,0,6,6,0,0,0,0,0,0,0,106,70,36,0,,78,0,78,73,0,73
08/09/2022 22:00,9,5,4,5,1,4,19,6,13,0,0,0,7,7,0,0,0,0,0,0,0,84,66,18,0,,52,0,52,50,1,49
08/09/2022 23:00,1,0,1,4,1,3,9,2,7,0,0,0,3,3,0,0,0,0,0,0,0,62,41,21,0,,42,0,42,22,0,22
09/09/2022 00:00,3,2,1,2,2,0,1,0,1,0,0,0,3,3,0,0,0,0,0,0,0,31,25,6,0,,42,1,41,15,0,15
09/09/2022 01:00,2,0,2,3,2,1,1,1,0,0,0,0,0,0,0,0,0,0,0,0,0,10,8,2,0,,6,0,6,1,0,1
09/09/2022 02:00,0,0,0,0,0,0,1,0,1,0,0,0,1,1,0,0,0,0,0,0,0,7,7,0,0,,12,0,12,5,0,5
09/09/2022 03:00,1,1,0,0,0,0,0,0,0,0,0,0,0,0,0,0,0,0,0,0,0,6,6,0,0,,12,0,12,2,0,2
09/09/2022 04:00,2,1,1,2,1,1,3,1,2,0,0,0,1,1,0,0,0,0,0,0,0,7,3,4,0,,8,0,8,2,0,2
09/09/2022 05:00,3,2,1,3,2,1,6,3,3,0,0,0,1,1,0,0,0,0,0,0,0,26,7,19,0,,2,0,2,4,0,4
09/09/2022 06:00,13,9,4,11,10,1,15,12,3,0,0,0,23,23,0,0,0,0,0,0,0,104,17,87,0,,9,0,9,28,0,28
09/09/2022 07:00,19,17,2,37,25,12,54,40,14,0,0,0,38,38,0,0,0,0,0,0,0,208,43,165,0,,26,0,26,54,0,54
09/09/2022 08:00,61,53,8,70,53,17,90,72,18,0,0,0,1,1,0,0,0,0,0,0,0,364,70,294,0,,57,1,56,108,0,108
09/09/2022 09:00,37,30,7,34,19,15,55,31,24,0,0,0,3,3,0,0,0,0,0,0,0,194,43,151,0,,41,0,41,128,1,127
09/09/2022 10:00,12,7,5,40,23,17,49,22,27,0,0,0,16,16,0,0,0,0,0,0,0,86,27,59,0,,32,0,32,74,0,74
09/09/2022 11:00,11,8,3,44,25,19,48,23,25,0,0,0,8,8,0,0,0,0,0,0,0,105,41,64,0,,49,0,49,81,0,81
09/09/2022 12:00,16,10,6,73,33,40,83,41,42,0,0,0,11,11,0,0,0,0,0,0,0,113,51,62,0,,63,1,62,104,1,103
09/09/2022 13:00,22,13,9,43,22,21,68,34,34,0,0,0,6,6,0,0,0,0,0,0,0,130,70,60,0,,96,0,96,115,0,115
09/09/2022 14:00,19,6,13,48,19,29,53,20,33,0,0,0,4,4,0,0,0,0,0,0,0,130,63,67,0,,89,0,89,88,0,88
09/09/2022 15:00,24,10,14,39,17,22,58,23,35,0,0,0,3,3,0,0,0,0,0,0,0,126,61,65,0,,65,1,64,84,1,83
09/09/2022 16:00,27,11,16,66,32,34,78,36,42,0,0,0,8,8,0,0,0,0,0,0,0,232,129,103,0,,119,0,119,111,1,110
09/09/2022 17:00,35,11,24,91,33,58,114,39,75,0,0,0,1,1,0,0,0,0,0,0,0,277,166,111,0,,181,0,181,133,0,133
09/09/2022 18:00,29,10,19,78,29,49,92,31,61,0,0,0,1,1,0,0,0,0,0,0,0,236,135,101,0,,142,0,142,126,0,126
09/09/2022 19:00,13,8,5,40,21,19,66,32,34,0,0,0,4,4,0,0,0,0,0,0,0,150,79,71,0,,88,0,88,110,2,108
09/09/2022 20:00,13,7,6,31,17,14,46,21,25,0,0,0,10,10,0,0,0,0,0,0,0,99,50,49,0,,90,0,90,99,0,99
09/09/2022 21:00,11,5,6,16,9,7,29,16,13,0,0,0,8,7,1,0,0,0,0,0,0,86,58,28,0,,69,0,69,76,0,76
09/09/2022 22:00,6,5,1,4,1,3,8,4,4,0,0,0,0,0,0,0,0,0,0,0,0,70,50,20,0,,59,0,59,63,1,62
09/09/2022 23:00,5,2,3,11,5,6,22,8,14,0,0,0,5,5,0,0,0,0,0,0,0,57,36,21,0,,48,1,47,37,0,37
10/09/2022 00:00,2,2,0,2,1,1,11,6,5,0,0,0,3,3,0,0,0,0,0,0,0,36,25,11,0,,30,1,29,17,0,17
10/09/2022 01:00,0,0,0,4,2,2,1,1,0,0,0,0,3,3,0,0,0,0,0,0,0,14,12,2,0,,9,0,9,0,0,0
10/09/2022 02:00,0,0,0,2,1,1,4,1,3,0,0,0,1,0,1,0,0,0,0,0,0,13,10,3,0,,20,1,19,6,0,6
10/09/2022 03:00,1,0,1,0,0,0,1,0,1,0,0,0,0,0,0,0,0,0,0,0,0,11,8,3,0,,21,0,21,2,0,2
10/09/2022 04:00,2,0,2,0,0,0,3,0,3,0,0,0,3,3,0,0,0,0,0,0,0,6,3,3,0,,7,0,7,6,0,6
10/09/2022 05:00,1,1,0,9,4,5,10,3,7,0,0,0,2,2,0,0,0,0,0,0,0,15,6,9,0,,9,0,9,7,0,7
10/09/2022 06:00,1,1,0,19,8,11,14,5,9,0,0,0,6,6,0,0,0,0,0,0,0,35,6,29,0,,9,0,9,15,0,15
10/09/2022 07:00,5,4,1,56,23,33,57,24,33,0,0,0,21,20,1,0,0,0,0,0,0,62,16,46,0,,9,0,9,15,0,15
10/09/2022 08:00,12,9,3,89,45,44,90,44,46,0,0,0,16,16,0,0,0,0,0,0,0,70,28,42,0,,20,0,20,33,0,33
10/09/2022 09:00,10,8,2,107,50,57,129,58,71,0,0,0,20,19,1,0,0,0,0,0,0,127,45,82,0,,29,0,29,66,0,66
10/09/2022 10:00,10,6,4,148,55,93,177,72,105,0,0,0,6,6,0,0,0,0,0,0,0,111,32,79,0,,44,0,44,76,1,75
10/09/2022 11:00,11,8,3,160,78,82,181,89,92,0,0,0,6,6,0,0,0,0,0,0,0,125,46,79,0,,54,0,54,113,0,113
10/09/2022 12:00,20,11,9,155,79,76,211,96,115,0,0,0,5,5,0,0,0,0,0,0,0,131,41,90,0,,66,0,66,104,0,104
10/09/2022 13:00,12,6,6,145,69,76,198,88,110,0,0,0,5,5,0,0,0,0,0,0,0,142,59,83,0,,72,0,72,102,0,102
10/09/2022 14:00,26,10,16,133,68,65,197,90,107,0,0,0,7,7,0,0,0,0,0,0,0,127,54,73,0,,67,0,67,127,0,127
10/09/2022 15:00,13,7,6,154,83,71,209,101,108,0,0,0,9,8,1,0,0,0,0,0,0,132,53,79,0,,86,1,85,125,0,125
10/09/2022 16:00,19,12,7,137,65,72,190,102,88,0,0,0,10,10,0,0,0,0,0,0,0,123,58,65,0,,88,2,86,100,1,99
10/09/2022 17:00,20,9,11,155,86,69,179,106,73,0,0,0,5,5,0,0,0,0,0,0,0,130,59,71,0,,103,0,103,102,0,102
10/09/2022 18:00,13,7,6,105,62,43,142,85,57,0,0,0,0,0,0,0,0,0,0,0,0,154,83,71,0,,102,1,101,95,0,95
10/09/2022 19:00,15,6,9,62,40,22,95,59,36,0,0,0,0,0,0,0,0,0,0,0,0,92,46,46,0,,86,1,85,115,0,115
10/09/2022 20:00,15,6,9,34,20,14,67,38,29,0,0,0,0,0,0,0,0,0,0,0,0,109,53,56,0,,64,1,63,70,0,70
10/09/2022 21:00,8,4,4,20,11,9,25,13,12,0,0,0,2,2,0,0,0,0,0,0,0,88,39,49,0,,47,0,47,83,0,83
10/09/2022 22:00,5,1,4,11,6,5,25,8,17,0,0,0,0,0,0,0,0,0,0,0,0,62,31,31,0,,38,0,38,44,1,43
10/09/2022 23:00,2,1,1,9,4,5,17,9,8,0,0,0,3,3,0,0,0,0,0,0,0,47,34,13,0,,44,1,43,33,0,33
11/09/2022 00:00,1,1,0,1,1,0,4,0,4,0,0,0,3,3,0,0,0,0,0,0,0,23,16,7,0,,38,0,38,19,1,18
11/09/2022 01:00,0,0,0,4,4,0,2,2,0,0,0,0,2,2,0,0,0,0,0,0,0,30,21,9,0,,16,1,15,2,0,2
11/09/2022 02:00,0,0,0,4,3,1,2,0,2,0,0,0,2,2,0,0,0,0,0,0,0,21,17,4,0,,30,0,30,11,1,10
11/09/2022 03:00,0,0,0,0,0,0,0,0,0,0,0,0,0,0,0,0,0,0,0,0,0,12,6,6,0,,22,1,21,8,1,7
11/09/2022 04:00,2,0,2,1,1,0,6,3,3,0,0,0,0,0,0,0,0,0,0,0,0,14,10,4,0,,14,1,13,6,1,5
11/09/2022 05:00,0,0,0,4,2,2,2,1,1,0,0,0,1,1,0,0,0,0,0,0,0,9,4,5,0,,5,0,5,6,0,6
11/09/2022 06:00,1,1,0,9,6,3,9,5,4,0,0,0,10,10,0,0,0,0,0,0,0,29,5,24,0,,4,0,4,6,1,5
11/09/2022 07:00,6,5,1,38,14,24,35,10,25,0,0,0,10,10,0,0,0,0,0,0,0,38,12,26,0,,10,0,10,7,0,7
11/09/2022 08:00,6,5,1,68,28,40,71,32,39,0,0,0,13,13,0,0,0,0,0,0,0,40,17,23,0,,10,0,10,19,0,19
11/09/2022 09:00,10,7,3,66,36,30,65,36,29,0,0,0,16,16,0,0,0,0,0,0,0,50,12,38,0,,9,0,9,33,0,33
11/09/2022 10:00,9,5,4,60,31,29,68,38,30,0,0,0,7,7,0,0,0,0,0,0,0,54,17,37,0,,7,0,7,34,1,33
11/09/2022 11:00,4,3,1,35,16,19,36,18,18,0,0,0,1,1,0,0,0,0,0,0,0,49,24,25,0,,20,0,20,18,0,18
11/09/2022 12:00,1,0,1,15,10,5,20,15,5,0,0,0,2,2,0,0,0,0,0,0,0,40,15,25,0,,27,0,27,35,1,34
11/09/2022 13:00,9,5,4,8,3,5,11,5,6,0,0,0,0,0,0,0,0,0,0,0,0,44,21,23,0,,27,1,26,54,0,54
11/09/2022 14:00,10,4,6,8,2,6,13,3,10,0,0,0,0,0,0,0,0,0,0,0,0,65,36,29,0,,38,0,38,56,0,56
11/09/2022 15:00,5,1,4,10,4,6,15,9,6,0,0,0,3,3,0,0,0,0,0,0,0,64,31,33,0,,41,0,41,66,2,64
11/09/2022 16:00,11,10,1,8,2,6,12,3,9,0,0,0,0,0,0,0,0,0,0,0,0,70,30,40,0,,46,1,45,68,0,68
11/09/2022 17:00,14,5,9,19,9,10,27,12,15,0,0,0,0,0,0,0,0,0,0,0,0,68,38,30,0,,65,0,65,61,0,61
11/09/2022 18:00,12,4,8,27,15,12,34,18,16,0,0,0,1,1,0,0,0,0,0,0,0,104,52,52,0,,72,1,71,58,1,57
11/09/2022 19:00,3,2,1,20,9,11,26,13,13,0,0,0,1,1,0,0,0,0,0,0,0,95,51,44,0,,49,0,49,62,0,62
11/09/2022 20:00,9,5,4,19,10,9,31,17,14,0,0,0,2,2,0,0,0,0,0,0,0,60,38,22,0,,45,0,45,43,0,43
11/09/2022 21:00,4,1,3,5,3,2,8,4,4,0,0,0,0,0,0,0,0,0,0,0,0,65,37,28,0,,38,0,38,58,0,58
11/09/2022 22:00,4,2,2,9,4,5,13,6,7,0,0,0,1,1,0,0,0,0,0,0,0,39,26,13,0,,9,0,9,32,1,31
11/09/2022 23:00,1,0,1,0,0,0,3,1,2,0,0,0,3,3,0,0,0,0,0,0,0,18,14,4,0,,0,0,0,24,0,24
12/09/2022 00:00,2,1,1,2,0,2,4,0,4,0,0,0,4,4,0,0,0,0,0,0,0,10,9,1,0,,8,0,8,8,0,8
12/09/2022 01:00,1,1,0,5,3,2,3,2,1,0,0,0,1,1,0,0,0,0,0,0,0,5,4,1,0,,2,0,2,0,0,0
12/09/2022 02:00,2,0,2,1,1,0,2,0,2,0,0,0,0,0,0,0,0,0,0,0,0,4,3,1,0,,5,1,4,3,0,3
12/09/2022 03:00,1,1,0,0,0,0,0,0,0,0,0,0,0,0,0,0,0,0,0,0,0,4,3,1,0,,3,0,3,1,0,1
12/09/2022 04:00,0,0,0,3,2,1,6,3,3,0,0,0,1,1,0,0,0,0,0,0,0,5,1,4,0,,4,0,4,2,0,2
12/09/2022 05:00,2,2,0,9,7,2,15,13,2,0,0,0,3,3,0,0,0,0,0,0,0,33,5,28,0,,5,0,5,5,0,5
12/09/2022 06:00,16,13,3,25,18,7,33,23,10,0,0,0,28,28,0,0,0,0,0,0,0,132,25,107,0,,10,0,10,34,0,34
12/09/2022 07:00,37,32,5,76,59,17,87,66,21,0,0,0,42,42,0,0,0,0,0,0,0,254,60,194,0,,41,1,40,85,0,85
12/09/2022 08:00,101,88,13,91,74,17,126,100,26,0,0,0,78,78,0,0,0,0,0,0,0,497,94,403,0,,73,1,72,197,2,195
12/09/2022 09:00,32,27,5,51,39,12,61,45,16,0,0,0,24,24,0,0,0,0,0,0,0,198,28,170,0,,40,2,38,120,2,118
12/09/2022 10:00,10,8,2,31,10,21,39,17,22,0,0,0,12,12,0,0,0,0,0,0,0,86,18,68,0,,22,0,22,58,0,58
12/09/2022 11:00,7,4,3,30,19,11,37,20,17,0,0,0,14,14,0,0,0,0,0,0,0,92,27,65,0,,33,0,33,64,0,64
12/09/2022 12:00,12,9,3,25,13,12,35,14,21,0,0,0,10,10,0,0,0,0,0,0,0,100,44,56,0,,58,0,58,79,0,79
12/09/2022 13:00,14,4,10,24,13,11,33,14,19,0,0,0,8,8,0,0,0,0,0,0,0,94,40,54,0,,72,1,71,72,0,72
12/09/2022 14:00,19,13,6,34,13,21,42,21,21,0,0,0,8,7,1,0,0,0,0,0,0,101,48,53,0,,72,0,72,70,0,70
12/09/2022 15:00,15,9,6,31,8,23,48,20,28,0,0,0,16,15,1,0,0,0,0,0,0,133,83,50,0,,58,1,57,68,0,68
12/09/2022 16:00,37,16,21,41,18,23,56,21,35,0,0,0,5,5,0,0,0,0,0,0,0,184,123,61,0,,106,0,106,74,0,74
12/09/2022 17:00,58,15,43,73,16,57,95,20,75,0,0,0,7,7,0,0,0,0,0,0,0,365,245,120,0,,165,0,165,115,1,114
12/09/2022 18:00,36,18,18,107,31,76,128,32,96,0,0,0,7,7,0,0,0,0,0,0,0,322,214,108,0,,169,3,166,93,1,92
12/09/2022 19:00,24,13,11,62,21,41,83,29,54,0,0,0,10,10,0,0,0,0,0,0,0,160,116,44,0,,108,0,108,81,1,80
12/09/2022 20:00,10,8,2,26,11,15,41,18,23,0,0,0,18,18,0,0,0,0,0,0,0,112,69,43,0,,82,0,82,74,1,73
12/09/2022 21:00,7,3,4,17,6,11,25,8,17,0,0,0,4,4,0,0,0,0,0,0,0,73,41,32,0,,46,1,45,61,0,61
12/09/2022 22:00,8,3,5,9,2,7,13,5,8,0,0,0,4,4,0,0,0,0,0,0,0,58,38,20,0,,52,0,52,32,1,31
12/09/2022 23:00,3,0,3,2,1,1,3,0,3,0,0,0,3,3,0,0,0,0,0,0,0,15,10,5,0,,23,0,23,21,0,21
13/09/2022 00:00,2,2,0,3,1,2,3,1,2,0,0,0,2,2,0,0,0,0,0,0,0,21,15,6,0,,14,0,14,8,0,8
13/09/2022 01:00,0,0,0,0,0,0,0,0,0,0,0,0,0,0,0,0,0,0,0,0,0,5,3,2,0,,1,0,1,1,0,1
13/09/2022 02:00,0,0,0,1,0,1,2,0,2,0,0,0,1,1,0,0,0,0,0,0,0,1,0,1,0,,4,0,4,1,0,1
13/09/2022 03:00,0,0,0,0,0,0,0,0,0,0,0,0,0,0,0,0,0,0,0,0,0,3,2,1,0,,5,0,5,0,0,0
13/09/2022 04:00,0,0,0,2,2,0,5,2,3,0,0,0,0,0,0,0,0,0,0,0,0,3,0,3,0,,3,0,3,3,0,3
13/09/2022 05:00,3,3,0,11,9,2,12,6,6,0,0,0,3,3,0,0,0,0,0,0,0,33,5,28,0,,6,0,6,7,0,7
13/09/2022 06:00,19,15,4,27,19,8,38,29,9,0,0,0,31,31,0,0,0,0,0,0,0,158,27,131,0,,11,0,11,47,0,47
13/09/2022 07:00,49,47,2,94,72,22,108,86,22,0,0,0,53,53,0,0,0,0,0,0,0,379,77,302,0,,42,0,42,99,0,99
13/09/2022 08:00,153,130,23,140,115,25,175,148,27,0,0,0,88,87,1,0,0,0,0,0,0,767,133,634,0,,81,2,79,257,2,255
13/09/2022 09:00,47,42,5,74,47,27,98,67,31,0,0,0,40,40,0,0,0,0,0,0,0,282,65,217,0,,39,0,39,153,0,153
13/09/2022 10:00,14,8,6,41,19,22,48,24,24,0,0,0,9,9,0,0,0,0,0,0,0,107,32,75,0,,35,0,35,69,0,69
13/09/2022 11:00,10,8,2,64,35,29,79,41,38,0,0,0,10,10,0,0,0,0,0,0,0,91,38,53,0,,42,0,42,78,0,78
13/09/2022 12:00,17,12,5,58,23,35,69,36,33,0,0,0,5,5,0,0,0,0,0,0,0,122,43,79,0,,56,0,56,107,2,105
13/09/2022 13:00,16,10,6,48,22,26,82,37,45,0,0,0,5,5,0,0,0,0,0,0,0,123,57,66,0,,74,1,73,111,1,110
13/09/2022 14:00,15,9,6,55,23,32,76,34,42,0,0,0,5,5,0,0,0,0,0,0,0,116,58,58,0,,84,0,84,75,0,75
13/09/2022 15:00,19,12,7,66,26,40,75,29,46,0,0,0,8,8,0,0,0,0,0,0,0,165,97,68,0,,107,0,107,79,0,79
13/09/2022 16:00,36,12,24,84,34,50,114,39,75,0,0,0,3,3,0,0,0,0,0,0,0,238,150,88,0,,152,0,152,100,1,99
13/09/2022 17:00,83,20,63,157,43,114,209,56,153,0,0,0,18,18,0,0,0,0,0,0,0,500,354,146,0,,272,1,271,135,0,135
13/09/2022 18:00,66,18,48,178,55,123,224,65,159,0,0,0,15,15,0,0,0,0,0,0,0,394,268,126,0,,196,0,196,135,2,133
13/09/2022 19:00,28,10,18,106,60,46,139,66,73,0,0,0,11,11,0,0,0,0,0,0,0,245,148,97,0,,130,0,130,93,0,93
13/09/2022 20:00,15,5,10,70,32,38,90,46,44,0,0,0,14,14,0,0,0,0,0,0,0,140,84,56,0,,82,1,81,107,0,107
13/09/2022 21:00,15,7,8,29,15,14,35,12,23,0,0,0,9,9,0,0,0,0,0,0,0,89,50,39,0,,58,0,58,53,0,53
13/09/2022 22:00,9,8,1,13,6,7,21,6,15,0,0,0,5,5,0,0,0,0,0,0,0,65,46,19,0,,19,0,19,30,0,30
13/09/2022 23:00,3,3,0,6,3,3,9,3,6,0,0,0,6,6,0,0,0,0,0,0,0,34,26,8,0,,0,0,0,17,0,17
14/09/2022 00:00,0,0,0,3,0,3,11,4,7,0,0,0,4,4,0,0,0,0,0,0,0,17,13,4,0,,0,0,0,9,0,9
14/09/2022 01:00,0,0,0,2,1,1,1,0,1,0,0,0,1,1,0,0,0,0,0,0,0,10,7,3,0,,2,0,2,0,0,0
14/09/2022 02:00,1,1,0,1,1,0,1,0,1,0,0,0,2,2,0,0,0,0,0,0,0,3,2,1,0,,16,0,16,2,0,2
14/09/2022 03:00,0,0,0,1,0,1,1,0,1,0,0,0,0,0,0,0,0,0,0,0,0,5,3,2,0,,4,0,4,2,0,2
14/09/2022 04:00,1,1,0,2,2,0,2,1,1,0,0,0,2,2,0,0,0,0,0,0,0,5,1,4,0,,3,0,3,2,0,2
14/09/2022 05:00,2,1,1,11,9,2,20,12,8,0,0,0,3,3,0,0,0,0,0,0,0,42,7,35,0,,3,0,3,9,0,9
14/09/2022 06:00,26,24,2,44,32,12,54,38,16,0,0,0,29,29,0,0,0,0,0,0,0,139,22,117,0,,11,1,10,41,0,41
14/09/2022 07:00,62,55,7,82,60,22,88,73,15,0,0,0,61,61,0,0,0,0,0,0,0,367,77,290,0,,42,0,42,101,0,101
14/09/2022 08:00,135,122,13,118,95,23,163,140,23,0,0,0,125,125,0,0,0,0,0,0,0,707,125,582,0,,91,0,91,213,2,211
14/09/2022 09:00,62,54,8,75,44,31,90,54,36,0,0,0,44,44,0,0,0,0,0,0,0,267,47,220,0,,40,1,39,155,0,155
14/09/2022 10:00,9,7,2,51,25,26,57,30,27,0,0,0,15,15,0,0,0,0,0,0,0,83,25,58,0,,46,1,45,77,0,77
14/09/2022 11:00,11,4,7,56,28,28,68,31,37,0,0,0,16,16,0,0,0,0,0,0,0,92,37,55,0,,27,0,27,71,0,71
14/09/2022 12:00,17,14,3,35,19,16,52,24,28,0,0,0,7,7,0,0,0,0,0,0,0,96,41,55,0,,67,0,67,81,0,81
14/09/2022 13:00,16,10,6,52,35,17,62,30,32,0,0,0,6,6,0,0,0,0,0,0,0,137,63,74,0,,76,1,75,107,0,107
14/09/2022 14:00,24,10,14,50,19,31,66,25,41,0,0,0,9,9,0,0,0,0,0,0,0,127,56,71,0,,72,0,72,86,0,86
14/09/2022 15:00,17,11,6,47,21,26,84,29,55,0,0,0,6,6,0,0,0,0,0,0,0,182,100,82,0,,88,0,88,99,2,97
14/09/2022 16:00,47,18,29,63,23,40,98,39,59,0,0,0,9,9,0,0,0,0,0,0,0,253,170,83,0,,147,1,146,67,0,67
14/09/2022 17:00,82,16,66,117,30,87,157,42,115,0,0,0,5,5,0,0,0,0,0,0,0,487,337,150,0,,264,1,263,150,3,147
14/09/2022 18:00,53,13,40,128,31,97,160,43,117,0,0,0,17,17,0,0,0,0,0,0,0,428,291,137,0,,212,0,212,143,1,142
14/09/2022 19:00,33,8,25,88,28,60,131,54,77,0,0,0,9,9,0,0,0,0,0,0,0,213,126,87,0,,152,1,151,104,0,104
14/09/2022 20:00,13,5,8,48,19,29,70,37,33,0,0,0,7,7,0,0,0,0,0,0,0,139,83,56,0,,83,0,83,98,0,98
14/09/2022 21:00,3,1,2,26,12,14,28,10,18,0,0,0,1,1,0,0,0,0,0,0,0,93,62,31,0,,56,0,56,46,0,46
14/09/2022 22:00,1,1,0,9,5,4,22,8,14,0,0,0,6,6,0,0,0,0,0,0,0,92,71,21,0,,60,0,60,29,0,29
14/09/2022 23:00,3,1,2,10,2,8,7,0,7,0,0,0,1,1,0,0,0,0,0,0,0,40,29,11,0,,43,0,43,21,1,20
15/09/2022 00:00,2,0,2,4,0,4,9,4,5,0,0,0,4,4,0,0,0,0,0,0,0,31,24,7,0,,18,0,18,8,0,8
15/09/2022 01:00,0,0,0,7,4,3,1,0,1,0,0,0,0,0,0,0,0,0,0,0,0,5,3,2,0,,4,0,4,0,0,0
15/09/2022 02:00,0,0,0,0,0,0,1,1,0,0,0,0,1,1,0,0,0,0,0,0,0,2,2,0,0,,14,0,14,1,0,1
15/09/2022 03:00,0,0,0,0,0,0,0,0,0,0,0,0,0,0,0,0,0,0,0,0,0,5,3,2,0,,4,0,4,0,0,0
15/09/2022 04:00,3,1,2,1,1,0,3,2,1,0,0,0,0,0,0,0,0,0,0,0,0,10,2,8,0,,4,0,4,1,0,1
15/09/2022 05:00,5,4,1,9,6,3,14,5,9,0,0,0,3,3,0,0,0,0,0,0,0,47,12,35,0,,3,0,3,7,0,7
15/09/2022 06:00,22,18,4,33,22,11,42,32,10,0,0,0,21,20,1,0,0,0,0,0,0,148,22,126,0,,7,0,7,45,2,43
15/09/2022 07:00,43,37,6,75,56,19,91,68,23,0,0,0,69,69,0,0,0,0,0,0,0,334,70,264,0,,43,0,43,97,0,97
15/09/2022 08:00,127,115,12,119,97,22,156,129,27,0,0,0,98,98,0,0,0,0,0,0,0,673,114,559,0,,84,2,82,209,1,208
15/09/2022 09:00,43,39,4,62,45,17,78,52,26,0,0,0,41,41,0,0,0,0,0,0,0,317,67,250,0,,43,0,43,148,1,147
15/09/2022 10:00,17,12,5,52,28,24,66,34,32,0,0,0,23,23,0,0,0,0,0,0,0,117,38,79,0,,45,0,45,82,1,81
15/09/2022 11:00,10,7,3,49,25,24,57,31,26,0,0,0,23,23,0,0,0,0,0,0,0,74,22,52,0,,38,0,38,70,0,70
15/09/2022 12:00,19,10,9,56,24,32,73,35,38,0,0,0,21,21,0,0,0,0,0,0,0,113,44,69,0,,48,0,48,105,1,104
15/09/2022 13:00,18,13,5,57,25,32,75,30,45,0,0,0,11,11,0,0,0,0,0,0,0,101,41,60,0,,36,0,36,118,0,118
15/09/2022 14:00,19,6,13,56,24,32,68,30,38,0,0,0,8,8,0,0,0,0,0,0,0,131,66,65,0,,71,0,71,78,1,77
15/09/2022 15:00,20,8,12,62,22,40,70,22,48,0,0,0,13,13,0,0,0,0,0,0,0,171,87,84,0,,103,0,103,95,0,95
15/09/2022 16:00,46,16,30,66,23,43,98,34,64,0,0,0,18,18,0,0,0,0,0,0,0,255,168,87,0,,152,1,151,95,3,92
15/09/2022 17:00,76,23,53,124,31,93,166,50,116,0,0,0,21,19,2,0,0,0,0,0,0,448,302,146,0,,229,1,228,166,0,166
15/09/2022 18:00,61,11,50,136,36,100,174,45,129,0,0,0,26,26,0,0,0,0,0,0,0,391,252,139,0,,221,0,221,144,1,143
15/09/2022 19:00,36,11,25,79,36,43,99,44,55,0,0,0,14,13,1,0,0,0,0,0,0,233,141,92,0,,126,1,125,92,0,92
15/09/2022 20:00,21,10,11,43,24,19,58,35,23,0,0,0,8,8,0,0,0,0,0,0,0,177,105,72,0,,104,1,103,104,1,103
15/09/2022 21:00,6,3,3,16,7,9,38,18,20,0,0,0,4,4,0,0,0,0,0,0,0,96,54,42,0,,78,0,78,77,1,76
15/09/2022 22:00,7,2,5,9,4,5,14,4,10,0,0,0,10,10,0,0,0,0,0,0,0,80,56,24,0,,63,0,63,38,0,38
15/09/2022 23:00,1,1,0,3,0,3,15,3,12,0,0,0,7,7,0,0,0,0,0,0,0,54,38,16,0,,46,2,44,18,0,18
16/09/2022 00:00,3,0,3,2,1,1,5,2,3,0,0,0,3,3,0,0,0,0,0,0,0,29,24,5,0,,33,0,33,13,0,13
16/09/2022 01:00,1,1,0,0,0,0,0,0,0,0,0,0,1,1,0,0,0,0,0,0,0,9,8,1,0,,8,0,8,1,0,1
16/09/2022 02:00,0,0,0,1,0,1,1,1,0,0,0,0,1,1,0,0,0,0,0,0,0,8,8,0,0,,11,0,11,2,0,2
16/09/2022 03:00,0,0,0,2,1,1,3,1,2,0,0,0,0,0,0,0,0,0,0,0,0,5,3,2,0,,12,0,12,5,0,5
16/09/2022 04:00,2,2,0,1,1,0,2,2,0,0,0,0,2,2,0,0,0,0,0,0,0,9,6,3,0,,9,0,9,2,0,2
16/09/2022 05:00,4,4,0,9,8,1,11,8,3,0,0,0,5,5,0,0,0,0,0,0,0,40,9,31,0,,3,0,3,5,0,5
16/09/2022 06:00,15,13,2,20,12,8,22,13,9,0,0,0,28,28,0,0,0,0,0,0,0,134,23,111,0,,10,0,10,31,0,31
16/09/2022 07:00,26,22,4,58,38,20,72,51,21,0,0,0,59,59,0,0,0,0,0,0,0,244,52,192,0,,38,1,37,81,2,79
16/09/2022 08:00,72,58,14,101,73,28,106,78,28,0,0,0,88,88,0,0,0,0,0,0,0,442,100,342,0,,57,0,57,155,1,154
16/09/2022 09:00,29,23,6,61,39,22,78,46,32,0,0,0,31,31,0,0,0,0,0,0,0,227,38,189,0,,45,2,43,120,0,120
16/09/2022 10:00,15,11,4,64,21,43,85,37,48,0,0,0,23,23,0,0,0,0,0,0,0,94,28,66,0,,45,0,45,81,0,81
16/09/2022 11:00,14,8,6,67,32,35,79,34,45,0,0,0,16,16,0,0,0,0,0,0,0,123,33,90,0,,56,0,56,58,0,58
16/09/2022 12:00,21,11,10,80,43,37,91,41,50,0,0,0,5,5,0,0,0,0,0,0,0,148,45,103,0,,78,2,76,103,0,103
16/09/2022 13:00,27,11,16,80,35,45,92,45,47,0,0,0,10,9,1,0,0,0,0,0,0,187,93,94,0,,94,1,93,140,0,140
16/09/2022 14:00,20,9,11,60,28,32,76,31,45,0,0,0,6,5,1,0,0,0,0,0,0,161,86,75,0,,85,1,84,104,0,104
16/09/2022 15:00,24,10,14,57,25,32,84,34,50,0,0,0,7,7,0,0,0,0,0,0,0,200,115,85,0,,113,3,110,83,0,83
16/09/2022 16:00,37,16,21,81,36,45,119,48,71,0,0,0,3,3,0,0,0,0,0,0,0,241,135,106,0,,126,0,126,153,1,152
16/09/2022 17:00,31,8,23,93,38,55,129,50,79,0,0,0,4,4,0,0,0,0,0,0,0,323,212,111,0,,202,0,202,118,1,117
16/09/2022 18:00,23,6,17,63,15,48,95,30,65,0,0,0,0,0,0,0,0,0,0,0,0,247,136,111,0,,163,0,163,104,0,104
16/09/2022 19:00,19,4,15,45,22,23,81,41,40,0,0,0,2,2,0,0,0,0,0,0,0,190,101,89,0,,113,1,112,105,0,105
16/09/2022 20:00,17,5,12,44,23,21,55,31,24,0,0,0,13,13,0,0,0,0,0,0,0,143,78,65,0,,89,0,89,88,2,86
16/09/2022 21:00,9,6,3,10,7,3,22,14,8,0,0,0,6,5,1,0,0,0,0,0,0,82,46,36,0,,63,2,61,74,0,74
16/09/2022 22:00,7,3,4,11,4,7,20,5,15,0,0,0,0,0,0,0,0,0,0,0,0,58,37,21,0,,71,0,71,48,0,48
16/09/2022 23:00,3,0,3,8,3,5,9,3,6,0,0,0,7,6,1,0,0,0,0,0,0,53,35,18,0,,58,3,55,35,0,35
17/09/2022 00:00,1,0,1,2,0,2,8,3,5,0,0,0,3,3,0,0,0,0,0,0,0,31,25,6,0,,45,1,44,23,0,23
17/09/2022 01:00,1,1,0,3,1,2,2,0,2,0,0,0,7,6,1,0,0,0,0,0,0,24,19,5,0,,14,1,13,1,0,1
17/09/2022 02:00,1,0,1,1,1,0,4,1,3,0,0,0,2,2,0,0,0,0,0,0,0,19,13,6,0,,24,2,22,14,0,14
17/09/2022 03:00,2,0,2,2,1,1,2,0,2,0,0,0,2,2,0,0,0,0,0,0,0,9,5,4,0,,19,0,19,5,0,5
17/09/2022 04:00,0,0,0,1,0,1,1,0,1,0,0,0,1,1,0,0,0,0,0,0,0,10,5,5,0,,12,0,12,3,0,3
17/09/2022 05:00,0,0,0,2,1,1,6,1,5,0,0,0,1,1,0,0,0,0,0,0,0,12,4,8,0,,3,0,3,13,0,13
17/09/2022 06:00,1,1,0,9,4,5,11,6,5,0,0,0,5,5,0,0,0,0,0,0,0,35,11,24,0,,9,0,9,8,0,8
17/09/2022 07:00,3,2,1,33,15,18,39,20,19,0,0,0,7,7,0,0,0,0,0,0,0,43,12,31,0,,14,0,14,20,0,20
17/09/2022 08:00,10,7,3,44,18,26,44,19,25,0,0,0,22,22,0,0,0,0,0,0,0,82,37,45,0,,12,0,12,52,1,51
17/09/2022 09:00,8,6,2,76,28,48,83,32,51,0,0,0,15,15,0,0,0,0,0,0,0,76,25,51,0,,19,0,19,70,1,69
17/09/2022 10:00,13,10,3,113,55,58,156,99,57,0,0,0,13,13,0,0,0,0,0,0,0,124,41,83,0,,48,0,48,53,0,53
17/09/2022 11:00,22,7,15,145,68,77,172,88,84,0,0,0,6,6,0,0,0,0,0,0,0,107,32,75,0,,57,0,57,100,1,99
17/09/2022 12:00,17,8,9,105,61,44,143,69,74,0,0,0,5,5,0,0,0,0,0,0,0,132,45,87,0,,78,0,78,122,0,122
17/09/2022 13:00,24,16,8,117,68,49,153,72,81,0,0,0,5,5,0,0,0,0,0,0,0,128,53,75,0,,87,1,86,108,1,107
17/09/2022 14:00,29,19,10,80,35,45,123,53,70,0,0,0,7,7,0,0,0,0,0,0,0,155,76,79,0,,88,1,87,124,0,124
17/09/2022 15:00,16,7,9,113,62,51,152,70,82,0,0,0,10,10,0,0,0,0,0,0,0,108,53,55,0,,101,0,101,108,0,108
17/09/2022 16:00,25,9,16,99,47,52,144,70,74,0,0,0,10,10,0,0,0,0,0,0,0,136,50,86,0,,103,0,103,110,0,110
17/09/2022 17:00,11,6,5,90,55,35,151,70,81,0,0,0,1,1,0,0,0,0,0,0,0,125,64,61,0,,109,1,108,99,0,99
17/09/2022 18:00,16,8,8,63,29,34,98,47,51,0,0,0,0,0,0,0,0,0,0,0,0,138,60,78,0,,103,1,102,87,0,87
17/09/2022 19:00,12,4,8,33,18,15,52,24,28,0,0,0,2,2,0,0,0,0,0,0,0,120,51,69,0,,74,0,74,100,0,100
17/09/2022 20:00,6,4,2,15,9,6,29,10,19,0,0,0,0,0,0,0,0,0,0,0,0,94,52,42,0,,71,0,71,67,1,66
17/09/2022 21:00,8,3,5,13,8,5,27,6,21,0,0,0,0,0,0,0,0,0,0,0,0,67,40,27,0,,68,2,66,58,2,56
17/09/2022 22:00,6,0,6,6,4,2,11,6,5,0,0,0,0,0,0,0,0,0,0,0,0,48,31,17,0,,54,0,54,43,0,43
17/09/2022 23:00,7,1,6,4,2,2,11,3,8,0,0,0,0,0,0,0,0,0,0,0,0,49,31,18,0,,37,0,37,31,0,31
18/09/2022 00:00,2,1,1,6,2,4,6,4,2,0,0,0,5,5,0,0,0,0,0,0,0,26,20,6,0,,30,1,29,21,1,20
18/09/2022 01:00,1,1,0,4,3,1,2,2,0,0,0,0,3,3,0,0,0,0,0,0,0,32,25,7,0,,10,0,10,0,0,0
18/09/2022 02:00,3,2,1,2,0,2,3,1,2,0,0,0,1,1,0,0,0,0,0,0,0,16,14,2,0,,22,0,22,7,0,7
18/09/2022 03:00,0,0,0,0,0,0,0,0,0,0,0,0,0,0,0,0,0,0,0,0,0,16,10,6,0,,25,1,24,4,0,4
18/09/2022 04:00,0,0,0,0,0,0,2,1,1,0,0,0,1,1,0,0,0,0,0,0,0,10,7,3,0,,10,0,10,6,1,5
18/09/2022 05:00,4,3,1,3,2,1,1,1,0,0,0,0,0,0,0,0,0,0,0,0,0,8,3,5,0,,6,0,6,6,0,6
18/09/2022 06:00,0,0,0,7,4,3,11,3,8,0,0,0,1,1,0,0,0,0,0,0,0,23,6,17,0,,6,0,6,8,0,8
18/09/2022 07:00,5,1,4,23,8,15,42,14,28,0,0,0,10,10,0,0,0,0,0,0,0,31,8,23,0,,9,0,9,15,0,15
18/09/2022 08:00,6,6,0,87,39,48,91,36,55,0,0,0,8,8,0,0,0,0,0,0,0,49,16,33,0,,17,0,17,26,0,26
18/09/2022 09:00,9,7,2,110,44,66,120,44,76,0,0,0,11,11,0,0,0,0,0,0,0,87,27,60,0,,22,0,22,41,0,41
18/09/2022 10:00,10,8,2,146,53,93,179,66,113,0,0,0,8,8,0,0,0,0,0,0,0,79,27,52,0,,28,0,28,47,0,47
18/09/2022 11:00,21,15,6,199,104,95,215,88,127,0,0,0,3,3,0,0,0,0,0,0,0,110,43,67,0,,50,0,50,70,0,70
18/09/2022 12:00,11,10,1,183,85,98,203,94,109,0,0,0,4,4,0,0,0,0,0,0,0,136,56,80,0,,43,0,43,77,1,76
18/09/2022 13:00,23,10,13,161,88,73,207,101,106,0,0,0,5,5,0,0,0,0,0,0,0,115,40,75,0,,66,0,66,98,0,98
18/09/2022 14:00,23,13,10,146,72,74,196,88,108,0,0,0,6,6,0,0,0,0,0,0,0,114,46,68,0,,88,0,88,98,0,98
18/09/2022 15:00,13,8,5,136,69,67,191,88,103,0,0,0,10,10,0,0,0,0,0,0,0,117,47,70,0,,59,0,59,115,0,115
18/09/2022 16:00,16,9,7,144,73,71,190,91,99,0,0,0,6,6,0,0,0,0,0,0,0,118,47,71,0,,103,1,102,85,0,85
18/09/2022 17:00,18,11,7,103,67,36,151,91,60,0,0,0,12,12,0,0,0,0,0,0,0,128,57,71,0,,95,0,95,68,1,67
18/09/2022 18:00,19,10,9,71,37,34,100,57,43,0,0,0,10,10,0,0,0,0,0,0,0,121,51,70,0,,86,0,86,97,1,96
18/09/2022 19:00,15,7,8,43,27,16,73,46,27,0,0,0,7,7,0,0,0,0,0,0,0,112,61,51,0,,74,0,74,80,1,79
18/09/2022 20:00,10,5,5,23,14,9,46,26,20,0,0,0,4,4,0,0,0,0,0,0,0,68,42,26,0,,62,0,62,64,0,64
18/09/2022 21:00,2,0,2,22,9,13,18,8,10,0,0,0,9,8,1,0,0,0,0,0,0,55,33,22,0,,44,1,43,47,0,47
18/09/2022 22:00,2,2,0,5,4,1,10,4,6,0,0,0,2,2,0,0,0,0,0,0,0,55,42,13,0,,6,0,6,29,0,29
18/09/2022 23:00,4,2,2,2,1,1,8,2,6,0,0,0,2,2,0,0,0,0,0,0,0,30,17,13,0,,0,0,0,16,0,16
19/09/2022 00:00,0,0,0,0,0,0,4,2,2,0,0,0,0,0,0,0,0,0,0,0,0,17,14,3,0,,8,0,8,21,0,21
19/09/2022 01:00,0,0,0,0,0,0,1,0,1,0,0,0,2,2,0,0,0,0,0,0,0,2,2,0,0,,5,0,5,0,0,0
19/09/2022 02:00,0,0,0,0,0,0,0,0,0,0,0,0,0,0,0,0,0,0,0,0,0,6,4,2,0,,6,0,6,1,0,1
19/09/2022 03:00,0,0,0,0,0,0,0,0,0,0,0,0,1,1,0,0,0,0,0,0,0,3,2,1,0,,3,0,3,0,0,0
19/09/2022 04:00,3,3,0,2,2,0,2,1,1,0,0,0,2,2,0,0,0,0,0,0,0,3,0,3,0,,1,0,1,2,0,2
19/09/2022 05:00,5,5,0,6,4,2,12,7,5,0,0,0,5,5,0,0,0,0,0,0,0,33,5,28,0,,5,0,5,3,0,3
19/09/2022 06:00,13,12,1,24,18,6,32,20,12,0,0,0,18,18,0,0,0,0,0,0,0,139,18,121,0,,10,0,10,40,0,40
19/09/2022 07:00,49,43,6,72,57,15,87,69,18,0,0,0,52,52,0,0,0,0,0,0,0,287,63,224,0,,35,1,34,81,0,81
19/09/2022 08:00,105,89,16,106,75,31,131,99,32,0,0,0,106,106,0,0,0,0,0,0,0,549,104,445,0,,73,0,73,179,0,179
19/09/2022 09:00,42,37,5,61,38,23,88,53,35,0,0,0,46,46,0,0,0,0,0,0,0,235,43,192,0,,38,0,38,133,0,133
19/09/2022 10:00,13,10,3,57,28,29,81,31,50,0,0,0,12,12,0,0,0,0,0,0,0,75,31,44,0,,32,0,32,58,0,58
19/09/2022 11:00,11,6,5,47,29,18,54,26,28,0,0,0,8,8,0,0,0,0,0,0,0,108,38,70,0,,36,0,36,67,0,67
19/09/2022 12:00,15,9,6,54,26,28,67,31,36,0,0,0,7,7,0,0,0,0,0,0,0,100,33,67,0,,58,0,58,92,0,92
19/09/2022 13:00,16,12,4,51,21,30,68,30,38,0,0,0,9,9,0,0,0,0,0,0,0,99,38,61,0,,72,0,72,101,0,101
19/09/2022 14:00,16,14,2,55,22,33,71,29,42,0,0,0,8,8,0,0,0,0,0,0,0,126,66,60,0,,63,0,63,76,1,75
19/09/2022 15:00,30,16,14,54,26,28,67,27,40,0,0,0,7,7,0,0,0,0,0,0,0,169,106,63,0,,79,0,79,92,1,91
19/09/2022 16:00,36,15,21,72,32,40,89,32,57,0,0,0,9,9,0,0,0,0,0,0,0,254,154,100,0,,137,0,137,97,0,97
19/09/2022 17:00,68,24,44,95,28,67,151,45,106,0,0,0,8,8,0,0,0,0,0,0,0,445,298,147,0,,252,1,251,115,1,114
19/09/2022 18:00,68,16,52,124,28,96,159,45,114,0,0,0,15,14,1,0,0,0,0,0,0,344,242,102,0,,187,1,186,136,1,135
19/09/2022 19:00,22,8,14,73,33,40,96,40,56,0,0,0,13,13,0,0,0,0,0,0,0,209,121,88,0,,134,0,134,86,1,85
19/09/2022 20:00,12,6,6,30,12,18,42,19,23,0,0,0,7,7,0,0,0,0,0,0,0,129,78,51,0,,49,0,49,75,2,73
19/09/2022 21:00,6,3,3,17,7,10,22,5,17,0,0,0,6,6,0,0,0,0,0,0,0,81,55,26,0,,0,0,0,55,0,55
19/09/2022 22:00,1,0,1,4,3,1,12,4,8,0,0,0,6,6,0,0,0,0,0,0,0,56,38,18,0,,0,0,0,31,0,31
19/09/2022 23:00,2,0,2,6,1,5,7,0,7,0,0,0,3,3,0,0,0,0,0,0,0,34,26,8,0,,0,0,0,9,0,9
20/09/2022 00:00,0,0,0,1,0,1,3,3,0,0,0,0,2,2,0,0,0,0,0,0,0,12,10,2,0,,0,0,0,12,0,12
20/09/2022 01:00,0,0,0,2,1,1,0,0,0,0,0,0,1,1,0,0,0,0,0,0,0,2,2,0,0,,2,0,2,0,0,0
20/09/2022 02:00,1,0,1,0,0,0,0,0,0,0,0,0,1,1,0,0,0,0,0,0,0,4,3,1,0,,12,0,12,1,0,1
20/09/2022 03:00,0,0,0,0,0,0,1,0,1,0,0,0,0,0,0,0,0,0,0,0,0,3,0,3,0,,1,0,1,0,0,0
20/09/2022 04:00,2,2,0,1,1,0,1,0,1,0,0,0,4,4,0,0,0,0,0,0,0,4,1,3,0,,3,0,3,3,0,3
20/09/2022 05:00,4,3,1,8,5,3,13,6,7,0,0,0,6,6,0,0,0,0,0,0,0,45,10,35,0,,2,0,2,7,0,7
20/09/2022 06:00,23,19,4,24,22,2,32,27,5,0,0,0,24,24,0,0,0,0,0,0,0,147,23,124,0,,12,0,12,52,0,52
20/09/2022 07:00,53,49,4,89,70,19,120,95,25,0,0,0,70,70,0,0,0,0,0,0,0,400,78,322,0,,42,2,40,98,0,98
20/09/2022 08:00,176,151,25,132,109,23,181,142,39,0,0,0,115,115,0,0,0,0,0,0,0,741,113,628,0,,76,0,76,263,0,263
20/09/2022 09:00,50,42,8,76,52,24,93,61,32,0,0,0,61,61,0,0,0,0,0,0,0,290,45,245,0,,34,0,34,190,0,190
20/09/2022 10:00,16,13,3,70,27,43,97,33,64,0,0,0,24,24,0,0,0,0,0,0,0,92,26,66,0,,33,0,33,83,0,83
20/09/2022 11:00,11,7,4,55,24,31,74,37,37,0,0,0,12,12,0,0,0,0,0,0,0,80,23,57,0,,37,0,37,71,1,70
20/09/2022 12:00,19,13,6,60,25,35,65,26,39,0,0,0,18,18,0,0,0,0,0,0,0,126,50,76,0,,52,1,51,104,0,104
20/09/2022 13:00,20,9,11,53,28,25,69,29,40,0,0,0,11,11,0,0,0,0,0,0,0,119,60,59,0,,71,1,70,107,2,105
20/09/2022 14:00,25,12,13,48,26,22,65,31,34,0,0,0,17,17,0,0,0,0,0,0,0,112,62,50,0,,79,0,79,78,0,78
20/09/2022 15:00,24,7,17,50,20,30,63,28,35,0,0,0,7,7,0,0,0,0,0,0,0,171,112,59,0,,104,0,104,80,1,79
20/09/2022 16:00,45,20,25,87,25,62,106,27,79,0,0,0,6,6,0,0,0,0,0,0,0,256,149,107,0,,146,0,146,102,0,102
20/09/2022 17:00,89,27,62,152,44,108,192,47,145,0,0,0,9,9,0,0,0,0,0,0,0,484,354,130,0,,285,0,285,133,0,133
20/09/2022 18:00,63,20,43,172,57,115,236,68,168,0,0,0,17,17,0,0,0,0,0,0,0,450,307,143,0,,234,2,232,149,0,149
20/09/2022 19:00,31,11,20,113,53,60,141,69,72,0,0,0,15,15,0,0,0,0,0,0,0,234,158,76,0,,131,0,131,127,2,125
20/09/2022 20:00,16,5,11,60,19,41,80,29,51,0,0,0,7,6,1,0,0,0,0,0,0,169,98,71,0,,91,0,91,71,0,71
20/09/2022 21:00,11,8,3,26,14,12,28,7,21,0,0,0,6,6,0,0,0,0,0,0,0,91,61,30,0,,75,1,74,42,0,42
20/09/2022 22:00,8,4,4,18,12,6,27,13,14,0,0,0,7,7,0,0,0,0,0,0,0,94,70,24,0,,15,1,14,39,0,39
20/09/2022 23:00,0,0,0,4,2,2,4,0,4,0,0,0,3,3,0,0,0,0,0,0,0,32,24,8,0,,0,0,0,19,0,19
21/09/2022 00:00,2,2,0,3,2,1,5,3,2,0,0,0,4,4,0,0,0,0,0,0,0,25,21,4,0,,6,2,4,7,0,7
21/09/2022 01:00,0,0,0,1,1,0,1,1,0,0,0,0,1,0,1,0,0,0,0,0,0,5,4,1,0,,2,0,2,0,0,0
21/09/2022 02:00,0,0,0,0,0,0,2,1,1,0,0,0,0,0,0,0,0,0,0,0,0,7,7,0,0,,6,0,6,0,0,0
21/09/2022 03:00,1,1,0,0,0,0,0,0,0,0,0,0,0,0,0,0,0,0,0,0,0,4,4,0,0,,9,0,9,3,0,3
21/09/2022 04:00,2,1,1,0,0,0,1,1,0,0,0,0,5,5,0,0,0,0,0,0,0,6,3,3,0,,1,0,1,4,0,4
21/09/2022 05:00,2,2,0,6,5,1,14,7,7,0,0,0,3,3,0,0,0,0,0,0,0,37,5,32,0,,5,0,5,5,0,5
21/09/2022 06:00,22,20,2,26,22,4,45,32,13,0,0,0,34,34,0,0,0,0,0,0,0,151,24,127,0,,11,0,11,42,1,41
21/09/2022 07:00,61,57,4,100,75,25,109,87,22,0,0,0,55,55,0,0,0,0,0,0,0,386,92,294,0,,40,1,39,106,0,106
21/09/2022 08:00,152,125,27,140,108,32,197,156,41,0,0,0,114,114,0,0,0,0,0,0,0,786,144,642,0,,74,0,74,241,0,241
21/09/2022 09:00,48,42,6,60,44,16,87,57,30,0,0,0,55,54,1,0,0,0,0,0,0,313,67,246,0,,57,0,57,183,1,182
21/09/2022 10:00,26,19,7,55,23,32,59,27,32,0,0,0,26,26,0,0,0,0,0,0,0,111,21,90,0,,41,0,41,92,0,92
21/09/2022 11:00,11,9,2,75,33,42,76,30,46,0,0,0,15,15,0,0,0,0,0,0,0,112,41,71,0,,44,0,44,67,0,67
21/09/2022 12:00,20,11,9,66,35,31,73,32,41,0,0,0,9,9,0,0,0,0,0,0,0,129,56,73,0,,66,1,65,99,1,98
21/09/2022 13:00,20,9,11,66,37,29,73,33,40,0,0,0,13,13,0,0,0,0,0,0,0,137,61,76,0,,84,0,84,124,2,122
21/09/2022 14:00,21,10,11,53,24,29,70,26,44,0,0,0,16,16,0,0,0,0,0,0,0,114,48,66,0,,93,1,92,87,1,86
21/09/2022 15:00,21,9,12,59,26,33,74,27,47,0,0,0,18,18,0,0,0,0,0,0,0,173,92,81,0,,97,0,97,80,2,78
21/09/2022 16:00,49,21,28,79,28,51,97,37,60,0,0,0,23,23,0,0,0,0,0,0,0,270,177,93,0,,142,1,141,97,0,97
21/09/2022 17:00,87,21,66,106,21,85,174,25,149,0,0,0,16,15,1,0,0,0,0,0,0,485,355,130,0,,268,0,268,127,0,127
21/09/2022 18:00,61,20,41,113,34,79,185,35,150,0,0,0,29,29,0,0,0,0,0,0,0,420,293,127,0,,204,0,204,138,0,138
21/09/2022 19:00,26,14,12,104,49,55,108,34,74,0,0,0,19,19,0,0,0,0,0,0,0,245,128,117,0,,108,0,108,99,0,99
21/09/2022 20:00,31,15,16,53,24,29,57,23,34,0,0,0,20,20,0,0,0,0,0,0,0,150,93,57,0,,22,0,22,102,0,102
21/09/2022 21:00,9,5,4,12,4,8,16,6,10,0,0,0,10,10,0,0,0,0,0,0,0,111,84,27,0,,23,0,23,71,0,71
21/09/2022 22:00,5,2,3,8,4,4,18,4,14,0,0,0,4,4,0,0,0,0,0,0,0,75,54,21,0,,66,1,65,40,0,40
21/09/2022 23:00,0,0,0,5,2,3,7,1,6,0,0,0,1,1,0,0,0,0,0,0,0,52,40,12,0,,45,0,45,23,0,23
22/09/2022 00:00,1,0,1,3,1,2,6,2,4,0,0,0,3,3,0,0,0,0,0,0,0,21,17,4,0,,25,0,25,12,0,12
22/09/2022 01:00,0,0,0,2,2,0,1,1,0,0,0,0,1,1,0,0,0,0,0,0,0,7,4,3,0,,6,1,5,0,0,0
22/09/2022 02:00,1,0,1,0,0,0,1,0,1,0,0,0,0,0,0,0,0,0,0,0,0,2,2,0,0,,13,0,13,3,0,3
22/09/2022 03:00,1,1,0,0,0,0,0,0,0,0,0,0,0,0,0,0,0,0,0,0,0,3,2,1,0,,7,0,7,3,0,3
22/09/2022 04:00,0,0,0,1,1,0,2,1,1,0,0,0,1,1,0,0,0,0,0,0,0,5,1,4,0,,4,0,4,3,0,3
22/09/2022 05:00,4,4,0,7,4,3,11,4,7,0,0,0,0,0,0,0,0,0,0,0,0,35,5,30,0,,2,0,2,5,0,5
22/09/2022 06:00,17,14,3,11,11,0,20,15,5,0,0,0,2,2,0,0,0,0,0,0,0,110,17,93,0,,11,0,11,37,0,37
22/09/2022 07:00,29,27,2,27,22,5,46,38,8,0,0,0,46,46,0,0,0,0,0,0,0,254,63,191,0,,29,0,29,62,0,62
22/09/2022 08:00,69,61,8,51,43,8,78,67,11,0,0,0,49,49,0,0,0,0,0,0,0,466,71,395,0,,48,0,48,130,0,130
22/09/2022 09:00,27,25,2,14,12,2,14,13,1,0,0,0,21,21,0,0,0,0,0,0,0,194,39,155,0,,23,2,21,98,0,98
22/09/2022 10:00,10,6,4,5,2,3,10,6,4,0,0,0,10,10,0,0,0,0,0,0,0,68,24,44,0,,18,1,17,40,0,40
22/09/2022 11:00,7,5,2,7,5,2,18,10,8,0,0,0,4,4,0,0,0,0,0,0,0,56,16,40,0,,24,1,23,42,0,42
22/09/2022 12:00,13,9,4,11,2,9,19,5,14,0,0,0,13,13,0,0,0,0,0,0,0,82,34,48,0,,37,0,37,69,0,69
22/09/2022 13:00,14,10,4,11,6,5,16,11,5,0,0,0,7,7,0,0,0,0,0,0,0,89,41,48,0,,52,0,52,68,0,68
22/09/2022 14:00,10,6,4,7,5,2,23,10,13,0,0,0,8,8,0,0,0,0,0,0,0,83,37,46,0,,47,0,47,55,1,54
22/09/2022 15:00,17,6,11,21,9,12,20,5,15,0,0,0,6,6,0,0,0,0,0,0,0,133,76,57,0,,53,0,53,62,0,62
22/09/2022 16:00,36,16,20,41,14,27,49,16,33,0,0,0,7,7,0,0,0,0,0,0,0,167,94,73,0,,92,0,92,95,1,94
22/09/2022 17:00,42,12,30,72,23,49,115,31,84,0,0,0,7,7,0,0,0,0,0,0,0,327,219,108,0,,175,0,175,119,1,118
22/09/2022 18:00,44,12,32,87,31,56,117,40,77,0,0,0,18,18,0,0,0,0,0,0,0,291,193,98,0,,157,0,157,137,0,137
22/09/2022 19:00,26,14,12,62,29,33,71,25,46,0,0,0,9,9,0,0,0,0,0,0,0,190,112,78,0,,105,0,105,98,0,98
22/09/2022 20:00,15,11,4,34,15,19,50,22,28,0,0,0,8,8,0,0,0,0,0,0,0,143,68,75,0,,105,0,105,114,0,114
22/09/2022 21:00,6,2,4,17,8,9,25,10,15,0,0,0,3,3,0,0,0,0,0,0,0,98,69,29,0,,72,0,72,61,1,60
22/09/2022 22:00,8,3,5,12,6,6,25,8,17,0,0,0,6,6,0,0,0,0,0,0,0,58,39,19,0,,56,1,55,22,0,22
22/09/2022 23:00,2,1,1,3,0,3,6,1,5,0,0,0,4,4,0,0,0,0,0,0,0,39,27,12,0,,42,0,42,24,1,23
23/09/2022 00:00,3,1,2,1,0,1,4,0,4,0,0,0,1,1,0,0,0,0,0,0,0,19,17,2,0,,31,0,31,11,0,11
23/09/2022 01:00,0,0,0,2,1,1,1,1,0,0,0,0,0,0,0,0,0,0,0,0,0,10,7,3,0,,5,0,5,0,0,0
23/09/2022 02:00,1,1,0,1,0,1,1,0,1,0,0,0,1,1,0,0,0,0,0,0,0,8,6,2,0,,13,0,13,6,0,6
23/09/2022 03:00,0,0,0,1,0,1,0,0,0,0,0,0,0,0,0,0,0,0,0,0,0,4,4,0,0,,8,0,8,3,0,3
23/09/2022 04:00,3,2,1,0,0,0,1,0,1,0,0,0,0,0,0,0,0,0,0,0,0,5,2,3,0,,4,0,4,1,0,1
23/09/2022 05:00,3,3,0,6,5,1,9,5,4,0,0,0,1,1,0,0,0,0,0,0,0,34,7,27,0,,3,0,3,5,0,5
23/09/2022 06:00,21,18,3,26,15,11,28,17,11,0,0,0,21,21,0,0,0,0,0,0,0,139,21,118,0,,15,0,15,29,0,29
23/09/2022 07:00,38,33,5,68,51,17,83,64,19,0,0,0,40,40,0,0,0,0,0,0,0,249,58,191,0,,35,0,35,66,0,66
23/09/2022 08:00,75,64,11,74,58,16,111,87,24,0,0,0,72,71,1,0,0,0,0,0,0,432,84,348,0,,48,0,48,166,0,166
23/09/2022 09:00,39,34,5,62,36,26,82,47,35,0,0,0,34,34,0,0,0,0,0,0,0,213,28,185,0,,46,0,46,149,0,149
23/09/2022 10:00,17,12,5,66,29,37,85,42,43,0,0,0,19,19,0,0,0,0,0,0,0,105,31,74,0,,25,0,25,70,0,70
23/09/2022 11:00,15,10,5,66,33,33,90,47,43,0,0,0,19,19,0,0,0,0,0,0,0,119,33,86,0,,47,0,47,96,0,96
23/09/2022 12:00,20,14,6,51,22,29,73,29,44,0,0,0,14,14,0,0,0,0,0,0,0,120,45,75,0,,86,0,86,96,0,96
23/09/2022 13:00,28,16,12,63,28,35,104,50,54,0,0,0,22,22,0,0,0,0,0,0,0,169,75,94,0,,107,1,106,133,0,133
23/09/2022 14:00,21,9,12,60,22,38,72,25,47,0,0,0,7,7,0,0,0,0,0,0,0,163,80,83,0,,94,0,94,104,1,103
23/09/2022 15:00,29,17,12,53,20,33,77,37,40,0,0,0,12,12,0,0,0,0,0,0,0,186,98,88,0,,108,0,108,95,2,93
23/09/2022 16:00,34,14,20,72,37,35,79,35,44,0,0,0,6,5,1,0,0,0,0,0,0,223,140,83,0,,105,0,105,79,1,78
23/09/2022 17:00,42,11,31,59,16,43,79,18,61,0,0,0,11,10,1,0,0,0,0,0,0,289,183,106,0,,169,1,168,136,0,136
23/09/2022 18:00,31,11,20,50,10,40,67,12,55,0,0,0,16,16,0,0,0,0,0,0,0,229,140,89,0,,138,0,138,148,0,148
23/09/2022 19:00,20,10,10,40,18,22,38,15,23,0,0,0,15,15,0,0,0,0,0,0,0,181,102,79,0,,120,0,120,113,1,112
23/09/2022 20:00,7,3,4,10,5,5,17,6,11,0,0,0,15,15,0,0,0,0,0,0,0,105,59,46,0,,72,0,72,104,0,104
23/09/2022 21:00,5,4,1,13,5,8,11,2,9,0,0,0,8,7,1,0,0,0,0,0,0,84,48,36,0,,68,0,68,70,0,70
23/09/2022 22:00,7,3,4,6,1,5,17,5,12,0,0,0,9,9,0,0,0,0,0,0,0,78,50,28,0,,70,1,69,46,0,46
23/09/2022 23:00,4,1,3,4,1,3,12,0,12,0,0,0,7,7,0,0,0,0,0,0,0,43,32,11,0,,57,1,56,24,0,24
24/09/2022 00:00,2,2,0,5,4,1,7,3,4,0,0,0,2,2,0,0,0,0,0,0,0,34,23,11,0,,52,0,52,25,0,25
24/09/2022 01:00,2,0,2,4,1,3,5,3,2,0,0,0,2,2,0,0,0,0,0,0,0,21,18,3,0,,22,0,22,4,0,4
24/09/2022 02:00,1,0,1,2,0,2,4,2,2,0,0,0,0,0,0,0,0,0,0,0,0,11,8,3,0,,31,0,31,7,0,7
24/09/2022 03:00,0,0,0,1,0,1,0,0,0,0,0,0,1,1,0,0,0,0,0,0,0,16,14,2,0,,26,2,24,7,0,7
24/09/2022 04:00,0,0,0,0,0,0,0,0,0,0,0,0,0,0,0,0,0,0,0,0,0,12,7,5,0,,5,0,5,0,0,0
24/09/2022 05:00,3,1,2,3,1,2,6,2,4,0,0,0,1,1,0,0,0,0,0,0,0,14,9,5,0,,0,0,0,4,0,4
24/09/2022 06:00,3,2,1,8,3,5,8,3,5,0,0,0,4,4,0,0,0,0,0,0,0,31,10,21,0,,9,0,9,11,0,11
24/09/2022 07:00,2,1,1,39,12,27,43,14,29,0,0,0,10,10,0,0,0,0,0,0,0,50,18,32,0,,16,0,16,16,0,16
24/09/2022 08:00,11,10,1,51,24,27,52,26,26,0,0,0,9,9,0,0,0,0,0,0,0,77,28,49,0,,17,0,17,35,0,35
24/09/2022 09:00,9,6,3,80,41,39,99,43,56,0,0,0,16,16,0,0,0,0,0,0,0,94,31,63,0,,28,1,27,74,0,74
24/09/2022 10:00,15,12,3,71,33,38,103,50,53,0,0,0,13,13,0,0,0,0,0,0,0,90,28,62,0,,7,0,7,74,0,74
24/09/2022 11:00,20,8,12,112,57,55,153,63,90,0,0,0,6,6,0,0,0,0,0,0,0,135,49,86,0,,13,0,13,91,2,89
24/09/2022 12:00,14,8,6,123,56,67,144,62,82,0,0,0,3,2,1,0,0,0,0,0,0,123,41,82,0,,75,0,75,103,0,103
24/09/2022 13:00,21,13,8,106,64,42,150,85,65,0,0,0,15,15,0,0,0,0,0,0,0,144,60,84,0,,82,0,82,127,0,127
24/09/2022 14:00,22,15,7,108,43,65,113,56,57,0,0,0,15,15,0,0,0,0,0,0,0,137,63,74,0,,73,0,73,111,2,109
24/09/2022 15:00,28,11,17,92,45,47,103,53,50,0,0,0,0,0,0,0,0,0,0,0,0,110,45,65,0,,78,1,77,113,1,112
24/09/2022 16:00,22,12,10,76,36,40,147,73,74,0,0,0,0,0,0,0,0,0,0,0,0,121,58,63,0,,97,0,97,117,1,116
24/09/2022 17:00,17,7,10,76,40,36,108,45,63,0,0,0,0,0,0,0,0,0,0,0,0,109,51,58,0,,118,0,118,92,0,92
24/09/2022 18:00,17,7,10,55,33,22,92,49,43,0,0,0,13,12,1,0,0,0,0,0,0,125,57,68,0,,86,2,84,110,2,108
24/09/2022 19:00,12,7,5,40,15,25,49,24,25,0,0,0,8,8,0,0,0,0,0,0,0,103,43,60,0,,31,0,31,92,0,92
24/09/2022 20:00,14,7,7,17,7,10,29,11,18,0,0,0,9,9,0,0,0,0,0,0,0,90,40,50,0,,65,1,64,78,1,77
24/09/2022 21:00,10,4,6,12,8,4,27,13,14,0,0,0,8,8,0,0,0,0,0,0,0,75,43,32,0,,62,0,62,71,1,70
24/09/2022 22:00,5,1,4,8,5,3,11,5,6,0,0,0,4,4,0,0,0,0,0,0,0,47,30,17,0,,28,0,28,54,0,54
24/09/2022 23:00,1,1,0,1,1,0,5,1,4,0,0,0,4,4,0,0,0,0,0,0,0,52,34,18,0,,39,0,39,33,1,32
25/09/2022 00:00,2,1,1,5,3,2,6,4,2,0,0,0,2,2,0,0,0,0,0,0,0,43,30,13,0,,39,1,38,31,0,31
25/09/2022 01:00,3,0,3,6,3,3,6,2,4,0,0,0,1,1,0,0,0,0,0,0,0,23,14,9,0,,7,0,7,2,0,2
25/09/2022 02:00,2,1,1,0,0,0,4,2,2,0,0,0,0,0,0,0,0,0,0,0,0,12,10,2,0,,32,1,31,6,0,6
25/09/2022 03:00,2,1,1,4,2,2,2,0,2,0,0,0,0,0,0,0,0,0,0,0,0,12,8,4,0,,14,0,14,10,0,10
25/09/2022 04:00,0,0,0,0,0,0,0,0,0,0,0,0,0,0,0,0,0,0,0,0,0,5,3,2,0,,7,0,7,3,0,3
25/09/2022 05:00,0,0,0,3,1,2,1,0,1,0,0,0,2,2,0,0,0,0,0,0,0,8,5,3,0,,4,0,4,6,0,6
25/09/2022 06:00,3,3,0,8,4,4,6,3,3,0,0,0,2,2,0,0,0,0,0,0,0,28,10,18,0,,5,0,5,9,0,9
25/09/2022 07:00,1,0,1,30,9,21,33,13,20,0,0,0,9,9,0,0,0,0,0,0,0,41,13,28,0,,13,0,13,12,0,12
25/09/2022 08:00,6,6,0,65,30,35,62,28,34,0,0,0,13,13,0,0,0,0,0,0,0,44,13,31,0,,9,0,9,19,0,19
25/09/2022 09:00,10,8,2,77,30,47,103,40,63,0,0,0,10,10,0,0,0,0,0,0,0,73,18,55,0,,15,0,15,44,0,44
25/09/2022 10:00,7,5,2,109,36,73,120,37,83,0,0,0,6,6,0,0,0,0,0,0,0,87,22,65,0,,25,0,25,53,0,53
25/09/2022 11:00,16,6,10,113,56,57,138,68,70,0,0,0,17,17,0,0,0,0,0,0,0,96,26,70,0,,37,1,36,90,0,90
25/09/2022 12:00,18,12,6,121,63,58,153,73,80,0,0,0,12,12,0,0,0,0,0,0,0,101,33,68,0,,58,0,58,77,0,77
25/09/2022 13:00,32,30,2,113,66,47,157,76,81,0,0,0,8,8,0,0,0,0,0,0,0,115,52,63,0,,62,0,62,105,1,104
25/09/2022 14:00,19,6,13,97,51,46,115,43,72,0,0,0,7,7,0,0,0,0,0,0,0,119,47,72,0,,81,0,81,108,1,107
25/09/2022 15:00,19,8,11,87,41,46,111,56,55,0,0,0,4,4,0,0,0,0,0,0,0,99,38,61,0,,59,1,58,77,0,77
25/09/2022 16:00,10,6,4,62,33,29,75,38,37,0,0,0,12,12,0,0,0,0,0,0,0,112,51,61,0,,19,0,19,93,0,93
25/09/2022 17:00,21,7,14,43,25,18,52,28,24,0,0,0,15,15,0,0,0,0,0,0,0,137,75,62,0,,72,0,72,56,2,54
25/09/2022 18:00,19,6,13,34,18,16,40,22,18,0,0,0,7,7,0,0,0,0,0,0,0,143,75,68,0,,89,1,88,70,0,70
25/09/2022 19:00,8,4,4,22,10,12,13,8,5,0,0,0,6,6,0,0,0,0,0,0,0,103,55,48,0,,68,1,67,63,0,63
25/09/2022 20:00,8,3,5,14,7,7,28,10,18,0,0,0,4,4,0,0,0,0,0,0,0,75,37,38,0,,46,0,46,55,1,54
25/09/2022 21:00,5,3,2,5,3,2,8,4,4,0,0,0,2,2,0,0,0,0,0,0,0,58,26,32,0,,28,0,28,35,0,35
25/09/2022 22:00,3,2,1,5,2,3,6,2,4,0,0,0,3,3,0,0,0,0,0,0,0,40,27,13,0,,3,0,3,24,0,24
25/09/2022 23:00,2,1,1,2,2,0,5,1,4,0,0,0,1,1,0,0,0,0,0,0,0,16,11,5,0,,0,0,0,19,1,18
26/09/2022 00:00,3,0,3,0,0,0,3,0,3,0,0,0,3,3,0,0,0,0,0,0,0,15,12,3,0,,6,0,6,9,0,9
26/09/2022 01:00,2,0,2,0,0,0,0,0,0,0,0,0,0,0,0,0,0,0,0,0,0,3,3,0,0,,3,0,3,1,0,1
26/09/2022 02:00,0,0,0,0,0,0,0,0,0,0,0,0,0,0,0,0,0,0,0,0,0,4,2,2,0,,7,0,7,4,0,4
26/09/2022 03:00,0,0,0,0,0,0,0,0,0,0,0,0,0,0,0,0,0,0,0,0,0,3,0,3,0,,3,0,3,0,0,0
26/09/2022 04:00,0,0,0,1,0,1,2,0,2,0,0,0,1,1,0,0,0,0,0,0,0,5,2,3,0,,1,0,1,4,0,4
26/09/2022 05:00,3,3,0,9,7,2,13,9,4,0,0,0,4,4,0,0,0,0,0,0,0,40,8,32,0,,4,0,4,2,0,2
26/09/2022 06:00,20,19,1,13,10,3,24,14,10,0,0,0,30,30,0,0,0,0,0,0,0,139,24,115,0,,9,0,9,34,0,34
26/09/2022 07:00,45,40,5,56,46,10,60,46,14,0,0,0,63,63,0,0,0,0,0,0,0,290,59,231,0,,44,0,44,85,0,85
26/09/2022 08:00,101,92,9,86,66,20,123,91,32,0,0,0,108,107,1,0,0,0,0,0,0,548,109,439,0,,67,0,67,192,2,190
26/09/2022 09:00,50,44,6,47,33,14,54,42,12,0,0,0,41,41,0,0,0,0,0,0,0,223,47,176,0,,44,1,43,115,0,115
26/09/2022 10:00,18,13,5,37,18,19,39,18,21,0,0,0,15,15,0,0,0,0,0,0,0,96,25,71,0,,35,0,35,69,0,69
26/09/2022 11:00,12,8,4,42,17,25,59,27,32,0,0,0,11,11,0,0,0,0,0,0,0,88,29,59,0,,36,1,35,73,0,73
26/09/2022 12:00,19,14,5,44,21,23,55,22,33,0,0,0,12,11,1,0,0,0,0,0,0,97,38,59,0,,55,0,55,93,0,93
26/09/2022 13:00,14,9,5,25,12,13,59,25,34,0,0,0,10,9,1,0,0,0,0,0,0,119,56,63,0,,91,0,91,102,0,102
26/09/2022 14:00,16,5,11,38,16,22,42,21,21,0,0,0,14,14,0,0,0,0,0,0,0,120,55,65,0,,84,0,84,73,0,73
26/09/2022 15:00,24,10,14,33,11,22,38,15,23,0,0,0,22,21,1,0,0,0,0,0,0,137,83,54,0,,70,1,69,69,0,69
26/09/2022 16:00,46,13,33,40,15,25,55,12,43,0,0,0,8,8,0,0,0,0,0,0,0,234,139,95,0,,135,0,135,78,0,78
26/09/2022 17:00,75,16,59,90,22,68,108,26,82,0,0,0,13,13,0,0,0,0,0,0,0,426,291,135,0,,260,1,259,136,0,136
26/09/2022 18:00,62,17,45,82,21,61,122,30,92,0,0,0,24,24,0,0,0,0,0,0,0,316,196,120,0,,208,0,208,121,0,121
26/09/2022 19:00,27,9,18,37,7,30,53,14,39,0,0,0,13,13,0,0,0,0,0,0,0,206,128,78,0,,140,0,140,91,0,91
26/09/2022 20:00,15,2,13,25,11,14,38,17,21,0,0,0,7,7,0,0,0,0,0,0,0,104,70,34,0,,93,0,93,72,0,72
26/09/2022 21:00,8,1,7,12,4,8,14,6,8,0,0,0,2,2,0,0,0,0,0,0,0,78,56,22,0,,63,1,62,47,0,47
26/09/2022 22:00,7,4,3,4,3,1,10,4,6,0,0,0,6,6,0,0,0,0,0,0,0,52,37,15,0,,59,3,56,31,1,30
26/09/2022 23:00,2,0,2,2,1,1,4,2,2,0,0,0,1,1,0,0,0,0,0,0,0,31,25,6,0,,26,0,26,14,0,14
27/09/2022 00:00,1,0,1,4,4,0,5,3,2,0,0,0,1,1,0,0,0,0,0,0,0,14,13,1,0,,12,0,12,5,0,5
27/09/2022 01:00,0,0,0,0,0,0,0,0,0,0,0,0,2,2,0,0,0,0,0,0,0,5,5,0,0,,0,0,0,0,0,0
27/09/2022 02:00,0,0,0,0,0,0,0,0,0,0,0,0,0,0,0,0,0,0,0,0,0,0,0,0,0,,4,0,4,0,0,0
27/09/2022 03:00,1,0,1,0,0,0,0,0,0,0,0,0,0,0,0,0,0,0,0,0,0,2,1,1,0,,3,0,3,0,0,0
27/09/2022 04:00,2,2,0,1,1,0,3,1,2,0,0,0,1,1,0,0,0,0,0,0,0,6,0,6,0,,0,0,0,1,0,1
27/09/2022 05:00,8,5,3,5,4,1,7,6,1,0,0,0,8,8,0,0,0,0,0,0,0,40,8,32,0,,5,0,5,4,0,4
27/09/2022 06:00,28,24,4,23,18,5,26,18,8,0,0,0,23,23,0,0,0,0,0,0,0,149,22,127,0,,11,0,11,38,1,37
27/09/2022 07:00,56,52,4,63,50,13,74,59,15,0,0,0,49,49,0,0,0,0,0,0,0,369,77,292,0,,43,0,43,93,0,93
27/09/2022 08:00,137,118,19,114,89,25,150,116,34,0,0,0,83,82,1,0,0,0,0,0,0,722,108,614,0,,70,1,69,276,0,276
27/09/2022 09:00,50,40,10,45,28,17,54,40,14,0,0,0,26,26,0,0,0,0,0,0,0,288,42,246,0,,35,0,35,117,0,117
27/09/2022 10:00,14,12,2,39,20,19,45,24,21,0,0,0,24,23,1,0,0,0,0,0,0,106,22,84,0,,38,0,38,74,0,74
27/09/2022 11:00,12,8,4,32,17,15,58,21,37,0,0,0,11,11,0,0,0,0,0,0,0,89,33,56,0,,53,1,52,77,0,77
27/09/2022 12:00,14,12,2,44,21,23,46,20,26,0,0,0,9,9,0,0,0,0,0,0,0,100,41,59,0,,61,1,60,97,2,95
27/09/2022 13:00,14,8,6,18,8,10,38,16,22,0,0,0,5,4,1,0,0,0,0,0,0,121,54,67,0,,91,1,90,116,0,116
27/09/2022 14:00,17,7,10,29,17,12,36,20,16,0,0,0,13,13,0,0,0,0,0,0,0,109,51,58,0,,75,1,74,75,0,75
27/09/2022 15:00,33,13,20,26,12,14,40,14,26,0,0,0,9,9,0,0,0,0,0,0,0,156,87,69,0,,85,1,84,80,3,77
27/09/2022 16:00,47,17,30,53,11,42,71,17,54,0,0,0,18,18,0,0,0,0,0,0,0,239,146,93,0,,144,2,142,91,0,91
27/09/2022 17:00,87,18,69,90,22,68,130,28,102,0,0,0,12,11,1,0,0,0,0,0,0,514,357,157,0,,300,2,298,140,0,140
27/09/2022 18:00,57,14,43,100,22,78,136,27,109,0,0,0,13,13,0,0,0,0,0,0,0,404,248,156,0,,211,0,211,125,1,124
27/09/2022 19:00,36,13,23,58,26,32,63,20,43,0,0,0,12,12,0,0,0,0,0,0,0,208,126,82,0,,121,0,121,93,1,92
27/09/2022 20:00,16,8,8,29,11,18,36,14,22,0,0,0,8,8,0,0,0,0,0,0,0,140,90,50,0,,86,0,86,75,0,75
27/09/2022 21:00,9,3,6,22,12,10,31,10,21,0,0,0,5,5,0,0,0,0,0,0,0,101,70,31,0,,68,1,67,40,0,40
27/09/2022 22:00,14,4,10,3,0,3,6,2,4,0,0,0,11,11,0,0,0,0,0,0,0,132,88,44,0,,10,0,10,34,0,34
27/09/2022 23:00,7,1,6,4,0,4,9,3,6,0,0,0,5,5,0,0,0,0,0,0,0,45,37,8,0,,1,0,1,23,0,23
28/09/2022 00:00,7,1,6,1,0,1,8,2,6,0,0,0,3,3,0,0,0,0,0,0,0,22,21,1,0,,1,0,1,5,0,5
28/09/2022 01:00,0,0,0,1,1,0,0,0,0,0,0,0,2,2,0,0,0,0,0,0,0,6,6,0,0,,3,1,2,0,0,0
28/09/2022 02:00,0,0,0,0,0,0,1,0,1,0,0,0,0,0,0,0,0,0,0,0,0,1,1,0,0,,10,0,10,1,0,1
28/09/2022 03:00,1,0,1,0,0,0,0,0,0,0,0,0,0,0,0,0,0,0,0,0,0,6,4,2,0,,3,0,3,0,0,0
28/09/2022 04:00,1,1,0,1,1,0,2,1,1,0,0,0,2,2,0,0,0,0,0,0,0,3,0,3,0,,1,0,1,2,0,2
28/09/2022 05:00,4,2,2,9,7,2,9,6,3,0,0,0,3,3,0,0,0,0,0,0,0,33,8,25,0,,4,0,4,6,0,6
28/09/2022 06:00,22,19,3,30,19,11,37,25,12,0,0,0,27,27,0,0,0,0,0,0,0,141,28,113,0,,8,0,8,39,0,39
28/09/2022 07:00,66,61,5,74,56,18,79,68,11,0,0,0,64,64,0,0,0,0,0,0,0,365,86,279,0,,43,3,40,94,1,93
28/09/2022 08:00,143,122,21,108,87,21,138,114,24,0,0,0,119,119,0,0,0,0,0,0,0,727,111,616,0,,74,0,74,289,0,289
28/09/2022 09:00,45,41,4,59,34,25,84,53,31,0,0,0,37,37,0,0,0,0,0,0,0,273,52,221,0,,45,0,45,178,0,178
28/09/2022 10:00,19,16,3,44,25,19,46,27,19,0,0,0,13,13,0,0,0,0,0,0,0,95,21,74,0,,39,0,39,68,1,67
28/09/2022 11:00,12,7,5,58,30,28,102,66,36,0,0,0,12,12,0,0,0,0,0,0,0,112,39,73,0,,43,0,43,73,0,73
28/09/2022 12:00,16,7,9,47,24,23,60,27,33,0,0,0,15,15,0,0,0,0,0,0,0,107,38,69,0,,60,0,60,94,1,93
28/09/2022 13:00,16,11,5,33,21,12,46,22,24,0,0,0,9,9,0,0,0,0,0,0,0,170,97,73,0,,95,1,94,83,0,83
28/09/2022 14:00,19,12,7,31,10,21,45,22,23,0,0,0,4,4,0,0,0,0,0,0,0,113,51,62,0,,79,0,79,46,0,46
28/09/2022 15:00,23,12,11,31,8,23,48,16,32,0,0,0,8,8,0,0,0,0,0,0,0,165,91,74,0,,89,0,89,65,0,65
28/09/2022 16:00,50,18,32,53,17,36,70,21,49,0,0,0,12,12,0,0,0,0,0,0,0,220,133,87,0,,125,0,125,82,0,82
28/09/2022 17:00,71,25,46,94,20,74,148,28,120,0,0,0,12,12,0,0,0,0,0,0,0,449,317,132,0,,277,0,277,134,1,133
28/09/2022 18:00,63,17,46,110,28,82,132,27,105,0,0,0,6,6,0,0,0,0,0,0,0,368,242,126,0,,205,1,204,129,1,128
28/09/2022 19:00,46,12,34,60,20,40,90,35,55,0,0,0,3,3,0,0,0,0,0,0,0,229,138,91,0,,116,1,115,98,1,97
28/09/2022 20:00,15,10,5,35,16,19,47,19,28,0,0,0,6,6,0,0,0,0,0,0,0,142,104,38,0,,105,0,105,110,1,109
28/09/2022 21:00,11,4,7,16,9,7,23,11,12,0,0,0,7,7,0,0,0,0,0,0,0,115,70,45,0,,62,1,61,62,1,61
28/09/2022 22:00,6,2,4,4,2,2,11,4,7,0,0,0,4,4,0,0,0,0,0,0,0,84,61,23,0,,50,0,50,40,0,40
28/09/2022 23:00,7,3,4,8,3,5,11,2,9,0,0,0,3,3,0,0,0,0,0,0,0,46,35,11,0,,40,0,40,22,0,22
29/09/2022 00:00,1,1,0,1,0,1,4,1,3,0,0,0,3,3,0,0,0,0,0,0,0,27,20,7,0,,34,0,34,7,0,7
29/09/2022 01:00,2,1,1,2,1,1,1,1,0,0,0,0,0,0,0,0,0,0,0,0,0,4,2,2,0,,4,0,4,0,0,0
29/09/2022 02:00,2,1,1,0,0,0,2,1,1,0,0,0,0,0,0,0,0,0,0,0,0,4,2,2,0,,7,0,7,3,0,3
29/09/2022 03:00,0,0,0,0,0,0,0,0,0,0,0,0,0,0,0,0,0,0,0,0,0,4,2,2,0,,7,0,7,2,0,2
29/09/2022 04:00,4,2,2,2,1,1,2,0,2,0,0,0,1,1,0,0,0,0,0,0,0,6,2,4,0,,1,0,1,2,0,2
29/09/2022 05:00,4,4,0,6,5,1,10,5,5,0,0,0,4,4,0,0,0,0,0,0,0,38,7,31,0,,3,0,3,6,0,6
29/09/2022 06:00,22,20,2,19,16,3,32,24,8,0,0,0,18,18,0,0,0,0,0,0,0,133,24,109,0,,7,0,7,38,0,38
29/09/2022 07:00,45,41,4,67,48,19,79,62,17,0,0,0,49,47,2,0,0,0,0,0,0,301,51,250,0,,47,2,45,87,1,86
29/09/2022 08:00,126,110,16,107,88,19,140,116,24,0,0,0,86,86,0,0,0,0,0,0,0,670,103,567,0,,68,1,67,220,0,220
29/09/2022 09:00,48,41,7,36,24,12,62,45,17,0,0,0,31,30,1,0,0,0,0,0,0,288,51,237,0,,39,0,39,142,0,142
29/09/2022 10:00,19,16,3,49,22,27,52,24,28,0,0,0,16,16,0,0,0,0,0,0,0,88,19,69,0,,27,1,26,76,0,76
29/09/2022 11:00,17,12,5,54,29,25,60,31,29,0,0,0,24,24,0,0,0,0,0,0,0,81,34,47,0,,49,1,48,67,0,67
29/09/2022 12:00,18,9,9,36,18,18,61,29,32,0,0,0,10,10,0,0,0,0,0,0,0,105,34,71,0,,48,1,47,103,0,103
29/09/2022 13:00,27,16,11,41,18,23,68,30,38,0,0,0,6,6,0,0,0,0,0,0,0,133,65,68,0,,78,0,78,109,0,109
29/09/2022 14:00,9,4,5,47,23,24,60,30,30,0,0,0,12,12,0,0,0,0,0,0,0,113,57,56,0,,75,0,75,88,1,87
29/09/2022 15:00,28,15,13,57,25,32,62,28,34,0,0,0,16,15,1,0,0,0,0,0,0,172,84,88,0,,76,0,76,63,1,62
29/09/2022 16:00,43,21,22,74,29,45,128,47,81,0,0,0,22,22,0,0,0,0,0,0,0,240,146,94,0,,145,0,145,72,0,72
29/09/2022 17:00,79,27,52,120,38,82,163,43,120,0,0,0,19,19,0,0,0,0,0,0,0,445,317,128,0,,225,0,225,155,0,155
29/09/2022 18:00,46,9,37,120,42,78,177,45,132,0,0,0,24,23,1,0,0,0,0,0,0,357,238,119,0,,177,0,177,130,2,128
29/09/2022 19:00,27,10,17,66,33,33,79,39,40,0,0,0,20,20,0,0,0,0,0,0,0,227,144,83,0,,126,0,126,103,0,103
29/09/2022 20:00,14,3,11,37,10,27,54,19,35,0,0,0,4,4,0,0,0,0,0,0,0,174,99,75,0,,111,0,111,110,1,109
29/09/2022 21:00,10,7,3,17,5,12,30,10,20,0,0,0,1,1,0,0,0,0,0,0,0,107,74,33,0,,102,2,100,75,1,74
29/09/2022 22:00,3,2,1,9,5,4,13,1,12,0,0,0,1,1,0,0,0,0,0,0,0,94,68,26,0,,75,1,74,46,0,46
29/09/2022 23:00,2,1,1,9,5,4,15,4,11,0,0,0,2,2,0,0,0,0,0,0,0,54,43,11,0,,53,0,53,21,1,20
30/09/2022 00:00,3,1,2,3,0,3,3,0,3,0,0,0,2,2,0,0,0,0,0,0,0,29,26,3,0,,40,1,39,7,0,7
30/09/2022 01:00,3,1,2,1,1,0,0,0,0,0,0,0,1,1,0,0,0,0,0,0,0,14,12,2,0,,6,0,6,2,0,2
30/09/2022 02:00,1,0,1,1,0,1,4,1,3,0,0,0,0,0,0,0,0,0,0,0,0,9,9,0,0,,16,0,16,2,0,2
30/09/2022 03:00,0,0,0,1,0,1,1,0,1,0,0,0,0,0,0,0,0,0,0,0,0,6,4,2,0,,7,0,7,4,0,4
30/09/2022 04:00,3,2,1,3,1,2,4,0,4,0,0,0,0,0,0,0,0,0,0,0,0,6,5,1,0,,5,0,5,2,0,2
30/09/2022 05:00,6,5,1,4,3,1,6,4,2,0,0,0,3,3,0,0,0,0,0,0,0,30,5,25,0,,6,0,6,3,0,3
30/09/2022 06:00,20,16,4,9,8,1,17,15,2,0,0,0,15,15,0,0,0,0,0,0,0,123,15,108,0,,8,0,8,31,0,31
30/09/2022 07:00,26,23,3,23,18,5,30,23,7,0,0,0,35,35,0,0,0,0,0,0,0,205,44,161,0,,19,0,19,44,2,42
30/09/2022 08:00,57,48,9,32,23,9,41,28,13,0,0,0,38,38,0,0,0,0,0,0,0,336,66,270,0,,36,0,36,127,0,127
30/09/2022 09:00,28,22,6,7,5,2,17,12,5,0,0,0,14,14,0,0,0,0,0,0,0,147,29,118,0,,33,0,33,70,0,70
30/09/2022 10:00,7,6,1,1,0,1,7,2,5,0,0,0,11,11,0,0,0,0,0,0,0,48,16,32,0,,29,0,29,35,0,35
30/09/2022 11:00,4,2,2,6,4,2,15,8,7,0,0,0,10,9,1,0,0,0,0,0,0,69,27,42,0,,21,0,21,42,0,42
30/09/2022 12:00,12,8,4,4,2,2,5,1,4,0,0,0,6,6,0,0,0,0,0,0,0,77,32,45,0,,54,0,54,56,0,56
30/09/2022 13:00,16,10,6,8,5,3,10,5,5,0,0,0,7,7,0,0,0,0,0,0,0,118,62,56,0,,67,0,67,70,0,70
30/09/2022 14:00,14,7,7,66,26,40,69,22,47,0,0,0,4,4,0,0,0,0,0,0,0,129,68,61,0,,56,0,56,96,0,96
30/09/2022 15:00,25,8,17,44,22,22,52,20,32,0,0,0,8,8,0,0,0,0,0,0,0,151,74,77,0,,70,0,70,78,0,78
30/09/2022 16:00,21,8,13,80,38,42,105,52,53,0,0,0,4,4,0,0,0,0,0,0,0,194,113,81,0,,100,2,98,78,0,78
30/09/2022 17:00,38,9,29,52,22,30,77,29,48,0,0,0,12,12,0,0,0,0,0,0,0,255,160,95,0,,147,1,146,118,0,118
30/09/2022 18:00,37,18,19,40,15,25,61,20,41,0,0,0,8,8,0,0,0,0,0,0,0,222,126,96,0,,111,0,111,107,1,106
30/09/2022 19:00,11,5,6,23,9,14,38,14,24,0,0,0,15,15,0,0,0,0,0,0,0,156,75,81,0,,103,0,103,101,0,101
30/09/2022 20:00,11,4,7,6,4,2,12,6,6,0,0,0,7,7,0,0,0,0,0,0,0,106,55,51,0,,55,0,55,83,0,83
30/09/2022 21:00,2,2,0,6,3,3,7,3,4,0,0,0,3,3,0,0,0,0,0,0,0,64,36,28,0,,31,0,31,55,0,55
30/09/2022 22:00,6,3,3,9,1,8,9,0,9,0,0,0,4,4,0,0,0,0,0,0,0,64,45,19,0,,50,2,48,37,0,37
30/09/2022 23:00,2,1,1,3,1,2,6,1,5,0,0,0,3,3,0,0,0,0,0,0,0,50,33,17,0,,39,0,39,30,0,30
01/10/2022 00:00,3,1,2,3,0,3,4,0,4,0,0,0,3,3,0,0,0,0,0,0,0,35,24,11,0,,47,1,46,16,0,16
01/10/2022 01:00,0,0,0,5,2,3,5,2,3,0,0,0,2,2,0,0,0,0,0,0,0,24,16,8,0,,12,0,12,0,0,0
01/10/2022 02:00,0,0,0,0,0,0,1,0,1,0,0,0,1,1,0,0,0,0,0,0,0,15,8,7,0,,24,0,24,9,0,9
01/10/2022 03:00,1,0,1,0,0,0,0,0,0,0,0,0,0,0,0,0,0,0,0,0,0,13,11,2,0,,18,0,18,3,0,3
01/10/2022 04:00,0,0,0,0,0,0,0,0,0,0,0,0,1,1,0,0,0,0,0,0,0,6,3,3,0,,12,0,12,3,0,3
01/10/2022 05:00,0,0,0,2,0,2,4,2,2,0,0,0,2,2,0,0,0,0,0,0,0,9,6,3,0,,3,0,3,6,0,6
01/10/2022 06:00,4,2,2,4,1,3,4,2,2,0,0,0,4,4,0,0,0,0,0,0,0,42,8,34,0,,7,0,7,8,0,8
01/10/2022 07:00,8,7,1,14,7,7,24,9,15,0,0,0,14,14,0,0,0,0,0,0,0,55,11,44,0,,7,0,7,11,0,11
01/10/2022 08:00,6,6,0,43,22,21,40,21,19,0,0,0,14,14,0,0,0,0,0,0,0,74,30,44,0,,19,0,19,43,0,43
01/10/2022 09:00,13,11,2,76,33,43,85,37,48,0,0,0,10,10,0,0,0,0,0,0,0,79,21,58,0,,27,1,26,73,0,73
01/10/2022 10:00,18,11,7,72,31,41,80,33,47,0,0,0,7,7,0,0,0,0,0,0,0,103,33,70,0,,43,1,42,67,2,65
01/10/2022 11:00,21,10,11,78,33,45,102,41,61,0,0,0,1,1,0,0,0,0,0,0,0,120,33,87,0,,23,0,23,95,0,95
01/10/2022 12:00,19,4,15,70,32,38,90,40,50,0,0,0,4,4,0,0,0,0,0,0,0,113,39,74,0,,64,0,64,83,1,82
01/10/2022 13:00,14,10,4,71,34,37,94,36,58,0,0,0,6,6,0,0,0,0,0,0,0,118,46,72,0,,65,0,65,88,1,87
01/10/2022 14:00,21,9,12,68,26,42,105,49,56,0,0,0,14,14,0,0,0,0,0,0,0,120,42,78,0,,66,0,66,104,0,104
01/10/2022 15:00,23,15,8,86,57,29,137,76,61,0,0,0,20,20,0,0,0,0,0,0,0,99,42,57,0,,83,1,82,109,0,109
01/10/2022 16:00,19,6,13,61,29,32,92,37,55,0,0,0,15,14,1,0,0,0,0,0,0,137,61,76,0,,80,1,79,96,1,95
01/10/2022 17:00,15,7,8,67,35,32,109,48,61,0,0,0,9,9,0,0,0,0,0,0,0,105,50,55,0,,94,0,94,73,1,72
01/10/2022 18:00,18,9,9,49,27,22,74,38,36,0,0,0,9,9,0,0,0,0,0,0,0,131,62,69,0,,94,0,94,84,1,83
01/10/2022 19:00,12,6,6,25,15,10,43,21,22,0,0,0,15,15,0,0,0,0,0,0,0,106,47,59,0,,88,0,88,96,0,96
01/10/2022 20:00,10,3,7,10,7,3,27,12,15,0,0,0,3,3,0,0,0,0,0,0,0,81,41,40,0,,61,1,60,65,0,65
01/10/2022 21:00,6,4,2,10,4,6,12,5,7,0,0,0,5,5,0,0,0,0,0,0,0,56,25,31,0,,58,0,58,66,1,65
01/10/2022 22:00,8,7,1,5,0,5,13,6,7,0,0,0,3,3,0,0,0,0,0,0,0,57,35,22,0,,41,2,39,42,1,41
01/10/2022 23:00,3,1,2,4,3,1,10,5,5,0,0,0,2,2,0,0,0,0,0,0,0,47,30,17,0,,36,0,36,35,1,34
02/10/2022 00:00,0,0,0,3,1,2,8,5,3,0,0,0,4,4,0,0,0,0,0,0,0,34,23,11,0,,23,0,23,19,0,19
02/10/2022 01:00,1,0,1,3,2,1,5,2,3,0,0,0,0,0,0,0,0,0,0,0,0,17,10,7,0,,14,1,13,2,0,2
02/10/2022 02:00,1,1,0,1,1,0,6,1,5,0,0,0,3,3,0,0,0,0,0,0,0,16,12,4,0,,20,0,20,4,0,4
02/10/2022 03:00,4,1,3,4,2,2,1,0,1,0,0,0,0,0,0,0,0,0,0,0,0,15,11,4,0,,19,0,19,3,0,3
02/10/2022 04:00,0,0,0,1,0,1,3,1,2,0,0,0,0,0,0,0,0,0,0,0,0,7,6,1,0,,13,1,12,4,0,4
02/10/2022 05:00,1,0,1,1,0,1,1,0,1,0,0,0,0,0,0,0,0,0,0,0,0,8,5,3,0,,5,0,5,6,0,6
02/10/2022 06:00,4,4,0,4,3,1,7,5,2,0,0,0,3,3,0,0,0,0,0,0,0,23,7,16,0,,4,0,4,8,0,8
02/10/2022 07:00,4,4,0,25,9,16,28,7,21,0,0,0,13,13,0,0,0,0,0,0,0,44,11,33,0,,8,0,8,10,0,10
02/10/2022 08:00,5,4,1,56,20,36,60,21,39,0,0,0,7,7,0,0,0,0,0,0,0,59,22,37,0,,6,0,6,18,0,18
02/10/2022 09:00,8,4,4,120,53,67,123,55,68,0,0,0,8,8,0,0,0,0,0,0,0,68,26,42,0,,19,0,19,30,1,29
02/10/2022 10:00,10,4,6,149,56,93,167,54,113,0,0,0,11,11,0,0,0,0,0,0,0,98,32,66,0,,22,0,22,49,0,49
02/10/2022 11:00,21,6,15,172,76,96,204,79,125,0,0,0,11,11,0,0,0,0,0,0,0,96,29,67,0,,51,0,51,70,0,70
02/10/2022 12:00,11,7,4,174,95,79,239,125,114,0,0,0,8,8,0,0,0,0,0,0,0,130,42,88,0,,64,1,63,87,1,86
02/10/2022 13:00,9,5,4,143,75,68,182,95,87,0,0,0,4,4,0,0,0,0,0,0,0,117,48,69,0,,53,0,53,96,0,96
02/10/2022 14:00,14,7,7,109,63,46,145,78,67,0,0,0,11,11,0,0,0,0,0,0,0,115,48,67,0,,69,0,69,83,0,83
02/10/2022 15:00,11,8,3,112,64,48,127,65,62,0,0,0,17,17,0,0,0,0,0,0,0,81,39,42,0,,72,1,71,85,0,85
02/10/2022 16:00,15,10,5,75,37,38,122,54,68,0,0,0,13,13,0,0,0,0,0,0,0,110,56,54,0,,71,3,68,84,1,83
02/10/2022 17:00,9,6,3,72,38,34,108,61,47,0,0,0,8,8,0,0,0,0,0,0,0,97,52,45,0,,72,0,72,84,0,84
02/10/2022 18:00,11,5,6,43,27,16,77,44,33,0,0,0,15,15,0,0,0,0,0,0,0,91,43,48,0,,76,0,76,90,0,90
02/10/2022 19:00,21,12,9,34,18,16,48,24,24,0,0,0,2,2,0,0,0,0,0,0,0,110,60,50,0,,60,0,60,88,0,88
02/10/2022 20:00,8,3,5,15,11,4,18,11,7,0,0,0,2,2,0,0,0,0,0,0,0,81,43,38,0,,43,0,43,68,0,68
02/10/2022 21:00,8,1,7,11,5,6,7,3,4,0,0,0,10,10,0,0,0,0,0,0,0,56,30,26,0,,25,1,24,59,0,59
02/10/2022 22:00,0,0,0,6,3,3,12,3,9,0,0,0,8,7,1,0,0,0,0,0,0,33,17,16,0,,3,0,3,33,0,33
02/10/2022 23:00,2,2,0,5,4,1,6,0,6,0,0,0,1,1,0,0,0,0,0,0,0,27,21,6,0,,0,0,0,20,0,20
03/10/2022 00:00,1,0,1,2,0,2,1,1,0,0,0,0,2,2,0,0,0,0,0,0,0,22,17,5,0,,8,0,8,8,0,8
03/10/2022 01:00,2,0,2,1,1,0,0,0,0,0,0,0,0,0,0,0,0,0,0,0,0,5,4,1,0,,3,0,3,0,0,0
03/10/2022 02:00,1,1,0,0,0,0,0,0,0,0,0,0,1,1,0,0,0,0,0,0,0,11,5,6,0,,11,1,10,1,0,1
03/10/2022 03:00,0,0,0,0,0,0,0,0,0,0,0,0,0,0,0,0,0,0,0,0,0,4,2,2,0,,5,0,5,0,0,0
03/10/2022 04:00,2,2,0,2,1,1,3,1,2,0,0,0,3,3,0,0,0,0,0,0,0,5,0,5,0,,0,0,0,1,0,1
03/10/2022 05:00,5,4,1,7,6,1,12,8,4,0,0,0,4,4,0,0,0,0,0,0,0,36,6,30,0,,5,0,5,9,0,9
03/10/2022 06:00,18,17,1,35,26,9,36,22,14,0,0,0,27,27,0,0,0,0,0,0,0,148,19,129,0,,9,0,9,32,0,32
03/10/2022 07:00,49,40,9,65,51,14,74,55,19,0,0,0,77,75,2,0,0,0,0,0,0,283,63,220,0,,37,3,34,79,0,79
03/10/2022 08:00,115,98,17,98,83,15,112,92,20,0,0,0,118,118,0,0,0,0,0,0,0,578,106,472,0,,63,1,62,211,0,211
03/10/2022 09:00,49,47,2,45,28,17,61,43,18,0,0,0,41,40,1,0,0,0,0,0,0,248,42,206,0,,42,0,42,145,0,145
03/10/2022 10:00,12,9,3,52,24,28,59,27,32,0,0,0,17,17,0,0,0,0,0,0,0,84,25,59,0,,36,2,34,72,0,72
03/10/2022 11:00,10,6,4,44,23,21,39,16,23,0,0,0,10,10,0,0,0,0,0,0,0,101,28,73,0,,34,0,34,79,1,78
03/10/2022 12:00,26,17,9,47,24,23,60,29,31,0,0,0,18,18,0,0,0,0,0,0,0,108,46,62,0,,75,0,75,101,0,101
03/10/2022 13:00,19,11,8,49,19,30,78,33,45,0,0,0,6,6,0,0,0,0,0,0,0,138,61,77,0,,86,0,86,93,2,91
03/10/2022 14:00,17,11,6,35,18,17,58,23,35,0,0,0,5,5,0,0,0,0,12,12,0,137,64,73,0,,63,0,63,75,0,75
03/10/2022 15:00,27,12,15,32,14,18,49,15,34,0,0,0,14,14,0,0,0,0,8,8,0,185,115,70,0,,101,0,101,91,1,90
03/10/2022 16:00,46,14,32,55,19,36,74,25,49,0,0,0,16,16,0,0,0,0,16,16,0,252,156,96,0,,154,1,153,108,1,107
03/10/2022 17:00,67,19,48,96,25,71,133,31,102,0,0,0,14,13,1,0,0,0,30,30,0,433,293,140,0,,237,2,235,145,1,144
03/10/2022 18:00,54,22,32,100,34,66,144,45,99,0,0,0,12,12,0,0,0,0,10,10,0,349,237,112,0,,214,0,214,121,1,120
03/10/2022 19:00,36,22,14,57,21,36,77,23,54,0,0,0,7,7,0,0,0,0,10,10,0,207,126,81,0,,128,1,127,112,1,111
03/10/2022 20:00,14,4,10,20,6,14,29,11,18,0,0,0,8,7,1,0,0,0,5,5,0,110,79,31,0,,75,0,75,71,1,70
03/10/2022 21:00,9,2,7,9,5,4,17,8,9,0,0,0,6,6,0,0,0,0,7,7,0,80,52,28,0,,79,1,78,52,0,52
03/10/2022 22:00,6,4,2,8,3,5,15,6,9,0,0,0,9,9,0,0,0,0,4,4,0,43,29,14,0,,48,0,48,39,0,39
03/10/2022 23:00,5,2,3,4,2,2,3,0,3,0,0,0,6,5,1,0,0,0,4,4,0,32,25,7,0,,23,0,23,19,0,19
04/10/2022 00:00,2,1,1,0,0,0,1,0,1,0,0,0,1,1,0,0,0,0,1,1,0,20,14,6,0,,14,0,14,4,0,4
04/10/2022 01:00,1,1,0,0,0,0,0,0,0,0,0,0,0,0,0,0,0,0,0,0,0,2,2,0,0,,1,0,1,0,0,0
04/10/2022 02:00,0,0,0,0,0,0,1,0,1,0,0,0,2,2,0,0,0,0,0,0,0,2,2,0,0,,9,0,9,1,0,1
04/10/2022 03:00,1,1,0,0,0,0,2,0,2,0,0,0,0,0,0,0,0,0,1,1,0,1,0,1,0,,2,0,2,0,0,0
04/10/2022 04:00,2,2,0,2,2,0,2,0,2,0,0,0,2,2,0,0,0,0,1,1,0,5,0,5,0,,1,0,1,1,0,1
04/10/2022 05:00,6,5,1,5,4,1,9,7,2,0,0,0,7,7,0,0,0,0,1,1,0,35,8,27,0,,7,0,7,8,0,8
04/10/2022 06:00,22,19,3,19,16,3,31,20,11,0,0,0,31,31,0,0,0,0,5,5,0,146,25,121,0,,11,0,11,41,0,41
04/10/2022 07:00,47,45,2,44,39,5,72,58,14,0,0,0,43,43,0,0,0,0,17,17,0,301,50,251,0,,31,0,31,84,0,84
04/10/2022 08:00,106,101,5,85,65,20,106,80,26,0,0,0,84,84,0,0,0,0,118,118,0,690,108,582,0,,62,0,62,232,0,232
04/10/2022 09:00,52,43,9,32,18,14,45,32,13,0,0,0,43,43,0,0,0,0,15,15,0,275,45,230,0,,46,1,45,145,0,145
04/10/2022 10:00,16,8,8,22,11,11,32,18,14,0,0,0,14,14,0,0,0,0,10,10,0,94,23,71,0,,35,1,34,78,3,75
04/10/2022 11:00,11,8,3,16,8,8,24,11,13,0,0,0,14,14,0,0,0,0,6,6,0,93,24,69,0,,37,0,37,76,2,74
04/10/2022 12:00,7,5,2,28,17,11,32,13,19,0,0,0,4,3,1,0,0,0,6,6,0,104,47,57,0,,49,0,49,102,0,102
04/10/2022 13:00,9,4,5,33,10,23,44,10,34,0,0,0,3,3,0,0,0,0,8,8,0,130,70,60,0,,91,0,91,98,1,97
04/10/2022 14:00,17,9,8,37,12,25,46,15,31,0,0,0,9,9,0,0,0,0,5,5,0,110,52,58,0,,81,0,81,75,0,75
04/10/2022 15:00,23,12,11,32,13,19,30,9,21,0,0,0,9,9,0,0,0,0,12,12,0,146,85,61,0,,74,0,74,68,0,68
04/10/2022 16:00,46,18,28,38,11,27,52,12,40,0,0,0,2,2,0,0,0,0,28,28,0,245,152,93,0,,128,0,128,92,1,91
04/10/2022 17:00,80,25,55,71,9,62,103,23,80,0,0,0,7,7,0,0,0,0,16,16,0,440,328,112,0,,229,1,228,114,1,113
04/10/2022 18:00,53,11,42,75,12,63,94,16,78,0,0,0,14,14,0,0,0,0,9,9,0,363,250,113,0,,188,0,188,116,1,115
04/10/2022 19:00,23,8,15,31,10,21,54,11,43,0,0,0,9,9,0,0,0,0,4,4,0,187,127,60,0,,120,1,119,74,0,74
04/10/2022 20:00,8,3,5,13,4,9,27,7,20,0,0,0,11,11,0,0,0,0,3,3,0,134,83,51,0,,86,1,85,84,0,84
04/10/2022 21:00,9,0,9,11,3,8,17,4,13,0,0,0,2,2,0,0,0,0,3,3,0,83,59,24,0,,64,1,63,47,0,47
04/10/2022 22:00,6,2,4,5,3,2,8,3,5,0,0,0,2,2,0,0,0,0,7,7,0,69,50,19,0,,13,0,13,43,0,43
04/10/2022 23:00,4,2,2,4,1,3,4,1,3,0,0,0,2,2,0,0,0,0,1,1,0,32,26,6,0,,2,0,2,19,0,19
05/10/2022 00:00,1,0,1,1,0,1,2,1,1,0,0,0,1,1,0,0,0,0,0,0,0,14,10,4,0,,0,0,0,10,0,10
05/10/2022 01:00,0,0,0,0,0,0,0,0,0,0,0,0,0,0,0,0,0,0,0,0,0,7,6,1,0,,2,0,2,0,0,0
05/10/2022 02:00,0,0,0,0,0,0,0,0,0,0,0,0,0,0,0,0,0,0,0,0,0,5,5,0,0,,6,0,6,2,0,2
05/10/2022 03:00,0,0,0,1,1,0,1,0,1,0,0,0,0,0,0,0,0,0,0,0,0,5,4,1,0,,3,0,3,0,0,0
05/10/2022 04:00,1,1,0,0,0,0,2,0,2,0,0,0,1,1,0,0,0,0,1,1,0,3,0,3,0,,0,0,0,2,0,2
05/10/2022 05:00,11,8,3,5,5,0,7,5,2,0,0,0,2,2,0,0,0,0,0,0,0,35,10,25,0,,1,0,1,9,0,9
05/10/2022 06:00,20,19,1,12,11,1,25,19,6,0,0,0,29,29,0,0,0,0,1,1,0,144,25,119,0,,16,0,16,37,0,37
05/10/2022 07:00,43,38,5,40,35,5,58,51,7,0,0,0,43,43,0,0,0,0,2,2,0,330,66,264,0,,35,1,34,76,0,76
05/10/2022 08:00,101,93,8,86,71,15,112,97,15,0,0,0,72,71,1,0,0,0,10,10,0,702,114,588,0,,60,1,59,215,1,214
05/10/2022 09:00,61,50,11,26,18,8,44,32,12,0,0,0,38,38,0,0,0,0,2,2,0,278,38,240,0,,47,1,46,172,0,172
05/10/2022 10:00,13,9,4,32,15,17,29,16,13,0,0,0,8,8,0,0,0,0,1,1,0,106,32,74,0,,34,0,34,60,0,60
05/10/2022 11:00,19,10,9,16,9,7,23,11,12,0,0,0,12,12,0,0,0,0,1,1,0,88,24,64,0,,41,2,39,63,0,63
05/10/2022 12:00,11,6,5,36,21,15,30,16,14,0,0,0,7,6,1,0,0,0,3,3,0,99,26,73,0,,53,0,53,83,1,82
05/10/2022 13:00,21,11,10,28,12,16,39,12,27,0,0,0,9,9,0,0,0,0,3,3,0,138,67,71,0,,81,0,81,89,0,89
05/10/2022 14:00,12,5,7,16,7,9,20,7,13,0,0,0,8,8,0,0,0,0,2,2,0,109,42,67,0,,59,0,59,54,0,54
05/10/2022 15:00,28,19,9,18,4,14,36,14,22,0,0,0,11,11,0,0,0,0,2,2,0,151,88,63,0,,79,2,77,66,1,65
05/10/2022 16:00,36,6,30,41,11,30,60,12,48,0,0,0,7,7,0,0,0,0,2,2,0,229,137,92,0,,109,0,109,71,0,71
05/10/2022 17:00,82,23,59,75,17,58,115,25,90,0,0,0,10,10,0,0,0,0,1,1,0,434,312,122,0,,213,1,212,105,2,103
05/10/2022 18:00,54,18,36,95,21,74,112,16,96,0,0,0,9,9,0,0,0,0,0,0,0,352,242,110,0,,208,2,206,129,2,127
05/10/2022 19:00,24,8,16,55,17,38,84,29,55,0,0,0,11,11,0,0,0,0,2,2,0,229,145,84,0,,103,0,103,108,1,107
05/10/2022 20:00,24,9,15,10,2,8,16,5,11,0,0,0,4,4,0,0,0,0,1,1,0,152,92,60,0,,96,0,96,84,1,83
05/10/2022 21:00,16,6,10,8,5,3,17,5,12,0,0,0,1,1,0,0,0,0,2,2,0,89,58,31,0,,75,0,75,57,0,57
05/10/2022 22:00,8,4,4,3,2,1,9,2,7,0,0,0,2,2,0,0,0,0,6,6,0,71,55,16,0,,77,0,77,37,1,36
05/10/2022 23:00,7,3,4,4,2,2,5,2,3,0,0,0,0,0,0,0,0,0,2,2,0,32,19,13,0,,32,0,32,18,0,18
06/10/2022 00:00,1,1,0,4,3,1,8,3,5,0,0,0,0,0,0,0,0,0,0,0,0,23,18,5,0,,20,1,19,8,0,8
06/10/2022 01:00,0,0,0,2,1,1,1,1,0,0,0,0,0,0,0,0,0,0,0,0,0,11,9,2,0,,2,0,2,1,0,1
06/10/2022 02:00,1,0,1,1,1,0,1,1,0,0,0,0,0,0,0,0,0,0,0,0,0,2,1,1,0,,3,0,3,2,0,2
06/10/2022 03:00,0,0,0,0,0,0,0,0,0,0,0,0,0,0,0,0,0,0,0,0,0,2,2,0,0,,8,0,8,1,0,1
06/10/2022 04:00,1,1,0,2,1,1,3,1,2,0,0,0,2,2,0,0,0,0,2,2,0,6,2,4,0,,1,0,1,1,0,1
06/10/2022 05:00,4,4,0,4,3,1,4,3,1,0,0,0,4,4,0,0,0,0,0,0,0,31,6,25,0,,3,0,3,8,0,8
06/10/2022 06:00,13,10,3,16,13,3,29,23,6,0,0,0,16,16,0,0,0,0,1,1,0,146,26,120,0,,11,0,11,31,0,31
06/10/2022 07:00,41,37,4,61,48,13,87,64,23,0,0,0,40,40,0,0,0,0,5,5,0,338,74,264,0,,44,1,43,69,0,69
06/10/2022 08:00,122,98,24,92,73,19,111,91,20,0,0,0,110,110,0,0,0,0,38,38,0,753,101,652,0,,83,1,82,170,0,170
06/10/2022 09:00,47,41,6,36,23,13,67,43,24,0,0,0,31,31,0,0,0,0,8,8,0,305,70,235,0,,45,0,45,147,1,146
06/10/2022 10:00,19,15,4,39,16,23,48,19,29,0,0,0,23,23,0,0,0,0,7,7,0,105,28,77,0,,38,0,38,79,0,79
06/10/2022 11:00,17,12,5,47,19,28,53,23,30,0,0,0,14,14,0,0,0,0,3,3,0,103,27,76,0,,25,0,25,72,1,71
06/10/2022 12:00,13,7,6,36,15,21,55,21,34,0,0,0,16,16,0,0,0,0,9,9,0,102,39,63,0,,71,0,71,102,0,102
06/10/2022 13:00,17,9,8,43,21,22,43,21,22,0,0,0,12,12,0,0,0,0,5,5,0,138,65,73,0,,97,2,95,112,0,112
06/10/2022 14:00,29,14,15,29,13,16,42,17,25,0,0,0,5,5,0,0,0,0,7,7,0,129,70,59,0,,80,0,80,73,0,73
06/10/2022 15:00,29,20,9,36,15,21,52,21,31,0,0,0,3,3,0,0,0,0,6,6,0,163,98,65,0,,96,1,95,76,1,75
06/10/2022 16:00,42,12,30,51,16,35,65,15,50,0,0,0,12,12,0,0,0,0,6,6,0,230,146,84,0,,126,1,125,99,0,99
06/10/2022 17:00,66,23,43,86,25,61,131,33,98,0,0,0,4,4,0,0,0,0,2,2,0,437,293,144,0,,216,1,215,133,0,133
06/10/2022 18:00,54,24,30,96,22,74,146,27,119,0,0,0,12,12,0,0,0,0,0,0,0,377,244,133,0,,203,0,203,133,0,133
06/10/2022 19:00,33,17,16,55,21,34,72,26,46,0,0,0,14,14,0,0,0,0,0,0,0,249,138,111,0,,162,2,160,112,0,112
06/10/2022 20:00,13,6,7,32,12,20,39,13,26,0,0,0,12,12,0,0,0,0,3,3,0,156,97,59,0,,100,0,100,97,1,96
06/10/2022 21:00,13,2,11,10,4,6,20,4,16,0,0,0,3,3,0,0,0,0,5,5,0,111,70,41,0,,114,1,113,69,2,67
06/10/2022 22:00,8,3,5,8,3,5,8,1,7,0,0,0,3,3,0,0,0,0,1,1,0,79,54,25,0,,76,0,76,29,0,29
06/10/2022 23:00,7,3,4,1,0,1,7,1,6,0,0,0,2,2,0,0,0,0,0,0,0,40,32,8,0,,67,1,66,28,0,28
07/10/2022 00:00,1,1,0,1,0,1,3,0,3,0,0,0,2,2,0,0,0,0,0,0,0,23,19,4,0,,38,0,38,15,0,15
07/10/2022 01:00,1,0,1,2,1,1,1,1,0,0,0,0,0,0,0,0,0,0,0,0,0,7,6,1,0,,5,0,5,2,0,2
07/10/2022 02:00,1,0,1,0,0,0,0,0,0,0,0,0,1,1,0,0,0,0,0,0,0,8,8,0,0,,11,0,11,1,0,1
07/10/2022 03:00,1,1,0,0,0,0,1,0,1,0,0,0,0,0,0,0,0,0,0,0,0,11,8,3,0,,12,0,12,4,0,4
07/10/2022 04:00,1,1,0,0,0,0,3,1,2,0,0,0,2,2,0,0,0,0,0,0,0,7,1,6,0,,3,0,3,1,0,1
07/10/2022 05:00,5,5,0,2,2,0,6,5,1,0,0,0,4,4,0,0,0,0,1,1,0,32,8,24,0,,4,0,4,8,0,8
07/10/2022 06:00,14,12,2,16,11,5,18,12,6,0,0,0,18,18,0,0,0,0,0,0,0,125,18,107,0,,10,0,10,29,1,28
07/10/2022 07:00,24,21,3,32,25,7,36,29,7,0,0,0,35,35,0,0,0,0,2,2,0,214,58,156,0,,21,0,21,52,0,52
07/10/2022 08:00,65,53,12,53,38,15,57,42,15,0,0,0,57,57,0,0,0,0,24,24,0,415,65,350,0,,35,0,35,151,1,150
07/10/2022 09:00,28,25,3,31,18,13,43,23,20,0,0,0,31,31,0,0,0,0,15,15,0,189,32,157,0,,35,0,35,125,0,125
07/10/2022 10:00,10,8,2,29,14,15,38,18,20,0,0,0,8,8,0,0,0,0,7,7,0,94,27,67,0,,36,0,36,77,1,76
07/10/2022 11:00,13,7,6,35,19,16,39,17,22,0,0,0,9,9,0,0,0,0,6,6,0,94,14,80,0,,10,1,9,81,0,81
07/10/2022 12:00,16,10,6,43,15,28,57,20,37,0,0,0,8,8,0,0,0,0,6,6,0,95,12,83,0,,72,0,72,107,0,107
07/10/2022 13:00,19,11,8,34,10,24,38,13,25,0,0,0,9,9,0,0,0,0,12,12,0,120,56,64,0,,92,0,92,101,1,100
07/10/2022 14:00,13,9,4,38,17,21,35,15,20,0,0,0,6,5,1,0,0,0,5,5,0,158,81,77,0,,99,1,98,96,1,95
07/10/2022 15:00,24,10,14,38,12,26,52,17,35,0,0,0,5,5,0,0,0,0,8,8,0,153,80,73,0,,88,0,88,77,1,76
07/10/2022 16:00,30,12,18,41,16,25,53,16,37,0,0,0,5,5,0,0,0,0,3,3,0,203,113,90,0,,135,0,135,87,0,87
07/10/2022 17:00,49,16,33,51,12,39,78,22,56,0,0,0,8,8,0,0,0,0,0,0,0,274,166,108,0,,182,1,181,92,0,92
07/10/2022 18:00,37,16,21,50,10,40,85,25,60,0,0,0,8,7,1,0,0,0,0,0,0,235,145,90,0,,175,0,175,128,1,127
07/10/2022 19:00,19,9,10,22,6,16,39,15,24,0,0,0,6,6,0,0,0,0,1,1,0,139,76,63,0,,142,3,139,129,0,129
07/10/2022 20:00,13,3,10,9,4,5,24,11,13,0,0,0,4,4,0,0,0,0,2,2,0,134,70,64,0,,118,2,116,105,0,105
07/10/2022 21:00,7,5,2,11,6,5,8,2,6,0,0,0,11,11,0,0,0,0,2,2,0,82,48,34,0,,76,0,76,76,0,76
07/10/2022 22:00,10,6,4,1,0,1,3,1,2,0,0,0,3,3,0,0,0,0,3,3,0,55,32,23,0,,61,0,61,49,0,49
07/10/2022 23:00,4,2,2,3,1,2,10,0,10,0,0,0,3,3,0,0,0,0,0,0,0,55,38,17,0,,57,2,55,32,0,32
08/10/2022 00:00,5,2,3,3,3,0,10,2,8,0,0,0,1,1,0,0,0,0,0,0,0,47,31,16,0,,38,0,38,25,1,24
08/10/2022 01:00,1,0,1,4,2,2,3,1,2,0,0,0,5,5,0,0,0,0,0,0,0,18,11,7,0,,11,0,11,1,0,1
08/10/2022 02:00,1,1,0,2,1,1,4,1,3,0,0,0,0,0,0,0,0,0,0,0,0,15,13,2,0,,16,0,16,5,0,5
08/10/2022 03:00,0,0,0,0,0,0,0,0,0,0,0,0,1,1,0,0,0,0,0,0,0,8,7,1,0,,16,0,16,7,1,6
08/10/2022 04:00,0,0,0,1,0,1,1,0,1,0,0,0,0,0,0,0,0,0,0,0,0,10,8,2,0,,9,0,9,2,0,2
08/10/2022 05:00,2,1,1,2,2,0,3,2,1,0,0,0,1,1,0,0,0,0,0,0,0,13,5,8,0,,5,0,5,2,0,2
08/10/2022 06:00,2,2,0,6,4,2,7,3,4,0,0,0,3,3,0,0,0,0,0,0,0,38,8,30,0,,9,0,9,11,0,11
08/10/2022 07:00,5,4,1,31,10,21,37,12,25,0,0,0,13,13,0,0,0,0,0,0,0,54,19,35,0,,10,0,10,14,0,14
08/10/2022 08:00,12,9,3,75,32,43,81,33,48,0,0,0,8,8,0,0,0,0,0,0,0,69,24,45,0,,18,0,18,46,0,46
08/10/2022 09:00,19,10,9,110,50,60,118,46,72,0,0,0,15,15,0,0,0,0,0,0,0,105,33,72,0,,36,0,36,55,0,55
08/10/2022 10:00,12,8,4,126,51,75,151,61,90,0,0,0,9,9,0,0,0,0,2,2,0,95,23,72,0,,7,0,7,72,1,71
08/10/2022 11:00,16,6,10,158,69,89,177,73,104,0,0,0,3,3,0,0,0,0,0,0,0,119,42,77,0,,52,0,52,78,0,78
08/10/2022 12:00,14,9,5,152,75,77,193,87,106,0,0,0,4,3,1,0,0,0,0,0,0,149,53,96,0,,75,0,75,102,1,101
08/10/2022 13:00,20,9,11,105,52,53,172,95,77,0,0,0,5,5,0,0,0,0,0,0,0,143,49,94,0,,80,1,79,115,0,115
08/10/2022 14:00,14,7,7,123,60,63,163,77,86,0,0,0,10,10,0,0,0,0,0,0,0,127,53,74,0,,85,0,85,115,0,115
08/10/2022 15:00,29,11,18,107,48,59,157,64,93,0,0,0,21,20,1,0,0,0,0,0,0,134,59,75,0,,78,1,77,108,1,107
08/10/2022 16:00,32,18,14,108,64,44,143,79,64,0,0,0,21,21,0,0,0,0,0,0,0,128,61,67,0,,110,0,110,123,0,123
08/10/2022 17:00,9,6,3,74,46,28,93,47,46,0,0,0,14,14,0,0,0,0,0,0,0,115,59,56,0,,127,2,125,95,1,94
08/10/2022 18:00,18,7,11,49,28,21,66,36,30,0,0,0,8,8,0,0,0,0,0,0,0,148,67,81,0,,97,0,97,85,1,84
08/10/2022 19:00,19,14,5,29,15,14,41,24,17,0,0,0,11,11,0,0,0,0,0,0,0,128,57,71,0,,104,0,104,103,1,102
08/10/2022 20:00,11,7,4,19,13,6,17,8,9,0,0,0,6,6,0,0,0,0,0,0,0,95,52,43,0,,82,0,82,96,1,95
08/10/2022 21:00,9,4,5,12,4,8,13,7,6,0,0,0,11,11,0,0,0,0,0,0,0,64,37,27,0,,87,0,87,65,0,65
08/10/2022 22:00,3,2,1,4,1,3,4,1,3,0,0,0,9,9,0,0,0,0,1,1,0,47,30,17,0,,57,0,57,41,0,41
08/10/2022 23:00,1,1,0,1,0,1,3,1,2,0,0,0,5,5,0,0,0,0,0,0,0,31,21,10,0,,48,0,48,36,0,36
09/10/2022 00:00,4,3,1,5,4,1,5,1,4,0,0,0,5,5,0,0,0,0,4,4,0,35,31,4,0,,47,0,47,22,0,22
09/10/2022 01:00,4,1,3,3,2,1,2,1,1,0,0,0,3,3,0,0,0,0,0,0,0,26,18,8,0,,6,0,6,1,0,1
09/10/2022 02:00,0,0,0,1,0,1,4,2,2,0,0,0,2,2,0,0,0,0,0,0,0,16,11,5,0,,21,1,20,3,0,3
09/10/2022 03:00,1,1,0,0,0,0,0,0,0,0,0,0,0,0,0,0,0,0,0,0,0,13,9,4,0,,9,0,9,3,0,3
09/10/2022 04:00,2,0,2,2,1,1,2,0,2,0,0,0,1,1,0,0,0,0,0,0,0,9,8,1,0,,4,0,4,6,0,6
09/10/2022 05:00,1,1,0,0,0,0,0,0,0,0,0,0,0,0,0,0,0,0,0,0,0,4,2,2,0,,1,0,1,2,0,2
09/10/2022 06:00,1,1,0,7,4,3,8,5,3,0,0,0,3,3,0,0,0,0,1,1,0,31,8,23,0,,2,1,1,7,0,7
09/10/2022 07:00,6,4,2,16,7,9,25,9,16,0,0,0,9,9,0,0,0,0,0,0,0,41,18,23,0,,10,0,10,7,0,7
09/10/2022 08:00,7,3,4,52,24,28,60,29,31,0,0,0,13,13,0,0,0,0,3,3,0,37,14,23,0,,6,0,6,12,0,12
09/10/2022 09:00,10,9,1,76,36,40,88,31,57,0,0,0,8,8,0,0,0,0,8,8,0,53,17,36,0,,9,0,9,30,0,30
09/10/2022 10:00,8,3,5,76,37,39,81,28,53,0,0,0,9,9,0,0,0,0,14,14,0,73,26,47,0,,21,0,21,39,0,39
09/10/2022 11:00,10,6,4,91,46,45,102,48,54,0,0,0,8,8,0,0,0,0,2,2,0,81,25,56,0,,34,0,34,48,0,48
09/10/2022 12:00,12,8,4,49,29,20,73,41,32,0,0,0,1,1,0,0,0,0,5,5,0,84,35,49,0,,46,0,46,46,0,46
09/10/2022 13:00,8,6,2,22,10,12,31,22,9,0,0,0,0,0,0,0,0,0,5,5,0,90,35,55,0,,53,0,53,63,0,63
09/10/2022 14:00,8,6,2,7,5,2,12,6,6,0,0,0,3,3,0,0,0,0,4,4,0,77,34,43,0,,66,0,66,62,0,62
09/10/2022 15:00,11,7,4,10,4,6,23,9,14,0,0,0,2,2,0,0,0,0,7,7,0,49,17,32,0,,48,2,46,79,0,79
09/10/2022 16:00,5,4,1,7,3,4,18,9,9,0,0,0,2,2,0,0,0,0,5,5,0,71,39,32,0,,46,0,46,56,1,55
09/10/2022 17:00,7,4,3,7,4,3,8,3,5,0,0,0,2,2,0,0,0,0,3,3,0,80,48,32,0,,72,0,72,62,0,62
09/10/2022 18:00,4,1,3,18,9,9,25,11,14,0,0,0,7,7,0,0,0,0,1,1,0,94,41,53,0,,84,0,84,81,1,80
09/10/2022 19:00,7,2,5,4,2,2,11,6,5,0,0,0,3,3,0,0,0,0,4,4,0,83,36,47,0,,54,0,54,65,0,65
09/10/2022 20:00,8,3,5,2,1,1,7,4,3,0,0,0,1,1,0,0,0,0,6,6,0,81,46,35,0,,56,0,56,52,0,52
09/10/2022 21:00,6,4,2,6,3,3,7,4,3,0,0,0,2,2,0,0,0,0,1,1,0,47,28,19,0,,39,1,38,61,0,61
09/10/2022 22:00,3,0,3,4,3,1,4,2,2,0,0,0,0,0,0,0,0,0,3,3,0,38,23,15,0,,6,0,6,29,0,29
09/10/2022 23:00,2,0,2,3,2,1,0,0,0,0,0,0,3,3,0,0,0,0,1,1,0,22,14,8,0,,0,0,0,13,0,13
10/10/2022 00:00,0,0,0,0,0,0,5,1,4,0,0,0,3,3,0,0,0,0,0,0,0,12,11,1,0,,0,0,0,11,0,11
10/10/2022 01:00,0,0,0,3,2,1,3,1,2,0,0,0,0,0,0,0,0,0,0,0,0,5,4,1,0,,4,0,4,0,0,0
10/10/2022 02:00,0,0,0,0,0,0,2,1,1,0,0,0,0,0,0,0,0,0,0,0,0,7,6,1,0,,6,0,6,0,0,0
10/10/2022 03:00,0,0,0,0,0,0,0,0,0,0,0,0,0,0,0,0,0,0,0,0,0,2,1,1,0,,2,0,2,0,0,0
10/10/2022 04:00,4,1,3,1,1,0,1,1,0,0,0,0,0,0,0,0,0,0,0,0,0,6,3,3,0,,2,0,2,1,0,1
10/10/2022 05:00,5,4,1,4,4,0,8,6,2,0,0,0,2,2,0,0,0,0,0,0,0,35,9,26,0,,5,0,5,6,0,6
10/10/2022 06:00,18,17,1,23,18,5,25,19,6,0,0,0,20,20,0,0,0,0,0,0,0,138,25,113,0,,6,0,6,27,0,27
10/10/2022 07:00,39,31,8,63,45,18,71,55,16,0,0,0,35,35,0,0,0,0,0,0,0,288,65,223,0,,36,0,36,79,0,79
10/10/2022 08:00,103,89,14,96,76,20,122,93,29,0,0,0,72,72,0,0,0,0,0,0,0,563,106,457,0,,60,1,59,188,0,188
10/10/2022 09:00,58,53,5,47,28,19,63,41,22,0,0,0,28,28,0,0,0,0,0,0,0,246,37,209,0,,52,0,52,126,0,126
10/10/2022 10:00,10,8,2,49,25,24,64,33,31,0,0,0,12,12,0,0,0,0,1,1,0,89,24,65,0,,22,1,21,66,0,66
10/10/2022 11:00,14,7,7,70,37,33,79,36,43,0,0,0,7,6,1,0,0,0,0,0,0,88,30,58,0,,30,0,30,66,0,66
10/10/2022 12:00,11,8,3,78,37,41,89,38,51,0,0,0,10,10,0,0,0,0,0,0,0,93,29,64,0,,65,0,65,82,0,82
10/10/2022 13:00,24,12,12,72,37,35,97,49,48,0,0,0,10,10,0,0,0,0,0,0,0,128,58,70,0,,94,2,92,84,0,84
10/10/2022 14:00,20,9,11,57,20,37,67,21,46,0,0,0,5,5,0,0,0,0,0,0,0,128,52,76,0,,81,0,81,68,0,68
10/10/2022 15:00,29,20,9,60,25,35,59,27,32,0,0,0,7,7,0,0,0,0,1,1,0,154,92,62,0,,96,1,95,86,0,86
10/10/2022 16:00,28,9,19,83,32,51,81,26,55,0,0,0,7,7,0,0,0,0,0,0,0,250,164,86,0,,171,1,170,83,1,82
10/10/2022 17:00,72,25,47,109,33,76,144,38,106,0,0,0,9,9,0,0,0,0,2,2,0,436,289,147,0,,240,1,239,118,1,117
10/10/2022 18:00,51,23,28,101,31,70,133,39,94,0,0,0,6,6,0,0,0,0,1,1,0,366,242,124,0,,204,0,204,136,1,135
10/10/2022 19:00,19,7,12,55,18,37,70,23,47,0,0,0,9,9,0,0,0,0,2,2,0,222,132,90,0,,154,0,154,113,1,112
10/10/2022 20:00,11,6,5,28,14,14,29,13,16,0,0,0,6,6,0,0,0,0,0,0,0,108,67,41,0,,66,2,64,64,1,63
10/10/2022 21:00,13,7,6,8,1,7,14,3,11,0,0,0,3,3,0,0,0,0,0,0,0,83,55,28,0,,3,0,3,48,0,48
10/10/2022 22:00,7,1,6,4,1,3,7,2,5,0,0,0,4,4,0,0,0,0,0,0,0,52,39,13,0,,1,0,1,32,0,32
10/10/2022 23:00,4,4,0,5,1,4,6,1,5,0,0,0,5,5,0,0,0,0,0,0,0,25,20,5,0,,0,0,0,10,0,10
11/10/2022 00:00,2,1,1,1,0,1,3,0,3,0,0,0,3,3,0,0,0,0,0,0,0,18,16,2,0,,0,0,0,7,0,7
11/10/2022 01:00,0,0,0,2,1,1,1,1,0,0,0,0,1,1,0,0,0,0,0,0,0,4,3,1,0,,1,0,1,0,0,0
11/10/2022 02:00,2,0,2,0,0,0,0,0,0,0,0,0,1,1,0,0,0,0,0,0,0,2,1,1,0,,5,0,5,0,0,0
11/10/2022 03:00,0,0,0,1,1,0,0,0,0,0,0,0,0,0,0,0,0,0,0,0,0,3,1,2,0,,1,0,1,1,0,1
11/10/2022 04:00,1,1,0,1,1,0,2,0,2,0,0,0,1,0,1,0,0,0,0,0,0,5,0,5,0,,1,0,1,2,0,2
11/10/2022 05:00,5,4,1,8,6,2,9,7,2,0,0,0,7,7,0,0,0,0,0,0,0,32,8,24,0,,4,0,4,9,0,9
11/10/2022 06:00,18,16,2,28,18,10,33,21,12,0,0,0,16,15,1,0,0,0,0,0,0,146,27,119,0,,10,1,9,36,0,36
11/10/2022 07:00,46,42,4,90,73,17,105,84,21,0,0,0,54,53,1,0,0,0,1,1,0,358,84,274,0,,36,2,34,103,1,102
11/10/2022 08:00,132,118,14,118,96,22,142,113,29,0,0,0,75,75,0,0,0,0,2,2,0,740,118,622,0,,72,0,72,265,1,264
11/10/2022 09:00,61,51,10,51,30,21,74,47,27,0,0,0,39,39,0,0,0,0,0,0,0,280,46,234,0,,38,0,38,161,0,161
11/10/2022 10:00,19,10,9,48,25,23,55,28,27,0,0,0,22,22,0,0,0,0,3,3,0,99,19,80,0,,32,1,31,81,0,81
11/10/2022 11:00,14,11,3,32,17,15,51,21,30,0,0,0,14,14,0,0,0,0,2,2,0,72,18,54,0,,38,0,38,59,0,59
11/10/2022 12:00,21,11,10,35,19,16,56,29,27,0,0,0,8,7,1,0,0,0,2,2,0,96,37,59,0,,86,0,86,105,0,105
11/10/2022 13:00,24,13,11,39,17,22,57,22,35,0,0,0,6,6,0,0,0,0,0,0,0,120,61,59,0,,97,1,96,112,3,109
11/10/2022 14:00,13,6,7,39,17,22,47,19,28,0,0,0,9,9,0,0,0,0,2,2,0,132,68,64,0,,75,0,75,76,1,75
11/10/2022 15:00,32,15,17,48,19,29,58,22,36,0,0,0,9,8,1,0,0,0,0,0,0,141,76,65,0,,91,0,91,67,0,67
11/10/2022 16:00,47,24,23,61,23,38,74,20,54,0,0,0,7,7,0,0,0,0,0,0,0,261,164,97,0,,154,0,154,88,0,88
11/10/2022 17:00,71,19,52,122,36,86,167,44,123,0,0,0,5,5,0,0,0,0,0,0,0,488,345,143,0,,266,2,264,146,1,145
11/10/2022 18:00,46,12,34,102,22,80,152,34,118,0,0,0,19,19,0,0,0,0,0,0,0,377,271,106,0,,204,0,204,135,1,134
11/10/2022 19:00,20,11,9,47,9,38,69,26,43,0,0,0,7,7,0,0,0,0,0,0,0,209,137,72,0,,171,1,170,80,0,80
11/10/2022 20:00,8,2,6,29,11,18,31,7,24,0,0,0,9,9,0,0,0,0,0,0,0,157,103,54,0,,133,0,133,72,0,72
11/10/2022 21:00,9,4,5,10,4,6,18,8,10,0,0,0,4,4,0,0,0,0,0,0,0,94,65,29,0,,82,0,82,53,0,53
11/10/2022 22:00,8,6,2,5,3,2,11,2,9,0,0,0,7,7,0,0,0,0,0,0,0,72,49,23,0,,36,0,36,35,1,34
11/10/2022 23:00,3,3,0,6,2,4,7,1,6,0,0,0,2,2,0,0,0,0,0,0,0,30,22,8,0,,0,0,0,25,0,25
12/10/2022 00:00,2,1,1,1,1,0,5,1,4,0,0,0,4,4,0,0,0,0,0,0,0,22,20,2,0,,8,0,8,7,0,7
12/10/2022 01:00,1,0,1,1,1,0,0,0,0,0,0,0,2,2,0,0,0,0,0,0,0,5,4,1,0,,2,0,2,2,0,2
12/10/2022 02:00,0,0,0,2,1,1,1,1,0,0,0,0,1,1,0,0,0,0,0,0,0,9,6,3,0,,13,0,13,3,1,2
12/10/2022 03:00,1,0,1,0,0,0,0,0,0,0,0,0,0,0,0,0,0,0,0,0,0,4,2,2,0,,4,0,4,1,0,1
12/10/2022 04:00,1,1,0,1,1,0,1,1,0,0,0,0,2,2,0,0,0,0,0,0,0,5,1,4,0,,2,0,2,2,0,2
12/10/2022 05:00,6,5,1,6,6,0,9,5,4,0,0,0,7,7,0,0,0,0,0,0,0,32,6,26,0,,4,0,4,2,0,2
12/10/2022 06:00,19,17,2,20,13,7,27,17,10,0,0,0,33,33,0,0,0,0,0,0,0,151,28,123,0,,12,1,11,31,0,31
12/10/2022 07:00,47,42,5,69,51,18,75,59,16,0,0,0,66,66,0,0,0,0,0,0,0,338,75,263,0,,48,1,47,101,0,101
12/10/2022 08:00,137,118,19,115,88,27,151,119,32,0,0,0,93,93,0,0,0,0,6,6,0,770,112,658,0,,81,0,81,274,1,273
12/10/2022 09:00,40,35,5,47,27,20,74,50,24,0,0,0,50,50,0,0,0,0,2,2,0,284,54,230,0,,47,0,47,177,2,175
12/10/2022 10:00,24,20,4,40,21,19,42,16,26,0,0,0,19,19,0,0,0,0,1,1,0,117,31,86,0,,40,1,39,56,2,54
12/10/2022 11:00,11,4,7,36,19,17,55,27,28,0,0,0,17,17,0,0,0,0,6,6,0,89,25,64,0,,39,0,39,61,1,60
12/10/2022 12:00,18,9,9,42,22,20,48,22,26,0,0,0,16,16,0,0,0,0,2,2,0,106,29,77,0,,64,1,63,122,0,122
12/10/2022 13:00,23,14,9,43,20,23,63,25,38,0,0,0,13,13,0,0,0,0,1,1,0,132,51,81,0,,79,0,79,100,0,100
12/10/2022 14:00,18,9,9,38,21,17,44,21,23,0,0,0,3,3,0,0,0,0,4,4,0,126,58,68,0,,91,0,91,97,1,96
12/10/2022 15:00,29,14,15,39,13,26,48,18,30,0,0,0,23,23,0,0,0,0,3,3,0,134,73,61,0,,90,0,90,76,0,76
12/10/2022 16:00,32,9,23,72,25,47,84,21,63,0,0,0,13,12,1,0,0,0,10,10,0,260,164,96,0,,144,1,143,91,0,91
12/10/2022 17:00,86,24,62,87,19,68,142,35,107,0,0,0,14,14,0,0,0,0,7,7,0,502,360,142,0,,282,0,282,141,0,141
12/10/2022 18:00,62,17,45,117,32,85,146,34,112,0,0,0,10,9,1,0,0,0,1,1,0,373,263,110,0,,252,0,252,138,2,136
12/10/2022 19:00,17,4,13,47,16,31,74,29,45,0,0,0,11,9,2,0,0,0,0,0,0,206,116,90,0,,163,1,162,112,1,111
12/10/2022 20:00,12,4,8,27,11,16,39,12,27,0,0,0,2,2,0,0,0,0,0,0,0,151,103,48,0,,112,0,112,90,1,89
12/10/2022 21:00,15,7,8,15,7,8,18,7,11,0,0,0,5,5,0,0,0,0,0,0,0,119,78,41,0,,92,0,92,58,0,58
12/10/2022 22:00,5,2,3,7,3,4,12,4,8,0,0,0,8,7,1,0,0,0,1,1,0,88,67,21,0,,69,0,69,33,0,33
12/10/2022 23:00,7,4,3,5,2,3,9,2,7,0,0,0,4,4,0,0,0,0,0,0,0,35,26,9,0,,50,0,50,22,0,22
13/10/2022 00:00,5,1,4,0,0,0,0,0,0,0,0,0,1,1,0,0,0,0,0,0,0,30,23,7,0,,31,1,30,7,0,7
13/10/2022 01:00,0,0,0,1,1,0,1,0,1,0,0,0,0,0,0,0,0,0,0,0,0,12,10,2,0,,3,0,3,1,0,1
13/10/2022 02:00,0,0,0,1,0,1,3,1,2,0,0,0,0,0,0,0,0,0,0,0,0,3,3,0,0,,7,0,7,3,0,3
13/10/2022 03:00,1,0,1,0,0,0,0,0,0,0,0,0,0,0,0,0,0,0,0,0,0,3,2,1,0,,4,0,4,0,0,0
13/10/2022 04:00,1,1,0,1,1,0,3,1,2,0,0,0,1,1,0,0,0,0,0,0,0,9,2,7,0,,4,0,4,3,0,3
13/10/2022 05:00,3,3,0,9,6,3,8,5,3,0,0,0,2,2,0,0,0,0,0,0,0,27,5,22,0,,4,0,4,6,1,5
13/10/2022 06:00,20,15,5,27,20,7,37,26,11,0,0,0,18,18,0,0,0,0,0,0,0,131,24,107,0,,9,1,8,38,0,38
13/10/2022 07:00,41,36,5,69,57,12,81,69,12,0,0,0,32,32,0,0,0,0,0,0,0,335,72,263,0,,51,1,50,89,0,89
13/10/2022 08:00,145,120,25,105,90,15,135,109,26,0,0,0,95,95,0,0,0,0,0,0,0,752,112,640,0,,75,1,74,237,2,235
13/10/2022 09:00,41,37,4,57,40,17,79,57,22,0,0,0,45,45,0,0,0,0,0,0,0,282,43,239,0,,37,0,37,198,0,198
13/10/2022 10:00,20,13,7,58,34,24,70,33,37,0,0,0,13,13,0,0,0,0,0,0,0,88,26,62,0,,38,0,38,86,0,86
13/10/2022 11:00,11,7,4,45,25,20,61,28,33,0,0,0,11,11,0,0,0,0,0,0,0,118,33,85,0,,44,0,44,81,0,81
13/10/2022 12:00,17,9,8,72,29,43,75,29,46,0,0,0,7,7,0,0,0,0,0,0,0,103,30,73,0,,47,1,46,93,1,92
13/10/2022 13:00,30,19,11,69,25,44,88,37,51,0,0,0,9,9,0,0,0,0,0,0,0,142,70,72,0,,92,0,92,94,1,93
13/10/2022 14:00,22,8,14,54,25,29,60,27,33,0,0,0,5,5,0,0,0,0,0,0,0,127,62,65,0,,108,0,108,82,1,81
13/10/2022 15:00,31,13,18,44,16,28,85,34,51,0,0,0,6,6,0,0,0,0,0,0,0,154,94,60,0,,82,0,82,74,0,74
13/10/2022 16:00,52,20,32,90,32,58,110,33,77,0,0,0,14,14,0,0,0,0,0,0,0,235,152,83,0,,145,0,145,100,2,98
13/10/2022 17:00,81,31,50,127,28,99,155,33,122,0,0,0,3,3,0,0,0,0,0,0,0,474,315,159,0,,264,1,263,138,1,137
13/10/2022 18:00,48,17,31,112,37,75,149,46,103,0,0,0,5,5,0,0,0,0,0,0,0,366,236,130,0,,223,2,221,153,0,153
13/10/2022 19:00,27,7,20,50,19,31,65,22,43,0,0,0,8,8,0,0,0,0,0,0,0,231,137,94,0,,144,0,144,111,0,111
13/10/2022 20:00,9,4,5,38,17,21,46,21,25,0,0,0,7,7,0,0,0,0,0,0,0,166,106,60,0,,122,0,122,97,0,97
13/10/2022 21:00,9,2,7,10,5,5,22,5,17,0,0,0,5,5,0,0,0,0,0,0,0,123,86,37,0,,91,1,90,70,0,70
13/10/2022 22:00,12,6,6,7,2,5,14,5,9,0,0,0,2,2,0,0,0,0,0,0,0,97,73,24,0,,73,0,73,42,1,41
13/10/2022 23:00,5,2,3,4,1,3,6,1,5,0,0,0,4,4,0,0,0,0,0,0,0,46,35,11,0,,42,1,41,28,0,28
14/10/2022 00:00,3,3,0,2,1,1,4,1,3,0,0,0,1,1,0,0,0,0,0,0,0,36,34,2,0,,39,0,39,10,0,10
14/10/2022 01:00,1,0,1,1,1,0,1,0,1,0,0,0,0,0,0,0,0,0,0,0,0,11,10,1,0,,8,0,8,0,0,0
14/10/2022 02:00,0,0,0,0,0,0,1,0,1,0,0,0,0,0,0,0,0,0,,,,5,5,0,0,,15,0,15,5,0,5
14/10/2022 03:00,1,1,0,0,0,0,1,0,1,0,0,0,1,1,0,0,0,0,,,,4,1,3,0,,12,0,12,1,0,1
14/10/2022 04:00,3,1,2,1,1,0,2,1,1,0,0,0,1,1,0,0,0,0,,,,8,3,5,0,,5,0,5,1,0,1
14/10/2022 05:00,1,1,0,7,4,3,9,5,4,0,0,0,2,2,0,0,0,0,,,,33,7,26,0,,5,0,5,4,0,4
14/10/2022 06:00,18,14,4,25,20,5,29,21,8,0,0,0,22,22,0,0,0,0,,,,130,30,100,0,,8,0,8,36,0,36
14/10/2022 07:00,31,27,4,53,38,15,68,44,24,0,0,0,31,31,0,0,0,0,,,,263,56,207,0,,37,1,36,66,0,66
14/10/2022 08:00,88,77,11,94,77,17,97,81,16,0,0,0,55,55,0,0,0,0,,,,458,91,367,0,,50,0,50,151,1,150
14/10/2022 09:00,35,25,10,36,22,14,56,34,22,0,0,0,31,31,0,0,0,0,,,,225,49,176,0,,44,0,44,148,1,147
14/10/2022 10:00,19,11,8,74,32,42,77,32,45,0,0,0,23,23,0,0,0,0,,,,100,30,70,0,,33,0,33,62,0,62
14/10/2022 11:00,12,8,4,65,33,32,56,28,28,0,0,0,9,9,0,0,0,0,,,,99,38,61,0,,37,1,36,69,0,69
14/10/2022 12:00,20,9,11,59,36,23,79,42,37,0,0,0,13,13,0,0,0,0,,,,127,49,78,0,,87,0,87,92,1,91
14/10/2022 13:00,25,11,14,39,18,21,61,24,37,0,0,0,6,6,0,0,0,0,0,0,0,127,60,67,0,,99,0,99,124,1,123
14/10/2022 14:00,20,12,8,45,15,30,63,24,39,0,0,0,8,7,1,0,0,0,0,0,0,153,81,72,0,,98,0,98,83,1,82
14/10/2022 15:00,27,12,15,61,26,35,87,31,56,0,0,0,6,6,0,0,0,0,0,0,0,189,100,89,0,,83,1,82,115,1,114
14/10/2022 16:00,36,16,20,70,36,34,108,54,54,0,0,0,8,7,1,0,0,0,0,0,0,238,134,104,0,,152,1,151,109,1,108
14/10/2022 17:00,49,20,29,112,33,79,146,45,101,0,0,0,10,10,0,0,0,0,0,0,0,331,222,109,0,,195,0,195,123,1,122
14/10/2022 18:00,32,14,18,71,25,46,79,26,53,0,0,0,15,15,0,0,0,0,0,0,0,239,126,113,0,,181,1,180,137,0,137
14/10/2022 19:00,16,10,6,46,17,29,56,19,37,0,0,0,4,4,0,0,0,0,0,0,0,187,111,76,0,,115,1,114,117,1,116
14/10/2022 20:00,8,3,5,21,8,13,36,16,20,0,0,0,6,6,0,0,0,0,0,0,0,129,67,62,0,,106,1,105,112,1,111
14/10/2022 21:00,10,4,6,14,6,8,12,5,7,0,0,0,7,7,0,0,0,0,0,0,0,90,46,44,0,,93,1,92,82,0,82
14/10/2022 22:00,10,5,5,6,2,4,13,7,6,0,0,0,7,7,0,0,0,0,0,0,0,77,55,22,0,,76,1,75,43,2,41
14/10/2022 23:00,2,0,2,5,3,2,6,1,5,0,0,0,7,7,0,0,0,0,0,0,0,67,53,14,0,,69,3,66,30,0,30
15/10/2022 00:00,2,0,2,4,2,2,7,1,6,0,0,0,3,3,0,0,0,0,0,0,0,40,28,12,0,,43,1,42,15,0,15
15/10/2022 01:00,1,1,0,5,2,3,1,0,1,0,0,0,3,3,0,0,0,0,0,0,0,20,14,6,0,,12,0,12,0,0,0
15/10/2022 02:00,0,0,0,0,0,0,2,0,2,0,0,0,0,0,0,0,0,0,0,0,0,17,17,0,0,,25,1,24,11,1,10
15/10/2022 03:00,1,0,1,0,0,0,3,0,3,0,0,0,0,0,0,0,0,0,0,0,0,20,14,6,0,,22,0,22,10,1,9
15/10/2022 04:00,1,1,0,1,1,0,0,0,0,0,0,0,0,0,0,0,0,0,0,0,0,6,5,1,0,,2,0,2,2,0,2
15/10/2022 05:00,2,1,1,3,2,1,5,4,1,0,0,0,0,0,0,0,0,0,0,0,0,9,5,4,0,,4,0,4,2,0,2
15/10/2022 06:00,3,2,1,7,3,4,7,2,5,0,0,0,3,3,0,0,0,0,0,0,0,38,10,28,0,,7,0,7,10,0,10
15/10/2022 07:00,3,3,0,17,8,9,18,7,11,0,0,0,8,8,0,0,0,0,0,0,0,46,12,34,0,,7,0,7,15,0,15
15/10/2022 08:00,15,11,4,37,17,20,40,14,26,0,0,0,8,8,0,0,0,0,0,0,0,67,26,41,0,,9,0,9,35,0,35
15/10/2022 09:00,11,10,1,84,37,47,85,32,53,0,0,0,15,15,0,0,0,0,1,1,0,82,21,61,0,,23,0,23,71,0,71
15/10/2022 10:00,17,13,4,48,32,16,91,49,42,0,0,0,8,8,0,0,0,0,0,0,0,70,23,47,0,,49,1,48,65,0,65
15/10/2022 11:00,13,8,5,73,23,50,86,34,52,0,0,0,0,0,0,0,0,0,0,0,0,94,34,60,0,,57,0,57,70,0,70
15/10/2022 12:00,19,10,9,61,33,28,94,41,53,0,0,0,2,2,0,0,0,0,0,0,0,122,42,80,0,,65,1,64,84,0,84
15/10/2022 13:00,20,9,11,48,20,28,77,41,36,0,0,0,4,4,0,0,0,0,0,0,0,100,45,55,0,,81,0,81,93,0,93
15/10/2022 14:00,13,7,6,40,23,17,57,27,30,0,0,0,5,5,0,0,0,0,1,1,0,112,44,68,0,,72,0,72,71,0,71
15/10/2022 15:00,11,5,6,43,22,21,85,48,37,0,0,0,7,7,0,0,0,0,0,0,0,87,35,52,0,,69,0,69,75,0,75
15/10/2022 16:00,9,6,3,33,18,15,69,29,40,0,0,0,7,7,0,0,0,0,0,0,0,105,43,62,0,,94,0,94,88,1,87
15/10/2022 17:00,8,6,2,39,16,23,45,14,31,0,0,0,5,4,1,0,0,0,0,0,0,122,61,61,0,,98,0,98,86,0,86
15/10/2022 18:00,15,7,8,19,12,7,25,11,14,0,0,0,3,3,0,0,0,0,0,0,0,139,58,81,0,,96,1,95,88,0,88
15/10/2022 19:00,14,4,10,6,2,4,10,6,4,0,0,0,5,5,0,0,0,0,0,0,0,101,48,53,0,,86,1,85,83,0,83
15/10/2022 20:00,11,5,6,4,2,2,6,3,3,0,0,0,1,1,0,0,0,0,0,0,0,94,41,53,0,,82,1,81,87,0,87
15/10/2022 21:00,2,0,2,5,3,2,6,3,3,0,0,0,4,4,0,0,0,0,1,1,0,76,39,37,0,,58,0,58,62,0,62
15/10/2022 22:00,4,4,0,4,0,4,3,0,3,0,0,0,2,2,0,0,0,0,0,0,0,38,25,13,0,,45,1,44,27,0,27
15/10/2022 23:00,1,1,0,3,0,3,8,1,7,0,0,0,2,2,0,0,0,0,0,0,0,40,20,20,0,,45,2,43,23,0,23
16/10/2022 00:00,2,2,0,4,3,1,2,1,1,0,0,0,0,0,0,0,0,0,0,0,0,31,18,13,0,,33,0,33,10,0,10
16/10/2022 01:00,1,0,1,5,4,1,3,2,1,0,0,0,3,3,0,0,0,0,0,0,0,22,20,2,0,,11,0,11,1,0,1
16/10/2022 02:00,0,0,0,1,1,0,2,0,2,0,0,0,3,3,0,0,0,0,0,0,0,17,14,3,0,,21,1,20,6,0,6
16/10/2022 03:00,1,0,1,0,0,0,2,0,2,0,0,0,0,0,0,0,0,0,0,0,0,16,11,5,0,,16,0,16,4,1,3
16/10/2022 04:00,1,1,0,1,0,1,3,1,2,0,0,0,0,0,0,0,0,0,0,0,0,11,4,7,0,,9,0,9,7,0,7
16/10/2022 05:00,1,1,0,3,2,1,3,3,0,0,0,0,0,0,0,0,0,0,0,0,0,7,6,1,0,,4,0,4,4,0,4
16/10/2022 06:00,3,3,0,1,0,1,1,1,0,0,0,0,1,1,0,0,0,0,1,1,0,40,10,30,0,,7,0,7,6,0,6
16/10/2022 07:00,3,2,1,13,5,8,20,6,14,0,0,0,7,7,0,0,0,0,0,0,0,27,6,21,0,,10,0,10,13,0,13
16/10/2022 08:00,3,2,1,56,20,36,62,24,38,0,0,0,3,3,0,0,0,0,0,0,0,48,22,26,0,,9,1,8,15,0,15
16/10/2022 09:00,10,5,5,107,36,71,101,32,69,0,0,0,12,12,0,0,0,0,0,0,0,61,15,46,0,,13,0,13,41,0,41
16/10/2022 10:00,5,2,3,130,58,72,138,56,82,0,0,0,15,15,0,0,0,0,2,2,0,80,33,47,0,,28,1,27,50,0,50
16/10/2022 11:00,17,13,4,128,69,59,156,75,81,0,0,0,6,6,0,0,0,0,1,1,0,91,22,69,0,,36,1,35,65,1,64
16/10/2022 12:00,16,8,8,125,76,49,144,75,69,0,0,0,1,1,0,0,0,0,1,1,0,87,30,57,0,,66,0,66,74,0,74
16/10/2022 13:00,13,7,6,92,49,43,121,56,65,0,0,0,4,4,0,0,0,0,0,0,0,104,41,63,0,,56,0,56,99,0,99
16/10/2022 14:00,18,8,10,63,34,29,81,40,41,0,0,0,3,3,0,0,0,0,0,0,0,93,42,51,0,,64,0,64,75,0,75
16/10/2022 15:00,10,7,3,31,15,16,50,30,20,0,0,0,1,1,0,0,0,0,1,1,0,91,47,44,0,,67,0,67,76,1,75
16/10/2022 16:00,11,7,4,22,16,6,37,21,16,0,0,0,4,4,0,0,0,0,0,0,0,74,35,39,0,,76,1,75,62,1,61
16/10/2022 17:00,14,5,9,9,2,7,17,8,9,0,0,0,5,5,0,0,0,0,0,0,0,86,39,47,0,,85,0,85,57,4,53
16/10/2022 18:00,8,2,6,6,2,4,9,5,4,0,0,0,3,3,0,0,0,0,0,0,0,80,43,37,0,,82,1,81,59,0,59
16/10/2022 19:00,6,4,2,1,1,0,5,3,2,0,0,0,4,4,0,0,0,0,0,0,0,60,33,27,0,,60,0,60,40,0,40
16/10/2022 20:00,6,4,2,4,3,1,4,3,1,0,0,0,3,3,0,0,0,0,0,0,0,53,35,18,0,,63,0,63,35,0,35
16/10/2022 21:00,6,2,4,3,1,2,2,0,2,0,0,0,1,1,0,0,0,0,0,0,0,52,31,21,0,,47,0,47,39,0,39
16/10/2022 22:00,3,2,1,4,1,3,5,1,4,0,0,0,0,0,0,0,0,0,0,0,0,30,17,13,0,,6,0,6,13,0,13
16/10/2022 23:00,1,1,0,1,0,1,7,0,7,0,0,0,0,0,0,0,0,0,0,0,0,15,12,3,0,,1,0,1,9,0,9
17/10/2022 00:00,0,0,0,3,1,2,2,0,2,0,0,0,0,0,0,0,0,0,0,0,0,11,10,1,0,,2,0,2,5,0,5
17/10/2022 01:00,0,0,0,0,0,0,0,0,0,0,0,0,0,0,0,0,0,0,0,0,0,5,5,0,0,,5,0,5,0,0,0
17/10/2022 02:00,1,0,1,0,0,0,1,0,1,0,0,0,0,0,0,0,0,0,0,0,0,3,3,0,0,,4,0,4,0,0,0
17/10/2022 03:00,0,0,0,0,0,0,0,0,0,0,0,0,0,0,0,0,0,0,0,0,0,2,0,2,0,,5,0,5,1,0,1
17/10/2022 04:00,0,0,0,2,2,0,3,0,3,0,0,0,1,1,0,0,0,0,0,0,0,6,1,5,0,,3,0,3,1,0,1
17/10/2022 05:00,3,3,0,4,3,1,8,5,3,0,0,0,7,7,0,0,0,0,0,0,0,34,6,28,0,,5,0,5,7,0,7
17/10/2022 06:00,15,10,5,7,5,2,10,6,4,0,0,0,17,17,0,0,0,0,0,0,0,131,27,104,0,,5,0,5,23,0,23
17/10/2022 07:00,23,20,3,20,14,6,27,17,10,0,0,0,38,38,0,0,0,0,1,1,0,219,55,164,0,,27,0,27,56,0,56
17/10/2022 08:00,107,89,18,32,26,6,43,31,12,0,0,0,71,71,0,0,0,0,18,18,0,449,81,368,0,,50,0,50,179,0,179
17/10/2022 09:00,39,32,7,15,8,7,23,15,8,0,0,0,27,27,0,0,0,0,3,3,0,208,32,176,0,,28,1,27,107,1,106
17/10/2022 10:00,18,14,4,10,4,6,15,5,10,0,0,0,11,11,0,0,0,0,5,5,0,66,17,49,0,,25,0,25,61,0,61
17/10/2022 11:00,13,7,6,14,8,6,20,8,12,0,0,0,2,2,0,0,0,0,0,0,0,75,20,55,0,,34,0,34,67,1,66
17/10/2022 12:00,10,6,4,15,5,10,17,5,12,0,0,0,1,1,0,0,0,0,0,0,0,94,35,59,0,,66,0,66,60,1,59
17/10/2022 13:00,20,9,11,17,6,11,18,6,12,0,0,0,7,7,0,0,0,0,5,5,0,104,49,55,0,,79,2,77,89,0,89
17/10/2022 14:00,15,9,6,17,8,9,30,10,20,0,0,0,11,11,0,0,0,0,3,3,0,88,45,43,0,,76,0,76,72,1,71
17/10/2022 15:00,20,10,10,13,1,12,30,8,22,0,0,0,8,8,0,0,0,0,10,10,0,139,85,54,0,,84,0,84,64,0,64
17/10/2022 16:00,38,14,24,32,11,21,38,9,29,0,0,0,4,4,0,0,0,0,14,14,0,207,125,82,0,,115,0,115,80,1,79
17/10/2022 17:00,55,13,42,73,24,49,104,29,75,0,0,0,3,3,0,0,0,0,4,4,0,384,252,132,0,,250,1,249,113,1,112
17/10/2022 18:00,25,8,17,55,13,42,77,19,58,0,0,0,6,6,0,0,0,0,2,2,0,299,192,107,0,,207,3,204,95,3,92
17/10/2022 19:00,20,6,14,34,9,25,54,15,39,0,0,0,5,5,0,0,0,0,0,0,0,188,118,70,0,,143,1,142,87,0,87
17/10/2022 20:00,14,3,11,21,9,12,30,9,21,0,0,0,14,14,0,0,0,0,0,0,0,114,71,43,0,,93,0,93,67,1,66
17/10/2022 21:00,8,5,3,8,2,6,10,1,9,0,0,0,2,2,0,0,0,0,0,0,0,80,47,33,0,,67,0,67,46,0,46
17/10/2022 22:00,3,3,0,7,4,3,9,2,7,0,0,0,4,4,0,0,0,0,0,0,0,42,27,15,0,,46,0,46,26,0,26
17/10/2022 23:00,3,1,2,2,1,1,5,0,5,0,0,0,2,2,0,0,0,0,0,0,0,25,20,5,0,,20,0,20,13,0,13
18/10/2022 00:00,2,2,0,2,1,1,1,0,1,0,0,0,0,0,0,0,0,0,1,1,0,15,14,1,0,,15,0,15,10,0,10
18/10/2022 01:00,2,1,1,1,1,0,1,1,0,0,0,0,1,1,0,0,0,0,0,0,0,9,6,3,0,,0,0,0,0,0,0
18/10/2022 02:00,0,0,0,1,1,0,0,0,0,0,0,0,1,1,0,0,0,0,0,0,0,6,3,3,0,,5,0,5,1,0,1
18/10/2022 03:00,0,0,0,0,0,0,0,0,0,0,0,0,0,0,0,0,0,0,0,0,0,2,1,1,0,,4,0,4,2,0,2
18/10/2022 04:00,1,1,0,2,2,0,2,2,0,0,0,0,0,0,0,0,0,0,0,0,0,6,0,6,0,,1,0,1,2,0,2
18/10/2022 05:00,4,3,1,7,5,2,9,6,3,0,0,0,3,3,0,0,0,0,0,0,0,25,6,19,0,,2,0,2,8,0,8
18/10/2022 06:00,21,17,4,30,23,7,36,24,12,0,0,0,20,20,0,0,0,0,3,3,0,142,27,115,0,,8,0,8,36,0,36
18/10/2022 07:00,58,53,5,80,68,12,100,78,22,0,0,0,46,46,0,0,0,0,4,4,0,373,90,283,0,,34,1,33,112,0,112
18/10/2022 08:00,123,114,9,110,93,17,148,124,24,0,0,0,70,70,0,0,0,0,4,4,0,743,107,636,0,,64,1,63,278,0,278
18/10/2022 09:00,42,37,5,73,46,27,96,59,37,0,0,0,49,48,1,0,0,0,0,0,0,309,43,266,0,,44,0,44,208,1,207
18/10/2022 10:00,19,13,6,64,30,34,75,37,38,0,0,0,13,13,0,0,0,0,0,0,0,115,19,96,0,,34,0,34,97,0,97
18/10/2022 11:00,13,7,6,72,39,33,84,43,41,0,0,0,16,16,0,0,0,0,1,1,0,97,31,66,0,,45,1,44,87,0,87
18/10/2022 12:00,16,12,4,68,36,32,72,37,35,0,0,0,10,10,0,0,0,0,1,1,0,110,47,63,0,,73,0,73,101,0,101
18/10/2022 13:00,24,12,12,65,28,37,83,32,51,0,0,0,8,8,0,0,0,0,0,0,0,142,60,82,0,,80,1,79,106,2,104
18/10/2022 14:00,22,10,12,40,17,23,71,30,41,0,0,0,3,3,0,0,0,0,5,5,0,119,61,58,0,,88,0,88,74,2,72
18/10/2022 15:00,19,9,10,62,30,32,89,41,48,0,0,0,8,8,0,0,0,0,12,12,0,159,92,67,0,,76,0,76,76,0,76
18/10/2022 16:00,33,15,18,82,34,48,95,35,60,0,0,0,7,7,0,0,0,0,16,16,0,263,179,84,0,,171,0,171,82,1,81
18/10/2022 17:00,75,21,54,116,31,85,162,37,125,0,0,0,16,16,0,0,0,0,20,20,0,483,351,132,0,,276,1,275,132,1,131
18/10/2022 18:00,57,16,41,117,26,91,167,42,125,0,0,0,22,21,1,0,0,0,8,8,0,431,297,134,0,,262,0,262,144,2,142
18/10/2022 19:00,25,8,17,47,19,28,80,27,53,0,0,0,1,1,0,0,0,0,6,6,0,213,126,87,0,,154,2,152,104,1,103
18/10/2022 20:00,12,7,5,51,18,33,42,14,28,0,0,0,6,6,0,0,0,0,0,0,0,141,99,42,0,,134,0,134,88,1,87
18/10/2022 21:00,12,9,3,22,11,11,25,11,14,0,0,0,9,9,0,0,0,0,1,1,0,98,62,36,0,,91,0,91,59,0,59
18/10/2022 22:00,8,4,4,7,4,3,16,7,9,0,0,0,3,3,0,0,0,0,0,0,0,84,50,34,0,,21,0,21,30,0,30
18/10/2022 23:00,1,1,0,2,1,1,4,1,3,0,0,0,3,3,0,0,0,0,0,0,0,30,23,7,0,,0,0,0,26,0,26
19/10/2022 00:00,1,1,0,1,1,0,0,0,0,0,0,0,0,0,0,0,0,0,0,0,0,20,17,3,0,,0,0,0,11,0,11
19/10/2022 01:00,0,0,0,0,0,0,0,0,0,0,0,0,0,0,0,0,0,0,0,0,0,7,5,2,0,,2,0,2,1,0,1
19/10/2022 02:00,0,0,0,0,0,0,0,0,0,0,0,0,0,0,0,,,,0,0,0,2,2,0,0,,12,0,12,1,0,1
19/10/2022 03:00,0,0,0,0,0,0,0,0,0,0,0,0,0,0,0,,,,0,0,0,1,1,0,0,,2,0,2,5,0,5
19/10/2022 04:00,2,2,0,1,1,0,2,2,0,0,0,0,2,2,0,,,,0,0,0,2,1,1,0,,1,0,1,2,0,2
19/10/2022 05:00,4,4,0,3,3,0,6,4,2,0,0,0,1,1,0,,,,0,0,0,27,4,23,0,,4,0,4,4,0,4
19/10/2022 06:00,11,9,2,12,11,1,17,11,6,0,0,0,8,8,0,,,,0,0,0,112,29,83,0,,6,0,6,26,0,26
19/10/2022 07:00,31,27,4,26,20,6,44,37,7,0,0,0,27,27,0,,,,5,5,0,268,60,208,0,,28,2,26,78,0,78
19/10/2022 08:00,79,67,12,40,35,5,53,47,6,0,0,0,60,60,0,,,,1,1,0,567,65,502,0,,48,1,47,159,0,159
19/10/2022 09:00,27,27,0,11,7,4,19,16,3,0,0,0,28,28,0,4,4,0,0,0,0,234,30,204,0,,35,0,35,122,0,122
19/10/2022 10:00,9,8,1,8,4,4,16,9,7,0,0,0,5,5,0,5,5,0,0,0,0,89,21,68,0,,32,0,32,58,1,57
19/10/2022 11:00,6,3,3,5,5,0,7,3,4,0,0,0,3,3,0,7,7,0,1,1,0,72,18,54,0,,35,0,35,50,0,50
19/10/2022 12:00,7,3,4,8,5,3,13,7,6,0,0,0,1,1,0,10,10,0,2,2,0,99,32,67,0,,63,0,63,85,0,85
19/10/2022 13:00,10,5,5,5,4,1,9,6,3,0,0,0,5,5,0,14,14,0,2,2,0,91,37,54,0,,54,0,54,50,0,50
19/10/2022 14:00,11,6,5,2,0,2,7,2,5,0,0,0,1,1,0,4,4,0,2,2,0,95,47,48,0,,64,0,64,46,0,46
19/10/2022 15:00,8,5,3,5,1,4,8,1,7,0,0,0,2,2,0,12,12,0,4,4,0,105,59,46,0,,53,0,53,43,0,43
19/10/2022 16:00,23,12,11,16,4,12,17,4,13,0,0,0,9,9,0,14,14,0,2,2,0,164,99,65,0,,101,1,100,63,0,63
19/10/2022 17:00,39,12,27,32,4,28,46,8,38,0,0,0,7,7,0,16,16,0,3,3,0,364,252,112,0,,165,1,164,97,0,97
19/10/2022 18:00,22,9,13,34,8,26,55,16,39,0,0,0,4,4,0,30,30,0,7,7,0,282,196,86,0,,169,0,169,73,2,71
19/10/2022 19:00,14,7,7,17,4,13,26,5,21,0,0,0,6,6,0,13,13,0,3,3,0,158,92,66,0,,104,0,104,90,1,89
19/10/2022 20:00,13,8,5,10,4,6,12,4,8,0,0,0,2,2,0,10,10,0,0,0,0,90,59,31,0,,58,0,58,69,2,67
19/10/2022 21:00,8,4,4,3,1,2,3,0,3,0,0,0,5,5,0,5,5,0,1,1,0,79,52,27,0,,66,0,66,38,0,38
19/10/2022 22:00,1,1,0,1,0,1,1,1,0,0,0,0,2,2,0,2,2,0,0,0,0,33,18,15,0,,41,0,41,24,0,24
19/10/2022 23:00,2,1,1,1,0,1,4,1,3,0,0,0,1,1,0,2,2,0,1,1,0,31,22,9,0,,25,0,25,18,0,18
20/10/2022 00:00,2,2,0,0,0,0,2,0,2,0,0,0,0,0,0,1,1,0,0,0,0,18,15,3,0,,16,2,14,5,0,5
20/10/2022 01:00,2,1,1,0,0,0,1,1,0,0,0,0,1,1,0,0,0,0,0,0,0,7,6,1,0,,3,0,3,0,0,0
20/10/2022 02:00,1,1,0,0,0,0,0,0,0,0,0,0,1,1,0,0,0,0,0,0,0,3,2,1,0,,6,0,6,1,0,1
20/10/2022 03:00,1,0,1,0,0,0,0,0,0,0,0,0,0,0,0,0,0,0,0,0,0,2,0,2,0,,2,0,2,2,0,2
20/10/2022 04:00,2,2,0,1,1,0,3,2,1,0,0,0,1,1,0,1,1,0,0,0,0,6,3,3,0,,5,0,5,2,0,2
20/10/2022 05:00,4,4,0,3,3,0,4,3,1,0,0,0,1,1,0,0,0,0,0,0,0,31,7,24,0,,4,0,4,9,0,9
20/10/2022 06:00,23,20,3,22,18,4,30,24,6,0,0,0,14,14,0,9,9,0,1,1,0,141,32,109,0,,11,1,10,31,0,31
20/10/2022 07:00,45,40,5,67,53,14,87,69,18,0,0,0,36,36,0,26,26,0,2,2,0,308,68,240,0,,44,1,43,90,2,88
20/10/2022 08:00,111,99,12,97,84,13,120,104,16,0,0,0,43,43,0,61,61,0,3,3,0,731,110,621,0,,73,0,73,247,2,245
20/10/2022 09:00,50,46,4,58,41,17,69,46,23,0,0,0,36,36,0,18,18,0,0,0,0,295,43,252,0,,44,0,44,166,1,165
20/10/2022 10:00,15,13,2,68,35,33,78,42,36,0,0,0,12,12,0,12,12,0,0,0,0,98,20,78,0,,31,0,31,68,0,68
20/10/2022 11:00,9,5,4,57,31,26,63,33,30,0,0,0,13,12,1,16,16,0,0,0,0,104,33,71,0,,50,0,50,55,0,55
20/10/2022 12:00,21,20,1,59,31,28,81,37,44,0,0,0,5,4,1,12,12,0,0,0,0,110,42,68,0,,48,1,47,97,0,97
20/10/2022 13:00,20,11,9,46,23,23,59,27,32,0,0,0,4,4,0,9,9,0,0,0,0,139,61,78,0,,69,0,69,102,0,102
20/10/2022 14:00,9,5,4,46,23,23,60,29,31,0,0,0,6,6,0,21,21,0,0,0,0,128,69,59,0,,87,0,87,91,1,90
20/10/2022 15:00,28,16,12,36,14,22,61,25,36,0,0,0,12,12,0,39,39,0,1,1,0,171,81,90,0,,84,1,83,85,0,85
20/10/2022 16:00,37,14,23,55,25,30,72,27,45,0,0,0,10,10,0,30,30,0,1,1,0,235,146,89,0,,130,1,129,94,0,94
20/10/2022 17:00,45,13,32,112,29,83,135,32,103,0,0,0,6,6,0,47,47,0,0,0,0,456,318,138,0,,228,1,227,129,1,128
20/10/2022 18:00,46,19,27,116,34,82,149,32,117,0,0,0,9,9,0,35,35,0,1,1,0,392,244,148,0,,199,1,198,138,1,137
20/10/2022 19:00,17,7,10,45,18,27,80,29,51,0,0,0,11,10,1,17,17,0,0,0,0,225,130,95,0,,148,0,148,125,1,124
20/10/2022 20:00,15,4,11,30,12,18,41,21,20,0,0,0,8,8,0,11,11,0,0,0,0,151,87,64,0,,120,2,118,109,0,109
20/10/2022 21:00,7,4,3,12,7,5,20,7,13,0,0,0,5,5,0,9,9,0,0,0,0,118,89,29,0,,98,0,98,59,1,58
20/10/2022 22:00,4,3,1,8,3,5,12,4,8,0,0,0,1,1,0,9,9,0,0,0,0,96,71,25,0,,72,0,72,40,2,38
20/10/2022 23:00,3,1,2,4,0,4,6,1,5,0,0,0,3,3,0,2,2,0,0,0,0,44,34,10,0,,53,1,52,21,1,20
21/10/2022 00:00,3,1,2,2,0,2,5,1,4,0,0,0,1,1,0,4,4,0,0,0,0,26,24,2,0,,38,1,37,17,0,17
21/10/2022 01:00,1,1,0,2,1,1,5,2,3,0,0,0,2,2,0,0,0,0,0,0,0,13,9,4,0,,2,0,2,0,0,0
21/10/2022 02:00,0,0,0,3,2,1,2,1,1,0,0,0,1,1,0,0,0,0,0,0,0,8,7,1,0,,9,0,9,4,0,4
21/10/2022 03:00,0,0,0,0,0,0,1,0,1,0,0,0,0,0,0,0,0,0,0,0,0,3,2,1,0,,6,0,6,4,0,4
21/10/2022 04:00,3,1,2,1,1,0,3,1,2,0,0,0,0,0,0,1,1,0,0,0,0,7,3,4,0,,4,0,4,2,0,2
21/10/2022 05:00,2,2,0,3,2,1,3,2,1,0,0,0,1,1,0,0,0,0,0,0,0,21,2,19,0,,4,0,4,9,0,9
21/10/2022 06:00,15,13,2,13,10,3,17,15,2,0,0,0,10,10,0,9,9,0,0,0,0,95,19,76,0,,7,0,7,25,1,24
21/10/2022 07:00,24,22,2,27,20,7,42,32,10,0,0,0,20,20,0,12,12,0,0,0,0,187,46,141,0,,23,0,23,53,0,53
21/10/2022 08:00,62,53,9,47,33,14,66,47,19,0,0,0,23,23,0,32,32,0,0,0,0,340,53,287,0,,43,0,43,120,1,119
21/10/2022 09:00,29,19,10,14,10,4,16,13,3,0,0,0,18,18,0,9,9,0,0,0,0,163,26,137,0,,41,0,41,86,1,85
21/10/2022 10:00,4,4,0,8,5,3,7,5,2,0,0,0,8,8,0,8,8,0,0,0,0,57,24,33,0,,12,0,12,41,0,41
21/10/2022 11:00,7,3,4,8,3,5,9,6,3,0,0,0,3,3,0,5,5,0,0,0,0,80,22,58,0,,28,0,28,42,0,42
21/10/2022 12:00,15,8,7,10,4,6,13,7,6,0,0,0,2,2,0,12,12,0,0,0,0,104,41,63,0,,68,0,68,68,0,68
21/10/2022 13:00,20,11,9,23,10,13,28,11,17,0,0,0,3,3,0,35,35,0,0,0,0,135,55,80,0,,80,1,79,127,0,127
21/10/2022 14:00,12,10,2,29,11,18,32,14,18,0,0,0,5,5,0,17,17,0,0,0,0,104,42,62,0,,79,0,79,81,0,81
21/10/2022 15:00,21,6,15,24,15,9,35,18,17,0,0,0,2,2,0,24,24,0,0,0,0,144,78,66,0,,64,2,62,83,1,82
21/10/2022 16:00,22,11,11,25,13,12,38,17,21,0,0,0,4,4,0,23,23,0,0,0,0,179,107,72,0,,103,0,103,84,1,83
21/10/2022 17:00,39,10,29,42,14,28,64,15,49,0,0,0,3,3,0,22,22,0,0,0,0,262,156,106,0,,184,0,184,115,0,115
21/10/2022 18:00,27,10,17,32,7,25,50,12,38,0,0,0,4,4,0,12,12,0,0,0,0,209,111,98,0,,146,2,144,96,1,95
21/10/2022 19:00,15,10,5,12,5,7,20,7,13,0,0,0,3,3,0,16,16,0,3,3,0,144,81,63,0,,104,0,104,74,1,73
21/10/2022 20:00,7,4,3,4,2,2,11,3,8,0,0,0,3,3,0,6,6,0,1,1,0,81,40,41,0,,65,0,65,75,0,75
21/10/2022 21:00,8,3,5,5,3,2,7,2,5,0,0,0,3,3,0,4,4,0,0,0,0,72,38,34,0,,69,0,69,74,0,74
21/10/2022 22:00,6,5,1,4,4,0,7,3,4,0,0,0,4,4,0,1,1,0,0,0,0,58,36,22,0,,53,1,52,36,1,35
21/10/2022 23:00,2,0,2,6,3,3,9,5,4,0,0,0,2,2,0,3,3,0,1,1,0,40,29,11,0,,51,0,51,34,0,34
22/10/2022 00:00,0,0,0,2,1,1,2,0,2,0,0,0,2,2,0,2,2,0,0,0,0,38,25,13,0,,28,0,28,19,0,19
22/10/2022 01:00,1,1,0,3,1,2,4,1,3,0,0,0,1,1,0,2,2,0,0,0,0,23,17,6,0,,9,0,9,0,0,0
22/10/2022 02:00,2,0,2,0,0,0,0,0,0,0,0,0,0,0,0,0,0,0,0,0,0,17,12,5,0,,24,0,24,6,0,6
22/10/2022 03:00,0,0,0,1,0,1,0,0,0,0,0,0,0,0,0,0,0,0,0,0,0,11,11,0,0,,18,0,18,4,0,4
22/10/2022 04:00,1,0,1,0,0,0,0,0,0,0,0,0,0,0,0,0,0,0,0,0,0,9,7,2,0,,3,0,3,5,0,5
22/10/2022 05:00,1,0,1,2,1,1,4,3,1,0,0,0,2,2,0,2,2,0,0,0,0,14,5,9,0,,4,0,4,2,0,2
22/10/2022 06:00,3,3,0,6,2,4,9,4,5,0,0,0,4,4,0,1,1,0,0,0,0,36,12,24,0,,5,0,5,6,0,6
22/10/2022 07:00,3,3,0,18,7,11,23,7,16,0,0,0,6,6,0,1,1,0,0,0,0,39,10,29,0,,11,0,11,11,0,11
22/10/2022 08:00,9,6,3,51,17,34,44,12,32,0,0,0,10,10,0,10,10,0,0,0,0,72,22,50,0,,20,0,20,32,0,32
22/10/2022 09:00,8,7,1,89,44,45,87,35,52,0,0,0,11,10,1,14,14,0,2,2,0,98,33,65,0,,28,0,28,50,0,50
22/10/2022 10:00,25,16,9,74,34,40,110,42,68,0,0,0,9,8,1,13,13,0,6,6,0,96,27,69,0,,33,0,33,75,1,74
22/10/2022 11:00,20,14,6,150,68,82,193,82,111,0,0,0,3,3,0,15,15,0,4,4,0,135,54,81,0,,55,0,55,68,0,68
22/10/2022 12:00,14,7,7,129,68,61,183,85,98,0,0,0,3,3,0,19,19,0,0,0,0,146,44,102,0,,66,1,65,105,0,105
22/10/2022 13:00,19,14,5,124,56,68,156,82,74,0,0,0,3,3,0,13,13,0,0,0,0,153,61,92,0,,80,0,80,113,1,112
22/10/2022 14:00,18,10,8,117,69,48,151,75,76,0,0,0,8,8,0,12,12,0,0,0,0,131,50,81,0,,97,2,95,118,1,117
22/10/2022 15:00,13,6,7,113,57,56,144,66,78,0,0,0,8,8,0,11,11,0,0,0,0,133,53,80,0,,93,0,93,130,0,130
22/10/2022 16:00,23,15,8,78,45,33,136,79,57,0,0,0,9,9,0,8,8,0,0,0,0,156,62,94,0,,111,0,111,109,0,109
22/10/2022 17:00,16,8,8,62,33,29,76,40,36,0,0,0,7,7,0,18,18,0,0,0,0,123,61,62,0,,96,2,94,84,1,83
22/10/2022 18:00,12,4,8,27,17,10,50,31,19,0,0,0,2,2,0,9,9,0,1,1,0,156,71,85,0,,101,1,100,81,0,81
22/10/2022 19:00,12,9,3,12,6,6,16,8,8,0,0,0,4,4,0,8,8,0,6,6,0,105,63,42,0,,96,0,96,89,2,87
22/10/2022 20:00,7,5,2,6,3,3,15,8,7,0,0,0,6,6,0,4,4,0,1,1,0,99,50,49,0,,77,1,76,94,0,94
22/10/2022 21:00,6,2,4,6,4,2,9,2,7,0,0,0,4,4,0,3,3,0,1,1,0,66,35,31,0,,61,0,61,72,0,72
22/10/2022 22:00,4,3,1,11,5,6,10,3,7,0,0,0,2,2,0,5,5,0,4,4,0,58,36,22,0,,54,0,54,32,0,32
22/10/2022 23:00,1,1,0,3,2,1,10,6,4,0,0,0,2,2,0,3,3,0,0,0,0,36,17,19,0,,39,0,39,33,0,33
23/10/2022 00:00,5,3,2,4,3,1,9,3,6,0,0,0,0,0,0,5,5,0,0,0,0,29,22,7,0,,31,0,31,27,0,27
23/10/2022 01:00,2,2,0,1,1,0,3,1,2,0,0,0,1,1,0,4,4,0,0,0,0,16,12,4,0,,11,1,10,1,0,1
23/10/2022 02:00,0,0,0,2,1,1,5,2,3,0,0,0,0,0,0,0,0,0,0,0,0,18,16,2,0,,26,0,26,4,0,4
23/10/2022 03:00,4,1,3,1,0,1,1,0,1,0,0,0,1,1,0,0,0,0,1,1,0,12,10,2,0,,20,0,20,4,0,4
23/10/2022 04:00,0,0,0,1,0,1,1,0,1,0,0,0,0,0,0,0,0,0,0,0,0,11,8,3,0,,13,0,13,3,0,3
23/10/2022 05:00,2,0,2,2,2,0,4,3,1,0,0,0,0,0,0,2,2,0,0,0,0,5,3,2,0,,4,1,3,1,0,1
23/10/2022 06:00,1,0,1,5,4,1,5,3,2,0,0,0,3,3,0,0,0,0,0,0,0,31,8,23,0,,5,0,5,4,0,4
23/10/2022 07:00,5,3,2,9,4,5,9,2,7,0,0,0,6,6,0,5,5,0,0,0,0,23,6,17,0,,9,0,9,6,0,6
23/10/2022 08:00,5,3,2,25,13,12,29,15,14,0,0,0,4,4,0,2,2,0,0,0,0,35,14,21,0,,7,0,7,7,1,6
23/10/2022 09:00,6,6,0,18,10,8,17,10,7,0,0,0,4,4,0,5,5,0,3,3,0,45,13,32,0,,13,0,13,15,0,15
23/10/2022 10:00,5,5,0,22,13,9,31,14,17,0,0,0,0,0,0,5,5,0,2,2,0,27,9,18,0,,10,0,10,16,0,16
23/10/2022 11:00,6,2,4,23,9,14,28,8,20,0,0,0,0,0,0,7,7,0,6,6,0,49,13,36,0,,20,0,20,34,1,33
23/10/2022 12:00,6,5,1,45,20,25,61,27,34,0,0,0,0,0,0,8,8,0,0,0,0,78,20,58,0,,55,0,55,62,1,61
23/10/2022 13:00,11,9,2,72,28,44,100,30,70,0,0,0,2,2,0,9,9,0,7,7,0,86,41,45,0,,58,0,58,82,2,80
23/10/2022 14:00,15,12,3,98,48,50,116,63,53,0,0,0,2,2,0,9,9,0,17,17,0,117,51,66,0,,67,0,67,103,0,103
23/10/2022 15:00,17,10,7,100,46,54,107,48,59,0,0,0,2,2,0,22,22,0,1,1,0,108,47,61,0,,63,0,63,93,0,93
23/10/2022 16:00,5,4,1,96,58,38,101,58,43,0,0,0,6,6,0,39,39,0,5,5,0,117,41,76,0,,65,0,65,87,0,87
23/10/2022 17:00,16,11,5,76,46,30,89,50,39,0,0,0,4,4,0,12,12,0,2,2,0,125,58,67,0,,122,0,122,95,0,95
23/10/2022 18:00,7,5,2,35,19,16,58,32,26,0,0,0,1,1,0,11,11,0,1,1,0,130,45,85,0,,117,0,117,98,1,97
23/10/2022 19:00,9,6,3,15,9,6,17,8,9,0,0,0,3,3,0,8,8,0,3,3,0,103,52,51,0,,91,0,91,95,0,95
23/10/2022 20:00,9,5,4,14,6,8,22,8,14,0,0,0,5,4,1,2,2,0,0,0,0,75,36,39,0,,71,0,71,102,0,102
23/10/2022 21:00,8,7,1,12,7,5,14,5,9,0,0,0,5,5,0,4,4,0,1,1,0,60,34,26,0,,49,1,48,61,1,60
23/10/2022 22:00,6,4,2,6,4,2,11,6,5,0,0,0,3,3,0,2,2,0,2,2,0,59,42,17,0,,47,1,46,26,1,25
23/10/2022 23:00,3,1,2,3,2,1,7,2,5,0,0,0,1,1,0,4,4,0,0,0,0,22,16,6,0,,34,0,34,13,0,13
24/10/2022 00:00,1,0,1,1,1,0,1,1,0,0,0,0,1,1,0,0,0,0,0,0,0,16,10,6,0,,16,1,15,9,0,9
24/10/2022 01:00,0,0,0,0,0,0,1,0,1,0,0,0,4,4,0,0,0,0,0,0,0,11,9,2,0,,8,0,8,0,0,0
24/10/2022 02:00,0,0,0,0,0,0,2,1,1,0,0,0,0,0,0,0,0,0,0,0,0,4,3,1,0,,3,0,3,1,0,1
24/10/2022 03:00,0,0,0,0,0,0,0,0,0,0,0,0,0,0,0,0,0,0,0,0,0,7,5,2,0,,0,0,0,0,0,0
24/10/2022 04:00,2,2,0,5,4,1,3,0,3,0,0,0,0,0,0,0,0,0,2,2,0,1,0,1,0,,3,0,3,1,0,1
24/10/2022 05:00,3,0,3,5,5,0,11,8,3,0,0,0,6,6,0,1,1,0,0,0,0,32,8,24,0,,7,0,7,6,0,6
24/10/2022 06:00,18,15,3,21,17,4,28,22,6,0,0,0,18,18,0,9,9,0,0,0,0,143,27,116,0,,10,0,10,31,0,31
24/10/2022 07:00,37,32,5,69,53,16,82,64,18,0,0,0,28,28,0,17,17,0,9,9,0,304,72,232,0,,33,1,32,72,1,71
24/10/2022 08:00,102,89,13,93,79,14,113,92,21,0,0,0,79,79,0,47,47,0,54,54,0,553,87,466,0,,75,1,74,173,2,171
24/10/2022 09:00,40,35,5,56,29,27,66,41,25,0,0,0,20,20,0,17,17,0,0,0,0,250,41,209,0,,41,0,41,128,1,127
24/10/2022 10:00,7,7,0,45,27,18,63,33,30,0,0,0,3,3,0,9,9,0,0,0,0,76,21,55,0,,24,0,24,53,1,52
24/10/2022 11:00,11,9,2,58,31,27,65,36,29,0,0,0,6,6,0,9,9,0,2,2,0,79,30,49,0,,41,0,41,51,0,51
24/10/2022 12:00,21,15,6,57,25,32,58,24,34,0,0,0,3,3,0,10,10,0,3,3,0,111,42,69,0,,65,0,65,90,1,89
24/10/2022 13:00,13,6,7,47,24,23,66,31,35,0,0,0,8,8,0,17,17,0,4,4,0,133,58,75,0,,81,0,81,111,2,109
24/10/2022 14:00,19,10,9,38,15,23,43,17,26,0,0,0,3,3,0,21,21,0,2,2,0,115,65,50,0,,65,0,65,82,1,81
24/10/2022 15:00,21,10,11,43,18,25,52,16,36,0,0,0,3,3,0,55,55,0,4,4,0,148,81,67,0,,92,1,91,64,0,64
24/10/2022 16:00,33,18,15,57,16,41,77,23,54,0,0,0,4,4,0,36,36,0,16,16,0,214,124,90,0,,133,0,133,73,0,73
24/10/2022 17:00,65,21,44,117,33,84,161,39,122,0,0,0,8,8,0,39,39,0,8,8,0,428,300,128,0,,236,0,236,128,2,126
24/10/2022 18:00,41,17,24,93,23,70,139,41,98,0,0,0,9,9,0,37,37,0,3,3,0,337,220,117,0,,191,1,190,117,0,117
24/10/2022 19:00,21,10,11,48,13,35,50,15,35,0,0,0,3,3,0,21,21,0,0,0,0,199,122,77,0,,112,1,111,97,1,96
24/10/2022 20:00,10,4,6,24,9,15,42,14,28,0,0,0,4,4,0,13,13,0,3,3,0,117,75,42,0,,97,0,97,95,1,94
24/10/2022 21:00,9,5,4,7,2,5,9,2,7,0,0,0,4,4,0,13,13,0,1,1,0,72,41,31,0,,52,0,52,53,2,51
24/10/2022 22:00,1,1,0,3,2,1,8,3,5,0,0,0,0,0,0,10,10,0,0,0,0,55,31,24,0,,43,0,43,24,0,24
24/10/2022 23:00,2,1,1,1,0,1,4,2,2,0,0,0,0,0,0,3,3,0,0,0,0,29,21,8,0,,40,0,40,10,0,10
25/10/2022 00:00,1,1,0,1,0,1,2,0,2,0,0,0,2,2,0,1,1,0,0,0,0,19,17,2,0,,16,0,16,3,0,3
25/10/2022 01:00,0,0,0,1,1,0,1,0,1,0,0,0,0,0,0,0,0,0,0,0,0,6,6,0,0,,0,0,0,0,0,0
25/10/2022 02:00,1,0,1,0,0,0,3,1,2,0,0,0,0,0,0,0,0,0,0,0,0,3,3,0,0,,4,0,4,0,0,0
25/10/2022 03:00,0,0,0,0,0,0,0,0,0,0,0,0,0,0,0,0,0,0,0,0,0,3,2,1,0,,1,0,1,2,0,2
25/10/2022 04:00,1,1,0,5,4,1,4,1,3,0,0,0,2,2,0,1,1,0,0,0,0,4,2,2,0,,2,0,2,3,0,3
25/10/2022 05:00,2,2,0,8,7,1,13,8,5,0,0,0,0,0,0,1,1,0,0,0,0,30,9,21,0,,5,0,5,17,0,17
25/10/2022 06:00,25,23,2,30,20,10,36,29,7,0,0,0,17,17,0,11,11,0,0,0,0,153,23,130,0,,15,0,15,39,1,38
25/10/2022 07:00,62,58,4,74,58,16,95,77,18,0,0,0,41,41,0,16,16,0,0,0,0,350,77,273,0,,37,0,37,89,0,89
25/10/2022 08:00,124,112,12,108,85,23,125,106,19,0,0,0,47,46,1,62,62,0,0,0,0,736,114,622,0,,70,0,70,209,3,206
25/10/2022 09:00,54,48,6,56,36,20,59,42,17,0,0,0,53,52,1,17,17,0,0,0,0,272,48,224,0,,52,0,52,159,1,158
25/10/2022 10:00,16,13,3,60,25,35,72,33,39,0,0,0,16,16,0,7,7,0,0,0,0,104,28,76,0,,38,0,38,52,0,52
25/10/2022 11:00,16,10,6,65,29,36,69,24,45,0,0,0,11,11,0,8,8,0,0,0,0,73,15,58,0,,41,1,40,81,0,81
25/10/2022 12:00,15,12,3,55,34,21,83,44,39,0,0,0,6,6,0,16,16,0,0,0,0,110,42,68,0,,68,1,67,96,0,96
25/10/2022 13:00,25,13,12,65,35,30,83,47,36,0,0,0,2,2,0,19,19,0,0,0,0,126,47,79,0,,70,0,70,103,0,103
25/10/2022 14:00,24,9,15,36,12,24,39,16,23,0,0,0,8,8,0,19,19,0,0,0,0,116,52,64,0,,68,0,68,80,0,80
25/10/2022 15:00,27,10,17,40,19,21,55,20,35,0,0,0,5,5,0,53,53,0,0,0,0,152,73,79,0,,80,0,80,66,0,66
25/10/2022 16:00,35,14,21,42,11,31,60,21,39,0,0,0,3,3,0,45,45,0,0,0,0,276,184,92,0,,155,0,155,83,0,83
25/10/2022 17:00,78,20,58,100,23,77,127,30,97,0,0,0,1,1,0,52,52,0,0,0,0,474,341,133,0,,257,0,257,151,1,150
25/10/2022 18:00,45,17,28,71,12,59,101,18,83,0,0,0,3,3,0,26,26,0,0,0,0,378,258,120,0,,202,0,202,108,0,108
25/10/2022 19:00,20,8,12,31,4,27,37,6,31,0,0,0,2,2,0,17,17,0,0,0,0,175,105,70,0,,130,0,130,68,0,68
25/10/2022 20:00,10,4,6,8,3,5,10,3,7,0,0,0,3,3,0,10,10,0,0,0,0,105,75,30,0,,76,0,76,55,1,54
25/10/2022 21:00,10,5,5,3,1,2,9,3,6,0,0,0,2,2,0,3,3,0,0,0,0,63,47,16,0,,66,0,66,32,0,32
25/10/2022 22:00,6,2,4,0,0,0,5,4,1,0,0,0,2,2,0,3,3,0,0,0,0,67,45,22,0,,41,0,41,28,0,28
25/10/2022 23:00,0,0,0,2,0,2,4,0,4,0,0,0,1,1,0,1,1,0,0,0,0,29,21,8,0,,34,0,34,15,0,15
26/10/2022 00:00,2,2,0,0,0,0,0,0,0,0,0,0,0,0,0,2,2,0,0,0,0,14,11,3,0,,16,0,16,3,0,3
26/10/2022 01:00,0,0,0,1,1,0,1,1,0,0,0,0,0,0,0,0,0,0,0,0,0,8,6,2,0,,5,0,5,2,0,2
26/10/2022 02:00,0,0,0,0,0,0,0,0,0,0,0,0,0,0,0,0,0,0,0,0,0,3,2,1,0,,2,0,2,1,0,1
26/10/2022 03:00,0,0,0,0,0,0,1,1,0,0,0,0,1,1,0,2,2,0,0,0,0,3,1,2,0,,0,0,0,3,0,3
26/10/2022 04:00,3,3,0,2,2,0,1,0,1,0,0,0,2,2,0,0,0,0,0,0,0,1,1,0,0,,1,0,1,2,0,2
26/10/2022 05:00,1,1,0,3,2,1,4,3,1,0,0,0,2,2,0,1,1,0,0,0,0,27,5,22,0,,1,0,1,7,1,6
26/10/2022 06:00,16,12,4,11,9,2,15,10,5,0,0,0,17,17,0,4,4,0,0,0,0,138,24,114,0,,16,0,16,39,0,39
26/10/2022 07:00,50,44,6,53,43,10,71,57,14,0,0,0,32,32,0,16,16,0,2,2,0,316,70,246,0,,35,0,35,81,0,81
26/10/2022 08:00,125,107,18,82,70,12,101,83,18,0,0,0,65,65,0,54,54,0,8,8,0,706,103,603,0,,84,0,84,224,0,224
26/10/2022 09:00,54,47,7,35,21,14,58,35,23,0,0,0,46,46,0,23,23,0,0,0,0,277,49,228,0,,33,1,32,148,2,146
26/10/2022 10:00,18,15,3,34,16,18,48,20,28,0,0,0,5,5,0,10,10,0,1,1,0,78,18,60,0,,26,0,26,71,0,71
26/10/2022 11:00,14,8,6,26,18,8,52,28,24,0,0,0,5,5,0,11,11,0,1,1,0,90,19,71,0,,39,1,38,60,1,59
26/10/2022 12:00,20,9,11,35,16,19,47,19,28,0,0,0,6,6,0,20,20,0,0,0,0,87,29,58,0,,64,2,62,94,0,94
26/10/2022 13:00,18,8,10,32,20,12,67,35,32,0,0,0,7,7,0,15,15,0,0,0,0,141,50,91,0,,90,0,90,107,0,107
26/10/2022 14:00,18,9,9,31,10,21,47,15,32,0,0,0,7,7,0,20,20,0,2,2,0,127,64,63,0,,72,0,72,81,0,81
26/10/2022 15:00,19,11,8,25,8,17,41,11,30,0,0,0,3,2,1,45,45,0,0,0,0,161,93,68,0,,63,1,62,49,0,49
26/10/2022 16:00,38,11,27,34,14,20,52,12,40,0,0,0,5,5,0,30,30,0,1,1,0,235,137,98,0,,135,0,135,71,1,70
26/10/2022 17:00,85,23,62,79,22,57,121,30,91,0,0,0,7,7,0,33,33,0,0,0,0,448,318,130,0,,235,0,235,115,0,115
26/10/2022 18:00,46,14,32,98,26,72,134,27,107,0,0,0,3,3,0,22,22,0,1,1,0,385,269,116,0,,245,0,245,121,2,119
26/10/2022 19:00,17,5,12,49,16,33,62,20,42,0,0,0,3,3,0,20,20,0,1,1,0,211,137,74,0,,143,0,143,98,1,97
26/10/2022 20:00,12,7,5,20,6,14,39,15,24,0,0,0,5,5,0,11,11,0,3,3,0,124,69,55,0,,108,1,107,71,1,70
26/10/2022 21:00,4,2,2,17,7,10,16,2,14,0,0,0,1,1,0,7,7,0,1,1,0,93,57,36,0,,92,0,92,69,0,69
26/10/2022 22:00,7,5,2,10,4,6,16,6,10,0,0,0,0,0,0,3,3,0,0,0,0,88,59,29,0,,71,2,69,26,0,26
26/10/2022 23:00,7,2,5,5,1,4,5,1,4,0,0,0,1,1,0,3,3,0,0,0,0,43,32,11,0,,44,0,44,15,0,15
27/10/2022 00:00,2,0,2,2,1,1,3,1,2,0,0,0,1,1,0,1,1,0,0,0,0,15,12,3,0,,20,0,20,8,0,8
27/10/2022 01:00,1,1,0,2,1,1,2,1,1,0,0,0,0,0,0,1,1,0,0,0,0,11,11,0,0,,3,0,3,0,0,0
27/10/2022 02:00,1,1,0,0,0,0,1,0,1,0,0,0,0,0,0,0,0,0,0,0,0,5,5,0,0,,6,0,6,2,0,2
27/10/2022 03:00,0,0,0,0,0,0,0,0,0,0,0,0,0,0,0,1,1,0,0,0,0,4,4,0,0,,7,0,7,2,0,2
27/10/2022 04:00,2,2,0,2,2,0,1,0,1,0,0,0,1,1,0,0,0,0,0,0,0,2,1,1,0,,1,1,0,2,0,2
27/10/2022 05:00,4,4,0,7,6,1,7,5,2,0,0,0,1,1,0,0,0,0,0,0,0,33,9,24,0,,5,0,5,12,1,11
27/10/2022 06:00,19,14,5,16,16,0,23,20,3,0,0,0,15,15,0,8,8,0,1,1,0,132,23,109,0,,7,0,7,31,0,31
27/10/2022 07:00,52,46,6,43,34,9,62,48,14,0,0,0,32,32,0,15,15,0,5,5,0,296,70,226,0,,29,0,29,80,1,79
27/10/2022 08:00,143,130,13,84,69,15,103,80,23,0,0,0,73,73,0,51,51,0,9,9,0,661,93,568,0,,78,0,78,221,1,220
27/10/2022 09:00,54,48,6,30,18,12,48,33,15,0,0,0,38,38,0,23,23,0,0,0,0,276,46,230,0,,39,0,39,154,0,154
27/10/2022 10:00,18,13,5,30,14,16,44,22,22,0,0,0,15,14,1,9,9,0,1,1,0,108,31,77,0,,11,0,11,77,0,77
27/10/2022 11:00,12,7,5,35,16,19,41,23,18,0,0,0,11,11,0,9,9,0,0,0,0,104,26,78,0,,27,0,27,70,2,68
27/10/2022 12:00,18,13,5,27,16,11,37,12,25,0,0,0,11,11,0,14,14,0,1,1,0,116,32,84,0,,68,0,68,92,1,91
27/10/2022 13:00,25,13,12,38,18,20,49,22,27,0,0,0,3,3,0,14,14,0,0,0,0,125,55,70,0,,94,0,94,78,0,78
27/10/2022 14:00,16,14,2,33,11,22,29,9,20,0,0,0,4,4,0,14,14,0,2,2,0,108,61,47,0,,82,1,81,81,2,79
27/10/2022 15:00,24,13,11,33,12,21,51,22,29,0,0,0,10,10,0,47,47,0,1,1,0,157,96,61,0,,78,1,77,76,0,76
27/10/2022 16:00,34,11,23,45,14,31,69,20,49,0,0,0,14,14,0,29,29,0,0,0,0,201,132,69,0,,119,1,118,89,0,89
27/10/2022 17:00,66,14,52,84,29,55,127,34,93,0,0,0,15,15,0,36,36,0,0,0,0,401,268,133,0,,212,1,211,132,1,131
27/10/2022 18:00,54,27,27,94,23,71,133,36,97,0,0,0,15,15,0,31,31,0,1,1,0,350,228,122,0,,189,0,189,126,1,125
27/10/2022 19:00,14,8,6,41,13,28,45,14,31,0,0,0,0,0,0,27,27,0,1,1,0,211,126,85,0,,134,3,131,123,0,123
27/10/2022 20:00,13,8,5,32,15,17,40,16,24,0,0,0,5,5,0,15,15,0,2,2,0,148,91,57,0,,103,1,102,120,2,118
27/10/2022 21:00,11,6,5,15,5,10,18,6,12,0,0,0,11,11,0,11,11,0,4,4,0,94,65,29,0,,98,1,97,81,2,79
27/10/2022 22:00,8,5,3,8,4,4,12,6,6,0,0,0,6,6,0,6,6,0,1,1,0,83,55,28,0,,90,1,89,38,2,36
27/10/2022 23:00,3,1,2,5,1,4,14,5,9,0,0,0,6,6,0,4,4,0,1,1,0,55,40,15,0,,67,0,67,30,0,30
28/10/2022 00:00,3,1,2,1,0,1,6,1,5,0,0,0,1,1,0,2,2,0,0,0,0,32,28,4,0,,38,1,37,18,1,17
28/10/2022 01:00,0,0,0,0,0,0,3,2,1,0,0,0,0,0,0,0,0,0,0,0,0,9,7,2,0,,3,0,3,0,0,0
28/10/2022 02:00,0,0,0,0,0,0,2,0,2,0,0,0,0,0,0,0,0,0,0,0,0,7,5,2,0,,15,0,15,3,0,3
28/10/2022 03:00,1,0,1,2,1,1,1,1,0,0,0,0,0,0,0,1,1,0,0,0,0,9,8,1,0,,8,0,8,3,0,3
28/10/2022 04:00,1,1,0,0,0,0,0,0,0,0,0,0,1,1,0,0,0,0,0,0,0,5,2,3,0,,2,0,2,2,0,2
28/10/2022 05:00,2,2,0,2,2,0,2,1,1,0,0,0,1,1,0,1,1,0,0,0,0,23,2,21,0,,4,1,3,10,0,10
28/10/2022 06:00,14,13,1,1,1,0,7,3,4,0,0,0,15,15,0,5,5,0,3,3,0,104,16,88,0,,7,0,7,26,0,26
28/10/2022 07:00,23,19,4,29,24,5,32,27,5,0,0,0,21,21,0,10,10,0,4,4,0,191,42,149,0,,30,0,30,53,0,53
28/10/2022 08:00,73,60,13,59,41,18,70,54,16,0,0,0,54,54,0,32,32,0,35,35,0,392,73,319,0,,42,1,41,125,0,125
28/10/2022 09:00,37,31,6,33,18,15,39,28,11,0,0,0,31,30,1,20,20,0,5,5,0,195,34,161,0,,32,0,32,120,1,119
28/10/2022 10:00,9,7,2,54,24,30,61,23,38,0,0,0,9,9,0,9,9,0,6,6,0,98,29,69,0,,34,0,34,55,1,54
28/10/2022 11:00,11,8,3,53,27,26,65,33,32,0,0,0,12,12,0,12,12,0,0,0,0,91,28,63,0,,44,1,43,77,0,77
28/10/2022 12:00,23,13,10,47,26,21,64,28,36,0,0,0,11,11,0,22,22,0,0,0,0,134,43,91,0,,77,0,77,87,1,86
28/10/2022 13:00,14,7,7,28,12,16,45,16,29,0,0,0,5,5,0,25,25,0,1,1,0,149,87,62,0,,65,0,65,126,1,125
28/10/2022 14:00,19,14,5,32,18,14,52,21,31,0,0,0,10,10,0,20,20,0,0,0,0,122,64,58,0,,97,1,96,119,0,119
28/10/2022 15:00,19,11,8,42,16,26,62,22,40,0,0,0,6,6,0,27,27,0,0,0,0,165,83,82,0,,78,0,78,89,0,89
28/10/2022 16:00,36,15,21,46,16,30,74,22,52,0,0,0,8,8,0,31,31,0,0,0,0,226,122,104,0,,144,0,144,111,0,111
28/10/2022 17:00,48,20,28,60,23,37,91,29,62,0,0,0,16,16,0,24,24,0,0,0,0,251,149,102,0,,164,0,164,127,2,125
28/10/2022 18:00,27,11,16,44,16,28,72,21,51,0,0,0,14,14,0,20,20,0,0,0,0,226,135,91,0,,156,0,156,121,1,120
28/10/2022 19:00,21,13,8,18,9,9,28,9,19,0,0,0,10,10,0,14,14,0,0,0,0,170,83,87,0,,125,1,124,110,1,109
28/10/2022 20:00,16,6,10,16,7,9,17,8,9,0,0,0,11,11,0,13,13,0,0,0,0,125,58,67,0,,106,1,105,116,0,116
28/10/2022 21:00,9,3,6,8,5,3,17,6,11,0,0,0,5,5,0,6,6,0,3,3,0,91,46,45,0,,87,1,86,69,0,69
28/10/2022 22:00,5,5,0,8,4,4,14,3,11,0,0,0,5,5,0,2,2,0,1,1,0,50,35,15,0,,65,1,64,52,1,51
28/10/2022 23:00,5,2,3,6,2,4,9,3,6,0,0,0,0,0,0,5,5,0,1,1,0,53,43,10,0,,45,1,44,44,2,42
29/10/2022 00:00,3,1,2,3,1,2,3,2,1,0,0,0,2,2,0,2,2,0,0,0,0,30,21,9,0,,39,0,39,27,0,27
29/10/2022 01:00,0,0,0,2,2,0,1,1,0,0,0,0,1,1,0,2,2,0,1,1,0,27,16,11,0,,6,0,6,2,0,2
29/10/2022 02:00,1,1,0,0,0,0,0,0,0,0,0,0,0,0,0,1,1,0,0,0,0,17,11,6,0,,20,0,20,6,0,6
29/10/2022 03:00,0,0,0,0,0,0,1,0,1,0,0,0,0,0,0,3,3,0,0,0,0,20,14,6,0,,18,0,18,3,1,2
29/10/2022 04:00,2,1,1,0,0,0,0,0,0,0,0,0,0,0,0,0,0,0,0,0,0,10,9,1,0,,8,0,8,4,0,4
29/10/2022 05:00,2,1,1,2,2,0,3,2,1,0,0,0,1,1,0,0,0,0,0,0,0,14,4,10,0,,4,0,4,4,0,4
29/10/2022 06:00,2,1,1,0,0,0,0,0,0,0,0,0,4,4,0,2,2,0,0,0,0,27,7,20,0,,2,0,2,5,0,5
29/10/2022 07:00,3,2,1,5,2,3,9,6,3,0,0,0,3,3,0,1,1,0,0,0,0,33,11,22,0,,7,0,7,11,0,11
29/10/2022 08:00,11,9,2,14,9,5,19,9,10,0,0,0,5,5,0,1,1,0,0,0,0,53,14,39,0,,11,0,11,22,0,22
29/10/2022 09:00,9,6,3,7,4,3,17,6,11,0,0,0,3,3,0,4,4,0,0,0,0,68,19,49,0,,16,1,15,35,0,35
29/10/2022 10:00,4,3,1,11,2,9,18,12,6,0,0,0,3,3,0,3,3,0,1,1,0,51,10,41,0,,22,0,22,32,0,32
29/10/2022 11:00,7,6,1,7,3,4,15,8,7,0,0,0,3,3,0,1,1,0,0,0,0,61,14,47,0,,26,0,26,64,0,64
29/10/2022 12:00,12,9,3,31,13,18,39,20,19,0,0,0,4,4,0,9,9,0,0,0,0,76,21,55,0,,47,0,47,75,0,75
29/10/2022 13:00,12,11,1,32,14,18,51,19,32,0,0,0,9,9,0,5,5,0,0,0,0,80,31,49,0,,68,0,68,106,0,106
29/10/2022 14:00,14,10,4,29,10,19,49,16,33,0,0,0,8,8,0,6,6,0,0,0,0,111,48,63,0,,58,0,58,92,0,92
29/10/2022 15:00,24,15,9,42,20,22,48,23,25,0,0,0,3,3,0,16,16,0,0,0,0,93,31,62,0,,53,0,53,115,0,115
29/10/2022 16:00,12,7,5,51,27,24,69,29,40,0,0,0,8,8,0,11,11,0,0,0,0,110,43,67,0,,73,0,73,77,0,77
29/10/2022 17:00,13,7,6,34,19,15,60,30,30,0,0,0,5,5,0,7,7,0,0,0,0,99,43,56,0,,91,0,91,87,1,86
29/10/2022 18:00,12,9,3,26,20,6,36,22,14,0,0,0,6,6,0,12,12,0,0,0,0,123,56,67,0,,96,1,95,72,0,72
29/10/2022 19:00,11,7,4,16,8,8,19,12,7,0,0,0,2,2,0,5,5,0,0,0,0,95,46,49,0,,81,0,81,96,2,94
29/10/2022 20:00,7,2,5,6,2,4,17,9,8,0,0,0,2,2,0,3,3,0,0,0,0,66,31,35,0,,58,0,58,87,1,86
29/10/2022 21:00,7,7,0,2,2,0,3,2,1,0,0,0,5,5,0,5,5,0,0,0,0,44,24,20,0,,64,0,64,57,1,56
29/10/2022 22:00,9,7,2,6,1,5,7,3,4,0,0,0,3,3,0,2,2,0,0,0,0,39,24,15,0,,42,1,41,44,0,44
29/10/2022 23:00,2,1,1,6,2,4,9,3,6,0,0,0,5,5,0,1,1,0,0,0,0,38,23,15,0,,30,0,30,24,0,24
30/10/2022 00:00,2,1,1,6,3,3,8,3,5,0,0,0,2,2,0,4,4,0,0,0,0,23,17,6,0,,28,0,28,20,0,20
30/10/2022 01:00,2,2,0,5,4,1,6,0,6,0,0,0,1,1,0,2,2,0,0,0,0,37,28,9,0,,27,1,26,16,0,16
30/10/2022 02:00,0,0,0,2,1,1,5,2,3,0,0,0,1,1,0,0,0,0,0,0,0,13,10,3,0,,15,0,15,6,0,6
30/10/2022 03:00,0,0,0,0,0,0,1,0,1,0,0,0,0,0,0,0,0,0,0,0,0,12,5,7,0,,13,1,12,5,0,5
30/10/2022 04:00,1,0,1,0,0,0,0,0,0,0,0,0,0,0,0,0,0,0,0,0,0,7,6,1,0,,5,0,5,5,0,5
30/10/2022 05:00,1,0,1,3,2,1,3,2,1,0,0,0,6,5,1,0,0,0,0,0,0,8,3,5,0,,5,0,5,2,0,2
30/10/2022 06:00,2,2,0,6,3,3,7,3,4,0,0,0,6,6,0,0,0,0,0,0,0,27,4,23,0,,10,2,8,3,0,3
30/10/2022 07:00,6,6,0,28,11,17,24,9,15,0,0,0,25,25,0,2,2,0,0,0,0,57,13,44,0,,14,2,12,27,0,27
30/10/2022 08:00,14,9,5,72,31,41,76,30,46,0,0,0,12,12,0,8,8,0,0,0,0,92,31,61,0,,17,0,17,45,1,44
30/10/2022 09:00,16,12,4,90,44,46,92,41,51,0,0,0,8,8,0,17,17,0,0,0,0,156,99,57,0,,19,0,19,52,0,52
30/10/2022 10:00,12,8,4,116,53,63,124,53,71,0,0,0,5,5,0,6,6,0,1,1,0,269,89,180,0,,60,2,58,64,0,64
30/10/2022 11:00,18,11,7,99,49,50,127,57,70,0,0,0,5,5,0,14,14,0,0,0,0,234,47,187,0,,57,0,57,77,0,77
30/10/2022 12:00,13,8,5,80,40,40,114,60,54,0,0,0,0,0,0,17,17,0,0,0,0,206,42,164,0,,55,1,54,83,0,83
30/10/2022 13:00,16,8,8,65,41,24,107,50,57,0,0,0,2,2,0,12,12,0,0,0,0,131,53,78,0,,74,0,74,76,1,75
30/10/2022 14:00,20,10,10,89,40,49,108,53,55,0,0,0,1,1,0,8,8,0,0,0,0,104,55,49,0,,90,1,89,79,0,79
30/10/2022 15:00,25,8,17,70,36,34,88,35,53,0,0,0,9,9,0,10,10,0,0,0,0,118,54,64,0,,85,2,83,82,0,82
30/10/2022 16:00,11,7,4,76,45,31,96,53,43,0,0,0,3,3,0,10,10,0,0,0,0,105,55,50,0,,82,0,82,65,0,65
30/10/2022 17:00,12,6,6,46,31,15,52,32,20,0,0,0,5,5,0,11,11,0,0,0,0,94,57,37,0,,86,0,86,67,0,67
30/10/2022 18:00,14,2,12,20,11,9,24,11,13,0,0,0,11,11,0,7,7,0,0,0,0,99,46,53,0,,82,0,82,100,0,100
30/10/2022 19:00,7,6,1,11,5,6,19,8,11,0,0,0,2,2,0,6,6,0,0,0,0,87,41,46,0,,58,0,58,72,0,72
30/10/2022 20:00,6,6,0,3,1,2,9,6,3,0,0,0,5,5,0,6,6,0,0,0,0,79,34,45,0,,59,0,59,58,1,57
30/10/2022 21:00,9,4,5,11,6,5,17,6,11,0,0,0,3,3,0,5,5,0,0,0,0,57,27,30,0,,37,0,37,38,1,37
30/10/2022 22:00,4,2,2,8,6,2,9,5,4,0,0,0,2,2,0,2,2,0,0,0,0,46,31,15,0,,34,1,33,35,1,34
30/10/2022 23:00,0,0,0,2,1,1,5,3,2,0,0,0,0,0,0,3,3,0,0,0,0,27,20,7,0,,27,0,27,14,0,14
31/10/2022 00:00,2,1,1,3,2,1,2,1,1,0,0,0,4,4,0,2,2,0,0,0,0,24,16,8,0,,9,0,9,1,0,1
31/10/2022 01:00,0,0,0,4,3,1,8,1,7,0,0,0,0,0,0,0,0,0,0,0,0,13,8,5,0,,25,0,25,8,0,8
31/10/2022 02:00,0,0,0,2,1,1,5,1,4,0,0,0,0,0,0,0,0,0,0,0,0,24,16,8,0,,14,1,13,7,0,7
31/10/2022 03:00,0,0,0,2,1,1,2,1,1,0,0,0,2,2,0,0,0,0,0,0,0,11,6,5,0,,11,0,11,3,0,3
31/10/2022 04:00,4,2,2,2,1,1,1,0,1,0,0,0,2,2,0,0,0,0,0,0,0,0,0,0,0,,11,0,11,2,0,2
31/10/2022 05:00,4,2,2,1,1,0,1,1,0,0,0,0,1,1,0,0,0,0,0,0,0,7,2,5,0,,4,0,4,2,0,2
31/10/2022 06:00,1,0,1,3,2,1,3,2,1,0,0,0,5,5,0,1,1,0,0,0,0,40,7,33,0,,5,0,5,7,0,7
31/10/2022 07:00,7,5,2,11,8,3,14,7,7,0,0,0,5,5,0,1,1,0,0,0,0,39,8,31,0,,6,0,6,15,0,15
31/10/2022 08:00,5,3,2,33,17,16,32,15,17,0,0,0,7,7,0,6,6,0,0,0,0,72,19,53,0,,11,0,11,13,0,13
31/10/2022 09:00,7,4,3,64,28,36,69,29,40,0,0,0,10,10,0,4,4,0,0,0,0,56,6,50,0,,18,0,18,40,0,40
31/10/2022 10:00,6,1,5,58,24,34,64,29,35,0,0,0,7,7,0,5,5,0,1,1,0,77,37,40,0,,30,0,30,37,0,37
31/10/2022 11:00,12,6,6,80,35,45,87,37,50,0,0,0,1,1,0,9,9,0,0,0,0,75,26,49,0,,32,0,32,60,1,59
31/10/2022 12:00,13,11,2,66,39,27,69,29,40,0,0,0,1,1,0,13,13,0,0,0,0,74,29,45,0,,51,0,51,73,0,73
31/10/2022 13:00,10,2,8,23,15,8,54,29,25,0,0,0,1,1,0,7,7,0,0,0,0,80,41,39,0,,70,0,70,78,0,78
31/10/2022 14:00,15,10,5,24,12,12,35,14,21,0,0,0,4,3,1,11,11,0,0,0,0,79,41,38,0,,56,0,56,73,1,72
31/10/2022 15:00,3,2,1,23,14,9,34,19,15,0,0,0,1,1,0,12,12,0,1,1,0,57,25,32,0,,38,0,38,47,0,47
31/10/2022 16:00,13,8,5,8,7,1,18,12,6,0,0,0,3,3,0,3,3,0,1,1,0,80,41,39,0,,61,1,60,32,1,31
31/10/2022 17:00,14,5,9,8,2,6,21,10,11,0,0,0,2,2,0,12,12,0,1,1,0,75,38,37,0,,39,0,39,46,0,46
31/10/2022 18:00,7,6,1,11,5,6,19,8,11,0,0,0,2,2,0,2,2,0,0,0,0,84,41,43,0,,46,0,46,52,0,52
31/10/2022 19:00,6,4,2,15,5,10,14,5,9,0,0,0,7,7,0,12,12,0,3,3,0,65,35,30,0,,58,0,58,45,0,45
31/10/2022 20:00,6,4,2,8,5,3,9,4,5,0,0,0,1,1,0,8,8,0,2,2,0,42,22,20,0,,51,0,51,40,0,40
31/10/2022 21:00,2,1,1,1,1,0,2,1,1,0,0,0,0,0,0,8,8,0,0,0,0,28,14,14,0,,33,0,33,20,0,20
31/10/2022 22:00,2,1,1,0,0,0,0,0,0,0,0,0,1,1,0,1,1,0,0,0,0,28,21,7,0,,23,0,23,21,0,21
31/10/2022 23:00,1,1,0,1,1,0,3,0,3,0,0,0,0,0,0,0,0,0,0,0,0,15,11,4,0,,20,0,20,12,0,12
01/11/2022 00:00,0,0,0,1,1,0,1,1,0,0,0,0,1,1,0,2,2,0,1,1,0,11,8,3,0,,3,0,3,0,0,0
01/11/2022 01:00,1,1,0,1,1,0,1,1,0,0,0,0,1,1,0,0,0,0,0,0,0,3,3,0,0,,3,0,3,0,0,0
01/11/2022 02:00,0,0,0,1,1,0,1,0,1,0,0,0,0,0,0,0,0,0,0,0,0,1,1,0,0,,5,0,5,1,0,1
01/11/2022 03:00,1,0,1,0,0,0,0,0,0,0,0,0,2,2,0,0,0,0,0,0,0,3,1,2,0,,11,1,10,0,0,0
01/11/2022 04:00,1,1,0,0,0,0,1,1,0,0,0,0,1,1,0,0,0,0,0,0,0,3,0,3,0,,6,0,6,3,0,3
01/11/2022 05:00,4,4,0,5,4,1,7,3,4,0,0,0,2,2,0,1,1,0,0,0,0,28,6,22,0,,4,0,4,6,0,6
01/11/2022 06:00,19,18,1,16,9,7,19,12,7,0,0,0,20,20,0,7,7,0,0,0,0,131,22,109,0,,7,0,7,38,0,38
01/11/2022 07:00,53,46,7,50,43,7,55,44,11,0,0,0,37,37,0,18,18,0,0,0,0,268,61,207,0,,24,0,24,82,0,82
01/11/2022 08:00,94,85,9,70,56,14,94,73,21,0,0,0,47,47,0,15,15,0,3,3,0,542,77,465,0,,55,0,55,209,1,208
01/11/2022 09:00,26,23,3,41,23,18,54,33,21,0,0,0,18,18,0,15,15,0,1,1,0,179,22,157,0,,36,2,34,135,0,135
01/11/2022 10:00,13,8,5,49,23,26,62,21,41,0,0,0,13,13,0,4,4,0,2,2,0,72,18,54,0,,40,1,39,79,0,79
01/11/2022 11:00,11,7,4,42,25,17,48,31,17,0,0,0,2,2,0,7,7,0,2,2,0,70,20,50,0,,24,0,24,52,1,51
01/11/2022 12:00,10,8,2,36,13,23,49,19,30,0,0,0,2,2,0,3,3,0,8,8,0,77,29,48,0,,67,0,67,74,0,74
01/11/2022 13:00,21,10,11,65,30,35,77,30,47,0,0,0,2,2,0,6,6,0,14,14,0,126,53,73,0,,76,0,76,80,2,78
01/11/2022 14:00,22,6,16,39,18,21,51,23,28,0,0,0,4,4,0,12,12,0,7,7,0,121,63,58,0,,72,0,72,86,0,86
01/11/2022 15:00,20,8,12,40,21,19,58,25,33,0,0,0,3,3,0,10,10,0,5,5,0,137,79,58,0,,85,1,84,65,1,64
01/11/2022 16:00,28,13,15,67,29,38,94,43,51,0,0,0,1,1,0,17,17,0,5,5,0,218,144,74,0,,147,1,146,79,1,78
01/11/2022 17:00,48,16,32,81,16,65,104,22,82,0,0,0,4,4,0,33,33,0,4,4,0,408,287,121,0,,248,1,247,105,2,103
01/11/2022 18:00,42,13,29,63,20,43,74,17,57,0,0,0,6,4,2,23,23,0,1,1,0,279,186,93,0,,181,3,178,107,1,106
01/11/2022 19:00,11,4,7,35,8,27,41,5,36,0,0,0,7,7,0,18,18,0,1,1,0,162,99,63,0,,127,0,127,85,1,84
01/11/2022 20:00,14,6,8,17,2,15,15,5,10,0,0,0,3,3,0,13,13,0,10,10,0,127,86,41,0,,67,0,67,53,0,53
01/11/2022 21:00,5,3,2,4,0,4,11,1,10,0,0,0,1,1,0,4,4,0,0,0,0,77,48,29,0,,51,0,51,32,0,32
01/11/2022 22:00,5,2,3,4,3,1,10,3,7,0,0,0,5,5,0,3,3,0,4,4,0,57,40,17,0,,42,1,41,28,1,27
01/11/2022 23:00,4,3,1,1,0,1,5,2,3,0,0,0,1,1,0,0,0,0,0,0,0,23,18,5,0,,39,1,38,15,0,15
02/11/2022 00:00,1,1,0,2,1,1,4,2,2,0,0,0,1,1,0,1,1,0,0,0,0,16,13,3,0,,17,0,17,4,0,4
02/11/2022 01:00,1,0,1,0,0,0,1,1,0,0,0,0,0,0,0,1,1,0,0,0,0,6,4,2,0,,1,0,1,0,0,0
02/11/2022 02:00,0,0,0,0,0,0,0,0,0,0,0,0,0,0,0,0,0,0,0,0,0,1,1,0,0,,2,0,2,1,0,1
02/11/2022 03:00,0,0,0,0,0,0,0,0,0,0,0,0,0,0,0,0,0,0,0,0,0,4,3,1,0,,3,0,3,2,0,2
02/11/2022 04:00,1,1,0,2,2,0,3,1,2,0,0,0,0,0,0,1,1,0,0,0,0,2,1,1,0,,0,0,0,3,0,3
02/11/2022 05:00,4,4,0,1,0,1,2,1,1,0,0,0,0,0,0,1,1,0,0,0,0,28,4,24,0,,1,0,1,6,0,6
02/11/2022 06:00,15,14,1,11,7,4,14,9,5,0,0,0,10,10,0,5,5,0,1,1,0,120,26,94,0,,10,0,10,33,0,33
02/11/2022 07:00,37,36,1,30,26,4,50,40,10,0,0,0,29,29,0,13,13,0,6,6,0,271,64,207,0,,28,0,28,75,0,75
02/11/2022 08:00,87,84,3,42,38,4,60,54,6,0,0,0,42,41,1,14,14,0,5,5,0,481,72,409,0,,59,0,59,172,0,172
02/11/2022 09:00,32,30,2,16,13,3,18,15,3,0,0,0,13,13,0,11,11,0,3,3,0,194,34,160,0,,34,0,34,112,0,112
02/11/2022 10:00,13,11,2,7,4,3,12,3,9,0,0,0,9,9,0,6,6,0,0,0,0,65,22,43,0,,29,0,29,40,1,39
02/11/2022 11:00,6,4,2,3,2,1,5,1,4,0,0,0,1,1,0,4,4,0,1,1,0,46,12,34,0,,13,0,13,42,0,42
02/11/2022 12:00,14,9,5,1,0,1,3,2,1,0,0,0,1,1,0,2,2,0,0,0,0,52,16,36,0,,39,0,39,46,1,45
02/11/2022 13:00,8,6,2,7,3,4,6,1,5,0,0,0,2,2,0,5,5,0,2,2,0,90,38,52,0,,56,2,54,77,1,76
02/11/2022 14:00,8,4,4,5,2,3,11,3,8,0,0,0,0,0,0,6,6,0,7,7,0,97,43,54,0,,53,0,53,38,0,38
02/11/2022 15:00,16,8,8,24,6,18,13,2,11,0,0,0,2,2,0,4,4,0,5,5,0,120,56,64,0,,55,0,55,54,1,53
02/11/2022 16:00,31,11,20,12,4,8,27,5,22,0,0,0,6,6,0,15,15,0,7,7,0,183,115,68,0,,97,0,97,70,0,70
02/11/2022 17:00,46,12,34,36,8,28,69,14,55,0,0,0,2,2,0,15,15,0,9,9,0,341,234,107,0,,190,1,189,81,0,81
02/11/2022 18:00,23,9,14,17,2,15,50,4,46,0,0,0,2,2,0,25,25,0,2,2,0,251,162,89,0,,150,0,150,77,1,76
02/11/2022 19:00,14,3,11,11,2,9,22,3,19,0,0,0,2,2,0,9,9,0,7,7,0,134,87,47,0,,112,0,112,77,0,77
02/11/2022 20:00,16,6,10,7,1,6,5,1,4,0,0,0,3,3,0,5,5,0,25,25,0,84,52,32,0,,75,0,75,57,0,57
02/11/2022 21:00,3,3,0,5,1,4,9,0,9,0,0,0,1,1,0,2,2,0,2,2,0,66,50,16,0,,57,0,57,40,0,40
02/11/2022 22:00,2,1,1,4,2,2,6,2,4,0,0,0,0,0,0,3,3,0,0,0,0,34,23,11,0,,26,0,26,33,0,33
02/11/2022 23:00,3,1,2,2,0,2,6,2,4,0,0,0,0,0,0,1,1,0,0,0,0,24,17,7,0,,32,0,32,13,0,13
03/11/2022 00:00,3,2,1,0,0,0,2,0,2,0,0,0,0,0,0,2,2,0,0,0,0,17,14,3,0,,15,0,15,4,0,4
03/11/2022 01:00,0,0,0,0,0,0,1,1,0,0,0,0,0,0,0,0,0,0,0,0,0,7,6,1,0,,3,0,3,0,0,0
03/11/2022 02:00,1,1,0,0,0,0,0,0,0,0,0,0,0,0,0,0,0,0,0,0,0,3,3,0,0,,0,0,0,1,0,1
03/11/2022 03:00,0,0,0,0,0,0,0,0,0,0,0,0,0,0,0,0,0,0,0,0,0,4,4,0,0,,3,0,3,2,0,2
03/11/2022 04:00,0,0,0,2,1,1,3,1,2,0,0,0,1,1,0,0,0,0,0,0,0,7,4,3,0,,2,0,2,1,0,1
03/11/2022 05:00,2,2,0,4,2,2,7,4,3,0,0,0,1,1,0,0,0,0,0,0,0,23,4,19,0,,3,1,2,6,0,6
03/11/2022 06:00,16,15,1,22,15,7,22,18,4,0,0,0,21,21,0,6,6,0,3,3,0,124,26,98,0,,8,0,8,34,0,34
03/11/2022 07:00,37,31,6,45,36,9,62,49,13,0,0,0,26,26,0,12,12,0,0,0,0,254,60,194,0,,28,0,28,65,0,65
03/11/2022 08:00,93,85,8,77,60,17,96,74,22,0,0,0,42,41,1,11,11,0,0,0,0,502,76,426,0,,50,0,50,172,0,172
03/11/2022 09:00,47,40,7,47,25,22,76,45,31,0,0,0,10,10,0,10,10,0,8,8,0,226,33,193,0,,33,1,32,129,0,129
03/11/2022 10:00,13,12,1,70,28,42,76,32,44,0,0,0,13,13,0,6,6,0,3,3,0,89,26,63,0,,36,0,36,69,0,69
03/11/2022 11:00,16,12,4,84,45,39,99,48,51,0,0,0,7,7,0,9,9,0,4,4,0,83,32,51,0,,36,1,35,59,1,58
03/11/2022 12:00,19,11,8,77,44,33,94,52,42,0,0,0,3,3,0,16,16,0,1,1,0,108,40,68,0,,65,1,64,90,1,89
03/11/2022 13:00,17,4,13,53,29,24,71,38,33,0,0,0,1,1,0,14,14,0,1,1,0,122,54,68,0,,67,1,66,87,0,87
03/11/2022 14:00,15,7,8,36,15,21,48,25,23,0,0,0,3,3,0,9,9,0,0,0,0,113,57,56,0,,61,1,60,72,0,72
03/11/2022 15:00,28,16,12,45,21,24,52,23,29,0,0,0,2,2,0,11,11,0,0,0,0,147,68,79,0,,81,0,81,68,0,68
03/11/2022 16:00,25,10,15,41,14,27,66,22,44,0,0,0,8,8,0,18,18,0,11,11,0,199,123,76,0,,122,0,122,69,0,69
03/11/2022 17:00,46,16,30,56,18,38,80,15,65,0,0,0,1,1,0,26,26,0,12,12,0,355,232,123,0,,197,2,195,111,2,109
03/11/2022 18:00,33,13,20,80,16,64,114,23,91,0,0,0,2,2,0,19,19,0,10,10,0,314,202,112,0,,164,0,164,93,0,93
03/11/2022 19:00,17,5,12,31,12,19,37,9,28,0,0,0,3,3,0,10,10,0,8,8,0,202,110,92,0,,139,0,139,112,0,112
03/11/2022 20:00,17,4,13,22,10,12,23,10,13,0,0,0,1,1,0,5,5,0,9,9,0,115,64,51,0,,108,0,108,74,0,74
03/11/2022 21:00,10,5,5,9,3,6,13,3,10,0,0,0,6,6,0,8,8,0,4,4,0,75,57,18,0,,75,0,75,62,0,62
03/11/2022 22:00,8,6,2,5,2,3,9,3,6,0,0,0,3,3,0,7,7,0,3,3,0,64,41,23,0,,53,1,52,18,0,18
03/11/2022 23:00,2,0,2,2,1,1,4,2,2,0,0,0,3,3,0,3,3,0,1,1,0,32,23,9,0,,46,0,46,28,0,28
04/11/2022 00:00,2,1,1,2,0,2,7,3,4,0,0,0,1,1,0,2,2,0,1,1,0,19,15,4,0,,28,0,28,14,0,14
04/11/2022 01:00,1,1,0,0,0,0,0,0,0,0,0,0,1,1,0,1,1,0,0,0,0,9,6,3,0,,7,0,7,0,0,0
04/11/2022 02:00,0,0,0,2,0,2,2,1,1,0,0,0,0,0,0,0,0,0,0,0,0,7,6,1,0,,6,0,6,2,0,2
04/11/2022 03:00,1,0,1,0,0,0,1,1,0,0,0,0,1,1,0,0,0,0,0,0,0,6,4,2,0,,6,0,6,1,0,1
04/11/2022 04:00,0,0,0,3,1,2,5,1,4,0,0,0,0,0,0,0,0,0,1,1,0,7,2,5,0,,1,0,1,3,1,2
04/11/2022 05:00,0,0,0,3,2,1,4,3,1,0,0,0,2,2,0,0,0,0,2,2,0,32,9,23,0,,6,0,6,7,0,7
04/11/2022 06:00,12,11,1,19,12,7,28,18,10,0,0,0,15,15,0,4,4,0,2,2,0,116,18,98,0,,8,0,8,29,0,29
04/11/2022 07:00,31,28,3,37,25,12,52,38,14,0,0,0,15,15,0,10,10,0,5,5,0,209,52,157,0,,22,1,21,63,0,63
04/11/2022 08:00,73,57,16,58,46,12,70,49,21,0,0,0,37,37,0,16,16,0,13,13,0,377,69,308,0,,37,0,37,149,0,149
04/11/2022 09:00,23,21,2,36,23,13,50,29,21,0,0,0,12,12,0,14,14,0,4,4,0,182,35,147,0,,33,0,33,111,0,111
04/11/2022 10:00,22,19,3,42,21,21,63,29,34,0,0,0,5,5,0,7,7,0,2,2,0,82,21,61,0,,15,1,14,67,0,67
04/11/2022 11:00,11,9,2,57,24,33,68,25,43,0,0,0,6,6,0,14,14,0,0,0,0,100,29,71,0,,37,0,37,77,0,77
04/11/2022 12:00,21,12,9,67,32,35,84,44,40,0,0,0,3,3,0,6,6,0,4,4,0,100,39,61,0,,74,0,74,102,1,101
04/11/2022 13:00,29,15,14,53,32,21,59,24,35,0,0,0,1,1,0,8,8,0,16,16,0,112,57,55,0,,77,0,77,105,0,105
04/11/2022 14:00,17,8,9,70,26,44,81,34,47,0,0,0,1,1,0,19,19,0,6,6,0,122,60,62,0,,106,0,106,87,0,87
04/11/2022 15:00,28,15,13,71,35,36,71,33,38,0,0,0,3,3,0,13,13,0,5,5,0,144,71,73,0,,101,1,100,77,1,76
04/11/2022 16:00,29,14,15,60,24,36,85,33,52,0,0,0,3,3,0,18,18,0,7,7,0,212,119,93,0,,141,0,141,85,0,85
04/11/2022 17:00,43,15,28,69,24,45,84,28,56,0,0,0,4,4,0,16,16,0,12,12,0,293,181,112,0,,190,0,190,117,2,115
04/11/2022 18:00,20,9,11,43,11,32,56,15,41,0,0,0,10,10,0,16,16,0,2,2,0,247,143,104,0,,151,1,150,124,1,123
04/11/2022 19:00,17,9,8,18,8,10,25,8,17,0,0,0,10,10,0,13,13,0,4,4,0,149,76,73,0,,129,2,127,112,1,111
04/11/2022 20:00,12,6,6,9,5,4,25,12,13,0,0,0,8,8,0,10,10,0,4,4,0,108,57,51,0,,99,0,99,96,1,95
04/11/2022 21:00,10,5,5,18,12,6,11,4,7,0,0,0,4,4,0,9,9,0,8,8,0,70,40,30,0,,67,0,67,66,0,66
04/11/2022 22:00,8,6,2,9,4,5,10,2,8,0,0,0,2,2,0,3,3,0,2,2,0,67,43,24,0,,51,1,50,30,0,30
04/11/2022 23:00,7,4,3,8,2,6,8,3,5,0,0,0,0,0,0,3,3,0,0,0,0,38,27,11,0,,40,0,40,26,0,26
05/11/2022 00:00,0,0,0,5,2,3,6,1,5,0,0,0,1,1,0,2,2,0,1,1,0,26,18,8,0,,34,1,33,28,0,28
05/11/2022 01:00,1,0,1,0,0,0,1,0,1,0,0,0,1,1,0,2,2,0,0,0,0,13,10,3,0,,6,0,6,0,0,0
05/11/2022 02:00,1,0,1,2,1,1,1,0,1,0,0,0,1,1,0,0,0,0,0,0,0,12,10,2,0,,14,0,14,7,0,7
05/11/2022 03:00,0,0,0,0,0,0,2,0,2,0,0,0,0,0,0,0,0,0,0,0,0,12,8,4,0,,18,0,18,5,0,5
05/11/2022 04:00,1,0,1,0,0,0,0,0,0,0,0,0,0,0,0,0,0,0,0,0,0,10,5,5,0,,2,0,2,0,0,0
05/11/2022 05:00,3,0,3,2,1,1,3,3,0,0,0,0,1,1,0,2,2,0,1,1,0,19,7,12,0,,5,0,5,1,0,1
05/11/2022 06:00,5,5,0,5,3,2,3,1,2,0,0,0,1,1,0,2,2,0,1,1,0,34,9,25,0,,4,0,4,10,0,10
05/11/2022 07:00,5,4,1,16,9,7,17,9,8,0,0,0,8,8,0,1,1,0,1,1,0,57,15,42,0,,9,0,9,15,0,15
05/11/2022 08:00,5,5,0,36,17,19,46,20,26,0,0,0,5,5,0,6,6,0,4,4,0,52,19,33,0,,12,0,12,35,1,34
05/11/2022 09:00,12,10,2,72,34,38,81,31,50,0,0,0,7,7,0,2,2,0,9,9,0,78,23,55,0,,22,0,22,54,0,54
05/11/2022 10:00,14,13,1,61,29,32,74,25,49,0,0,0,5,5,0,6,6,0,3,3,0,97,31,66,0,,30,0,30,75,0,75
05/11/2022 11:00,15,8,7,79,39,40,97,55,42,0,0,0,1,1,0,15,15,0,5,5,0,93,23,70,0,,50,0,50,91,1,90
05/11/2022 12:00,11,6,5,80,34,46,109,50,59,0,0,0,2,2,0,17,17,0,1,1,0,100,36,64,0,,75,1,74,110,1,109
05/11/2022 13:00,19,13,6,73,38,35,79,37,42,0,0,0,3,3,0,16,16,0,9,9,0,147,69,78,0,,83,0,83,90,0,90
05/11/2022 14:00,16,7,9,104,41,63,115,38,77,0,0,0,10,10,0,13,13,0,11,11,0,131,43,88,0,,79,0,79,103,0,103
05/11/2022 15:00,20,12,8,96,55,41,123,63,60,0,0,0,6,6,0,20,20,0,7,7,0,142,58,84,0,,94,0,94,99,1,98
05/11/2022 16:00,18,9,9,75,44,31,103,65,38,0,0,0,10,10,0,15,15,0,4,4,0,111,53,58,0,,103,0,103,77,0,77
05/11/2022 17:00,14,6,8,38,20,18,54,27,27,0,0,0,6,5,1,9,9,0,2,2,0,132,66,66,0,,93,0,93,88,0,88
05/11/2022 18:00,8,8,0,15,6,9,19,10,9,0,0,0,3,2,1,4,4,0,3,3,0,107,56,51,0,,85,1,84,109,1,108
05/11/2022 19:00,9,6,3,12,6,6,22,9,13,0,0,0,10,10,0,6,6,0,2,2,0,84,35,49,0,,77,2,75,100,1,99
05/11/2022 20:00,10,6,4,13,2,11,11,4,7,0,0,0,4,4,0,2,2,0,0,0,0,139,60,79,0,,68,1,67,97,0,97
05/11/2022 21:00,7,4,3,10,8,2,8,3,5,0,0,0,6,5,1,3,3,0,0,0,0,91,34,57,0,,51,0,51,62,0,62
05/11/2022 22:00,0,0,0,5,3,2,5,1,4,0,0,0,3,3,0,3,3,0,1,1,0,56,34,22,0,,33,1,32,41,0,41
05/11/2022 23:00,6,4,2,6,3,3,5,1,4,0,0,0,2,2,0,0,0,0,1,1,0,62,42,20,0,,35,1,34,23,0,23
06/11/2022 00:00,0,0,0,1,0,1,6,0,6,0,0,0,0,0,0,2,2,0,0,0,0,30,22,8,0,,31,0,31,12,0,12
06/11/2022 01:00,1,0,1,4,3,1,2,0,2,0,0,0,1,1,0,0,0,0,0,0,0,25,14,11,0,,7,0,7,0,0,0
06/11/2022 02:00,0,0,0,0,0,0,3,1,2,0,0,0,0,0,0,0,0,0,0,0,0,18,11,7,0,,26,0,26,7,0,7
06/11/2022 03:00,0,0,0,1,0,1,0,0,0,0,0,0,2,2,0,0,0,0,0,0,0,12,11,1,0,,10,1,9,6,0,6
06/11/2022 04:00,1,0,1,0,0,0,0,0,0,0,0,0,1,1,0,1,1,0,0,0,0,5,5,0,0,,6,0,6,3,0,3
06/11/2022 05:00,1,1,0,4,2,2,6,2,4,0,0,0,0,0,0,1,1,0,0,0,0,9,5,4,0,,5,0,5,3,0,3
06/11/2022 06:00,0,0,0,5,3,2,5,1,4,0,0,0,3,3,0,0,0,0,1,1,0,27,5,22,0,,4,0,4,8,0,8
06/11/2022 07:00,6,4,2,16,7,9,25,7,18,0,0,0,5,5,0,3,3,0,1,1,0,33,11,22,0,,9,0,9,8,0,8
06/11/2022 08:00,5,5,0,50,20,30,61,24,37,0,0,0,6,6,0,4,4,0,0,0,0,66,28,38,0,,15,1,14,19,0,19
06/11/2022 09:00,12,9,3,112,47,65,125,41,84,0,0,0,10,10,0,10,10,0,0,0,0,69,21,48,0,,23,1,22,31,0,31
06/11/2022 10:00,11,9,2,134,60,74,163,67,96,0,0,0,8,8,0,10,10,0,2,2,0,64,24,40,0,,30,0,30,53,0,53
06/11/2022 11:00,15,10,5,138,74,64,187,84,103,0,0,0,5,5,0,16,16,0,1,1,0,106,33,73,0,,33,0,33,63,0,63
06/11/2022 12:00,13,9,4,120,61,59,165,92,73,0,0,0,4,4,0,23,23,0,1,1,0,138,62,76,0,,66,2,64,87,1,86
06/11/2022 13:00,17,10,7,108,53,55,154,73,81,0,0,0,2,2,0,17,17,0,0,0,0,126,45,81,0,,58,0,58,106,1,105
06/11/2022 14:00,23,11,12,93,49,44,117,54,63,0,0,0,6,6,0,6,6,0,0,0,0,103,50,53,0,,61,1,60,92,0,92
06/11/2022 15:00,13,7,6,77,42,35,101,59,42,0,0,0,5,5,0,10,10,0,0,0,0,86,38,48,0,,66,1,65,79,0,79
06/11/2022 16:00,18,13,5,76,44,32,79,40,39,0,0,0,2,2,0,15,15,0,0,0,0,109,50,59,0,,78,0,78,69,0,69
06/11/2022 17:00,9,7,2,42,21,21,50,28,22,0,0,0,1,1,0,5,5,0,0,0,0,92,39,53,0,,80,0,80,71,1,70
06/11/2022 18:00,11,10,1,17,10,7,18,11,7,0,0,0,2,2,0,10,10,0,0,0,0,91,42,49,0,,95,0,95,84,1,83
06/11/2022 19:00,10,7,3,13,5,8,17,5,12,0,0,0,2,2,0,4,4,0,0,0,0,69,43,26,0,,63,0,63,66,0,66
06/11/2022 20:00,6,3,3,17,8,9,20,7,13,0,0,0,0,0,0,5,5,0,0,0,0,68,36,32,0,,50,0,50,65,0,65
06/11/2022 21:00,7,4,3,4,3,1,4,1,3,0,0,0,0,0,0,8,8,0,0,0,0,48,30,18,0,,48,2,46,33,0,33
06/11/2022 22:00,5,5,0,1,1,0,3,2,1,0,0,0,2,2,0,4,4,0,0,0,0,33,23,10,0,,31,0,31,25,0,25
06/11/2022 23:00,0,0,0,0,0,0,1,0,1,0,0,0,1,1,0,1,1,0,0,0,0,26,18,8,0,,17,0,17,15,0,15
07/11/2022 00:00,1,0,1,1,1,0,2,0,2,0,0,0,0,0,0,0,0,0,0,0,0,13,10,3,0,,18,0,18,9,0,9
07/11/2022 01:00,0,0,0,0,0,0,0,0,0,0,0,0,0,0,0,0,0,0,0,0,0,7,6,1,0,,5,0,5,0,0,0
07/11/2022 02:00,1,0,1,0,0,0,0,0,0,0,0,0,0,0,0,0,0,0,0,0,0,4,3,1,0,,8,1,7,2,0,2
07/11/2022 03:00,0,0,0,0,0,0,0,0,0,0,0,0,0,0,0,0,0,0,0,0,0,0,0,0,0,,2,0,2,3,0,3
07/11/2022 04:00,2,1,1,1,1,0,1,0,1,0,0,0,2,2,0,0,0,0,1,1,0,10,5,5,0,,2,0,2,2,0,2
07/11/2022 05:00,4,3,1,6,6,0,8,5,3,0,0,0,2,2,0,2,2,0,0,0,0,25,5,20,0,,7,0,7,7,0,7
07/11/2022 06:00,16,15,1,12,9,3,21,14,7,0,0,0,14,14,0,8,8,0,2,2,0,131,26,105,0,,8,0,8,25,0,25
07/11/2022 07:00,45,41,4,39,31,8,52,41,11,0,0,0,37,37,0,20,20,0,8,8,0,252,55,197,0,,24,0,24,65,0,65
07/11/2022 08:00,99,80,19,57,47,10,77,59,18,0,0,0,41,41,0,45,45,0,108,108,0,528,98,430,0,,63,1,62,189,2,187
07/11/2022 09:00,37,33,4,31,22,9,39,29,10,0,0,0,12,12,0,12,12,0,15,15,0,205,34,171,0,,31,0,31,118,0,118
07/11/2022 10:00,21,17,4,22,12,10,23,6,17,0,0,0,12,12,0,8,8,0,9,9,0,62,20,42,0,,20,0,20,70,0,70
07/11/2022 11:00,15,7,8,24,9,15,47,23,24,0,0,0,5,4,1,7,7,0,2,2,0,67,21,46,0,,31,0,31,62,0,62
07/11/2022 12:00,14,8,6,20,11,9,36,18,18,0,0,0,4,4,0,7,7,0,7,7,0,102,45,57,0,,63,2,61,81,0,81
07/11/2022 13:00,16,13,3,24,12,12,21,7,14,0,0,0,6,6,0,6,6,0,10,10,0,110,56,54,0,,90,0,90,85,1,84
07/11/2022 14:00,16,5,11,15,4,11,33,14,19,0,0,0,4,4,0,15,15,0,9,9,0,101,48,53,0,,77,0,77,66,0,66
07/11/2022 15:00,17,8,9,22,10,12,29,6,23,0,0,0,3,3,0,36,36,0,17,17,0,131,75,56,0,,68,0,68,53,1,52
07/11/2022 16:00,28,15,13,35,11,24,43,11,32,0,0,0,5,5,0,33,33,0,17,17,0,226,143,83,0,,114,0,114,81,0,81
07/11/2022 17:00,64,20,44,44,8,36,68,12,56,0,0,0,4,4,0,37,37,0,8,8,0,387,274,113,0,,235,0,235,102,1,101
07/11/2022 18:00,37,16,21,53,10,43,65,6,59,0,0,0,3,3,0,13,13,0,8,8,0,282,181,101,0,,186,0,186,83,0,83
07/11/2022 19:00,10,3,7,13,5,8,27,3,24,0,0,0,6,6,0,25,25,0,0,0,0,155,94,61,0,,114,0,114,74,2,72
07/11/2022 20:00,13,1,12,8,3,5,11,4,7,0,0,0,1,1,0,9,9,0,0,0,0,103,72,31,0,,79,0,79,64,0,64
07/11/2022 21:00,10,4,6,7,1,6,10,0,10,0,0,0,1,1,0,7,7,0,5,5,0,72,37,35,0,,47,0,47,40,0,40
07/11/2022 22:00,7,4,3,1,1,0,1,0,1,0,0,0,0,0,0,4,4,0,4,4,0,41,27,14,0,,26,0,26,26,0,26
07/11/2022 23:00,4,3,1,3,1,2,4,1,3,0,0,0,2,2,0,0,0,0,1,1,0,20,15,5,0,,21,0,21,13,0,13
08/11/2022 00:00,1,1,0,1,0,1,0,0,0,0,0,0,0,0,0,0,0,0,0,0,0,18,15,3,0,,15,0,15,9,0,9
08/11/2022 01:00,0,0,0,1,1,0,0,0,0,0,0,0,1,1,0,0,0,0,0,0,0,7,4,3,0,,3,0,3,0,0,0
08/11/2022 02:00,1,0,1,1,1,0,4,2,2,0,0,0,0,0,0,0,0,0,0,0,0,4,2,2,0,,9,0,9,5,0,5
08/11/2022 03:00,0,0,0,0,0,0,0,0,0,0,0,0,0,0,0,0,0,0,0,0,0,2,1,1,0,,2,0,2,1,0,1
08/11/2022 04:00,1,1,0,1,1,0,4,1,3,0,0,0,2,2,0,0,0,0,0,0,0,2,0,2,0,,0,0,0,1,0,1
08/11/2022 05:00,4,4,0,4,3,1,9,6,3,0,0,0,1,1,0,1,1,0,1,1,0,26,4,22,0,,4,0,4,10,0,10
08/11/2022 06:00,20,16,4,27,22,5,28,23,5,0,0,0,9,9,0,9,9,0,0,0,0,134,27,107,0,,8,0,8,30,0,30
08/11/2022 07:00,65,58,7,53,43,10,77,65,12,0,0,0,25,25,0,23,23,0,0,0,0,358,81,277,0,,32,0,32,83,0,83
08/11/2022 08:00,135,120,15,93,75,18,127,99,28,0,0,0,54,54,0,45,45,0,0,0,0,722,92,630,0,,68,0,68,271,3,268
08/11/2022 09:00,43,39,4,40,25,15,56,37,19,0,0,0,24,24,0,23,23,0,1,1,0,285,47,238,0,,45,1,44,181,1,180
08/11/2022 10:00,16,12,4,33,16,17,52,25,27,0,0,0,17,17,0,5,5,0,3,3,0,86,21,65,0,,37,0,37,83,0,83
08/11/2022 11:00,7,5,2,58,23,35,61,19,42,0,0,0,9,9,0,9,9,0,1,1,0,88,24,64,0,,41,0,41,70,1,69
08/11/2022 12:00,21,19,2,37,16,21,58,26,32,0,0,0,7,7,0,10,10,0,1,1,0,122,52,70,0,,58,1,57,102,0,102
08/11/2022 13:00,11,4,7,51,26,25,65,28,37,0,0,0,3,3,0,8,8,0,0,0,0,146,66,80,0,,71,0,71,93,1,92
08/11/2022 14:00,18,9,9,29,13,16,47,21,26,0,0,0,4,4,0,32,32,0,0,0,0,112,53,59,0,,73,0,73,79,0,79
08/11/2022 15:00,27,11,16,40,17,23,47,17,30,0,0,0,3,3,0,38,38,0,2,2,0,149,80,69,0,,94,2,92,79,1,78
08/11/2022 16:00,40,12,28,64,27,37,83,24,59,0,0,0,10,9,1,32,32,0,1,1,0,283,192,91,0,,170,0,170,94,0,94
08/11/2022 17:00,78,17,61,83,20,63,137,29,108,0,0,0,1,1,0,43,43,0,2,2,0,478,323,155,0,,285,0,285,133,1,132
08/11/2022 18:00,42,10,32,75,16,59,106,19,87,0,0,0,4,4,0,26,26,0,0,0,0,362,257,105,0,,231,2,229,129,2,127
08/11/2022 19:00,19,4,15,42,10,32,57,13,44,0,0,0,5,5,0,21,21,0,4,4,0,214,142,72,0,,164,1,163,111,1,110
08/11/2022 20:00,9,2,7,25,7,18,23,9,14,0,0,0,6,6,0,17,17,0,5,5,0,143,91,52,0,,107,0,107,89,0,89
08/11/2022 21:00,3,2,1,15,9,6,21,7,14,0,0,0,5,5,0,8,8,0,1,1,0,93,70,23,0,,71,0,71,44,0,44
08/11/2022 22:00,5,2,3,4,2,2,9,1,8,0,0,0,1,1,0,4,4,0,0,0,0,74,50,24,0,,48,0,48,19,0,19
08/11/2022 23:00,3,0,3,7,2,5,3,1,2,0,0,0,1,1,0,3,3,0,1,1,0,35,27,8,0,,32,0,32,15,0,15
09/11/2022 00:00,1,1,0,1,0,1,3,1,2,0,0,0,1,1,0,2,2,0,0,0,0,18,16,2,0,,21,0,21,9,0,9
09/11/2022 01:00,0,0,0,3,3,0,1,1,0,0,0,0,0,0,0,0,0,0,0,0,0,11,9,2,0,,5,0,5,0,0,0
09/11/2022 02:00,1,0,1,0,0,0,0,0,0,0,0,0,0,0,0,0,0,0,0,0,0,4,1,3,0,,7,0,7,2,0,2
09/11/2022 03:00,0,0,0,0,0,0,0,0,0,0,0,0,1,1,0,0,0,0,0,0,0,4,3,1,0,,6,0,6,1,0,1
09/11/2022 04:00,2,2,0,2,2,0,3,0,3,0,0,0,1,1,0,0,0,0,1,1,0,3,2,1,0,,0,0,0,2,0,2
09/11/2022 05:00,6,6,0,2,1,1,5,3,2,0,0,0,4,4,0,0,0,0,1,1,0,36,9,27,0,,3,0,3,8,0,8
09/11/2022 06:00,17,13,4,21,17,4,27,23,4,0,0,0,13,13,0,10,10,0,0,0,0,153,38,115,0,,9,0,9,38,0,38
09/11/2022 07:00,64,58,6,61,52,9,79,63,16,0,0,0,39,38,1,21,21,0,0,0,0,313,61,252,0,,39,0,39,96,0,96
09/11/2022 08:00,116,103,13,104,86,18,126,102,24,0,0,0,59,59,0,49,49,0,2,2,0,724,110,614,0,,68,0,68,219,2,217
09/11/2022 09:00,42,35,7,27,18,9,41,31,10,0,0,0,32,31,1,19,19,0,2,2,0,228,31,197,0,,34,0,34,159,0,159
09/11/2022 10:00,18,16,2,39,19,20,42,16,26,0,0,0,4,4,0,8,8,0,1,1,0,112,35,77,0,,35,1,34,81,0,81
09/11/2022 11:00,9,8,1,38,17,21,47,17,30,0,0,0,5,5,0,8,8,0,0,0,0,92,27,65,0,,32,0,32,74,0,74
09/11/2022 12:00,22,18,4,47,22,25,56,25,31,0,0,0,11,11,0,9,9,0,1,1,0,105,35,70,0,,66,0,66,98,0,98
09/11/2022 13:00,27,11,16,34,16,18,56,21,35,0,0,0,8,8,0,16,16,0,0,0,0,140,69,71,0,,96,0,96,112,1,111
09/11/2022 14:00,14,8,6,26,9,17,39,17,22,0,0,0,9,9,0,19,19,0,0,0,0,122,58,64,0,,83,0,83,77,0,77
09/11/2022 15:00,27,13,14,36,13,23,48,16,32,0,0,0,7,7,0,48,48,0,0,0,0,166,105,61,0,,79,0,79,71,0,71
09/11/2022 16:00,41,13,28,54,14,40,68,16,52,0,0,0,6,6,0,46,46,0,0,0,0,237,150,87,0,,165,0,165,89,0,89
09/11/2022 17:00,65,17,48,72,18,54,117,21,96,0,0,0,10,10,0,30,30,0,0,0,0,470,338,132,0,,264,1,263,118,2,116
09/11/2022 18:00,45,17,28,73,13,60,133,18,115,0,0,0,6,6,0,16,16,0,0,0,0,371,245,126,0,,216,0,216,127,1,126
09/11/2022 19:00,16,5,11,38,10,28,54,16,38,0,0,0,1,1,0,20,20,0,0,0,0,230,140,90,0,,125,0,125,94,1,93
09/11/2022 20:00,10,3,7,17,6,11,20,9,11,0,0,0,5,5,0,17,17,0,0,0,0,137,89,48,0,,113,2,111,75,0,75
09/11/2022 21:00,9,4,5,8,4,4,10,4,6,0,0,0,2,2,0,8,8,0,0,0,0,84,52,32,0,,91,0,91,67,0,67
09/11/2022 22:00,4,2,2,5,2,3,9,2,7,0,0,0,4,4,0,9,9,0,0,0,0,70,43,27,0,,50,0,50,41,0,41
09/11/2022 23:00,4,2,2,4,2,2,8,1,7,0,0,0,1,1,0,4,4,0,0,0,0,42,34,8,0,,27,0,27,16,0,16
10/11/2022 00:00,1,0,1,2,1,1,4,2,2,0,0,0,1,1,0,2,2,0,0,0,0,11,11,0,0,,20,1,19,11,0,11
10/11/2022 01:00,1,1,0,0,0,0,1,0,1,0,0,0,1,0,1,0,0,0,0,0,0,6,4,2,0,,3,0,3,0,0,0
10/11/2022 02:00,2,0,2,0,0,0,1,0,1,0,0,0,0,0,0,0,0,0,0,0,0,4,4,0,0,,7,0,7,2,0,2
10/11/2022 03:00,0,0,0,0,0,0,1,0,1,0,0,0,0,0,0,0,0,0,0,0,0,5,4,1,0,,1,0,1,1,0,1
10/11/2022 04:00,4,3,1,1,1,0,2,1,1,0,0,0,1,1,0,0,0,0,0,0,0,8,3,5,0,,2,0,2,2,0,2
10/11/2022 05:00,7,6,1,5,1,4,5,2,3,0,0,0,4,4,0,0,0,0,0,0,0,30,6,24,0,,1,0,1,9,0,9
10/11/2022 06:00,23,19,4,7,5,2,14,9,5,0,0,0,17,16,1,5,5,0,0,0,0,147,27,120,0,,10,0,10,41,0,41
10/11/2022 07:00,59,58,1,38,31,7,46,38,8,0,0,0,49,49,0,20,20,0,0,0,0,307,61,246,0,,24,0,24,85,0,85
10/11/2022 08:00,125,107,18,69,59,10,94,79,15,0,0,0,66,65,1,47,47,0,0,0,0,636,87,549,0,,72,0,72,246,1,245
10/11/2022 09:00,54,46,8,33,19,14,43,26,17,0,0,0,46,46,0,18,18,0,0,0,0,274,50,224,0,,38,1,37,172,1,171
10/11/2022 10:00,13,8,5,24,15,9,29,19,10,0,0,0,15,15,0,10,10,0,1,1,0,99,27,72,0,,39,0,39,84,0,84
10/11/2022 11:00,16,12,4,16,7,9,32,13,19,0,0,0,7,7,0,13,13,0,4,4,0,78,20,58,0,,32,0,32,63,0,63
10/11/2022 12:00,24,12,12,17,9,8,30,9,21,0,0,0,3,3,0,6,6,0,0,0,0,114,33,81,0,,68,0,68,97,0,97
10/11/2022 13:00,17,12,5,16,5,11,38,10,28,0,0,0,6,6,0,9,9,0,0,0,0,115,53,62,0,,70,0,70,104,1,103
10/11/2022 14:00,18,10,8,16,5,11,30,10,20,0,0,0,5,5,0,17,17,0,0,0,0,116,62,54,0,,74,0,74,84,0,84
10/11/2022 15:00,21,10,11,22,8,14,36,9,27,0,0,0,4,4,0,25,25,0,0,0,0,162,89,73,0,,66,1,65,65,1,64
10/11/2022 16:00,33,12,21,37,11,26,59,13,46,0,0,0,6,6,0,39,39,0,2,2,0,242,151,91,0,,134,1,133,74,0,74
10/11/2022 17:00,51,12,39,45,7,38,106,23,83,0,0,0,8,8,0,32,32,0,1,1,0,371,263,108,0,,220,0,220,108,1,107
10/11/2022 18:00,42,14,28,51,13,38,100,22,78,0,0,0,3,3,0,23,23,0,1,1,0,327,228,99,0,,204,1,203,115,2,113
10/11/2022 19:00,23,9,14,21,4,17,40,11,29,0,0,0,8,8,0,17,17,0,0,0,0,161,86,75,0,,107,0,107,91,1,90
10/11/2022 20:00,13,7,6,17,8,9,21,7,14,0,0,0,6,6,0,10,10,0,0,0,0,131,81,50,0,,90,0,90,90,2,88
10/11/2022 21:00,8,5,3,7,2,5,15,5,10,0,0,0,6,6,0,11,11,0,0,0,0,87,62,25,0,,80,0,80,76,0,76
10/11/2022 22:00,5,3,2,4,0,4,5,1,4,0,0,0,4,4,0,2,2,0,0,0,0,71,49,22,0,,77,0,77,33,0,33
10/11/2022 23:00,9,4,5,7,5,2,8,1,7,0,0,0,4,4,0,2,2,0,0,0,0,49,36,13,0,,61,0,61,23,0,23
11/11/2022 00:00,0,0,0,1,0,1,5,1,4,0,0,0,2,2,0,2,2,0,0,0,0,20,18,2,0,,29,0,29,12,0,12
11/11/2022 01:00,0,0,0,2,1,1,1,0,1,0,0,0,1,1,0,1,1,0,0,0,0,10,8,2,0,,3,0,3,0,0,0
11/11/2022 02:00,2,1,1,0,0,0,1,1,0,0,0,0,0,0,0,0,0,0,0,0,0,6,5,1,0,,7,0,7,1,0,1
11/11/2022 03:00,1,0,1,0,0,0,1,0,1,0,0,0,0,0,0,0,0,0,0,0,0,7,4,3,0,,7,0,7,3,0,3
11/11/2022 04:00,2,2,0,1,1,0,1,0,1,0,0,0,0,0,0,0,0,0,0,0,0,3,0,3,0,,3,0,3,2,0,2
11/11/2022 05:00,5,3,2,3,2,1,3,2,1,0,0,0,4,4,0,0,0,0,1,1,0,28,4,24,0,,1,0,1,7,0,7
11/11/2022 06:00,19,16,3,5,5,0,10,6,4,0,0,0,19,19,0,8,8,0,1,1,0,114,22,92,0,,8,0,8,29,0,29
11/11/2022 07:00,34,27,7,16,13,3,23,18,5,0,0,0,20,20,0,11,11,0,5,5,0,236,55,181,0,,25,1,24,73,1,72
11/11/2022 08:00,68,56,12,39,23,16,54,38,16,0,0,0,39,38,1,35,35,0,45,45,0,394,71,323,0,,54,0,54,139,0,139
11/11/2022 09:00,31,25,6,21,11,10,41,23,18,0,0,0,21,21,0,10,10,0,9,9,0,209,44,165,0,,38,0,38,122,0,122
11/11/2022 10:00,20,13,7,26,13,13,35,16,19,0,0,0,4,4,0,10,10,0,2,2,0,90,25,65,0,,30,0,30,78,0,78
11/11/2022 11:00,14,10,4,26,12,14,37,19,18,0,0,0,6,6,0,6,6,0,2,2,0,104,39,65,0,,41,0,41,65,0,65
11/11/2022 12:00,20,10,10,16,9,7,42,12,30,0,0,0,7,7,0,17,17,0,0,0,0,117,41,76,0,,65,0,65,104,0,104
11/11/2022 13:00,24,9,15,24,17,7,53,30,23,0,0,0,8,8,0,39,39,0,2,2,0,142,66,76,0,,86,1,85,103,1,102
11/11/2022 14:00,15,8,7,21,7,14,45,13,32,0,0,0,6,6,0,16,16,0,11,11,0,131,67,64,0,,92,1,91,97,1,96
11/11/2022 15:00,29,10,19,31,12,19,41,15,26,0,0,0,9,9,0,23,23,0,5,5,0,188,101,87,0,,96,1,95,79,1,78
11/11/2022 16:00,36,14,22,35,12,23,50,16,34,0,0,0,5,5,0,17,17,0,0,0,0,220,122,98,0,,116,0,116,96,0,96
11/11/2022 17:00,33,10,23,38,16,22,65,16,49,0,0,0,6,6,0,24,24,0,0,0,0,299,176,123,0,,184,1,183,133,1,132
11/11/2022 18:00,19,7,12,30,7,23,61,16,45,0,0,0,15,14,1,9,9,0,0,0,0,239,141,98,0,,136,0,136,142,0,142
11/11/2022 19:00,14,9,5,16,6,10,22,6,16,0,0,0,11,10,1,14,14,0,1,1,0,161,89,72,0,,129,1,128,102,2,100
11/11/2022 20:00,12,6,6,17,9,8,37,15,22,0,0,0,10,10,0,11,11,0,0,0,0,114,53,61,0,,88,3,85,93,0,93
11/11/2022 21:00,7,4,3,9,6,3,12,5,7,0,0,0,12,12,0,4,4,0,0,0,0,87,51,36,0,,85,0,85,67,0,67
11/11/2022 22:00,3,1,2,3,1,2,7,1,6,0,0,0,2,1,1,6,6,0,0,0,0,75,48,27,0,,68,1,67,57,0,57
11/11/2022 23:00,0,0,0,5,2,3,7,2,5,0,0,0,5,5,0,2,2,0,0,0,0,44,35,9,0,,51,1,50,26,0,26
12/11/2022 00:00,3,1,2,5,1,4,8,3,5,0,0,0,3,2,1,5,5,0,0,0,0,32,23,9,0,,51,0,51,21,0,21
12/11/2022 01:00,1,1,0,0,0,0,1,0,1,0,0,0,1,1,0,2,2,0,0,0,0,25,14,11,0,,11,1,10,0,0,0
12/11/2022 02:00,0,0,0,0,0,0,2,0,2,0,0,0,1,1,0,0,0,0,0,0,0,13,9,4,0,,26,0,26,8,0,8
12/11/2022 03:00,1,1,0,0,0,0,0,0,0,0,0,0,1,1,0,1,1,0,0,0,0,10,6,4,0,,19,0,19,2,0,2
12/11/2022 04:00,2,1,1,1,1,0,1,0,1,0,0,0,1,1,0,0,0,0,0,0,0,9,6,3,0,,10,0,10,3,0,3
12/11/2022 05:00,1,1,0,5,3,2,4,2,2,0,0,0,2,2,0,1,1,0,0,0,0,10,3,7,0,,3,0,3,5,0,5
12/11/2022 06:00,2,2,0,4,2,2,6,2,4,0,0,0,4,4,0,3,3,0,0,0,0,33,6,27,0,,9,0,9,10,0,10
12/11/2022 07:00,8,6,2,25,12,13,26,13,13,0,0,0,8,8,0,4,4,0,0,0,0,50,13,37,0,,10,0,10,17,0,17
12/11/2022 08:00,6,4,2,47,18,29,48,21,27,0,0,0,13,13,0,6,6,0,0,0,0,75,20,55,0,,18,0,18,36,0,36
12/11/2022 09:00,9,8,1,82,31,51,80,27,53,0,0,0,12,12,0,14,14,0,3,3,0,87,28,59,0,,24,1,23,65,0,65
12/11/2022 10:00,7,4,3,67,26,41,85,33,52,0,0,0,10,10,0,15,15,0,0,0,0,123,41,82,0,,35,0,35,56,0,56
12/11/2022 11:00,12,8,4,105,49,56,143,70,73,0,0,0,11,11,0,12,12,0,3,3,0,152,55,97,0,,52,0,52,95,0,95
12/11/2022 12:00,13,8,5,92,53,39,116,60,56,0,0,0,7,7,0,17,17,0,1,1,0,173,65,108,0,,75,0,75,101,1,100
12/11/2022 13:00,10,7,3,62,33,29,95,51,44,0,0,0,5,5,0,10,10,0,1,1,0,142,59,83,0,,89,0,89,109,0,109
12/11/2022 14:00,20,12,8,48,26,22,76,35,41,0,0,0,8,8,0,9,9,0,0,0,0,123,52,71,0,,71,0,71,103,0,103
12/11/2022 15:00,17,13,4,47,22,25,75,41,34,0,0,0,19,19,0,11,11,0,4,4,0,152,80,72,0,,87,0,87,119,0,119
12/11/2022 16:00,11,10,1,36,26,10,50,29,21,0,0,0,14,14,0,21,21,0,0,0,0,137,64,73,0,,93,1,92,88,0,88
12/11/2022 17:00,17,8,9,20,15,5,34,20,14,0,0,0,14,14,0,12,12,0,0,0,0,131,62,69,0,,92,1,91,97,0,97
12/11/2022 18:00,15,6,9,18,7,11,34,13,21,0,0,0,2,2,0,15,15,0,1,1,0,136,57,79,0,,64,0,64,99,1,98
12/11/2022 19:00,12,8,4,15,6,9,21,6,15,0,0,0,1,1,0,8,8,0,0,0,0,91,44,47,0,,89,0,89,86,0,86
12/11/2022 20:00,4,1,3,10,4,6,23,10,13,0,0,0,6,6,0,5,5,0,0,0,0,81,45,36,0,,69,0,69,93,0,93
12/11/2022 21:00,8,5,3,3,2,1,8,3,5,0,0,0,6,6,0,2,2,0,0,0,0,61,26,35,0,,58,0,58,69,0,69
12/11/2022 22:00,9,5,4,3,2,1,3,0,3,0,0,0,4,4,0,8,8,0,0,0,0,67,40,27,0,,37,0,37,48,1,47
12/11/2022 23:00,5,3,2,3,2,1,5,3,2,0,0,0,5,5,0,2,2,0,0,0,0,40,27,13,0,,32,1,31,26,2,24
13/11/2022 00:00,2,1,1,3,2,1,9,3,6,0,0,0,2,2,0,2,2,0,0,0,0,38,24,14,0,,43,0,43,26,1,25
13/11/2022 01:00,2,0,2,3,0,3,2,1,1,0,0,0,2,2,0,1,1,0,0,0,0,26,16,10,0,,6,0,6,0,0,0
13/11/2022 02:00,1,1,0,3,2,1,3,1,2,0,0,0,1,1,0,0,0,0,0,0,0,27,17,10,0,,16,0,16,6,0,6
13/11/2022 03:00,2,0,2,1,0,1,2,0,2,0,0,0,1,1,0,0,0,0,0,0,0,11,9,2,0,,11,1,10,3,0,3
13/11/2022 04:00,1,0,1,0,0,0,0,0,0,0,0,0,2,2,0,1,1,0,0,0,0,6,3,3,0,,8,0,8,5,0,5
13/11/2022 05:00,0,0,0,2,1,1,1,1,0,0,0,0,2,2,0,1,1,0,0,0,0,6,2,4,0,,8,0,8,6,0,6
13/11/2022 06:00,2,1,1,6,3,3,9,2,7,0,0,0,4,3,1,0,0,0,0,0,0,22,6,16,0,,3,0,3,3,0,3
13/11/2022 07:00,1,1,0,16,5,11,15,4,11,0,0,0,14,14,0,5,5,0,0,0,0,39,14,25,0,,9,0,9,8,0,8
13/11/2022 08:00,5,5,0,65,27,38,59,25,34,0,0,0,6,6,0,7,7,0,0,0,0,47,15,32,0,,5,0,5,23,0,23
13/11/2022 09:00,18,12,6,85,37,48,95,35,60,0,0,0,8,8,0,18,18,0,0,0,0,59,18,41,0,,13,1,12,40,0,40
13/11/2022 10:00,8,6,2,100,42,58,106,47,59,0,0,0,6,6,0,15,15,0,0,0,0,86,26,60,0,,26,0,26,50,0,50
13/11/2022 11:00,17,10,7,108,53,55,150,66,84,0,0,0,6,6,0,12,12,0,2,2,0,105,29,76,0,,42,2,40,61,0,61
13/11/2022 12:00,18,11,7,107,59,48,132,70,62,0,0,0,7,7,0,10,10,0,13,13,0,114,43,71,0,,49,0,49,88,1,87
13/11/2022 13:00,14,6,8,84,40,44,110,46,64,0,0,0,4,4,0,13,13,0,5,5,0,128,45,83,0,,69,1,68,112,1,111
13/11/2022 14:00,23,16,7,92,56,36,110,57,53,0,0,0,6,6,0,12,12,0,13,13,0,132,47,85,0,,66,0,66,100,0,100
13/11/2022 15:00,8,4,4,70,32,38,103,46,57,0,0,0,7,7,0,15,15,0,6,6,0,114,53,61,0,,71,0,71,96,0,96
13/11/2022 16:00,16,8,8,27,19,8,55,31,24,0,0,0,9,9,0,11,11,0,12,12,0,106,48,58,0,,84,0,84,83,2,81
13/11/2022 17:00,6,2,4,17,13,4,36,22,14,0,0,0,5,5,0,14,14,0,3,3,0,159,73,86,0,,89,0,89,90,0,90
13/11/2022 18:00,9,5,4,14,7,7,14,7,7,0,0,0,10,10,0,10,10,0,0,0,0,106,44,62,0,,94,0,94,91,0,91
13/11/2022 19:00,7,3,4,7,4,3,12,5,7,0,0,0,8,8,0,6,6,0,0,0,0,93,47,46,0,,82,0,82,81,1,80
13/11/2022 20:00,4,1,3,6,3,3,10,4,6,0,0,0,4,4,0,3,3,0,1,1,0,66,35,31,0,,65,0,65,68,0,68
13/11/2022 21:00,6,3,3,3,2,1,5,3,2,0,0,0,5,5,0,3,3,0,0,0,0,47,31,16,0,,40,2,38,47,2,45
13/11/2022 22:00,5,5,0,2,2,0,4,2,2,0,0,0,3,2,1,2,2,0,0,0,0,25,15,10,0,,47,1,46,32,1,31
13/11/2022 23:00,3,0,3,1,0,1,9,2,7,0,0,0,1,1,0,1,1,0,0,0,0,27,21,6,0,,34,1,33,14,0,14
14/11/2022 00:00,0,0,0,2,1,1,0,0,0,0,0,0,0,0,0,4,4,0,0,0,0,18,12,6,0,,16,0,16,7,0,7
14/11/2022 01:00,0,0,0,0,0,0,0,0,0,0,0,0,3,3,0,0,0,0,0,0,0,2,2,0,0,,4,0,4,0,0,0
14/11/2022 02:00,0,0,0,0,0,0,0,0,0,0,0,0,0,0,0,0,0,0,0,0,0,4,3,1,0,,6,0,6,2,0,2
14/11/2022 03:00,0,0,0,0,0,0,0,0,0,0,0,0,1,1,0,1,1,0,0,0,0,3,2,1,0,,3,0,3,1,0,1
14/11/2022 04:00,1,1,0,1,1,0,2,1,1,0,0,0,1,1,0,0,0,0,0,0,0,4,0,4,0,,3,0,3,1,0,1
14/11/2022 05:00,5,3,2,7,6,1,9,8,1,0,0,0,5,5,0,2,2,0,0,0,0,36,8,28,0,,4,0,4,5,0,5
14/11/2022 06:00,12,10,2,14,13,1,15,12,3,0,0,0,13,13,0,6,6,0,0,0,0,123,29,94,0,,4,0,4,29,0,29
14/11/2022 07:00,39,34,5,56,44,12,63,46,17,0,0,0,40,39,1,19,19,0,0,0,0,276,63,213,0,,23,1,22,57,0,57
14/11/2022 08:00,95,82,13,90,72,18,120,95,25,0,0,0,81,80,1,51,51,0,0,0,0,544,99,445,0,,63,0,63,188,0,188
14/11/2022 09:00,49,45,4,40,29,11,46,32,14,0,0,0,23,23,0,17,17,0,1,1,0,234,37,197,0,,28,1,27,143,0,143
14/11/2022 10:00,22,12,10,60,23,37,72,30,42,0,0,0,14,14,0,10,10,0,1,1,0,101,26,75,0,,21,0,21,60,0,60
14/11/2022 11:00,12,12,0,38,20,18,51,24,27,0,0,0,6,6,0,9,9,0,1,1,0,87,28,59,0,,35,1,34,60,0,60
14/11/2022 12:00,13,9,4,64,36,28,82,42,40,0,0,0,4,4,0,13,13,0,4,4,0,106,31,75,0,,70,0,70,97,1,96
14/11/2022 13:00,18,10,8,72,33,39,87,30,57,0,0,0,7,7,0,21,21,0,1,1,0,135,64,71,0,,83,0,83,102,0,102
14/11/2022 14:00,9,3,6,50,27,23,78,27,51,0,0,0,5,5,0,24,24,0,3,3,0,127,59,68,0,,86,3,83,72,2,70
14/11/2022 15:00,26,9,17,44,19,25,62,30,32,0,0,0,5,5,0,54,54,0,4,4,0,141,78,63,0,,73,0,73,66,1,65
14/11/2022 16:00,40,19,21,53,27,26,77,28,49,0,0,0,6,5,1,43,43,0,6,6,0,255,148,107,0,,115,0,115,94,1,93
14/11/2022 17:00,56,26,30,75,18,57,120,26,94,0,0,0,8,8,0,43,43,0,3,3,0,406,269,137,0,,247,0,247,117,3,114
14/11/2022 18:00,42,14,28,75,16,59,90,15,75,0,0,0,12,11,1,32,32,0,0,0,0,334,224,110,0,,212,0,212,98,0,98
14/11/2022 19:00,17,8,9,44,15,29,48,10,38,0,0,0,8,8,0,19,19,0,0,0,0,170,110,60,0,,132,1,131,75,1,74
14/11/2022 20:00,15,4,11,13,5,8,12,3,9,0,0,0,7,7,0,13,13,0,0,0,0,120,81,39,0,,100,0,100,78,1,77
14/11/2022 21:00,12,7,5,7,2,5,8,1,7,0,0,0,2,2,0,10,10,0,0,0,0,67,40,27,0,,62,0,62,44,1,43
14/11/2022 22:00,8,5,3,2,1,1,1,0,1,0,0,0,3,3,0,6,6,0,0,0,0,59,40,19,0,,30,0,30,18,0,18
14/11/2022 23:00,2,1,1,1,0,1,2,0,2,0,0,0,2,2,0,3,3,0,0,0,0,14,12,2,0,,28,0,28,10,0,10
15/11/2022 00:00,0,0,0,0,0,0,0,0,0,0,0,0,0,0,0,0,0,0,0,0,0,15,11,4,0,,19,0,19,8,0,8
15/11/2022 01:00,2,1,1,1,1,0,1,1,0,0,0,0,1,1,0,0,0,0,0,0,0,5,5,0,0,,1,0,1,0,0,0
15/11/2022 02:00,0,0,0,0,0,0,0,0,0,0,0,0,0,0,0,0,0,0,0,0,0,0,0,0,0,,3,0,3,0,0,0
15/11/2022 03:00,0,0,0,0,0,0,0,0,0,0,0,0,2,2,0,0,0,0,0,0,0,2,0,2,0,,3,0,3,3,0,3
15/11/2022 04:00,0,0,0,2,2,0,4,2,2,0,0,0,2,2,0,0,0,0,0,0,0,3,0,3,0,,3,0,3,3,0,3
15/11/2022 05:00,5,4,1,11,9,2,13,11,2,0,0,0,1,1,0,0,0,0,0,0,0,30,6,24,0,,2,0,2,12,0,12
15/11/2022 06:00,24,18,6,17,14,3,21,16,5,0,0,0,18,18,0,9,9,0,0,0,0,142,32,110,0,,10,0,10,31,0,31
15/11/2022 07:00,67,60,7,66,55,11,76,60,16,0,0,0,36,36,0,24,24,0,2,2,0,323,78,245,0,,39,0,39,101,1,100
15/11/2022 08:00,143,132,11,101,85,16,134,113,21,0,0,0,60,60,0,48,48,0,1,1,0,704,107,597,0,,59,0,59,209,0,209
15/11/2022 09:00,55,46,9,58,37,21,81,50,31,0,0,0,42,42,0,22,22,0,0,0,0,266,32,234,0,,45,1,44,139,1,138
15/11/2022 10:00,18,13,5,39,18,21,47,21,26,0,0,0,21,21,0,14,14,0,1,1,0,106,33,73,0,,31,0,31,79,0,79
15/11/2022 11:00,8,6,2,58,30,28,55,28,27,0,0,0,12,11,1,10,10,0,1,1,0,88,27,61,0,,37,0,37,66,2,64
15/11/2022 12:00,26,18,8,50,19,31,58,13,45,0,0,0,23,23,0,7,7,0,6,6,0,109,45,64,0,,61,0,61,90,0,90
15/11/2022 13:00,20,10,10,72,34,38,90,38,52,0,0,0,17,16,1,16,16,0,9,9,0,116,44,72,0,,93,1,92,89,0,89
15/11/2022 14:00,7,4,3,65,24,41,76,32,44,0,0,0,8,7,1,17,17,0,11,11,0,132,58,74,0,,73,0,73,71,0,71
15/11/2022 15:00,23,7,16,55,28,27,70,27,43,0,0,0,7,7,0,52,52,0,12,12,0,175,102,73,0,,83,0,83,68,0,68
15/11/2022 16:00,37,9,28,66,30,36,79,31,48,0,0,0,4,4,0,41,41,0,0,0,0,246,144,102,0,,158,0,158,103,1,102
15/11/2022 17:00,66,21,45,97,21,76,141,30,111,0,0,0,6,6,0,58,58,0,2,2,0,490,345,145,0,,300,1,299,133,0,133
15/11/2022 18:00,47,17,30,102,20,82,146,28,118,0,0,0,9,9,0,34,34,0,0,0,0,396,284,112,0,,239,0,239,129,1,128
15/11/2022 19:00,15,6,9,47,13,34,55,14,41,0,0,0,7,7,0,27,27,0,0,0,0,199,132,67,0,,128,1,127,106,0,106
15/11/2022 20:00,14,4,10,31,12,19,41,14,27,0,0,0,10,10,0,20,20,0,0,0,0,132,89,43,0,,94,0,94,74,0,74
15/11/2022 21:00,6,2,4,11,4,7,22,7,15,0,0,0,5,5,0,9,9,0,0,0,0,73,55,18,0,,69,0,69,37,0,37
15/11/2022 22:00,7,6,1,1,0,1,7,1,6,0,0,0,4,4,0,5,5,0,0,0,0,54,37,17,0,,55,0,55,28,0,28
15/11/2022 23:00,3,0,3,4,2,2,7,3,4,0,0,0,1,1,0,1,1,0,0,0,0,25,19,6,0,,41,0,41,17,1,16
16/11/2022 00:00,0,0,0,0,0,0,3,1,2,0,0,0,1,1,0,2,2,0,0,0,0,26,21,5,0,,25,0,25,7,1,6
16/11/2022 01:00,0,0,0,1,1,0,2,2,0,0,0,0,1,1,0,0,0,0,0,0,0,3,2,1,0,,2,0,2,1,0,1
16/11/2022 02:00,0,0,0,0,0,0,0,0,0,0,0,0,1,1,0,0,0,0,0,0,0,1,1,0,0,,4,0,4,1,0,1
16/11/2022 03:00,0,0,0,0,0,0,0,0,0,0,0,0,0,0,0,0,0,0,0,0,0,4,3,1,0,,2,0,2,1,0,1
16/11/2022 04:00,1,1,0,1,1,0,2,2,0,0,0,0,2,2,0,0,0,0,0,0,0,1,1,0,0,,2,0,2,2,0,2
16/11/2022 05:00,3,2,1,13,10,3,14,9,5,0,0,0,4,4,0,0,0,0,0,0,0,26,5,21,0,,6,0,6,6,0,6
16/11/2022 06:00,19,17,2,16,14,2,31,24,7,0,0,0,22,22,0,7,7,0,0,0,0,145,38,107,0,,6,0,6,50,0,50
16/11/2022 07:00,56,51,5,63,52,11,83,66,17,0,0,0,61,61,0,21,21,0,9,9,0,341,69,272,0,,37,0,37,80,0,80
16/11/2022 08:00,157,141,16,104,76,28,121,95,26,0,0,0,84,84,0,52,52,0,17,17,0,692,118,574,0,,69,0,69,266,1,265
16/11/2022 09:00,52,47,5,53,30,23,78,46,32,0,0,0,53,52,1,22,22,0,2,2,0,300,43,257,0,,43,2,41,169,1,168
16/11/2022 10:00,18,12,6,53,27,26,53,27,26,0,0,0,5,5,0,11,11,0,3,3,0,101,24,77,0,,25,0,25,92,0,92
16/11/2022 11:00,16,11,5,45,16,29,55,23,32,0,0,0,6,6,0,17,17,0,0,0,0,73,22,51,0,,40,1,39,67,0,67
16/11/2022 12:00,18,11,7,64,34,30,80,43,37,0,0,0,9,9,0,11,11,0,2,2,0,121,37,84,0,,81,0,81,100,2,98
16/11/2022 13:00,17,11,6,63,31,32,70,25,45,0,0,0,8,8,0,31,31,0,3,3,0,154,67,87,0,,92,2,90,123,3,120
16/11/2022 14:00,15,8,7,41,18,23,60,24,36,0,0,0,3,3,0,15,15,0,5,5,0,106,53,53,0,,82,0,82,92,1,91
16/11/2022 15:00,31,15,16,49,21,28,75,34,41,0,0,0,5,5,0,53,53,0,7,7,0,183,97,86,0,,92,0,92,77,0,77
16/11/2022 16:00,41,17,24,45,15,30,61,17,44,0,0,0,5,5,0,29,29,0,2,2,0,241,147,94,0,,150,0,150,82,1,81
16/11/2022 17:00,67,14,53,69,14,55,107,23,84,0,0,0,3,3,0,33,33,0,0,0,0,478,334,144,0,,267,1,266,143,1,142
16/11/2022 18:00,35,11,24,72,10,62,94,13,81,0,0,0,3,3,0,33,33,0,1,1,0,402,273,129,0,,210,0,210,137,1,136
16/11/2022 19:00,26,6,20,48,9,39,60,9,51,0,0,0,2,2,0,15,15,0,1,1,0,223,134,89,0,,135,0,135,103,0,103
16/11/2022 20:00,19,8,11,20,8,12,27,10,17,0,0,0,7,7,0,14,14,0,3,3,0,140,100,40,0,,110,0,110,89,0,89
16/11/2022 21:00,9,3,6,5,3,2,13,5,8,0,0,0,1,1,0,11,11,0,1,1,0,106,73,33,0,,82,1,81,61,0,61
16/11/2022 22:00,4,4,0,5,2,3,8,1,7,0,0,0,3,3,0,4,4,0,0,0,0,80,51,29,0,,68,0,68,29,0,29
16/11/2022 23:00,3,3,0,5,0,5,8,2,6,0,0,0,4,4,0,1,1,0,0,0,0,37,31,6,0,,50,1,49,20,0,20
17/11/2022 00:00,1,0,1,0,0,0,0,0,0,0,0,0,2,2,0,6,6,0,0,0,0,32,22,10,0,,28,1,27,6,0,6
17/11/2022 01:00,1,0,1,0,0,0,0,0,0,0,0,0,1,1,0,1,1,0,0,0,0,4,3,1,0,,3,0,3,0,0,0
17/11/2022 02:00,0,0,0,0,0,0,2,1,1,0,0,0,0,0,0,0,0,0,0,0,0,5,3,2,0,,4,0,4,1,0,1
17/11/2022 03:00,1,1,0,0,0,0,2,1,1,0,0,0,0,0,0,0,0,0,0,0,0,6,4,2,0,,4,0,4,0,0,0
17/11/2022 04:00,1,1,0,1,1,0,2,1,1,0,0,0,2,2,0,2,2,0,0,0,0,2,0,2,0,,2,0,2,1,0,1
17/11/2022 05:00,2,2,0,6,5,1,8,6,2,0,0,0,3,3,0,1,1,0,0,0,0,27,4,23,0,,3,0,3,7,0,7
17/11/2022 06:00,20,16,4,16,15,1,14,10,4,0,0,0,18,18,0,8,8,0,0,0,0,138,31,107,0,,7,0,7,38,0,38
17/11/2022 07:00,52,45,7,49,40,9,69,59,10,0,0,0,34,34,0,25,25,0,0,0,0,308,71,237,0,,33,0,33,75,0,75
17/11/2022 08:00,124,108,16,84,62,22,113,94,19,0,0,0,84,83,1,50,50,0,3,3,0,640,99,541,0,,53,0,53,218,1,217
17/11/2022 09:00,42,38,4,29,18,11,47,31,16,0,0,0,37,35,2,19,19,0,0,0,0,282,42,240,0,,27,0,27,180,0,180
17/11/2022 10:00,13,12,1,44,20,24,51,21,30,0,0,0,21,21,0,6,6,0,0,0,0,83,26,57,0,,33,0,33,71,0,71
17/11/2022 11:00,7,3,4,47,27,20,59,23,36,0,0,0,6,5,1,7,7,0,1,1,0,92,31,61,0,,41,0,41,74,0,74
17/11/2022 12:00,14,5,9,54,26,28,61,32,29,0,0,0,2,2,0,13,13,0,2,2,0,91,27,64,0,,73,0,73,119,1,118
17/11/2022 13:00,19,11,8,37,21,16,57,28,29,0,0,0,7,7,0,16,16,0,1,1,0,135,53,82,0,,98,0,98,93,0,93
17/11/2022 14:00,22,12,10,33,10,23,33,13,20,0,0,0,4,4,0,16,16,0,1,1,0,110,51,59,0,,86,0,86,68,0,68
17/11/2022 15:00,32,12,20,30,8,22,57,16,41,0,0,0,7,7,0,34,34,0,0,0,0,182,103,79,0,,94,0,94,84,2,82
17/11/2022 16:00,44,17,27,38,14,24,56,16,40,0,0,0,11,11,0,41,41,0,1,1,0,254,158,96,0,,121,0,121,94,1,93
17/11/2022 17:00,63,16,47,82,21,61,111,22,89,0,0,0,8,8,0,40,40,0,0,0,0,444,294,150,0,,233,4,229,130,1,129
17/11/2022 18:00,42,13,29,74,16,58,104,21,83,0,0,0,8,8,0,29,29,0,0,0,0,354,218,136,0,,208,3,205,139,0,139
17/11/2022 19:00,26,8,18,34,12,22,46,13,33,0,0,0,8,8,0,20,20,0,0,0,0,218,140,78,0,,134,0,134,80,0,80
17/11/2022 20:00,15,5,10,30,9,21,34,11,23,0,0,0,9,8,1,17,17,0,0,0,0,128,81,47,0,,111,2,109,90,0,90
17/11/2022 21:00,11,6,5,11,5,6,23,7,16,0,0,0,5,5,0,13,13,0,2,2,0,99,65,34,0,,92,1,91,66,0,66
17/11/2022 22:00,12,5,7,2,1,1,11,4,7,0,0,0,3,3,0,2,2,0,0,0,0,127,83,44,0,,64,0,64,53,0,53
17/11/2022 23:00,3,1,2,7,3,4,10,2,8,0,0,0,3,3,0,4,4,0,2,2,0,79,42,37,0,,54,1,53,19,1,18
18/11/2022 00:00,3,1,2,5,1,4,5,1,4,0,0,0,0,0,0,5,5,0,0,0,0,34,29,5,0,,55,0,55,14,0,14
18/11/2022 01:00,0,0,0,2,1,1,1,0,1,0,0,0,1,1,0,0,0,0,1,1,0,18,14,4,0,,6,0,6,0,0,0
18/11/2022 02:00,1,0,1,0,0,0,1,1,0,0,0,0,0,0,0,0,0,0,0,0,0,11,8,3,0,,15,0,15,4,0,4
18/11/2022 03:00,1,0,1,3,1,2,1,1,0,0,0,0,0,0,0,0,0,0,0,0,0,6,5,1,0,,12,0,12,2,0,2
18/11/2022 04:00,2,2,0,1,1,0,2,1,1,0,0,0,3,3,0,1,1,0,0,0,0,11,5,6,0,,4,0,4,4,0,4
18/11/2022 05:00,2,2,0,8,6,2,11,8,3,0,0,0,4,4,0,2,2,0,0,0,0,24,4,20,0,,2,0,2,6,0,6
18/11/2022 06:00,16,15,1,13,9,4,14,8,6,0,0,0,16,16,0,7,7,0,1,1,0,101,19,82,0,,8,0,8,33,0,33
18/11/2022 07:00,41,37,4,36,26,10,41,29,12,0,0,0,33,33,0,16,16,0,5,5,0,215,52,163,0,,35,1,34,56,0,56
18/11/2022 08:00,80,67,13,67,49,18,75,57,18,0,0,0,53,53,0,39,39,0,13,13,0,422,88,334,0,,52,0,52,152,0,152
18/11/2022 09:00,27,24,3,35,15,20,54,32,22,0,0,0,31,31,0,13,13,0,0,0,0,231,49,182,0,,43,0,43,124,1,123
18/11/2022 10:00,16,12,4,50,25,25,50,22,28,0,0,0,18,18,0,8,8,0,1,1,0,112,28,84,0,,33,1,32,65,2,63
18/11/2022 11:00,16,11,5,44,22,22,41,20,21,0,0,0,9,9,0,4,4,0,0,0,0,103,29,74,0,,43,0,43,64,1,63
18/11/2022 12:00,18,10,8,39,16,23,48,22,26,0,0,0,10,10,0,15,15,0,0,0,0,134,49,85,0,,67,1,66,85,0,85
18/11/2022 13:00,19,12,7,50,24,26,68,29,39,0,0,0,3,3,0,36,36,0,0,0,0,143,62,81,0,,101,0,101,109,1,108
18/11/2022 14:00,15,6,9,63,28,35,65,27,38,0,0,0,2,2,0,24,24,0,0,0,0,168,81,87,0,,88,1,87,92,1,91
18/11/2022 15:00,20,12,8,59,28,31,70,26,44,0,0,0,6,6,0,22,22,0,2,2,0,192,99,93,0,,85,0,85,77,0,77
18/11/2022 16:00,29,8,21,54,24,30,56,24,32,0,0,0,3,3,0,28,28,0,5,5,0,225,121,104,0,,119,0,119,105,0,105
18/11/2022 17:00,42,12,30,61,17,44,101,27,74,0,0,0,0,0,0,34,34,0,6,6,0,315,190,125,0,,189,1,188,106,0,106
18/11/2022 18:00,31,15,16,53,15,38,59,11,48,0,0,0,3,3,0,15,15,0,2,2,0,253,140,113,0,,185,0,185,134,0,134
18/11/2022 19:00,15,5,10,21,7,14,26,6,20,0,0,0,3,3,0,14,14,0,0,0,0,169,96,73,0,,119,0,119,101,0,101
18/11/2022 20:00,8,2,6,12,3,9,16,6,10,0,0,0,6,6,0,9,9,0,7,7,0,105,59,46,0,,102,1,101,96,0,96
18/11/2022 21:00,6,1,5,6,5,1,8,5,3,0,0,0,6,6,0,4,4,0,1,1,0,86,54,32,0,,87,0,87,72,0,72
18/11/2022 22:00,9,7,2,4,1,3,12,5,7,0,0,0,3,3,0,3,3,0,1,1,0,60,34,26,0,,52,0,52,45,0,45
18/11/2022 23:00,2,1,1,8,2,6,10,1,9,0,0,0,1,1,0,0,0,0,2,2,0,58,38,20,0,,65,1,64,25,0,25
19/11/2022 00:00,3,1,2,2,2,0,3,1,2,0,0,0,1,1,0,4,4,0,2,2,0,36,20,16,0,,38,0,38,17,0,17
19/11/2022 01:00,1,0,1,0,0,0,0,0,0,0,0,0,1,1,0,2,2,0,1,1,0,29,22,7,0,,7,0,7,1,0,1
19/11/2022 02:00,1,1,0,0,0,0,1,0,1,0,0,0,0,0,0,0,0,0,0,0,0,6,3,3,0,,11,0,11,4,0,4
19/11/2022 03:00,1,0,1,0,0,0,1,0,1,0,0,0,1,1,0,0,0,0,0,0,0,10,8,2,0,,6,0,6,6,0,6
19/11/2022 04:00,2,0,2,0,0,0,1,0,1,0,0,0,0,0,0,0,0,0,0,0,0,9,4,5,0,,4,0,4,4,0,4
19/11/2022 05:00,1,1,0,3,0,3,3,2,1,0,0,0,2,2,0,3,3,0,0,0,0,8,4,4,0,,6,0,6,3,0,3
19/11/2022 06:00,2,2,0,6,2,4,5,1,4,0,0,0,5,5,0,2,2,0,0,0,0,37,14,23,0,,3,0,3,6,0,6
19/11/2022 07:00,5,5,0,13,7,6,23,10,13,0,0,0,8,8,0,4,4,0,1,1,0,41,15,26,0,,10,0,10,12,0,12
19/11/2022 08:00,9,6,3,45,21,24,56,23,33,0,0,0,8,8,0,6,6,0,1,1,0,58,16,42,0,,10,0,10,30,0,30
19/11/2022 09:00,8,7,1,77,32,45,96,40,56,0,0,0,6,6,0,7,7,0,6,6,0,97,33,64,0,,16,0,16,49,1,48
19/11/2022 10:00,13,11,2,105,46,59,117,45,72,0,0,0,7,6,1,22,22,0,4,4,0,81,27,54,0,,32,0,32,82,2,80
19/11/2022 11:00,8,5,3,114,69,45,134,76,58,0,0,0,0,0,0,17,17,0,5,5,0,109,36,73,0,,41,0,41,84,0,84
19/11/2022 12:00,11,5,6,85,37,48,92,43,49,0,0,0,1,1,0,16,16,0,2,2,0,114,48,66,0,,54,1,53,88,0,88
19/11/2022 13:00,16,5,11,54,29,25,66,38,28,0,0,0,6,6,0,13,13,0,6,6,0,121,38,83,0,,66,1,65,100,0,100
19/11/2022 14:00,15,8,7,39,19,20,60,27,33,0,0,0,11,11,0,13,13,0,6,6,0,132,43,89,0,,77,0,77,88,0,88
19/11/2022 15:00,11,6,5,37,18,19,44,20,24,0,0,0,11,10,1,13,13,0,1,1,0,128,55,73,0,,94,0,94,98,0,98
19/11/2022 16:00,10,6,4,24,12,12,30,14,16,0,0,0,6,6,0,5,5,0,0,0,0,142,70,72,0,,81,1,80,58,0,58
19/11/2022 17:00,6,4,2,12,7,5,15,5,10,0,0,0,2,2,0,8,8,0,0,0,0,109,68,41,0,,88,0,88,50,0,50
19/11/2022 18:00,15,13,2,3,2,1,8,3,5,0,0,0,13,13,0,4,4,0,0,0,0,112,61,51,0,,96,2,94,68,0,68
19/11/2022 19:00,5,3,2,5,2,3,10,2,8,0,0,0,13,13,0,4,4,0,1,1,0,108,48,60,0,,90,1,89,37,0,37
19/11/2022 20:00,6,1,5,2,0,2,7,2,5,0,0,0,6,6,0,5,5,0,3,3,0,80,42,38,0,,57,0,57,55,0,55
19/11/2022 21:00,3,3,0,1,1,0,4,2,2,0,0,0,7,7,0,5,5,0,0,0,0,44,25,19,0,,55,1,54,42,1,41
19/11/2022 22:00,4,3,1,2,0,2,4,0,4,0,0,0,5,5,0,3,3,0,0,0,0,61,32,29,0,,38,0,38,38,0,38
19/11/2022 23:00,1,0,1,2,1,1,15,7,8,0,0,0,0,0,0,5,5,0,0,0,0,66,33,33,0,,38,0,38,37,0,37
20/11/2022 00:00,4,1,3,3,1,2,6,2,4,0,0,0,1,1,0,0,0,0,2,2,0,35,24,11,0,,27,0,27,19,0,19
20/11/2022 01:00,0,0,0,5,2,3,4,0,4,0,0,0,0,0,0,0,0,0,0,0,0,29,23,6,0,,6,0,6,1,0,1
20/11/2022 02:00,3,0,3,1,0,1,4,1,3,0,0,0,0,0,0,1,1,0,0,0,0,26,17,9,0,,17,1,16,4,0,4
20/11/2022 03:00,0,0,0,1,0,1,0,0,0,0,0,0,1,1,0,2,2,0,0,0,0,10,8,2,0,,15,0,15,5,0,5
20/11/2022 04:00,1,0,1,0,0,0,1,1,0,0,0,0,2,2,0,2,2,0,0,0,0,12,8,4,0,,4,0,4,3,0,3
20/11/2022 05:00,1,1,0,1,1,0,1,1,0,0,0,0,4,4,0,2,2,0,0,0,0,12,6,6,0,,4,0,4,5,0,5
20/11/2022 06:00,2,2,0,3,2,1,4,2,2,0,0,0,2,2,0,3,3,0,0,0,0,25,5,20,0,,5,0,5,5,0,5
20/11/2022 07:00,5,4,1,15,8,7,16,5,11,0,0,0,9,9,0,2,2,0,1,1,0,27,10,17,0,,5,0,5,7,0,7
20/11/2022 08:00,8,4,4,54,20,34,57,19,38,0,0,0,8,7,1,6,6,0,3,3,0,48,19,29,0,,8,0,8,9,0,9
20/11/2022 09:00,9,7,2,46,19,27,51,24,27,0,0,0,8,8,0,11,11,0,9,9,0,46,14,32,0,,13,0,13,28,0,28
20/11/2022 10:00,9,6,3,57,21,36,62,29,33,0,0,0,6,6,0,10,10,0,6,6,0,59,20,39,0,,25,2,23,46,0,46
20/11/2022 11:00,10,6,4,69,38,31,82,36,46,0,0,0,3,3,0,14,14,0,9,9,0,81,28,53,0,,25,0,25,46,0,46
20/11/2022 12:00,16,12,4,68,32,36,78,39,39,0,0,0,1,1,0,15,15,0,4,4,0,108,28,80,0,,39,0,39,68,0,68
20/11/2022 13:00,12,9,3,61,32,29,86,42,44,0,0,0,6,6,0,14,14,0,0,0,0,112,34,78,0,,61,0,61,87,0,87
20/11/2022 14:00,13,6,7,66,27,39,98,47,51,0,0,0,3,3,0,13,13,0,3,3,0,99,48,51,0,,48,0,48,94,0,94
20/11/2022 15:00,10,6,4,56,26,30,84,32,52,0,0,0,2,2,0,8,8,0,2,2,0,89,40,49,0,,72,0,72,61,1,60
20/11/2022 16:00,7,4,3,42,24,18,64,42,22,0,0,0,1,1,0,14,14,0,13,13,0,106,44,62,0,,70,1,69,64,1,63
20/11/2022 17:00,4,1,3,17,10,7,30,16,14,0,0,0,4,4,0,8,8,0,5,5,0,111,53,58,0,,117,1,116,83,2,81
20/11/2022 18:00,10,3,7,15,3,12,21,7,14,0,0,0,5,5,0,8,8,0,3,3,0,99,44,55,0,,106,1,105,69,1,68
20/11/2022 19:00,12,5,7,18,12,6,23,10,13,0,0,0,5,5,0,11,11,0,3,3,0,77,54,23,0,,84,1,83,69,0,69
20/11/2022 20:00,4,3,1,9,4,5,17,8,9,0,0,0,6,6,0,7,7,0,4,4,0,64,26,38,0,,60,1,59,64,2,62
20/11/2022 21:00,7,4,3,7,4,3,17,8,9,0,0,0,2,2,0,1,1,0,0,0,0,42,22,20,0,,44,0,44,44,0,44
20/11/2022 22:00,6,5,1,3,1,2,4,3,1,0,0,0,4,4,0,3,3,0,0,0,0,32,21,11,0,,30,1,29,28,0,28
20/11/2022 23:00,3,1,2,2,0,2,3,2,1,0,0,0,2,1,1,1,1,0,0,0,0,19,15,4,0,,27,1,26,20,0,20
21/11/2022 00:00,2,2,0,1,1,0,1,0,1,0,0,0,1,1,0,2,2,0,0,0,0,11,7,4,0,,12,1,11,8,0,8
21/11/2022 01:00,0,0,0,0,0,0,0,0,0,0,0,0,0,0,0,0,0,0,0,0,0,4,4,0,0,,3,1,2,0,0,0
21/11/2022 02:00,0,0,0,1,1,0,3,2,1,0,0,0,0,0,0,0,0,0,0,0,0,2,2,0,0,,4,0,4,0,0,0
21/11/2022 03:00,0,0,0,1,0,1,3,2,1,0,0,0,0,0,0,0,0,0,0,0,0,4,3,1,0,,4,0,4,1,0,1
21/11/2022 04:00,1,1,0,1,1,0,1,0,1,0,0,0,0,0,0,0,0,0,0,0,0,5,0,5,0,,1,0,1,2,0,2
21/11/2022 05:00,3,3,0,2,2,0,6,3,3,0,0,0,3,3,0,2,2,0,0,0,0,22,2,20,0,,3,0,3,4,0,4
21/11/2022 06:00,12,12,0,0,0,0,0,0,0,0,0,0,7,7,0,6,6,0,0,0,0,103,26,77,0,,4,0,4,19,0,19
21/11/2022 07:00,24,22,2,10,10,0,13,10,3,0,0,0,23,23,0,9,9,0,4,4,0,193,45,148,0,,15,0,15,46,0,46
21/11/2022 08:00,46,42,4,16,12,4,16,14,2,0,0,0,43,43,0,21,21,0,50,50,0,332,69,263,0,,31,0,31,84,0,84
21/11/2022 09:00,19,16,3,9,8,1,11,10,1,0,0,0,17,17,0,5,5,0,4,4,0,160,27,133,0,,20,0,20,58,0,58
21/11/2022 10:00,5,3,2,6,3,3,7,3,4,0,0,0,2,2,0,3,3,0,1,1,0,49,7,42,0,,7,0,7,22,0,22
21/11/2022 11:00,8,7,1,7,6,1,4,2,2,0,0,0,1,1,0,4,4,0,3,3,0,50,15,35,0,,17,0,17,26,1,25
21/11/2022 12:00,9,7,2,4,2,2,9,3,6,0,0,0,0,0,0,5,5,0,1,1,0,87,34,53,0,,33,0,33,61,0,61
21/11/2022 13:00,19,12,7,10,4,6,13,6,7,0,0,0,1,1,0,14,14,0,5,5,0,79,31,48,0,,43,0,43,46,0,46
21/11/2022 14:00,13,8,5,16,8,8,20,10,10,0,0,0,0,0,0,12,12,0,13,13,0,82,41,41,0,,61,1,60,60,0,60
21/11/2022 15:00,22,9,13,19,4,15,20,7,13,0,0,0,1,1,0,21,21,0,6,6,0,131,66,65,0,,56,2,54,63,0,63
21/11/2022 16:00,26,8,18,32,15,17,40,15,25,0,0,0,4,4,0,32,32,0,1,1,0,208,111,97,0,,75,0,75,67,0,67
21/11/2022 17:00,41,15,26,30,10,20,41,13,28,0,0,0,1,1,0,28,28,0,6,6,0,301,167,134,0,,141,1,140,94,2,92
21/11/2022 18:00,23,7,16,28,6,22,47,12,35,0,0,0,4,4,0,18,18,0,0,0,0,228,149,79,0,,136,0,136,71,0,71
21/11/2022 19:00,12,6,6,24,9,15,30,8,22,0,0,0,3,3,0,13,13,0,9,9,0,147,87,60,0,,99,1,98,74,1,73
21/11/2022 20:00,10,4,6,15,8,7,19,8,11,0,0,0,2,2,0,11,11,0,0,0,0,102,69,33,0,,73,2,71,66,1,65
21/11/2022 21:00,13,10,3,8,3,5,9,3,6,0,0,0,2,2,0,8,8,0,1,1,0,69,45,24,0,,59,0,59,40,0,40
21/11/2022 22:00,11,7,4,8,2,6,8,4,4,0,0,0,2,2,0,4,4,0,0,0,0,40,29,11,0,,28,0,28,23,0,23
21/11/2022 23:00,1,0,1,1,0,1,4,2,2,0,0,0,0,0,0,0,0,0,0,0,0,24,16,8,0,,18,0,18,11,0,11
22/11/2022 00:00,2,1,1,0,0,0,1,0,1,0,0,0,1,1,0,0,0,0,1,1,0,10,8,2,0,,11,0,11,9,0,9
22/11/2022 01:00,0,0,0,0,0,0,0,0,0,0,0,0,1,1,0,0,0,0,0,0,0,3,2,1,0,,5,0,5,0,0,0
22/11/2022 02:00,0,0,0,0,0,0,0,0,0,0,0,0,0,0,0,0,0,0,0,0,0,5,2,3,0,,4,0,4,1,0,1
22/11/2022 03:00,0,0,0,0,0,0,0,0,0,0,0,0,1,1,0,0,0,0,0,0,0,4,2,2,0,,3,1,2,2,0,2
22/11/2022 04:00,2,1,1,2,1,1,1,1,0,0,0,0,1,1,0,0,0,0,0,0,0,4,2,2,0,,1,0,1,1,0,1
22/11/2022 05:00,3,2,1,6,5,1,8,6,2,0,0,0,5,5,0,2,2,0,0,0,0,30,2,28,0,,2,0,2,7,0,7
22/11/2022 06:00,22,19,3,19,16,3,29,23,6,0,0,0,20,20,0,5,5,0,0,0,0,128,27,101,0,,10,0,10,34,0,34
22/11/2022 07:00,40,33,7,68,56,12,83,69,14,0,0,0,27,27,0,25,25,0,18,18,0,299,62,237,0,,20,0,20,79,0,79
22/11/2022 08:00,138,120,18,70,60,10,96,83,13,0,0,0,46,46,0,48,48,0,41,41,0,689,112,577,0,,53,0,53,226,0,226
22/11/2022 09:00,57,53,4,29,19,10,44,31,13,0,0,0,33,33,0,16,16,0,5,5,0,293,55,238,0,,39,1,38,154,0,154
22/11/2022 10:00,11,9,2,44,18,26,53,19,34,0,0,0,11,11,0,8,8,0,0,0,0,84,13,71,0,,25,0,25,66,0,66
22/11/2022 11:00,10,6,4,34,18,16,36,20,16,0,0,0,4,4,0,5,5,0,3,3,0,77,3,74,0,,30,0,30,65,0,65
22/11/2022 12:00,18,8,10,21,11,10,33,15,18,0,0,0,4,4,0,10,10,0,7,7,0,85,24,61,0,,61,3,58,70,0,70
22/11/2022 13:00,11,5,6,42,23,19,36,19,17,0,0,0,4,4,0,11,11,0,4,4,0,111,41,70,0,,87,0,87,85,1,84
22/11/2022 14:00,14,10,4,42,21,21,53,22,31,0,0,0,2,2,0,21,21,0,5,5,0,101,48,53,0,,64,0,64,61,0,61
22/11/2022 15:00,24,12,12,50,19,31,54,20,34,0,0,0,1,1,0,50,50,0,3,3,0,138,73,65,0,,72,0,72,67,0,67
22/11/2022 16:00,42,13,29,61,21,40,72,21,51,0,0,0,1,1,0,41,41,0,5,5,0,247,161,86,0,,138,1,137,73,1,72
22/11/2022 17:00,64,19,45,79,18,61,122,24,98,0,0,0,6,6,0,38,38,0,11,11,0,426,284,142,0,,262,0,262,112,2,110
22/11/2022 18:00,25,5,20,67,9,58,93,16,77,0,0,0,2,2,0,19,19,0,2,2,0,362,253,109,0,,238,0,238,120,0,120
22/11/2022 19:00,14,6,8,33,9,24,51,9,42,0,0,0,1,1,0,20,20,0,1,1,0,187,119,68,0,,119,0,119,95,1,94
22/11/2022 20:00,12,4,8,21,9,12,28,17,11,0,0,0,1,1,0,14,14,0,0,0,0,139,92,47,0,,81,0,81,85,0,85
22/11/2022 21:00,9,3,6,18,8,10,22,7,15,0,0,0,4,4,0,9,9,0,0,0,0,100,74,26,0,,72,0,72,47,0,47
22/11/2022 22:00,9,4,5,3,2,1,6,2,4,0,0,0,0,0,0,5,5,0,0,0,0,59,41,18,0,,49,1,48,21,0,21
22/11/2022 23:00,1,0,1,1,0,1,4,0,4,0,0,0,0,0,0,1,1,0,0,0,0,22,15,7,0,,33,0,33,9,0,9
23/11/2022 00:00,0,0,0,0,0,0,1,0,1,0,0,0,0,0,0,1,1,0,0,0,0,17,14,3,0,,17,0,17,7,0,7
23/11/2022 01:00,0,0,0,0,0,0,1,0,1,0,0,0,0,0,0,1,1,0,0,0,0,14,11,3,0,,4,0,4,2,0,2
23/11/2022 02:00,1,1,0,1,1,0,2,1,1,0,0,0,0,0,0,0,0,0,0,0,0,1,1,0,0,,5,0,5,1,0,1
23/11/2022 03:00,0,0,0,0,0,0,1,0,1,0,0,0,1,1,0,0,0,0,0,0,0,3,3,0,0,,1,0,1,0,0,0
23/11/2022 04:00,1,1,0,1,1,0,2,0,2,0,0,0,0,0,0,0,0,0,0,0,0,2,2,0,0,,1,0,1,1,0,1
23/11/2022 05:00,3,3,0,6,5,1,5,3,2,0,0,0,0,0,0,0,0,0,0,0,0,28,5,23,0,,3,0,3,10,0,10
23/11/2022 06:00,12,12,0,11,9,2,16,12,4,0,0,0,15,15,0,4,4,0,2,2,0,114,24,90,0,,8,0,8,23,0,23
23/11/2022 07:00,44,40,4,39,33,6,59,53,6,0,0,0,26,26,0,21,21,0,5,5,0,326,69,257,0,,41,0,41,87,0,87
23/11/2022 08:00,128,112,16,71,55,16,89,70,19,0,0,0,68,68,0,55,55,0,18,18,0,626,110,516,0,,54,0,54,231,0,231
23/11/2022 09:00,47,43,4,45,24,21,53,29,24,0,0,0,21,21,0,16,16,0,1,1,0,260,46,214,0,,39,0,39,136,1,135
23/11/2022 10:00,18,13,5,46,26,20,48,30,18,0,0,0,17,16,1,9,9,0,2,2,0,92,25,67,0,,37,1,36,64,0,64
23/11/2022 11:00,11,5,6,37,16,21,57,21,36,0,0,0,5,5,0,12,12,0,2,2,0,88,26,62,0,,27,1,26,60,0,60
23/11/2022 12:00,29,18,11,44,20,24,67,32,35,0,0,0,7,6,1,17,17,0,0,0,0,101,41,60,0,,70,1,69,92,1,91
23/11/2022 13:00,16,12,4,37,20,17,62,29,33,0,0,0,11,11,0,24,24,0,0,0,0,146,65,81,0,,74,0,74,112,0,112
23/11/2022 14:00,17,8,9,34,14,20,45,17,28,0,0,0,3,3,0,11,11,0,1,1,0,108,48,60,0,,64,0,64,71,1,70
23/11/2022 15:00,25,11,14,41,17,24,50,18,32,0,0,0,6,6,0,49,49,0,1,1,0,155,75,80,0,,76,1,75,74,0,74
23/11/2022 16:00,43,14,29,30,11,19,51,20,31,0,0,0,3,3,0,35,35,0,4,4,0,236,143,93,0,,111,0,111,75,0,75
23/11/2022 17:00,45,7,38,59,10,49,85,9,76,0,0,0,0,0,0,34,34,0,1,1,0,371,251,120,0,,206,0,206,96,0,96
23/11/2022 18:00,40,14,26,55,12,43,75,11,64,0,0,0,2,2,0,25,25,0,0,0,0,341,232,109,0,,225,1,224,94,1,93
23/11/2022 19:00,18,8,10,28,6,22,46,10,36,0,0,0,3,3,0,13,13,0,0,0,0,194,126,68,0,,137,0,137,75,0,75
23/11/2022 20:00,12,3,9,17,2,15,19,2,17,0,0,0,5,5,0,11,11,0,0,0,0,131,79,52,0,,105,1,104,68,0,68
23/11/2022 21:00,12,4,8,8,2,6,17,3,14,0,0,0,4,4,0,10,10,0,1,1,0,89,52,37,0,,72,2,70,44,0,44
23/11/2022 22:00,8,3,5,3,0,3,8,4,4,0,0,0,1,1,0,5,5,0,0,0,0,75,61,14,0,,38,0,38,23,0,23
23/11/2022 23:00,1,0,1,2,0,2,4,0,4,0,0,0,0,0,0,1,1,0,1,1,0,32,23,9,0,,33,0,33,18,0,18
24/11/2022 00:00,4,1,3,0,0,0,2,0,2,0,0,0,0,0,0,0,0,0,0,0,0,23,20,3,0,,18,0,18,11,0,11
24/11/2022 01:00,0,0,0,1,0,1,1,0,1,0,0,0,0,0,0,2,2,0,0,0,0,7,5,2,0,,6,0,6,0,0,0
24/11/2022 02:00,0,0,0,0,0,0,0,0,0,0,0,0,0,0,0,0,0,0,0,0,0,3,2,1,0,,6,0,6,2,0,2
24/11/2022 03:00,1,0,1,0,0,0,0,0,0,0,0,0,0,0,0,0,0,0,0,0,0,6,4,2,0,,5,0,5,0,0,0
24/11/2022 04:00,2,2,0,1,1,0,3,1,2,0,0,0,0,0,0,0,0,0,0,0,0,5,2,3,0,,1,0,1,1,0,1
24/11/2022 05:00,5,4,1,3,1,2,3,2,1,0,0,0,1,1,0,1,1,0,0,0,0,31,4,27,0,,2,0,2,7,0,7
24/11/2022 06:00,14,13,1,12,11,1,19,15,4,0,0,0,11,11,0,4,4,0,0,0,0,114,27,87,0,,4,0,4,32,0,32
24/11/2022 07:00,37,36,1,33,25,8,46,37,9,0,0,0,15,15,0,16,16,0,0,0,0,232,49,183,0,,21,0,21,74,1,73
24/11/2022 08:00,93,86,7,53,41,12,65,54,11,0,0,0,23,23,0,42,42,0,1,1,0,509,83,426,0,,46,0,46,172,0,172
24/11/2022 09:00,27,25,2,11,10,1,22,15,7,0,0,0,12,12,0,9,9,0,0,0,0,153,22,131,0,,23,0,23,70,1,69
24/11/2022 10:00,11,10,1,10,6,4,19,8,11,0,0,0,1,1,0,7,7,0,0,0,0,109,37,72,0,,11,0,11,65,0,65
24/11/2022 11:00,15,11,4,13,6,7,20,10,10,0,0,0,1,1,0,5,5,0,0,0,0,86,22,64,0,,26,1,25,52,0,52
24/11/2022 12:00,18,14,4,16,6,10,20,5,15,0,0,0,3,3,0,15,15,0,0,0,0,92,30,62,0,,63,0,63,95,0,95
24/11/2022 13:00,19,12,7,28,10,18,39,17,22,0,0,0,3,3,0,15,15,0,0,0,0,121,52,69,0,,75,0,75,97,2,95
24/11/2022 14:00,20,11,9,29,9,20,36,13,23,0,0,0,5,5,0,18,18,0,0,0,0,116,56,60,0,,72,0,72,70,0,70
24/11/2022 15:00,29,12,17,34,10,24,48,17,31,0,0,0,4,4,0,40,40,0,2,2,0,129,73,56,0,,77,0,77,75,1,74
24/11/2022 16:00,36,16,20,29,10,19,46,11,35,0,0,0,1,1,0,28,28,0,4,4,0,231,125,106,0,,99,0,99,64,1,63
24/11/2022 17:00,36,10,26,50,11,39,73,19,54,0,0,0,1,1,0,29,29,0,9,9,0,354,220,134,0,,182,1,181,86,2,84
24/11/2022 18:00,27,10,17,54,10,44,66,11,55,0,0,0,7,7,0,23,23,0,8,8,0,279,187,92,0,,162,0,162,80,0,80
24/11/2022 19:00,13,6,7,30,10,20,31,8,23,0,0,0,4,3,1,17,17,0,2,2,0,145,84,61,0,,84,0,84,67,0,67
24/11/2022 20:00,7,2,5,28,10,18,28,10,18,0,0,0,4,4,0,9,9,0,0,0,0,123,82,41,0,,97,1,96,51,1,50
24/11/2022 21:00,13,6,7,12,4,8,17,6,11,0,0,0,1,1,0,11,11,0,1,1,0,75,53,22,0,,76,0,76,57,0,57
24/11/2022 22:00,11,6,5,8,4,4,12,3,9,0,0,0,2,2,0,5,5,0,0,0,0,91,57,34,0,,51,1,50,42,0,42
24/11/2022 23:00,4,3,1,2,0,2,2,0,2,0,0,0,0,0,0,2,2,0,0,0,0,39,28,11,0,,45,1,44,17,0,17
25/11/2022 00:00,1,0,1,4,2,2,5,3,2,0,0,0,0,0,0,2,2,0,0,0,0,34,23,11,0,,26,0,26,13,0,13
25/11/2022 01:00,1,0,1,0,0,0,2,1,1,0,0,0,0,0,0,0,0,0,0,0,0,15,13,2,0,,7,0,7,1,0,1
25/11/2022 02:00,0,0,0,1,0,1,1,0,1,0,0,0,0,0,0,0,0,0,0,0,0,5,4,1,0,,16,1,15,2,0,2
25/11/2022 03:00,1,0,1,0,0,0,1,0,1,0,0,0,0,0,0,0,0,0,0,0,0,7,5,2,0,,1,0,1,1,0,1
25/11/2022 04:00,1,1,0,1,1,0,3,0,3,0,0,0,3,2,1,0,0,0,0,0,0,7,6,1,0,,1,0,1,1,0,1
25/11/2022 05:00,2,2,0,5,4,1,4,2,2,0,0,0,1,1,0,3,3,0,0,0,0,25,5,20,0,,2,0,2,7,0,7
25/11/2022 06:00,12,10,2,7,5,2,9,4,5,0,0,0,10,10,0,6,6,0,0,0,0,102,28,74,0,,10,0,10,20,0,20
25/11/2022 07:00,33,25,8,29,25,4,41,34,7,0,0,0,15,15,0,10,10,0,1,1,0,219,57,162,0,,26,0,26,65,0,65
25/11/2022 08:00,64,53,11,53,41,12,68,52,16,0,0,0,28,28,0,42,42,0,3,3,0,380,78,302,0,,36,0,36,132,0,132
25/11/2022 09:00,29,23,6,51,27,24,55,34,21,0,0,0,16,15,1,13,13,0,0,0,0,194,42,152,0,,32,0,32,122,1,121
25/11/2022 10:00,13,11,2,33,16,17,47,17,30,0,0,0,7,7,0,8,8,0,3,3,0,83,21,62,0,,24,1,23,56,0,56
25/11/2022 11:00,10,6,4,54,31,23,54,23,31,0,0,0,4,4,0,10,10,0,0,0,0,100,24,76,0,,46,0,46,79,0,79
25/11/2022 12:00,15,11,4,49,21,28,60,26,34,0,0,0,11,11,0,18,18,0,4,4,0,149,56,93,0,,68,1,67,81,0,81
25/11/2022 13:00,19,12,7,34,15,19,50,19,31,0,0,0,3,3,0,33,33,0,2,2,0,125,50,75,0,,99,0,99,123,0,123
25/11/2022 14:00,19,9,10,30,8,22,42,17,25,0,0,0,2,2,0,21,21,0,3,3,0,140,68,72,0,,79,1,78,85,0,85
25/11/2022 15:00,16,6,10,45,19,26,58,21,37,0,0,0,4,4,0,20,20,0,9,9,0,172,86,86,0,,81,0,81,88,0,88
25/11/2022 16:00,25,12,13,36,12,24,57,20,37,0,0,0,2,2,0,22,22,0,7,7,0,227,117,110,0,,114,0,114,87,0,87
25/11/2022 17:00,35,12,23,46,13,33,64,17,47,0,0,0,4,3,1,29,29,0,0,0,0,293,181,112,0,,190,1,189,129,0,129
25/11/2022 18:00,26,10,16,48,14,34,65,15,50,0,0,0,8,8,0,13,13,0,1,1,0,210,126,84,0,,181,0,181,134,0,134
25/11/2022 19:00,19,11,8,22,8,14,25,9,16,0,0,0,6,6,0,13,13,0,0,0,0,163,80,83,0,,122,1,121,103,0,103
25/11/2022 20:00,9,5,4,13,4,9,24,8,16,0,0,0,5,4,1,10,10,0,0,0,0,107,64,43,0,,116,1,115,87,2,85
25/11/2022 21:00,9,8,1,10,3,7,13,6,7,0,0,0,2,2,0,3,3,0,0,0,0,88,47,41,0,,88,0,88,79,0,79
25/11/2022 22:00,13,11,2,1,1,0,3,2,1,0,0,0,2,2,0,5,5,0,0,0,0,67,42,25,0,,56,0,56,40,0,40
25/11/2022 23:00,4,1,3,5,0,5,7,1,6,0,0,0,3,3,0,4,4,0,1,1,0,53,37,16,0,,47,1,46,38,0,38
26/11/2022 00:00,4,0,4,4,0,4,5,0,5,0,0,0,3,3,0,2,2,0,0,0,0,33,19,14,0,,44,0,44,26,0,26
26/11/2022 01:00,0,0,0,2,1,1,2,0,2,0,0,0,1,1,0,3,3,0,0,0,0,29,21,8,0,,10,0,10,1,0,1
26/11/2022 02:00,1,0,1,2,0,2,1,0,1,0,0,0,1,1,0,0,0,0,0,0,0,17,8,9,0,,16,1,15,8,0,8
26/11/2022 03:00,2,2,0,1,1,0,2,1,1,0,0,0,1,1,0,0,0,0,0,0,0,14,7,7,0,,25,0,25,4,0,4
26/11/2022 04:00,2,1,1,0,0,0,1,0,1,0,0,0,0,0,0,0,0,0,0,0,0,10,6,4,0,,10,0,10,6,1,5
26/11/2022 05:00,0,0,0,3,2,1,3,1,2,0,0,0,2,2,0,4,4,0,0,0,0,9,4,5,0,,3,0,3,4,0,4
26/11/2022 06:00,1,1,0,0,0,0,1,0,1,0,0,0,3,3,0,1,1,0,0,0,0,31,9,22,0,,3,0,3,7,0,7
26/11/2022 07:00,5,5,0,12,7,5,14,5,9,0,0,0,10,10,0,3,3,0,0,0,0,52,19,33,0,,11,0,11,14,0,14
26/11/2022 08:00,11,8,3,21,8,13,23,7,16,0,0,0,10,10,0,8,8,0,0,0,0,72,21,51,0,,8,0,8,31,0,31
26/11/2022 09:00,5,4,1,63,33,30,77,32,45,0,0,0,3,3,0,7,7,0,0,0,0,69,23,46,0,,16,0,16,61,0,61
26/11/2022 10:00,8,7,1,51,24,27,68,18,50,0,0,0,8,8,0,14,14,0,1,1,0,72,22,50,0,,27,1,26,53,0,53
26/11/2022 11:00,18,7,11,73,44,29,79,34,45,0,0,0,5,5,0,12,12,0,6,6,0,85,31,54,0,,46,0,46,77,0,77
26/11/2022 12:00,13,8,5,32,19,13,52,21,31,0,0,0,3,3,0,16,16,0,5,5,0,91,33,58,0,,65,2,63,86,0,86
26/11/2022 13:00,16,9,7,26,14,12,50,21,29,0,0,0,9,9,0,9,9,0,3,3,0,128,49,79,0,,88,1,87,97,1,96
26/11/2022 14:00,13,9,4,18,9,9,39,16,23,0,0,0,7,7,0,11,11,0,5,5,0,113,47,66,0,,65,1,64,83,1,82
26/11/2022 15:00,11,9,2,23,16,7,36,20,16,0,0,0,5,4,1,9,9,0,5,5,0,92,46,46,0,,75,1,74,95,0,95
26/11/2022 16:00,9,7,2,12,6,6,27,14,13,0,0,0,8,8,0,4,4,0,5,5,0,100,41,59,0,,95,0,95,80,3,77
26/11/2022 17:00,14,8,6,14,9,5,22,9,13,0,0,0,4,3,1,5,5,0,2,2,0,119,59,60,0,,101,0,101,81,0,81
26/11/2022 18:00,9,5,4,11,8,3,18,10,8,0,0,0,3,3,0,9,9,0,1,1,0,110,50,60,0,,83,0,83,85,0,85
26/11/2022 19:00,8,2,6,8,5,3,14,8,6,0,0,0,3,3,0,6,6,0,0,0,0,82,42,40,0,,76,1,75,80,1,79
26/11/2022 20:00,8,4,4,4,1,3,9,2,7,0,0,0,3,2,1,4,4,0,0,0,0,64,29,35,0,,71,0,71,79,0,79
26/11/2022 21:00,8,7,1,6,4,2,2,0,2,0,0,0,4,4,0,2,2,0,0,0,0,44,23,21,0,,47,1,46,51,0,51
26/11/2022 22:00,3,2,1,6,3,3,7,2,5,0,0,0,0,0,0,1,1,0,0,0,0,48,29,19,0,,35,0,35,41,0,41
26/11/2022 23:00,3,1,2,5,2,3,8,4,4,0,0,0,0,0,0,3,3,0,1,1,0,44,28,16,0,,34,0,34,37,1,36
27/11/2022 00:00,2,0,2,2,2,0,5,1,4,0,0,0,1,1,0,1,1,0,1,1,0,32,21,11,0,,31,0,31,18,1,17
27/11/2022 01:00,0,0,0,4,3,1,1,0,1,0,0,0,2,2,0,0,0,0,1,1,0,20,13,7,0,,6,0,6,1,0,1
27/11/2022 02:00,0,0,0,1,1,0,5,2,3,0,0,0,0,0,0,0,0,0,1,1,0,14,11,3,0,,27,0,27,6,0,6
27/11/2022 03:00,1,0,1,0,0,0,1,0,1,0,0,0,0,0,0,0,0,0,0,0,0,23,17,6,0,,24,0,24,4,0,4
27/11/2022 04:00,1,0,1,0,0,0,0,0,0,0,0,0,1,1,0,0,0,0,0,0,0,7,5,2,0,,11,0,11,4,0,4
27/11/2022 05:00,1,1,0,2,2,0,3,2,1,0,0,0,0,0,0,1,1,0,0,0,0,6,2,4,0,,7,0,7,3,0,3
27/11/2022 06:00,3,3,0,3,2,1,4,0,4,0,0,0,3,3,0,1,1,0,1,1,0,25,11,14,0,,8,0,8,3,0,3
27/11/2022 07:00,2,1,1,15,5,10,25,5,20,0,0,0,8,8,0,2,2,0,1,1,0,37,10,27,0,,6,0,6,7,0,7
27/11/2022 08:00,8,6,2,70,31,39,74,30,44,0,0,0,5,5,0,5,5,0,4,4,0,53,19,34,0,,10,0,10,23,0,23
27/11/2022 09:00,7,6,1,91,34,57,103,36,67,0,0,0,1,1,0,11,11,0,6,6,0,57,15,42,0,,18,0,18,31,0,31
27/11/2022 10:00,8,4,4,109,52,57,150,58,92,0,0,0,8,8,0,20,20,0,8,8,0,75,21,54,0,,26,1,25,49,0,49
27/11/2022 11:00,11,6,5,137,64,73,144,57,87,0,0,0,2,2,0,22,22,0,0,0,0,84,31,53,0,,40,1,39,55,0,55
27/11/2022 12:00,12,7,5,103,57,46,132,76,56,0,0,0,1,1,0,19,19,0,0,0,0,81,23,58,0,,40,0,40,55,1,54
27/11/2022 13:00,13,9,4,65,35,30,103,49,54,0,0,0,0,0,0,21,21,0,0,0,0,90,36,54,0,,52,0,52,91,1,90
27/11/2022 14:00,20,12,8,81,41,40,100,47,53,0,0,0,1,1,0,23,23,0,1,1,0,81,36,45,0,,55,1,54,89,0,89
27/11/2022 15:00,19,9,10,55,30,25,104,52,52,0,0,0,0,0,0,16,16,0,0,0,0,91,58,33,0,,73,0,73,101,2,99
27/11/2022 16:00,9,3,6,29,21,8,52,31,21,0,0,0,0,0,0,12,12,0,0,0,0,96,40,56,0,,69,2,67,66,2,64
27/11/2022 17:00,10,3,7,13,7,6,36,20,16,0,0,0,0,0,0,9,9,0,0,0,0,100,47,53,0,,95,1,94,77,1,76
27/11/2022 18:00,8,1,7,17,9,8,15,9,6,0,0,0,7,7,0,10,10,0,1,1,0,101,58,43,0,,97,1,96,96,0,96
27/11/2022 19:00,4,2,2,4,4,0,6,4,2,0,0,0,3,3,0,12,12,0,1,1,0,63,29,34,0,,81,0,81,57,1,56
27/11/2022 20:00,3,0,3,4,2,2,16,7,9,0,0,0,4,4,0,6,6,0,3,3,0,52,30,22,0,,66,0,66,80,0,80
27/11/2022 21:00,10,9,1,2,2,0,9,2,7,0,0,0,4,4,0,4,4,0,3,3,0,51,31,20,0,,71,3,68,52,0,52
27/11/2022 22:00,2,0,2,7,6,1,8,4,4,0,0,0,1,1,0,5,5,0,1,1,0,42,23,19,0,,41,0,41,26,0,26
27/11/2022 23:00,1,0,1,2,1,1,6,3,3,0,0,0,0,0,0,3,3,0,0,0,0,18,13,5,0,,24,0,24,8,0,8
28/11/2022 00:00,1,1,0,1,0,1,3,1,2,0,0,0,0,0,0,1,1,0,1,1,0,17,14,3,0,,12,0,12,6,0,6
28/11/2022 01:00,0,0,0,1,1,0,0,0,0,0,0,0,0,0,0,1,1,0,0,0,0,4,4,0,0,,3,0,3,0,0,0
28/11/2022 02:00,1,0,1,0,0,0,0,0,0,0,0,0,0,0,0,0,0,0,0,0,0,5,4,1,0,,4,0,4,1,0,1
28/11/2022 03:00,0,0,0,0,0,0,0,0,0,0,0,0,0,0,0,0,0,0,0,0,0,2,1,1,0,,3,0,3,3,0,3
28/11/2022 04:00,1,1,0,0,0,0,0,0,0,0,0,0,2,2,0,0,0,0,0,0,0,1,0,1,0,,3,0,3,2,0,2
28/11/2022 05:00,6,5,1,5,3,2,8,5,3,0,0,0,4,4,0,3,3,0,0,0,0,30,8,22,0,,3,0,3,6,0,6
28/11/2022 06:00,14,12,2,18,13,5,17,14,3,0,0,0,9,9,0,5,5,0,0,0,0,120,24,96,0,,7,0,7,25,0,25
28/11/2022 07:00,37,32,5,50,39,11,61,49,12,0,0,0,17,17,0,12,12,0,0,0,0,258,68,190,0,,27,0,27,67,0,67
28/11/2022 08:00,110,96,14,71,60,11,104,85,19,0,0,0,16,16,0,46,46,0,3,3,0,515,89,426,0,,55,1,54,190,0,190
28/11/2022 09:00,36,33,3,36,22,14,47,29,18,0,0,0,11,11,0,12,12,0,5,5,0,224,44,180,0,,41,1,40,141,1,140
28/11/2022 10:00,11,8,3,27,20,7,29,16,13,0,0,0,2,2,0,7,7,0,8,8,0,78,22,56,0,,23,0,23,61,1,60
28/11/2022 11:00,13,9,4,22,4,18,31,10,21,0,0,0,2,2,0,8,8,0,1,1,0,78,29,49,0,,30,0,30,55,1,54
28/11/2022 12:00,22,17,5,26,14,12,42,22,20,0,0,0,3,2,1,10,10,0,0,0,0,99,35,64,0,,60,1,59,83,1,82
28/11/2022 13:00,29,20,9,43,21,22,54,24,30,0,0,0,0,0,0,23,23,0,0,0,0,118,49,69,0,,63,0,63,85,0,85
28/11/2022 14:00,12,4,8,34,20,14,35,14,21,0,0,0,1,1,0,17,17,0,0,0,0,92,35,57,0,,80,0,80,58,1,57
28/11/2022 15:00,22,5,17,32,10,22,42,16,26,0,0,0,3,3,0,41,41,0,1,1,0,147,86,61,0,,79,0,79,75,0,75
28/11/2022 16:00,26,10,16,49,25,24,58,24,34,0,0,0,0,0,0,43,43,0,1,1,0,232,138,94,0,,125,2,123,61,1,60
28/11/2022 17:00,55,16,39,69,17,52,89,15,74,0,0,0,0,0,0,29,29,0,2,2,0,396,264,132,0,,224,2,222,90,0,90
28/11/2022 18:00,24,5,19,63,16,47,89,20,69,0,0,0,5,5,0,24,24,0,0,0,0,300,201,99,0,,163,2,161,98,0,98
28/11/2022 19:00,12,4,8,41,12,29,48,12,36,0,0,0,3,3,0,12,12,0,0,0,0,151,95,56,0,,98,0,98,59,1,58
28/11/2022 20:00,11,6,5,22,10,12,30,11,19,0,0,0,2,2,0,14,14,0,1,1,0,101,69,32,0,,77,0,77,44,2,42
28/11/2022 21:00,8,2,6,13,5,8,18,4,14,0,0,0,6,6,0,12,12,0,1,1,0,90,56,34,0,,53,0,53,37,0,37
28/11/2022 22:00,3,2,1,1,1,0,6,3,3,0,0,0,0,0,0,5,5,0,1,1,0,54,37,17,0,,40,0,40,23,0,23
28/11/2022 23:00,2,1,1,1,0,1,2,1,1,0,0,0,0,0,0,1,1,0,0,0,0,29,25,4,0,,34,0,34,12,1,11
29/11/2022 00:00,0,0,0,0,0,0,1,1,0,0,0,0,0,0,0,1,1,0,0,0,0,19,16,3,0,,13,0,13,6,0,6
29/11/2022 01:00,1,0,1,1,0,1,0,0,0,0,0,0,1,1,0,0,0,0,0,0,0,3,2,1,0,,2,0,2,0,0,0
29/11/2022 02:00,0,0,0,0,0,0,0,0,0,0,0,0,0,0,0,0,0,0,0,0,0,4,3,1,0,,4,0,4,2,0,2
29/11/2022 03:00,0,0,0,0,0,0,0,0,0,0,0,0,1,1,0,0,0,0,0,0,0,2,1,1,0,,3,0,3,1,0,1
29/11/2022 04:00,1,1,0,0,0,0,0,0,0,0,0,0,0,0,0,0,0,0,0,0,0,2,0,2,0,,2,0,2,2,0,2
29/11/2022 05:00,4,4,0,4,4,0,9,6,3,0,0,0,3,3,0,2,2,0,0,0,0,30,5,25,0,,2,0,2,7,0,7
29/11/2022 06:00,17,13,4,16,13,3,18,14,4,0,0,0,4,4,0,5,5,0,0,0,0,114,25,89,0,,9,1,8,27,0,27
29/11/2022 07:00,58,55,3,73,58,15,81,63,18,0,0,0,29,28,1,21,21,0,3,3,0,332,74,258,0,,29,0,29,90,0,90
29/11/2022 08:00,152,131,21,86,67,19,123,104,19,0,0,0,60,60,0,57,57,0,21,21,0,733,112,621,0,,60,1,59,235,1,234
29/11/2022 09:00,52,45,7,53,33,20,71,45,26,0,0,0,41,41,0,13,13,0,0,0,0,272,41,231,0,,36,0,36,167,0,167
29/11/2022 10:00,10,9,1,59,31,28,64,30,34,0,0,0,16,16,0,8,8,0,0,0,0,105,29,76,0,,28,1,27,55,0,55
29/11/2022 11:00,11,8,3,42,21,21,42,18,24,0,0,0,14,14,0,13,13,0,0,0,0,73,19,54,0,,45,0,45,55,0,55
29/11/2022 12:00,18,12,6,70,31,39,65,31,34,0,0,0,4,4,0,13,13,0,0,0,0,96,35,61,0,,50,0,50,93,0,93
29/11/2022 13:00,18,6,12,40,23,17,52,26,26,0,0,0,1,1,0,21,21,0,0,0,0,117,43,74,0,,95,3,92,106,1,105
29/11/2022 14:00,14,7,7,48,19,29,51,22,29,0,0,0,1,1,0,25,25,0,0,0,0,97,39,58,0,,81,1,80,63,1,62
29/11/2022 15:00,26,14,12,46,22,24,61,25,36,0,0,0,1,1,0,52,52,0,0,0,0,136,78,58,0,,79,0,79,49,0,49
29/11/2022 16:00,47,19,28,51,25,26,69,25,44,0,0,0,2,2,0,44,44,0,0,0,0,243,158,85,0,,129,0,129,86,0,86
29/11/2022 17:00,72,20,52,90,20,70,129,26,103,0,0,0,3,3,0,42,42,0,0,0,0,463,326,137,0,,269,2,267,122,0,122
29/11/2022 18:00,54,16,38,73,16,57,103,17,86,0,0,0,6,6,0,29,29,0,0,0,0,353,244,109,0,,220,1,219,127,0,127
29/11/2022 19:00,25,3,22,40,8,32,60,13,47,0,0,0,1,1,0,22,22,0,0,0,0,192,127,65,0,,129,0,129,75,0,75
29/11/2022 20:00,8,1,7,33,15,18,38,12,26,0,0,0,3,3,0,11,11,0,0,0,0,130,86,44,0,,102,0,102,79,0,79
29/11/2022 21:00,8,3,5,16,4,12,22,8,14,0,0,0,5,5,0,10,10,0,0,0,0,99,74,25,0,,68,2,66,59,0,59
29/11/2022 22:00,8,3,5,11,4,7,14,2,12,0,0,0,2,2,0,5,5,0,1,1,0,70,50,20,0,,69,0,69,27,0,27
29/11/2022 23:00,3,2,1,2,0,2,2,0,2,0,0,0,1,1,0,4,4,0,0,0,0,35,29,6,0,,29,0,29,21,0,21
30/11/2022 00:00,0,0,0,0,0,0,0,0,0,0,0,0,0,0,0,2,2,0,0,0,0,14,12,2,0,,25,3,22,14,0,14
30/11/2022 01:00,0,0,0,0,0,0,1,0,1,0,0,0,1,1,0,0,0,0,0,0,0,3,3,0,0,,0,0,0,0,0,0
30/11/2022 02:00,0,0,0,1,0,1,2,0,2,0,0,0,0,0,0,0,0,0,0,0,0,6,3,3,0,,7,0,7,0,0,0
30/11/2022 03:00,0,0,0,1,1,0,0,0,0,0,0,0,1,1,0,0,0,0,0,0,0,3,3,0,0,,3,0,3,1,0,1
30/11/2022 04:00,2,1,1,0,0,0,1,1,0,0,0,0,0,0,0,0,0,0,0,0,0,3,1,2,0,,2,0,2,2,0,2
30/11/2022 05:00,3,3,0,6,5,1,10,5,5,0,0,0,4,4,0,1,1,0,0,0,0,28,3,25,0,,5,0,5,8,1,7
30/11/2022 06:00,15,12,3,16,15,1,21,17,4,0,0,0,10,10,0,6,6,0,0,0,0,120,28,92,0,,9,1,8,35,0,35
30/11/2022 07:00,56,52,4,61,48,13,77,58,19,0,0,0,21,21,0,12,12,0,0,0,0,306,74,232,0,,37,0,37,84,0,84
30/11/2022 08:00,145,125,20,105,84,21,132,112,20,0,0,0,52,52,0,51,51,0,1,1,0,618,95,523,0,,58,0,58,212,0,212
30/11/2022 09:00,57,48,9,38,20,18,53,29,24,0,0,0,24,24,0,12,12,0,0,0,0,273,40,233,0,,43,0,43,176,0,176
30/11/2022 10:00,21,18,3,40,20,20,41,20,21,0,0,0,12,12,0,7,7,0,1,1,0,104,29,75,0,,41,0,41,63,0,63
30/11/2022 11:00,17,9,8,36,22,14,41,22,19,0,0,0,15,15,0,14,14,0,0,0,0,87,31,56,0,,53,1,52,53,0,53
30/11/2022 12:00,22,13,9,36,16,20,52,26,26,0,0,0,2,2,0,13,13,0,0,0,0,109,39,70,0,,81,2,79,84,1,83
30/11/2022 13:00,16,8,8,37,17,20,44,22,22,0,0,0,11,11,0,29,29,0,0,0,0,144,75,69,0,,99,3,96,104,1,103
30/11/2022 14:00,13,2,11,27,17,10,32,14,18,0,0,0,12,12,0,18,18,0,0,0,0,116,60,56,0,,97,0,97,74,0,74
30/11/2022 15:00,13,6,7,17,4,13,34,10,24,0,0,0,6,6,0,53,53,0,0,0,0,146,84,62,0,,73,1,72,78,1,77
30/11/2022 16:00,29,12,17,36,13,23,51,22,29,0,0,0,4,4,0,36,36,0,1,1,0,221,130,91,0,,145,1,144,86,0,86
30/11/2022 17:00,51,15,36,66,11,55,97,10,87,0,0,0,6,6,0,40,40,0,0,0,0,396,275,121,0,,236,1,235,119,0,119
30/11/2022 18:00,42,10,32,76,11,65,105,17,88,0,0,0,5,5,0,27,27,0,0,0,0,361,239,122,0,,222,2,220,135,1,134
30/11/2022 19:00,26,10,16,39,11,28,58,15,43,0,0,0,2,2,0,14,14,0,0,0,0,217,128,89,0,,136,1,135,98,0,98
30/11/2022 20:00,7,0,7,14,7,7,26,6,20,0,0,0,2,2,0,19,19,0,0,0,0,119,83,36,0,,107,0,107,89,0,89
30/11/2022 21:00,10,4,6,19,5,14,20,7,13,0,0,0,0,0,0,13,13,0,0,0,0,114,79,35,0,,90,0,90,65,1,64
30/11/2022 22:00,14,7,7,11,4,7,16,5,11,0,0,0,2,2,0,7,7,0,0,0,0,85,58,27,0,,71,1,70,48,0,48
30/11/2022 23:00,1,1,0,4,1,3,5,2,3,0,0,0,2,2,0,2,2,0,0,0,0,52,43,9,0,,59,0,59,22,1,21
01/12/2022 00:00,2,0,2,1,1,0,6,4,2,0,0,0,0,0,0,4,4,0,0,0,0,34,27,7,0,,46,0,46,7,0,7
01/12/2022 01:00,1,0,1,0,0,0,0,0,0,0,0,0,0,0,0,1,1,0,0,0,0,10,8,2,0,,2,0,2,0,0,0
01/12/2022 02:00,0,0,0,0,0,0,0,0,0,0,0,0,0,0,0,0,0,0,0,0,0,6,4,2,0,,7,0,7,4,0,4
01/12/2022 03:00,0,0,0,0,0,0,0,0,0,0,0,0,0,0,0,0,0,0,0,0,0,2,2,0,0,,3,0,3,1,0,1
01/12/2022 04:00,2,1,1,0,0,0,0,0,0,0,0,0,0,0,0,0,0,0,0,0,0,5,2,3,0,,5,0,5,1,0,1
01/12/2022 05:00,3,3,0,3,2,1,8,3,5,0,0,0,2,2,0,2,2,0,0,0,0,29,7,22,0,,2,0,2,4,0,4
01/12/2022 06:00,20,17,3,21,16,5,20,16,4,0,0,0,11,11,0,7,7,0,0,0,0,114,28,86,0,,8,0,8,24,0,24
01/12/2022 07:00,52,47,5,48,39,9,68,58,10,0,0,0,16,14,2,16,16,0,0,0,0,272,56,216,0,,32,1,31,74,0,74
01/12/2022 08:00,148,130,18,79,64,15,109,92,17,0,0,0,66,65,1,46,46,0,1,1,0,614,105,509,0,,66,1,65,224,0,224
01/12/2022 09:00,42,40,2,41,23,18,71,44,27,0,0,0,31,31,0,16,16,0,0,0,0,299,39,260,0,,39,2,37,163,0,163
01/12/2022 10:00,19,10,9,44,23,21,50,30,20,0,0,0,11,11,0,7,7,0,0,0,0,98,21,77,0,,19,0,19,77,0,77
01/12/2022 11:00,16,11,5,48,25,23,51,26,25,0,0,0,6,6,0,10,10,0,1,1,0,87,32,55,0,,41,0,41,76,0,76
01/12/2022 12:00,20,12,8,40,20,20,51,23,28,0,0,0,7,6,1,17,17,0,0,0,0,107,40,67,0,,62,1,61,72,0,72
01/12/2022 13:00,18,7,11,43,18,25,63,29,34,0,0,0,9,9,0,22,22,0,0,0,0,119,46,73,0,,91,1,90,94,0,94
01/12/2022 14:00,23,11,12,33,13,20,53,20,33,0,0,0,4,4,0,17,17,0,0,0,0,121,62,59,0,,66,1,65,81,2,79
01/12/2022 15:00,28,16,12,58,21,37,65,23,42,0,0,0,7,7,0,37,37,0,1,1,0,168,96,72,0,,102,0,102,81,0,81
01/12/2022 16:00,36,11,25,54,18,36,75,20,55,0,0,0,12,11,1,33,33,0,0,0,0,242,151,91,0,,124,2,122,75,0,75
01/12/2022 17:00,44,18,26,67,11,56,93,23,70,0,0,0,3,3,0,27,27,0,1,1,0,379,238,141,0,,250,1,249,147,0,147
01/12/2022 18:00,43,11,32,71,17,54,94,28,66,0,0,0,2,2,0,31,31,0,0,0,0,376,253,123,0,,190,1,189,142,0,142
01/12/2022 19:00,22,11,11,34,15,19,46,15,31,0,0,0,2,2,0,20,20,0,0,0,0,194,118,76,0,,150,0,150,104,1,103
01/12/2022 20:00,9,3,6,24,12,12,37,16,21,0,0,0,5,5,0,13,13,0,0,0,0,147,96,51,0,,92,1,91,81,0,81
01/12/2022 21:00,7,4,3,12,6,6,18,5,13,0,0,0,4,4,0,13,13,0,0,0,0,106,62,44,0,,83,1,82,73,0,73
01/12/2022 22:00,11,7,4,12,5,7,13,7,6,0,0,0,1,1,0,7,7,0,0,0,0,94,67,27,0,,58,0,58,26,0,26
01/12/2022 23:00,4,2,2,1,0,1,5,0,5,0,0,0,0,0,0,3,3,0,1,1,0,55,38,17,0,,54,0,54,31,1,30
